"","Query.seq.ID","Subject.seq.ID","X.ID","Alignment.length","X..mismatches","X..gap.openings","start.in.query","end.in.query","start.in.subject","end.in.subject","evalue","bitscore","match.length.query","match.length.subject"
"1","Ntome_NODE_1_length_16607_cov_83","Nsylvestris_NODE_1_length_19140_cov_79",98.129,16624,248,22,21,16607,1801,18398,0,28917,16586,16597
"241","Ntome_NODE_41_length_10213_cov_186","Nsylvestris_NODE_31_length_10192_cov_149",97.736,10157,195,8,71,10213,40,10175,0,17450,10142,10135
"702","Ntome_NODE_138_length_7978_cov_141","Nsylvestris_NODE_122_length_8122_cov_92",97.722,7989,141,13,1,7976,62,8022,0,13706,7975,7960
"1048","Ntome_NODE_213_length_7347_cov_33","Nsylvestris_NODE_470_length_6031_cov_12",100,28,0,0,5296,5323,555,528,5.38e-05,52.8,27,27
"1229","Ntome_NODE_243_length_7128_cov_113","Nsylvestris_NODE_419_length_6212_cov_98",95.652,46,2,0,7072,7117,5050,5095,1.11e-11,75,45,45
"1276","Ntome_NODE_252_length_7064_cov_77","Nsylvestris_NODE_1085_length_4831_cov_262",80.856,4346,723,78,2223,6506,4458,160,0,3315,4283,4298
"1325","Ntome_NODE_265_length_6989_cov_204","Nsylvestris_NODE_258_length_6946_cov_183",97.032,6975,154,17,29,6979,1,6946,0,11684,6950,6945
"1547","Ntome_NODE_301_length_6721_cov_124","Nsylvestris_NODE_379_length_6394_cov_159",97.326,6358,163,7,183,6538,6353,1,0,10792,6355,6352
"1573","Ntome_NODE_306_length_6678_cov_26","Nsylvestris_NODE_1538_length_4371_cov_113",95.082,61,3,0,1,61,4103,4043,2.23e-18,97.1,60,60
"1591","Ntome_NODE_311_length_6659_cov_97","Nsylvestris_NODE_263_length_6934_cov_93",95.917,6612,208,18,55,6610,194,6799,0,10658,6555,6605
"1657","Ntome_NODE_323_length_6619_cov_19","Nsylvestris_NODE_10301_length_2075_cov_38",73.469,343,82,8,4759,5098,192,528,1.31e-25,121,339,336
"1761","Ntome_NODE_351_length_6498_cov_169","Nsylvestris_NODE_359_length_6446_cov_171",97.08,6405,159,12,36,6422,33,6427,0,10767,6386,6394
"2093","Ntome_NODE_415_length_6251_cov_172","Nsylvestris_NODE_495_length_5979_cov_90",96.035,5901,187,21,373,6245,49,5930,0,9557,5872,5881
"2224","Ntome_NODE_442_length_6185_cov_261","Nsylvestris_NODE_481_length_6006_cov_227",98.062,5986,83,9,88,6051,7,5981,0,10381,5963,5974
"2274","Ntome_NODE_454_length_6143_cov_308","Nsylvestris_NODE_429_length_6174_cov_233",97.895,5892,103,7,3,5888,6120,244,0,10174,5885,5876
"2343","Ntome_NODE_472_length_6098_cov_47","Nsylvestris_NODE_470_length_6031_cov_12",79.729,2728,503,35,1345,4057,4684,1992,0,1929,2712,2692
"2513","Ntome_NODE_495_length_6033_cov_297","Nsylvestris_NODE_535_length_5858_cov_220",97.698,5865,110,10,64,5912,5856,1,0,10059,5848,5855
"2604","Ntome_NODE_515_length_5978_cov_313","Nsylvestris_NODE_102_length_8418_cov_231",96.652,5973,168,13,19,5978,4,5957,0,9893,5959,5953
"2647","Ntome_NODE_526_length_5953_cov_134","Nsylvestris_NODE_10559_length_2042_cov_212",94.868,2007,78,11,3,1992,2018,20,0,3112,1989,1998
"2774","Ntome_NODE_552_length_5891_cov_62","Nsylvestris_NODE_1027_length_4901_cov_151",97.178,4040,114,0,1806,5845,543,4582,0,6830,4039,4039
"2814","Ntome_NODE_563_length_5853_cov_23","Nsylvestris_NODE_71_length_8986_cov_19",72.05,322,76,13,1395,1709,4329,4015,1.52e-14,84.2,314,314
"2830","Ntome_NODE_567_length_5837_cov_30","Nsylvestris_NODE_36942_length_253_cov_3",92.683,246,17,1,3955,4199,253,8,1.05e-95,353,244,245
"2837","Ntome_NODE_569_length_5831_cov_290","Nsylvestris_NODE_632_length_5617_cov_228",96.078,5635,161,27,169,5785,20,5612,0,9127,5616,5592
"2879","Ntome_NODE_579_length_5810_cov_102","Nsylvestris_NODE_11124_length_1973_cov_167",95.827,1246,30,6,4586,5810,719,1963,0,1993,1224,1244
"3257","Ntome_NODE_666_length_5627_cov_283","Nsylvestris_NODE_577_length_5757_cov_217",96.688,5585,132,16,10,5581,5754,210,0,9239,5571,5544
"3277","Ntome_NODE_672_length_5613_cov_39","Nsylvestris_NODE_1202_length_4705_cov_14",71.331,1458,362,41,2425,3846,3262,4699,2.19e-87,326,1421,1437
"3432","Ntome_NODE_712_length_5539_cov_171","Nsylvestris_NODE_9641_length_2159_cov_203",95.06,2085,67,14,3422,5481,29,2102,0,3247,2059,2073
"3479","Ntome_NODE_722_length_5523_cov_201","Nsylvestris_NODE_418_length_6225_cov_175",97.787,5513,116,1,1,5513,5562,56,0,9500,5512,5506
"3513","Ntome_NODE_729_length_5505_cov_63","Nsylvestris_NODE_8984_length_2253_cov_115",100,55,0,0,1,55,1603,1549,3.94e-20,102,54,54
"3720","Ntome_NODE_777_length_5425_cov_249","Nsylvestris_NODE_527_length_5882_cov_161",96.189,5379,157,12,1,5359,523,5873,0,8754,5358,5350
"3751","Ntome_NODE_786_length_5407_cov_259","Nsylvestris_NODE_896_length_5092_cov_162",97.277,5032,114,12,178,5194,66,5089,0,8512,5016,5023
"3783","Ntome_NODE_796_length_5390_cov_268","Nsylvestris_NODE_710_length_5408_cov_215",96.411,5377,135,16,43,5381,19,5375,0,8807,5338,5356
"3851","Ntome_NODE_814_length_5361_cov_301","Nsylvestris_NODE_784_length_5259_cov_192",97.889,5211,89,9,154,5349,52,5256,0,8994,5195,5204
"3927","Ntome_NODE_833_length_5338_cov_294","Nsylvestris_NODE_807_length_5236_cov_202",97.639,5209,98,7,51,5257,5186,1,0,8914,5206,5185
"3936","Ntome_NODE_836_length_5327_cov_252","Nsylvestris_NODE_740_length_5365_cov_202",98.297,5225,78,9,46,5264,5265,46,0,9145,5218,5219
"3946","Ntome_NODE_839_length_5322_cov_110","Nsylvestris_NODE_6592_length_2644_cov_144",94.828,58,3,0,2139,2196,1598,1541,8.25e-17,91.6,57,57
"4067","Ntome_NODE_866_length_5276_cov_251","Nsylvestris_NODE_872_length_5122_cov_205",95.885,5128,155,27,29,5143,4,5088,0,8250,5114,5084
"4105","Ntome_NODE_875_length_5260_cov_302","Nsylvestris_NODE_749_length_5353_cov_163",80,105,16,5,3211,3312,2784,2886,2.95e-11,73.1,101,102
"4244","Ntome_NODE_908_length_5215_cov_33","Nsylvestris_NODE_2263_length_3909_cov_15",71.249,1593,407,44,1795,3360,1715,147,7.22e-97,357,1565,1568
"4358","Ntome_NODE_934_length_5187_cov_285","Nsylvestris_NODE_10211_length_2087_cov_73",84.81,79,10,2,2326,2403,83,6,6.26e-13,78.7,77,77
"4409","Ntome_NODE_949_length_5168_cov_79","Nsylvestris_NODE_255_length_6967_cov_81",96.059,4973,175,13,1,4961,6890,1927,0,8078,4960,4963
"4437","Ntome_NODE_958_length_5154_cov_213","Nsylvestris_NODE_7294_length_2519_cov_69",83.648,159,16,8,3,152,1317,1474,7.82e-32,141,149,157
"4517","Ntome_NODE_981_length_5116_cov_292","Nsylvestris_NODE_974_length_4986_cov_218",95.546,4939,189,5,158,5065,48,4986,0,7873,4907,4938
"4559","Ntome_NODE_991_length_5102_cov_77","Nsylvestris_NODE_3059_length_3562_cov_193",92.727,55,3,1,5049,5102,1815,1869,6.16e-13,78.7,53,54
"4899","Ntome_NODE_1065_length_5003_cov_107","Nsylvestris_NODE_15414_length_1511_cov_145",86.493,422,54,3,4501,4920,449,29,5.13e-128,460,419,420
"4915","Ntome_NODE_1071_length_4997_cov_170","Nsylvestris_NODE_5618_length_2835_cov_153",96.465,2433,77,6,154,2579,2823,393,0,4008,2425,2430
"4956","Ntome_NODE_1083_length_4976_cov_69","Nsylvestris_NODE_1297_length_4596_cov_158",85.294,238,24,8,307,535,1585,1350,3.37e-60,235,228,235
"4983","Ntome_NODE_1089_length_4965_cov_62","Nsylvestris_NODE_6020_length_2757_cov_35",81.533,287,45,4,4507,4789,347,65,1.56e-58,230,282,282
"5005","Ntome_NODE_1096_length_4954_cov_237","Nsylvestris_NODE_250_length_6992_cov_162",98.046,4963,88,2,1,4954,1100,6062,0,8619,4953,4962
"5012","Ntome_NODE_1099_length_4946_cov_245","Nsylvestris_NODE_1158_length_4748_cov_123",96.375,4662,149,7,81,4737,52,4698,0,7655,4656,4646
"5071","Ntome_NODE_1114_length_4934_cov_251","Nsylvestris_NODE_11155_length_1968_cov_32",87.68,487,46,10,603,1086,863,388,2.26e-156,555,483,475
"5144","Ntome_NODE_1132_length_4916_cov_30","Nsylvestris_NODE_925_length_5053_cov_43",96.469,4899,158,7,1,4885,4898,1,0,8074,4884,4897
"5171","Ntome_NODE_1139_length_4908_cov_252","Nsylvestris_NODE_1191_length_4709_cov_224",97.342,4627,92,13,1,4599,4625,2,0,7834,4598,4623
"5177","Ntome_NODE_1141_length_4905_cov_158","Nsylvestris_NODE_22833_length_900_cov_206",88.187,364,39,4,1084,1445,485,124,3.94e-119,431,361,361
"5181","Ntome_NODE_1143_length_4904_cov_140","Nsylvestris_NODE_989_length_4970_cov_182",96.412,4905,120,27,8,4902,4967,109,0,8032,4894,4858
"5225","Ntome_NODE_1150_length_4898_cov_30","Nsylvestris_NODE_36370_length_264_cov_4",83.571,280,30,4,139,418,1,264,4.26e-64,248,279,263
"5309","Ntome_NODE_1171_length_4873_cov_148","Nsylvestris_NODE_28816_length_592_cov_8",79.897,388,64,9,2322,2696,3,389,2.52e-71,272,374,386
"5316","Ntome_NODE_1174_length_4867_cov_56","Nsylvestris_NODE_24646_length_792_cov_12",87.603,242,27,3,4627,4867,792,553,5.4e-73,278,240,239
"5352","Ntome_NODE_1183_length_4859_cov_78","Nsylvestris_NODE_1054_length_4875_cov_139",89.13,46,5,0,3861,3906,2716,2671,7.64e-07,58.4,45,45
"5561","Ntome_NODE_1229_length_4799_cov_42","Nsylvestris_NODE_1323_length_4569_cov_70",69.274,1061,274,41,2118,3159,1462,2489,2.66e-21,106,1041,1027
"5666","Ntome_NODE_1258_length_4773_cov_108","Nsylvestris_NODE_1219_length_4685_cov_90",91.304,46,4,0,3056,3101,3105,3150,1.61e-08,63.9,45,45
"5761","Ntome_NODE_1282_length_4750_cov_151","Nsylvestris_NODE_12558_length_1808_cov_220",96.014,1430,54,2,3249,4675,1597,168,0,2322,1426,1429
"5774","Ntome_NODE_1285_length_4749_cov_57","Nsylvestris_NODE_1121_length_4799_cov_231",96.881,4649,89,12,27,4662,53,4658,0,7731,4635,4605
"5775","Ntome_NODE_1286_length_4745_cov_279","Nsylvestris_NODE_583_length_5741_cov_230",95.966,4611,177,7,136,4743,4605,1,0,7476,4607,4604
"5776","Ntome_NODE_1287_length_4745_cov_261","Nsylvestris_NODE_1440_length_4458_cov_209",98.057,4374,64,11,133,4489,42,4411,0,7587,4356,4369
"5970","Ntome_NODE_1332_length_4699_cov_92","Nsylvestris_NODE_2253_length_3913_cov_88",98.827,3581,42,0,3,3583,3853,273,0,6381,3580,3580
"5971","Ntome_NODE_1333_length_4697_cov_56","Nsylvestris_NODE_5929_length_2775_cov_116",95.367,2439,105,6,63,2496,54,2489,0,3871,2433,2435
"5978","Ntome_NODE_1336_length_4695_cov_24","Nsylvestris_NODE_26398_length_700_cov_154",98.182,55,1,0,4641,4695,254,308,1.57e-18,97.1,54,54
"6011","Ntome_NODE_1344_length_4686_cov_245","Nsylvestris_NODE_35193_length_291_cov_2",83.085,201,32,2,4131,4330,10,209,4.19e-44,182,199,199
"6012","Ntome_NODE_1345_length_4686_cov_49","Nsylvestris_NODE_863_length_5146_cov_222",76.881,2366,479,44,836,3157,848,3189,0,1277,2321,2341
"6040","Ntome_NODE_1352_length_4677_cov_27","Nsylvestris_NODE_187_length_7443_cov_93",81.604,212,31,7,316,522,1,209,3.26e-40,169,206,208
"6075","Ntome_NODE_1360_length_4668_cov_84","Nsylvestris_NODE_756_length_5337_cov_164",96.732,4406,130,7,31,4428,5269,870,0,7326,4397,4399
"6087","Ntome_NODE_1364_length_4663_cov_85","Nsylvestris_NODE_30981_length_453_cov_2",80.8,125,24,0,1212,1336,232,108,4.32e-19,99,124,124
"6129","Ntome_NODE_1376_length_4654_cov_58","Nsylvestris_NODE_3095_length_3545_cov_13",79.116,747,145,6,3918,4654,1418,673,2.18e-141,505,736,745
"6183","Ntome_NODE_1391_length_4641_cov_162","Nsylvestris_NODE_1378_length_4523_cov_106",94.894,4426,191,14,86,4506,4444,49,0,6889,4420,4395
"6313","Ntome_NODE_1417_length_4614_cov_68","Nsylvestris_NODE_1483_length_4412_cov_12",93.462,4451,233,14,147,4578,4412,1,0,6554,4431,4411
"6314","Ntome_NODE_1418_length_4613_cov_296","Nsylvestris_NODE_1086_length_4831_cov_220",94.983,4624,196,19,12,4607,1,4616,0,7221,4595,4615
"6527","Ntome_NODE_1470_length_4560_cov_135","Nsylvestris_NODE_983_length_4978_cov_134",97.678,3488,76,1,1,3488,4563,1081,0,5987,3487,3482
"6535","Ntome_NODE_1472_length_4558_cov_41","Nsylvestris_NODE_25991_length_718_cov_44",84.404,327,50,1,4233,4558,3,329,8.28e-86,320,325,326
"6540","Ntome_NODE_1474_length_4556_cov_66","Nsylvestris_NODE_127_length_8073_cov_98",97.87,4554,89,2,1,4554,4558,13,0,7866,4553,4545
"6743","Ntome_NODE_1525_length_4517_cov_41","Nsylvestris_NODE_36186_length_269_cov_3",93.6,125,7,1,613,736,238,114,3.12e-45,185,123,124
"6771","Ntome_NODE_1533_length_4512_cov_82","Nsylvestris_NODE_14157_length_1635_cov_6",84.345,1367,173,18,3095,4436,40,1390,0,1301,1341,1350
"6815","Ntome_NODE_1542_length_4499_cov_296","Nsylvestris_NODE_1558_length_4355_cov_230",97.108,4184,87,13,222,4381,4174,1,0,7025,4159,4173
"6861","Ntome_NODE_1555_length_4491_cov_264","Nsylvestris_NODE_1525_length_4376_cov_205",97.62,4328,89,10,137,4462,4376,61,0,7409,4325,4315
"7001","Ntome_NODE_1593_length_4459_cov_160","Nsylvestris_NODE_3864_length_3280_cov_151",97.212,3192,82,3,1219,4410,3279,95,0,5395,3191,3184
"7050","Ntome_NODE_1605_length_4447_cov_298","Nsylvestris_NODE_1141_length_4765_cov_225",98.294,4279,67,5,139,4415,76,4350,0,7492,4276,4274
"7086","Ntome_NODE_1612_length_4446_cov_208","Nsylvestris_NODE_144_length_7837_cov_109",98.539,4448,60,5,1,4446,6137,1693,0,7849,4445,4444
"7134","Ntome_NODE_1623_length_4437_cov_13","Nsylvestris_NODE_5476_length_2867_cov_125",88.608,79,9,0,2494,2572,271,349,1.48e-18,97.1,78,78
"7221","Ntome_NODE_1648_length_4423_cov_294","Nsylvestris_NODE_442_length_6136_cov_195",96.367,4239,104,26,233,4423,6090,1854,0,6929,4190,4236
"7236","Ntome_NODE_1653_length_4420_cov_228","Nsylvestris_NODE_1853_length_4147_cov_145",97.283,4086,102,7,211,4294,4147,69,0,6922,4083,4078
"7268","Ntome_NODE_1662_length_4415_cov_159","Nsylvestris_NODE_528_length_5879_cov_117",95.009,4067,152,21,310,4365,20,4046,0,6338,4055,4026
"7315","Ntome_NODE_1676_length_4407_cov_65","Nsylvestris_NODE_1496_length_4403_cov_97",95.602,4184,151,7,238,4407,52,4216,0,6676,4169,4164
"7400","Ntome_NODE_1696_length_4385_cov_34","Nsylvestris_NODE_6173_length_2722_cov_72",91.137,1918,124,12,2491,4385,770,2664,0,2558,1894,1894
"7653","Ntome_NODE_1752_length_4341_cov_22","Nsylvestris_NODE_1454_length_4445_cov_170",96.204,4347,140,13,4,4341,73,4403,0,7090,4337,4330
"7681","Ntome_NODE_1762_length_4335_cov_80","Nsylvestris_NODE_11627_length_1916_cov_106",76.535,635,124,19,3,624,1294,1916,6.09e-87,324,621,622
"7740","Ntome_NODE_1776_length_4329_cov_144","Nsylvestris_NODE_7845_length_2429_cov_130",96.162,990,34,4,3247,4236,1372,2357,0,1615,989,985
"7741","Ntome_NODE_1777_length_4329_cov_53","Nsylvestris_NODE_1630_length_4311_cov_86",97.454,4242,92,12,4,4232,4288,50,0,7221,4228,4238
"7936","Ntome_NODE_1819_length_4295_cov_49","Nsylvestris_NODE_2035_length_4032_cov_82",95.907,3982,118,7,18,3956,3,3982,0,6408,3938,3979
"8144","Ntome_NODE_1867_length_4262_cov_153","Nsylvestris_NODE_1090_length_4831_cov_167",94.88,3203,124,21,34,3202,1635,4831,0,4970,3168,3196
"8271","Ntome_NODE_1900_length_4235_cov_126","Nsylvestris_NODE_1626_length_4313_cov_129",97.548,4241,83,7,1,4224,58,4294,0,7236,4223,4236
"8280","Ntome_NODE_1903_length_4234_cov_152","Nsylvestris_NODE_18236_length_1247_cov_32",94.055,1026,59,2,3210,4234,1179,155,0,1555,1024,1024
"8323","Ntome_NODE_1913_length_4227_cov_203","Nsylvestris_NODE_1988_length_4063_cov_181",95.864,4038,127,16,166,4184,1,4017,0,6495,4018,4016
"8400","Ntome_NODE_1930_length_4220_cov_271","Nsylvestris_NODE_1441_length_4456_cov_192",96.792,3896,103,5,124,4014,482,4360,0,6482,3890,3878
"8403","Ntome_NODE_1932_length_4220_cov_221","Nsylvestris_NODE_2489_length_3800_cov_124",96.349,3698,121,10,527,4220,3750,63,0,6069,3693,3687
"8483","Ntome_NODE_1952_length_4208_cov_51","Nsylvestris_NODE_34524_length_307_cov_3",94.444,306,17,0,792,1097,306,1,1.99e-131,472,305,305
"8488","Ntome_NODE_1954_length_4207_cov_54","Nsylvestris_NODE_27879_length_634_cov_7",87.664,535,66,0,3673,4207,634,100,5.2e-177,623,534,534
"8651","Ntome_NODE_1995_length_4177_cov_112","Nsylvestris_NODE_17155_length_1343_cov_223",93.764,1299,42,11,2889,4168,12,1290,0,1914,1279,1278
"8667","Ntome_NODE_2000_length_4174_cov_238","Nsylvestris_NODE_2022_length_4038_cov_161",96.606,3948,105,10,56,3987,4037,103,0,6521,3931,3934
"8892","Ntome_NODE_2051_length_4141_cov_88","Nsylvestris_NODE_1841_length_4153_cov_82",96.026,3951,143,6,198,4141,3982,39,0,6414,3943,3943
"8922","Ntome_NODE_2060_length_4135_cov_74","Nsylvestris_NODE_1896_length_4120_cov_101",94.483,4133,149,45,38,4135,4120,32,0,6296,4097,4088
"8929","Ntome_NODE_2062_length_4133_cov_35","Nsylvestris_NODE_20_length_11989_cov_112",87.931,174,17,4,1,173,6371,6201,2.84e-50,202,172,170
"8960","Ntome_NODE_2072_length_4128_cov_235","Nsylvestris_NODE_1798_length_4179_cov_146",95.311,4073,131,28,42,4077,58,4107,0,6408,4035,4049
"9001","Ntome_NODE_2085_length_4115_cov_260","Nsylvestris_NODE_2431_length_3825_cov_140",94.453,3714,119,31,128,3791,4,3680,0,5637,3663,3676
"9061","Ntome_NODE_2100_length_4110_cov_303","Nsylvestris_NODE_621_length_5653_cov_228",97.981,4012,76,4,53,4059,60,4071,0,6955,4006,4011
"9062","Ntome_NODE_2101_length_4110_cov_28","Nsylvestris_NODE_16118_length_1438_cov_23",93.491,338,15,4,648,979,1096,1432,1.16e-138,496,331,336
"9063","Ntome_NODE_2102_length_4109_cov_77","Nsylvestris_NODE_2333_length_3881_cov_52",94.986,3829,187,3,237,4060,3881,53,0,6002,3823,3828
"9136","Ntome_NODE_2121_length_4098_cov_51","Nsylvestris_NODE_1913_length_4104_cov_108",96.76,3920,120,4,134,4047,4013,95,0,6529,3913,3918
"9143","Ntome_NODE_2124_length_4095_cov_289","Nsylvestris_NODE_1309_length_4585_cov_174",95.88,4102,131,13,5,4095,4529,455,0,6604,4090,4074
"9306","Ntome_NODE_2163_length_4079_cov_64","Nsylvestris_NODE_64_length_9157_cov_92",88,75,9,0,3112,3186,771,697,2.27e-16,89.8,74,74
"9604","Ntome_NODE_2244_length_4037_cov_263","Nsylvestris_NODE_2817_length_3654_cov_232",97.696,3255,75,0,593,3847,316,3570,0,5596,3254,3254
"9608","Ntome_NODE_2246_length_4031_cov_42","Nsylvestris_NODE_11727_length_1901_cov_206",93.141,729,37,3,74,790,13,740,0,1057,716,727
"9629","Ntome_NODE_2253_length_4032_cov_53","Nsylvestris_NODE_2148_length_3965_cov_56",94.908,3947,191,5,95,4032,1,3946,0,6167,3937,3945
"9658","Ntome_NODE_2260_length_4028_cov_63","Nsylvestris_NODE_1557_length_4356_cov_128",71.029,680,193,4,1205,1882,1465,2142,4.69e-38,161,677,677
"9670","Ntome_NODE_2264_length_4026_cov_39","Nsylvestris_NODE_1032_length_4896_cov_143",96.717,2833,80,5,1115,3939,2017,4844,0,4704,2824,2827
"9718","Ntome_NODE_2276_length_4017_cov_286","Nsylvestris_NODE_2348_length_3871_cov_222",96.843,3864,58,14,72,3919,1,3816,0,6401,3847,3815
"9757","Ntome_NODE_2286_length_4014_cov_121","Nsylvestris_NODE_1475_length_4421_cov_114",95.832,3959,122,12,42,3984,447,4378,0,6357,3942,3931
"9825","Ntome_NODE_2303_length_4004_cov_34","Nsylvestris_NODE_1870_length_4136_cov_184",95.918,49,2,0,1,49,2894,2846,1.34e-13,80.5,48,48
"9858","Ntome_NODE_2312_length_4000_cov_241","Nsylvestris_NODE_1805_length_4172_cov_65",97.099,3723,106,2,236,3958,452,4172,0,6276,3722,3720
"9878","Ntome_NODE_2319_length_3998_cov_205","Nsylvestris_NODE_2241_length_3918_cov_140",96.869,3896,93,12,40,3933,3869,1,0,6492,3893,3868
"9882","Ntome_NODE_2322_length_3996_cov_293","Nsylvestris_NODE_2404_length_3838_cov_232",96.411,3789,108,13,218,3984,3831,49,0,6218,3766,3782
"9943","Ntome_NODE_2337_length_3991_cov_300","Nsylvestris_NODE_517_length_5911_cov_217",98.221,3991,71,0,1,3991,4032,42,0,6977,3990,3990
"9944","Ntome_NODE_2338_length_3990_cov_45","Nsylvestris_NODE_10915_length_1998_cov_114",86.271,1515,171,25,2487,3987,191,1682,0,1611,1500,1491
"10061","Ntome_NODE_2370_length_3977_cov_60","Nsylvestris_NODE_4387_length_3130_cov_25",93.639,393,13,5,3211,3599,3130,2746,3.88e-163,577,388,384
"10113","Ntome_NODE_2381_length_3969_cov_149","Nsylvestris_NODE_2309_length_3890_cov_35",85.878,262,37,0,1713,1974,2386,2125,1.22e-73,279,261,261
"10294","Ntome_NODE_2425_length_3946_cov_63","Nsylvestris_NODE_2290_length_3898_cov_70",95.56,3671,136,6,5,3671,3898,251,0,5851,3666,3647
"10330","Ntome_NODE_2433_length_3941_cov_53","Nsylvestris_NODE_2961_length_3600_cov_74",88.687,2201,228,12,1756,3941,3093,899,0,2665,2185,2194
"10338","Ntome_NODE_2436_length_3939_cov_12","Nsylvestris_NODE_1435_length_4462_cov_74",96.447,3940,128,5,1,3939,4315,387,0,6490,3938,3928
"10356","Ntome_NODE_2441_length_3936_cov_262","Nsylvestris_NODE_176_length_7526_cov_167",96.202,3712,125,7,226,3931,3768,67,0,6059,3705,3701
"10396","Ntome_NODE_2451_length_3932_cov_69","Nsylvestris_NODE_93_length_8521_cov_68",96.754,3912,111,4,1,3896,3912,1,0,6506,3895,3911
"10414","Ntome_NODE_2457_length_3927_cov_57","Nsylvestris_NODE_2093_length_3999_cov_136",95.732,3889,122,19,59,3923,3869,1,0,6222,3864,3868
"10452","Ntome_NODE_2468_length_3922_cov_130","Nsylvestris_NODE_3418_length_3431_cov_74",96.385,3347,106,7,164,3502,3384,45,0,5496,3338,3339
"10453","Ntome_NODE_2469_length_3921_cov_71","Nsylvestris_NODE_2783_length_3671_cov_183",95.424,3584,150,6,341,3921,49,3621,0,5698,3580,3572
"10522","Ntome_NODE_2488_length_3914_cov_20","Nsylvestris_NODE_1079_length_4839_cov_117",97.525,3919,83,7,1,3914,49,3958,0,6687,3913,3909
"10603","Ntome_NODE_2511_length_3902_cov_289","Nsylvestris_NODE_1299_length_4593_cov_224",97.891,3793,80,0,1,3793,528,4320,0,6562,3792,3792
"10621","Ntome_NODE_2517_length_3901_cov_293","Nsylvestris_NODE_2602_length_3744_cov_230",97.647,3697,79,4,111,3803,3693,1,0,6338,3692,3692
"10633","Ntome_NODE_2522_length_3898_cov_200","Nsylvestris_NODE_124_length_8100_cov_69",86.614,127,16,1,571,696,70,196,2.13e-31,139,125,126
"10634","Ntome_NODE_2523_length_3897_cov_215","Nsylvestris_NODE_1502_length_4395_cov_193",96.717,3868,91,14,45,3897,371,4217,0,6407,3852,3846
"10683","Ntome_NODE_2533_length_3892_cov_289","Nsylvestris_NODE_3119_length_3537_cov_237",96.749,3445,106,5,257,3697,47,3489,0,5736,3440,3442
"10721","Ntome_NODE_2543_length_3888_cov_80","Nsylvestris_NODE_2604_length_3744_cov_34",95.828,3691,136,5,77,3756,61,3744,0,5947,3679,3683
"10747","Ntome_NODE_2550_length_3884_cov_245","Nsylvestris_NODE_2395_length_3842_cov_210",97.416,3792,82,7,56,3843,1,3780,0,6445,3787,3779
"10817","Ntome_NODE_2568_length_3875_cov_19","Nsylvestris_NODE_18674_length_1212_cov_9",97.03,101,3,0,3760,3860,101,1,7.49e-41,171,100,100
"10957","Ntome_NODE_2600_length_3860_cov_32","Nsylvestris_NODE_5736_length_2812_cov_207",94.915,59,2,1,4,61,647,589,5.98e-17,91.6,57,58
"10995","Ntome_NODE_2610_length_3855_cov_36","Nsylvestris_NODE_30686_length_472_cov_5",82.759,203,28,4,73,268,244,42,5.76e-42,174,195,202
"11008","Ntome_NODE_2615_length_3852_cov_263","Nsylvestris_NODE_1774_length_4193_cov_175",96.987,3585,94,3,94,3678,3,3573,0,6010,3584,3570
"11064","Ntome_NODE_2631_length_3846_cov_232","Nsylvestris_NODE_2015_length_4044_cov_141",97.633,3718,67,10,96,3800,4017,308,0,6359,3704,3709
"11101","Ntome_NODE_2640_length_3844_cov_44","Nsylvestris_NODE_3070_length_3555_cov_66",94.847,3474,155,5,90,3560,56,3508,0,5402,3470,3452
"11154","Ntome_NODE_2654_length_3836_cov_113","Nsylvestris_NODE_6394_length_2681_cov_74",94.318,88,4,1,258,345,2387,2301,9.73e-30,134,87,86
"11155","Ntome_NODE_2655_length_3835_cov_36","Nsylvestris_NODE_93_length_8521_cov_68",88.321,3853,379,28,1,3822,3912,100,0,4556,3821,3812
"11177","Ntome_NODE_2661_length_3832_cov_272","Nsylvestris_NODE_2782_length_3672_cov_228",94.619,3624,144,20,2,3594,9,3612,0,5565,3592,3603
"11266","Ntome_NODE_2688_length_3820_cov_60","Nsylvestris_NODE_2280_length_3902_cov_113",95.492,3394,111,23,58,3446,288,3644,0,5382,3388,3356
"11370","Ntome_NODE_2712_length_3805_cov_20","Nsylvestris_NODE_12566_length_1808_cov_174",83.448,145,21,1,926,1067,683,539,3.47e-29,132,141,144
"11472","Ntome_NODE_2737_length_3798_cov_115","Nsylvestris_NODE_2710_length_3700_cov_109",95.12,3627,136,14,78,3697,3616,24,0,5679,3619,3592
"11488","Ntome_NODE_2742_length_3796_cov_63","Nsylvestris_NODE_966_length_4996_cov_91",95.58,3597,137,8,206,3786,3626,36,0,5742,3580,3590
"11498","Ntome_NODE_2745_length_3794_cov_137","Nsylvestris_NODE_20158_length_1090_cov_9",77.465,213,38,10,2096,2305,250,45,2.7e-25,119,209,205
"11618","Ntome_NODE_2778_length_3777_cov_226","Nsylvestris_NODE_845_length_5164_cov_145",95.896,3338,135,1,92,3427,106,3443,0,5404,3335,3337
"11639","Ntome_NODE_2784_length_3774_cov_104","Nsylvestris_NODE_1202_length_4705_cov_14",74.885,653,146,17,2801,3444,2312,2955,3.23e-74,281,643,643
"11659","Ntome_NODE_2790_length_3775_cov_52","Nsylvestris_NODE_22936_length_895_cov_29",81.818,110,20,0,2984,3093,411,520,1.63e-17,93.5,109,109
"11660","Ntome_NODE_2791_length_3774_cov_273","Nsylvestris_NODE_1536_length_4371_cov_182",94.692,3674,145,21,2,3664,4367,733,0,5659,3662,3634
"11666","Ntome_NODE_2793_length_3774_cov_124","Nsylvestris_NODE_5597_length_2841_cov_125",92.84,2849,151,17,119,2929,2841,8,0,4082,2810,2833
"11769","Ntome_NODE_2816_length_3766_cov_303","Nsylvestris_NODE_1661_length_4279_cov_229",96.307,3683,97,14,96,3766,4222,567,0,6011,3670,3655
"11919","Ntome_NODE_2853_length_3755_cov_60","Nsylvestris_NODE_2708_length_3701_cov_37",96.643,3724,81,11,49,3751,3701,1,0,6144,3702,3700
"11969","Ntome_NODE_2868_length_3750_cov_151","Nsylvestris_NODE_10882_length_2002_cov_215",95.014,1725,74,9,50,1764,1846,124,0,2699,1714,1722
"11976","Ntome_NODE_2870_length_3749_cov_250","Nsylvestris_NODE_2526_length_3780_cov_208",95.389,3687,109,21,50,3700,109,3770,0,5810,3650,3661
"12000","Ntome_NODE_2877_length_3747_cov_177","Nsylvestris_NODE_790_length_5256_cov_221",94.614,3602,138,29,11,3590,80,3647,0,5526,3579,3567
"12090","Ntome_NODE_2898_length_3737_cov_129","Nsylvestris_NODE_4083_length_3209_cov_107",94.073,3138,131,23,65,3160,3173,49,0,4713,3095,3124
"12091","Ntome_NODE_2899_length_3736_cov_295","Nsylvestris_NODE_22_length_11544_cov_169",96.757,3700,105,7,46,3736,17,3710,0,6154,3690,3693
"12140","Ntome_NODE_2911_length_3732_cov_164","Nsylvestris_NODE_2673_length_3714_cov_138",90.727,3688,220,53,47,3670,77,3706,0,4804,3623,3629
"12184","Ntome_NODE_2921_length_3728_cov_42","Nsylvestris_NODE_2424_length_3829_cov_166",95.975,3627,86,18,107,3728,49,3620,0,5834,3621,3571
"12269","Ntome_NODE_2943_length_3721_cov_155","Nsylvestris_NODE_1166_length_4738_cov_208",98.113,53,1,0,1,53,3161,3213,1.6e-17,93.5,52,52
"12270","Ntome_NODE_2944_length_3720_cov_136","Nsylvestris_NODE_3139_length_3531_cov_115",94.794,2593,122,6,736,3316,1,2592,0,4028,2580,2591
"12368","Ntome_NODE_2971_length_3711_cov_283","Nsylvestris_NODE_2845_length_3639_cov_205",96.415,3654,82,17,54,3691,19,3639,0,5976,3637,3620
"12396","Ntome_NODE_2979_length_3707_cov_280","Nsylvestris_NODE_2823_length_3651_cov_234",96.881,3495,83,10,54,3541,3526,51,0,5827,3487,3475
"12397","Ntome_NODE_2980_length_3706_cov_286","Nsylvestris_NODE_179_length_7502_cov_164",96.96,3586,93,5,19,3598,25,3600,0,6004,3579,3575
"12490","Ntome_NODE_3001_length_3699_cov_223","Nsylvestris_NODE_3552_length_3381_cov_228",98.18,3352,54,4,321,3666,3381,31,0,5845,3345,3350
"12491","Ntome_NODE_3002_length_3699_cov_132","Nsylvestris_NODE_2584_length_3753_cov_168",94.747,3617,133,20,67,3656,3587,1,0,5574,3589,3586
"12512","Ntome_NODE_3008_length_3696_cov_70","Nsylvestris_NODE_6796_length_2604_cov_162",95.872,654,20,6,31,680,2568,1918,0,1051,649,650
"12513","Ntome_NODE_3009_length_3696_cov_35","Nsylvestris_NODE_2688_length_3710_cov_68",96.145,3709,118,7,4,3695,1,3701,0,6034,3691,3700
"12577","Ntome_NODE_3025_length_3689_cov_260","Nsylvestris_NODE_2460_length_3809_cov_226",96.499,3656,88,12,46,3687,159,3788,0,6006,3641,3629
"12599","Ntome_NODE_3030_length_3687_cov_290","Nsylvestris_NODE_67_length_9106_cov_194",96.645,3636,101,3,1,3633,5401,9018,0,6019,3632,3617
"12663","Ntome_NODE_3046_length_3679_cov_162","Nsylvestris_NODE_2025_length_4037_cov_130",94.159,2585,105,14,1101,3679,218,2762,0,3895,2578,2544
"12718","Ntome_NODE_3061_length_3674_cov_66","Nsylvestris_NODE_3409_length_3434_cov_42",92.982,3420,171,26,113,3499,3396,13,0,4922,3386,3383
"12735","Ntome_NODE_3065_length_3672_cov_96","Nsylvestris_NODE_2999_length_3588_cov_69",98.161,3481,63,1,54,3533,3481,1,0,6072,3479,3480
"12747","Ntome_NODE_3068_length_3670_cov_238","Nsylvestris_NODE_25880_length_725_cov_5",84.828,145,11,7,2681,2815,280,137,2.59e-30,135,134,143
"12796","Ntome_NODE_3081_length_3664_cov_123","Nsylvestris_NODE_5096_length_2947_cov_67",89.655,58,6,0,3413,3470,213,156,5.71e-12,75,57,57
"12834","Ntome_NODE_3093_length_3660_cov_296","Nsylvestris_NODE_2654_length_3721_cov_230",97.765,3624,68,4,48,3660,3622,1,0,6231,3612,3621
"12944","Ntome_NODE_3119_length_3650_cov_176","Nsylvestris_NODE_5060_length_2958_cov_70",95.914,2692,97,7,65,2747,5,2692,0,4349,2682,2687
"13013","Ntome_NODE_3135_length_3645_cov_11","Nsylvestris_NODE_3169_length_3518_cov_171",96.346,3476,116,6,1,3466,24,3498,0,5705,3465,3474
"13024","Ntome_NODE_3138_length_3643_cov_49","Nsylvestris_NODE_2329_length_3881_cov_160",95.409,3659,118,18,9,3643,3673,41,0,5781,3634,3632
"13112","Ntome_NODE_3160_length_3634_cov_51","Nsylvestris_NODE_2929_length_3610_cov_54",95.116,3563,166,7,71,3632,3588,33,0,5609,3561,3555
"13163","Ntome_NODE_3175_length_3629_cov_205","Nsylvestris_NODE_3505_length_3399_cov_183",94.335,3248,145,21,9,3247,3352,135,0,4942,3238,3217
"13201","Ntome_NODE_3185_length_3626_cov_33","Nsylvestris_NODE_398_length_6281_cov_149",97.295,3512,92,1,23,3531,6281,2770,0,5956,3508,3511
"13244","Ntome_NODE_3195_length_3623_cov_69","Nsylvestris_NODE_3258_length_3487_cov_43",95.931,3441,120,7,19,3445,4,3438,0,5561,3426,3434
"13267","Ntome_NODE_3202_length_3621_cov_277","Nsylvestris_NODE_3370_length_3449_cov_198",97.521,3388,64,13,195,3579,3414,44,0,5773,3384,3370
"13281","Ntome_NODE_3207_length_3621_cov_135","Nsylvestris_NODE_836_length_5180_cov_82",77.238,659,108,19,2535,3155,2491,1837,3.01e-94,348,620,654
"13294","Ntome_NODE_3211_length_3618_cov_191","Nsylvestris_NODE_3081_length_3549_cov_195",96.492,3449,104,5,37,3481,3486,51,0,5683,3444,3435
"13338","Ntome_NODE_3222_length_3613_cov_39","Nsylvestris_NODE_4803_length_3021_cov_214",92.381,105,8,0,1,105,2702,2598,9.1e-35,150,104,104
"13394","Ntome_NODE_3239_length_3608_cov_20","Nsylvestris_NODE_534_length_5860_cov_52",95.687,3524,144,5,39,3555,50,3572,0,5659,3516,3522
"13477","Ntome_NODE_3262_length_3601_cov_213","Nsylvestris_NODE_4199_length_3176_cov_199",97.603,3004,52,8,613,3599,3055,55,0,5131,2986,3000
"13561","Ntome_NODE_3286_length_3592_cov_55","Nsylvestris_NODE_32055_length_392_cov_2",87.143,70,7,2,2296,2364,168,100,4.33e-13,78.7,68,68
"13594","Ntome_NODE_3293_length_3590_cov_84","Nsylvestris_NODE_3280_length_3481_cov_185",97.466,3433,63,10,50,3466,3447,23,0,5836,3416,3424
"13788","Ntome_NODE_3344_length_3570_cov_292","Nsylvestris_NODE_4308_length_3147_cov_234",97.098,3101,90,0,76,3176,47,3147,0,5228,3100,3100
"13789","Ntome_NODE_3345_length_3570_cov_243","Nsylvestris_NODE_3225_length_3498_cov_204",96.435,3478,76,18,47,3507,1,3447,0,5692,3460,3446
"13825","Ntome_NODE_3356_length_3566_cov_181","Nsylvestris_NODE_3545_length_3385_cov_168",97.408,3318,79,4,73,3385,1,3316,0,5644,3312,3315
"13842","Ntome_NODE_3360_length_3566_cov_65","Nsylvestris_NODE_2718_length_3697_cov_88",97.51,3494,80,3,77,3566,3526,36,0,5963,3489,3490
"13928","Ntome_NODE_3386_length_3555_cov_242","Nsylvestris_NODE_2522_length_3782_cov_186",95.886,3500,124,5,70,3555,3713,220,0,5648,3485,3493
"13977","Ntome_NODE_3398_length_3540_cov_213","Nsylvestris_NODE_9074_length_2242_cov_23",79.325,474,49,23,664,1126,858,423,6.51e-76,287,462,435
"14004","Ntome_NODE_3406_length_3545_cov_180","Nsylvestris_NODE_3033_length_3574_cov_154",97.603,3504,68,8,1,3499,3543,51,0,5991,3498,3492
"14021","Ntome_NODE_3410_length_3544_cov_232","Nsylvestris_NODE_661_length_5525_cov_176",96.509,3437,97,10,123,3544,47,3475,0,5661,3421,3428
"14063","Ntome_NODE_3421_length_3541_cov_266","Nsylvestris_NODE_2699_length_3705_cov_186",97.562,3527,69,6,1,3517,3520,1,0,6021,3516,3519
"14077","Ntome_NODE_3426_length_3539_cov_176","Nsylvestris_NODE_3670_length_3344_cov_147",97.428,3266,70,7,91,3356,3279,28,0,5553,3265,3251
"14182","Ntome_NODE_3454_length_3529_cov_223","Nsylvestris_NODE_3235_length_3496_cov_32",97.231,3214,85,2,192,3402,3476,264,0,5439,3210,3212
"14243","Ntome_NODE_3473_length_3524_cov_285","Nsylvestris_NODE_3365_length_3451_cov_123",95.025,3457,152,9,47,3489,1,3451,0,5413,3442,3450
"14367","Ntome_NODE_3502_length_3516_cov_177","Nsylvestris_NODE_3111_length_3539_cov_191",96.365,3466,98,8,1,3466,6,3443,0,5677,3465,3437
"14525","Ntome_NODE_3546_length_3502_cov_83","Nsylvestris_NODE_14234_length_1625_cov_218",95.313,64,3,0,1,64,1430,1493,2.5e-20,102,63,63
"14597","Ntome_NODE_3566_length_3495_cov_96","Nsylvestris_NODE_1206_length_4699_cov_133",96.612,3424,87,14,1,3410,60,3468,0,5653,3409,3408
"14712","Ntome_NODE_3598_length_3485_cov_206","Nsylvestris_NODE_2755_length_3681_cov_72",97.539,3210,66,2,235,3444,485,3681,0,5478,3209,3196
"14872","Ntome_NODE_3638_length_3471_cov_110","Nsylvestris_NODE_3752_length_3318_cov_153",97.088,3056,77,3,54,3104,3049,1,0,5140,3050,3048
"14920","Ntome_NODE_3652_length_3469_cov_192","Nsylvestris_NODE_346_length_6486_cov_74",95.047,2665,124,4,809,3468,4850,2189,0,4183,2659,2661
"14951","Ntome_NODE_3662_length_3466_cov_240","Nsylvestris_NODE_2790_length_3666_cov_158",97.349,3470,85,3,1,3466,3579,113,0,5891,3465,3466
"14955","Ntome_NODE_3664_length_3466_cov_92","Nsylvestris_NODE_4947_length_2987_cov_37",89.48,2386,182,27,48,2392,4,2361,0,2952,2344,2357
"14968","Ntome_NODE_3669_length_3459_cov_75","Nsylvestris_NODE_735_length_5379_cov_128",96.115,489,15,2,95,579,662,174,0,795,484,488
"14993","Ntome_NODE_3677_length_3459_cov_45","Nsylvestris_NODE_31890_length_399_cov_2",85.586,111,16,0,2137,2247,25,135,8.83e-25,117,110,110
"15003","Ntome_NODE_3680_length_3457_cov_241","Nsylvestris_NODE_2972_length_3597_cov_185",88.78,3458,251,50,2,3425,115,3469,0,4109,3423,3354
"15133","Ntome_NODE_3716_length_3445_cov_78","Nsylvestris_NODE_2651_length_3722_cov_83",97.667,3300,72,3,50,3346,236,3533,0,5662,3296,3297
"15211","Ntome_NODE_3734_length_3439_cov_91","Nsylvestris_NODE_1941_length_4091_cov_102",95.692,3180,104,7,67,3239,1,3154,0,5083,3172,3153
"15212","Ntome_NODE_3735_length_3439_cov_50","Nsylvestris_NODE_4074_length_3212_cov_21",87.705,122,11,4,3295,3414,3076,3195,1.87e-31,139,119,119
"15213","Ntome_NODE_3736_length_3439_cov_26","Nsylvestris_NODE_3480_length_3408_cov_17",95.602,3320,138,7,124,3437,90,3407,0,5315,3313,3317
"15236","Ntome_NODE_3742_length_3437_cov_101","Nsylvestris_NODE_14752_length_1574_cov_191",96.704,1062,34,1,529,1590,6,1066,0,1766,1061,1060
"15243","Ntome_NODE_3745_length_3436_cov_222","Nsylvestris_NODE_3423_length_3428_cov_231",97.816,3389,68,4,49,3432,40,3427,0,5843,3383,3387
"15326","Ntome_NODE_3768_length_3430_cov_269","Nsylvestris_NODE_2033_length_4032_cov_229",96.081,3292,109,5,94,3385,4032,761,0,5347,3291,3271
"15338","Ntome_NODE_3770_length_3430_cov_60","Nsylvestris_NODE_7600_length_2469_cov_40",90.534,1067,95,6,2241,3303,2466,1402,0,1406,1062,1064
"15376","Ntome_NODE_3780_length_3427_cov_29","Nsylvestris_NODE_3565_length_3378_cov_116",94.321,3381,135,15,52,3423,3333,1,0,5127,3371,3332
"15396","Ntome_NODE_3787_length_3424_cov_291","Nsylvestris_NODE_1242_length_4655_cov_128",96.787,3424,110,0,1,3424,3499,76,0,5714,3423,3423
"15415","Ntome_NODE_3794_length_3421_cov_285","Nsylvestris_NODE_3348_length_3456_cov_216",94.202,3415,156,18,11,3420,14,3391,0,5171,3409,3377
"15439","Ntome_NODE_3802_length_3420_cov_259","Nsylvestris_NODE_293_length_6765_cov_138",97.032,3369,80,9,52,3420,6759,3411,0,5650,3368,3348
"15466","Ntome_NODE_3808_length_3418_cov_198","Nsylvestris_NODE_239_length_7063_cov_138",96.261,2300,59,9,275,2573,4387,6660,0,3746,2298,2273
"15484","Ntome_NODE_3813_length_3415_cov_241","Nsylvestris_NODE_3498_length_3402_cov_221",96.505,3376,91,16,1,3363,39,3400,0,5555,3362,3361
"15556","Ntome_NODE_3832_length_3414_cov_81","Nsylvestris_NODE_19293_length_1161_cov_120",98.182,55,1,0,3360,3414,220,166,1.14e-18,97.1,54,54
"15601","Ntome_NODE_3847_length_3405_cov_253","Nsylvestris_NODE_3869_length_3277_cov_192",94.621,3309,94,19,102,3367,3273,6,0,5048,3265,3267
"15638","Ntome_NODE_3856_length_3402_cov_309","Nsylvestris_NODE_3616_length_3360_cov_171",94.778,3313,160,1,28,3340,25,3324,0,5147,3312,3299
"15664","Ntome_NODE_3864_length_3400_cov_92","Nsylvestris_NODE_3536_length_3387_cov_181",94.847,3377,148,8,38,3396,1,3369,0,5249,3358,3368
"15700","Ntome_NODE_3875_length_3395_cov_278","Nsylvestris_NODE_2190_length_3940_cov_200",96.163,3362,94,7,1,3351,71,3408,0,5461,3350,3337
"15731","Ntome_NODE_3883_length_3393_cov_141","Nsylvestris_NODE_3936_length_3256_cov_141",96.838,3036,77,5,183,3203,3211,180,0,5057,3020,3031
"15866","Ntome_NODE_3921_length_3380_cov_282","Nsylvestris_NODE_3856_length_3282_cov_181",96.068,3128,97,9,50,3165,3114,1,0,5072,3115,3113
"15876","Ntome_NODE_3925_length_3379_cov_294","Nsylvestris_NODE_202_length_7334_cov_199",97.449,3214,76,5,100,3311,7236,4027,0,5476,3211,3209
"15926","Ntome_NODE_3940_length_3375_cov_76","Nsylvestris_NODE_3129_length_3534_cov_114",94.92,3366,129,20,3,3352,3525,186,0,5230,3349,3339
"15931","Ntome_NODE_3942_length_3375_cov_34","Nsylvestris_NODE_5980_length_2765_cov_72",95.838,2571,101,4,1,2567,2685,117,0,4150,2566,2568
"15951","Ntome_NODE_3948_length_3374_cov_38","Nsylvestris_NODE_3448_length_3421_cov_23",94.844,3375,146,7,15,3374,55,3416,0,5243,3359,3361
"16104","Ntome_NODE_3991_length_3355_cov_14","Nsylvestris_NODE_1946_length_4089_cov_12",82.966,681,111,5,2531,3209,2434,1757,3.22e-173,610,678,677
"16109","Ntome_NODE_3993_length_3353_cov_269","Nsylvestris_NODE_4036_length_3221_cov_203",96.535,3059,67,13,271,3294,52,3106,0,5025,3023,3054
"16129","Ntome_NODE_3999_length_3352_cov_212","Nsylvestris_NODE_1282_length_4612_cov_151",91.313,2567,124,35,629,3159,3835,1332,0,3413,2530,2503
"16138","Ntome_NODE_4002_length_3351_cov_258","Nsylvestris_NODE_4876_length_3001_cov_183",97.914,2924,61,0,90,3013,70,2993,0,5062,2923,2923
"16240","Ntome_NODE_4028_length_3341_cov_287","Nsylvestris_NODE_4105_length_3201_cov_223",93.827,3159,140,26,140,3249,3201,49,0,4702,3109,3152
"16280","Ntome_NODE_4039_length_3337_cov_292","Nsylvestris_NODE_4006_length_3231_cov_233",97.321,3173,73,9,172,3337,53,3220,0,5378,3165,3167
"16337","Ntome_NODE_4055_length_3333_cov_129","Nsylvestris_NODE_19453_length_1148_cov_27",89.758,908,62,8,2312,3212,8,891,0,1133,900,883
"16361","Ntome_NODE_4061_length_3331_cov_262","Nsylvestris_NODE_4603_length_3072_cov_226",96.343,2707,80,7,64,2763,2850,156,0,4433,2699,2694
"16463","Ntome_NODE_4087_length_3324_cov_35","Nsylvestris_NODE_15982_length_1451_cov_15",83.933,1500,182,32,151,1641,2,1451,0,1380,1490,1449
"16482","Ntome_NODE_4094_length_3322_cov_203","Nsylvestris_NODE_24113_length_824_cov_208",95.034,443,16,1,51,493,41,477,0,691,442,436
"16504","Ntome_NODE_4101_length_3321_cov_76","Nsylvestris_NODE_3404_length_3435_cov_110",93.279,3288,187,16,19,3283,3416,140,0,4817,3264,3276
"16626","Ntome_NODE_4135_length_3311_cov_231","Nsylvestris_NODE_6445_length_2670_cov_217",96.43,2549,75,7,1,2547,29,2563,0,4189,2546,2534
"16694","Ntome_NODE_4154_length_3306_cov_274","Nsylvestris_NODE_622_length_5651_cov_203",95.501,3045,106,10,30,3067,5639,2619,0,4835,3037,3020
"16712","Ntome_NODE_4160_length_3305_cov_210","Nsylvestris_NODE_3483_length_3406_cov_194",95.984,3237,115,13,54,3288,3261,38,0,5243,3234,3223
"16767","Ntome_NODE_4176_length_3302_cov_153","Nsylvestris_NODE_3520_length_3393_cov_118",96.64,3244,88,9,15,3244,3391,155,0,5367,3229,3236
"16788","Ntome_NODE_4181_length_3301_cov_161","Nsylvestris_NODE_4095_length_3204_cov_107",95.253,3202,118,17,115,3288,3196,1,0,5040,3173,3195
"16808","Ntome_NODE_4186_length_3300_cov_252","Nsylvestris_NODE_3959_length_3246_cov_183",95.278,3198,137,7,35,3221,1,3195,0,5057,3186,3194
"16860","Ntome_NODE_4200_length_3295_cov_70","Nsylvestris_NODE_30_length_10263_cov_164",74.345,1602,304,63,1319,2851,1197,2760,6.9e-165,582,1532,1563
"17067","Ntome_NODE_4259_length_3275_cov_37","Nsylvestris_NODE_6970_length_2574_cov_110",98.113,53,1,0,3221,3273,395,343,1.41e-17,93.5,52,52
"17068","Ntome_NODE_4260_length_3274_cov_215","Nsylvestris_NODE_3609_length_3361_cov_218",95.626,3269,131,6,7,3266,89,3354,0,5234,3259,3265
"17069","Ntome_NODE_4261_length_3274_cov_92","Nsylvestris_NODE_3295_length_3476_cov_65",96,2275,76,9,115,2379,75,2344,0,3683,2264,2269
"17070","Ntome_NODE_4262_length_3273_cov_206","Nsylvestris_NODE_4558_length_3083_cov_185",96.511,3038,76,12,52,3086,3011,1,0,4996,3034,3010
"17093","Ntome_NODE_4268_length_3272_cov_34","Nsylvestris_NODE_12459_length_1821_cov_28",95.677,1573,68,0,463,2035,94,1666,0,2529,1572,1572
"17178","Ntome_NODE_4293_length_3263_cov_89","Nsylvestris_NODE_3110_length_3539_cov_211",97.294,739,20,0,2477,3215,2560,3298,0,1254,738,738
"17186","Ntome_NODE_4296_length_3262_cov_288","Nsylvestris_NODE_3998_length_3233_cov_210",94.678,3063,131,12,1,3042,174,3225,0,4724,3041,3051
"17195","Ntome_NODE_4300_length_3261_cov_38","Nsylvestris_NODE_4858_length_3006_cov_16",95.148,2906,128,12,364,3259,45,2947,0,4573,2895,2902
"17264","Ntome_NODE_4317_length_3256_cov_116","Nsylvestris_NODE_6711_length_2620_cov_28",95.25,2463,107,2,743,3205,2620,168,0,3892,2462,2452
"17265","Ntome_NODE_4318_length_3256_cov_87","Nsylvestris_NODE_3772_length_3312_cov_63",92.885,3289,165,15,1,3246,3265,3,0,4713,3245,3262
"17266","Ntome_NODE_4319_length_3255_cov_289","Nsylvestris_NODE_4760_length_3031_cov_150",96.701,2971,79,3,33,3003,28,2979,0,4926,2970,2951
"17365","Ntome_NODE_4346_length_3251_cov_16","Nsylvestris_NODE_2819_length_3654_cov_52",97.919,3219,65,2,35,3251,3267,49,0,5572,3216,3218
"17410","Ntome_NODE_4360_length_3248_cov_90","Nsylvestris_NODE_3604_length_3364_cov_74",95.075,3147,129,9,111,3248,3220,91,0,4929,3137,3129
"17473","Ntome_NODE_4380_length_3243_cov_274","Nsylvestris_NODE_4365_length_3135_cov_215",96.741,3099,77,6,12,3107,9,3086,0,5142,3095,3077
"17511","Ntome_NODE_4391_length_3240_cov_138","Nsylvestris_NODE_3292_length_3478_cov_160",97.056,3193,90,3,44,3233,3426,235,0,5373,3189,3191
"17536","Ntome_NODE_4399_length_3239_cov_104","Nsylvestris_NODE_4145_length_3190_cov_135",96.305,3004,99,6,56,3059,3046,55,0,4922,3003,2991
"17581","Ntome_NODE_4414_length_3234_cov_164","Nsylvestris_NODE_4180_length_3181_cov_174",97.585,3106,66,7,132,3232,53,3154,0,5312,3100,3101
"17582","Ntome_NODE_4415_length_3234_cov_105","Nsylvestris_NODE_3321_length_3468_cov_119",95.424,3147,132,12,58,3197,3174,33,0,5003,3139,3141
"17595","Ntome_NODE_4419_length_3232_cov_32","Nsylvestris_NODE_24535_length_799_cov_15",95.115,737,31,3,2496,3232,735,4,0,1157,736,731
"17596","Ntome_NODE_4420_length_3231_cov_225","Nsylvestris_NODE_1231_length_4670_cov_207",95.897,3022,111,5,145,3161,4619,1606,0,4881,3016,3013
"17614","Ntome_NODE_4424_length_3229_cov_271","Nsylvestris_NODE_4276_length_3156_cov_223",95.788,3158,105,12,53,3197,3156,14,0,5070,3144,3142
"17636","Ntome_NODE_4430_length_3227_cov_156","Nsylvestris_NODE_4604_length_3072_cov_118",96.721,3019,95,3,160,3178,1,3015,0,5024,3018,3014
"17919","Ntome_NODE_4506_length_3208_cov_19","Nsylvestris_NODE_1877_length_4132_cov_87",98.077,52,1,0,3060,3111,539,590,4.96e-17,91.6,51,51
"17928","Ntome_NODE_4510_length_3207_cov_134","Nsylvestris_NODE_4659_length_3055_cov_57",94.53,2907,118,14,279,3166,2885,1,0,4449,2887,2884
"17999","Ntome_NODE_4531_length_3201_cov_292","Nsylvestris_NODE_4480_length_3103_cov_226",97.348,3054,56,15,152,3192,3044,3,0,5168,3040,3041
"18010","Ntome_NODE_4534_length_3201_cov_155","Nsylvestris_NODE_4313_length_3146_cov_236",93.763,2966,135,21,49,2985,202,3146,0,4407,2936,2944
"18058","Ntome_NODE_4546_length_3198_cov_69","Nsylvestris_NODE_4123_length_3195_cov_127",87.879,66,8,0,1638,1703,925,990,3.85e-13,78.7,65,65
"18075","Ntome_NODE_4550_length_3197_cov_179","Nsylvestris_NODE_28349_length_612_cov_10",75.802,343,74,8,2094,2433,276,612,2.87e-39,165,339,336
"18104","Ntome_NODE_4560_length_3194_cov_132","Nsylvestris_NODE_17685_length_1295_cov_210",98.333,60,0,1,3136,3194,313,254,6.35e-21,104,58,59
"18136","Ntome_NODE_4573_length_3189_cov_33","Nsylvestris_NODE_5451_length_2873_cov_45",96.741,2792,90,1,381,3172,1,2791,0,4650,2791,2790
"18141","Ntome_NODE_4575_length_3187_cov_78","Nsylvestris_NODE_4489_length_3103_cov_20",90.886,3127,203,34,27,3095,3103,1,0,4120,3068,3102
"18145","Ntome_NODE_4577_length_3187_cov_17","Nsylvestris_NODE_2444_length_3820_cov_223",98.182,55,1,0,1,55,1076,1130,1.06e-18,97.1,54,54
"18174","Ntome_NODE_4587_length_3185_cov_86","Nsylvestris_NODE_3256_length_3487_cov_203",96.321,3044,101,4,47,3089,316,3349,0,4990,3042,3033
"18243","Ntome_NODE_4606_length_3181_cov_254","Nsylvestris_NODE_6877_length_2588_cov_231",95.875,2570,76,10,498,3061,3,2548,0,4132,2563,2545
"18257","Ntome_NODE_4611_length_3181_cov_76","Nsylvestris_NODE_3731_length_3326_cov_51",95.467,2934,124,9,43,2971,3326,397,0,4673,2928,2929
"18296","Ntome_NODE_4625_length_3178_cov_303","Nsylvestris_NODE_304_length_6709_cov_224",97.236,3075,68,4,107,3178,6660,3600,0,5192,3071,3060
"18311","Ntome_NODE_4630_length_3176_cov_295","Nsylvestris_NODE_3576_length_3372_cov_210",94.073,3037,140,10,43,3077,3069,71,0,4575,3034,2998
"18440","Ntome_NODE_4668_length_3166_cov_187","Nsylvestris_NODE_744_length_5355_cov_157",94.375,1991,102,6,310,2297,3268,5251,0,3048,1987,1983
"18452","Ntome_NODE_4672_length_3165_cov_76","Nsylvestris_NODE_9020_length_2248_cov_17",81.677,1610,268,22,1569,3165,229,1824,0,1314,1596,1595
"18471","Ntome_NODE_4678_length_3163_cov_294","Nsylvestris_NODE_4555_length_3084_cov_230",95.711,3031,77,14,39,3032,29,3043,0,4828,2993,3014
"18475","Ntome_NODE_4680_length_3163_cov_184","Nsylvestris_NODE_1354_length_4540_cov_191",98.286,3150,53,1,14,3163,17,3165,0,5517,3149,3148
"18499","Ntome_NODE_4687_length_3162_cov_88","Nsylvestris_NODE_14891_length_1561_cov_210",88.693,566,40,13,2405,2954,558,1,0,669,549,557
"18519","Ntome_NODE_4692_length_3161_cov_200","Nsylvestris_NODE_2347_length_3872_cov_54",90.705,936,81,6,2143,3076,2879,3810,0,1242,933,931
"18539","Ntome_NODE_4698_length_3160_cov_216","Nsylvestris_NODE_2461_length_3809_cov_194",76.929,1348,295,15,1666,3007,2162,3499,0,752,1341,1337
"18564","Ntome_NODE_4706_length_3158_cov_238","Nsylvestris_NODE_5530_length_2855_cov_224",96.27,2842,94,8,2,2843,2830,1,0,4650,2841,2829
"18567","Ntome_NODE_4708_length_3158_cov_176","Nsylvestris_NODE_3281_length_3481_cov_139",95.652,966,22,8,1,948,234,1197,0,1533,947,963
"18596","Ntome_NODE_4715_length_3156_cov_204","Nsylvestris_NODE_4627_length_3066_cov_109",96.323,2801,61,7,282,3040,2901,101,0,4564,2758,2800
"18651","Ntome_NODE_4733_length_3152_cov_178","Nsylvestris_NODE_8146_length_2381_cov_140",95.705,2375,89,4,575,2946,2381,17,0,3808,2371,2364
"18677","Ntome_NODE_4739_length_3149_cov_287","Nsylvestris_NODE_3035_length_3573_cov_205",100,53,0,0,1,53,1076,1128,2.91e-19,99,52,52
"18746","Ntome_NODE_4759_length_3144_cov_205","Nsylvestris_NODE_4500_length_3100_cov_168",96.763,3089,84,4,15,3102,3,3076,0,5136,3087,3073
"18866","Ntome_NODE_4796_length_3134_cov_87","Nsylvestris_NODE_4458_length_3108_cov_33",96.34,3060,101,7,8,3062,55,3108,0,5020,3054,3053
"18873","Ntome_NODE_4799_length_3133_cov_210","Nsylvestris_NODE_5442_length_2875_cov_206",96.1,2692,77,13,148,2813,45,2734,0,4364,2665,2689
"18891","Ntome_NODE_4805_length_3132_cov_55","Nsylvestris_NODE_2510_length_3788_cov_92",84.348,460,43,14,942,1400,3310,2879,4.2e-117,424,458,431
"18990","Ntome_NODE_4832_length_3126_cov_18","Nsylvestris_NODE_2573_length_3759_cov_153",97.618,3148,51,4,1,3126,212,3357,0,5376,3125,3145
"19013","Ntome_NODE_4840_length_3123_cov_285","Nsylvestris_NODE_5520_length_2858_cov_108",93.682,2833,135,25,47,2866,2857,56,0,4200,2819,2801
"19047","Ntome_NODE_4851_length_3122_cov_30","Nsylvestris_NODE_470_length_6031_cov_12",74.889,1354,313,17,791,2121,6031,4682,1.09e-167,592,1330,1349
"19094","Ntome_NODE_4864_length_3120_cov_35","Nsylvestris_NODE_26225_length_709_cov_5",76.226,530,116,8,580,1104,179,703,1.61e-71,272,524,524
"19112","Ntome_NODE_4870_length_3117_cov_297","Nsylvestris_NODE_4479_length_3104_cov_188",96.325,2993,88,9,133,3117,3058,80,0,4898,2984,2978
"19113","Ntome_NODE_4871_length_3117_cov_296","Nsylvestris_NODE_4928_length_2990_cov_223",98.214,2744,25,8,287,3027,152,2874,0,4774,2740,2722
"19138","Ntome_NODE_4877_length_3116_cov_12","Nsylvestris_NODE_3746_length_3321_cov_61",95.512,3075,93,5,33,3062,99,3173,0,4872,3029,3074
"19139","Ntome_NODE_4878_length_3115_cov_294","Nsylvestris_NODE_3162_length_3522_cov_228",97.428,3111,68,3,1,3108,3146,45,0,5291,3107,3101
"19140","Ntome_NODE_4879_length_3115_cov_261","Nsylvestris_NODE_432_length_6171_cov_190",97.989,3034,49,4,88,3115,1560,4587,0,5254,3027,3027
"19183","Ntome_NODE_4892_length_3113_cov_34","Nsylvestris_NODE_230_length_7142_cov_214",98.182,55,1,0,1,55,4227,4173,1.03e-18,97.1,54,54
"19213","Ntome_NODE_4900_length_3111_cov_259","Nsylvestris_NODE_4767_length_3029_cov_209",95.2,2979,95,12,61,3018,2979,28,0,4665,2957,2951
"19264","Ntome_NODE_4911_length_3109_cov_29","Nsylvestris_NODE_12111_length_1856_cov_192",98.148,54,1,0,1,54,776,829,3.72e-18,95.3,53,53
"19324","Ntome_NODE_4927_length_3104_cov_178","Nsylvestris_NODE_3253_length_3488_cov_174",96.823,1731,31,7,42,1766,167,1879,0,2870,1724,1712
"19398","Ntome_NODE_4947_length_3098_cov_246","Nsylvestris_NODE_4374_length_3133_cov_196",96.3,2973,81,13,22,2972,3133,168,0,4854,2950,2965
"19439","Ntome_NODE_4956_length_3089_cov_50","Nsylvestris_NODE_7994_length_2405_cov_30",82.777,749,75,23,1,717,884,1610,4.93e-176,619,716,726
"19527","Ntome_NODE_4980_length_3082_cov_15","Nsylvestris_NODE_1969_length_4073_cov_46",96.053,3091,89,10,1,3082,19,3085,0,5001,3081,3066
"19538","Ntome_NODE_4984_length_3087_cov_42","Nsylvestris_NODE_5377_length_2891_cov_64",94.06,2761,118,19,330,3064,119,2859,0,4148,2734,2740
"19566","Ntome_NODE_4990_length_3085_cov_33","Nsylvestris_NODE_4188_length_3179_cov_43",96.036,3078,110,6,16,3085,60,3133,0,4998,3069,3073
"19721","Ntome_NODE_5033_length_3068_cov_299","Nsylvestris_NODE_4796_length_3022_cov_225",94.254,2924,152,11,27,2938,3005,86,0,4455,2911,2919
"19744","Ntome_NODE_5041_length_3067_cov_178","Nsylvestris_NODE_4620_length_3067_cov_197",95.4,3022,93,16,61,3064,1,2994,0,4769,3003,2993
"19771","Ntome_NODE_5049_length_3066_cov_75","Nsylvestris_NODE_1367_length_4529_cov_119",85.156,256,32,5,873,1125,1998,2250,4.42e-67,257,252,252
"19807","Ntome_NODE_5060_length_3063_cov_35","Nsylvestris_NODE_28700_length_598_cov_5",86.116,605,62,14,813,1407,6,598,6.27e-180,632,594,592
"19836","Ntome_NODE_5070_length_3061_cov_113","Nsylvestris_NODE_5687_length_2822_cov_26",93.748,2751,141,14,248,2995,53,2775,0,4098,2747,2722
"19904","Ntome_NODE_5093_length_3055_cov_222","Nsylvestris_NODE_5371_length_2892_cov_78",98.135,2842,40,6,17,2846,2892,52,0,4942,2829,2840
"19905","Ntome_NODE_5094_length_3055_cov_198","Nsylvestris_NODE_4405_length_3124_cov_164",95.976,2858,76,17,148,2971,3078,226,0,4604,2823,2852
"19913","Ntome_NODE_5097_length_3054_cov_279","Nsylvestris_NODE_398_length_6281_cov_149",95.526,2660,105,6,406,3054,108,2764,0,4241,2648,2656
"19914","Ntome_NODE_5098_length_3054_cov_229","Nsylvestris_NODE_782_length_5265_cov_159",98.562,2712,39,0,1,2712,1155,3866,0,4793,2711,2711
"19946","Ntome_NODE_5107_length_3053_cov_49","Nsylvestris_NODE_4327_length_3144_cov_158",95.437,3068,119,5,1,3053,37,3098,0,4870,3052,3061
"19953","Ntome_NODE_5109_length_3052_cov_106","Nsylvestris_NODE_3429_length_3428_cov_56",87.179,117,11,4,227,339,1212,1328,1e-28,130,112,116
"20141","Ntome_NODE_5153_length_3043_cov_258","Nsylvestris_NODE_5911_length_2779_cov_210",96.933,2739,65,9,178,2908,46,2773,0,4575,2730,2727
"20182","Ntome_NODE_5165_length_3041_cov_10","Nsylvestris_NODE_4170_length_3185_cov_19",97.143,2870,82,0,1,2870,2870,1,0,4846,2869,2869
"20205","Ntome_NODE_5171_length_3038_cov_295","Nsylvestris_NODE_598_length_5712_cov_232",98.35,2909,45,3,130,3038,38,2943,0,5103,2908,2905
"20221","Ntome_NODE_5176_length_3037_cov_298","Nsylvestris_NODE_4354_length_3138_cov_227",97.532,2958,68,3,81,3037,1,2954,0,5053,2956,2953
"20231","Ntome_NODE_5179_length_3036_cov_295","Nsylvestris_NODE_4591_length_3075_cov_226",96.822,3021,81,7,23,3030,3,3021,0,5033,3007,3018
"20276","Ntome_NODE_5191_length_3033_cov_206","Nsylvestris_NODE_438_length_6143_cov_128",95.243,2922,112,17,85,3005,2909,14,0,4601,2920,2895
"20286","Ntome_NODE_5194_length_3032_cov_238","Nsylvestris_NODE_2429_length_3826_cov_206",96.759,2592,83,1,441,3032,7,2597,0,4320,2591,2590
"20341","Ntome_NODE_5211_length_3028_cov_87","Nsylvestris_NODE_5130_length_2942_cov_183",97.375,2895,67,5,128,3021,51,2937,0,4916,2893,2886
"20376","Ntome_NODE_5222_length_3023_cov_297","Nsylvestris_NODE_5122_length_2943_cov_173",96.057,2891,88,7,107,2973,54,2942,0,4684,2866,2888
"20434","Ntome_NODE_5239_length_3019_cov_278","Nsylvestris_NODE_2751_length_3681_cov_224",94.29,2907,121,14,1,2877,746,3637,0,4407,2876,2891
"20460","Ntome_NODE_5246_length_3018_cov_176","Nsylvestris_NODE_7369_length_2509_cov_200",92.786,2398,89,41,654,3017,2348,1,0,3393,2363,2347
"20511","Ntome_NODE_5261_length_3015_cov_153","Nsylvestris_NODE_5485_length_2865_cov_111",96.352,2138,78,0,168,2305,53,2190,0,3517,2137,2137
"20521","Ntome_NODE_5264_length_3014_cov_75","Nsylvestris_NODE_4748_length_3034_cov_126",94.737,3040,121,15,6,3014,1,3032,0,4691,3008,3031
"20522","Ntome_NODE_5265_length_3015_cov_56","Nsylvestris_NODE_358_length_6447_cov_57",76.15,1891,391,51,631,2492,4913,3054,0,939,1861,1859
"20584","Ntome_NODE_5282_length_3011_cov_289","Nsylvestris_NODE_4482_length_3103_cov_205",94.276,3005,97,27,48,2998,3005,22,0,4527,2950,2983
"20680","Ntome_NODE_5308_length_3005_cov_155","Nsylvestris_NODE_3921_length_3262_cov_186",95.415,698,29,3,2191,2888,2522,3216,0,1109,697,694
"20727","Ntome_NODE_5322_length_3002_cov_233","Nsylvestris_NODE_1047_length_4880_cov_146",98.02,2879,48,7,1,2873,4065,1190,0,4992,2872,2875
"20746","Ntome_NODE_5327_length_3001_cov_134","Nsylvestris_NODE_13520_length_1704_cov_147",94.624,1302,45,12,47,1331,110,1403,0,1993,1284,1293
"20758","Ntome_NODE_5331_length_3000_cov_225","Nsylvestris_NODE_5595_length_2841_cov_151",96.112,2855,74,14,40,2871,1,2841,0,4623,2831,2840
"20759","Ntome_NODE_5332_length_3000_cov_223","Nsylvestris_NODE_6893_length_2586_cov_208",97.145,2347,63,1,458,2800,2347,1,0,3960,2342,2346
"20780","Ntome_NODE_5338_length_2999_cov_64","Nsylvestris_NODE_1073_length_4850_cov_130",97.287,2801,75,1,19,2818,4850,2050,0,4750,2799,2800
"20898","Ntome_NODE_5370_length_2993_cov_168","Nsylvestris_NODE_6025_length_2755_cov_179",96.938,2711,61,9,187,2879,5,2711,0,4527,2692,2706
"20899","Ntome_NODE_5371_length_2993_cov_59","Nsylvestris_NODE_19337_length_1157_cov_20",90.411,73,5,2,2915,2986,793,722,3.58e-18,95.3,71,71
"20902","Ntome_NODE_5373_length_2992_cov_282","Nsylvestris_NODE_3369_length_3450_cov_157",95.174,2756,87,14,3,2741,3419,693,0,4311,2738,2726
"20958","Ntome_NODE_5387_length_2988_cov_268","Nsylvestris_NODE_6695_length_2623_cov_223",96.719,2499,77,4,485,2979,2498,1,0,4156,2494,2497
"20996","Ntome_NODE_5398_length_2985_cov_273","Nsylvestris_NODE_1784_length_4187_cov_161",96.94,2680,60,8,101,2778,4062,1403,0,4475,2677,2659
"21065","Ntome_NODE_5418_length_2982_cov_99","Nsylvestris_NODE_6161_length_2723_cov_231",85.692,650,89,4,831,1478,1061,1708,0,682,647,647
"21078","Ntome_NODE_5423_length_2981_cov_37","Nsylvestris_NODE_2309_length_3890_cov_35",81.203,133,25,0,1878,2010,1686,1554,4.58e-22,108,132,132
"21105","Ntome_NODE_5432_length_2978_cov_35","Nsylvestris_NODE_4084_length_3208_cov_128",95.505,2981,116,7,1,2978,3165,200,0,4747,2977,2965
"21124","Ntome_NODE_5438_length_2976_cov_161","Nsylvestris_NODE_21660_length_980_cov_188",95.271,719,31,2,2143,2860,205,921,0,1136,717,716
"21192","Ntome_NODE_5456_length_2972_cov_214","Nsylvestris_NODE_5061_length_2957_cov_226",94.692,2958,136,7,1,2939,2956,1,0,4573,2938,2955
"21198","Ntome_NODE_5458_length_2972_cov_207","Nsylvestris_NODE_5066_length_2956_cov_176",97.431,2958,69,4,6,2958,2956,1,0,5035,2952,2955
"21211","Ntome_NODE_5462_length_2972_cov_52","Nsylvestris_NODE_21359_length_1003_cov_9",85.343,962,119,12,1761,2707,955,1,0,976,946,954
"21244","Ntome_NODE_5471_length_2970_cov_38","Nsylvestris_NODE_4994_length_2974_cov_114",94.597,2980,107,13,1,2969,2957,21,0,4562,2968,2936
"21292","Ntome_NODE_5482_length_2966_cov_301","Nsylvestris_NODE_509_length_5936_cov_229",96.532,2970,96,2,1,2964,2740,5708,0,4907,2963,2968
"21558","Ntome_NODE_5554_length_2949_cov_267","Nsylvestris_NODE_5491_length_2863_cov_223",97.498,2838,45,9,61,2898,2855,44,0,4824,2837,2811
"21570","Ntome_NODE_5557_length_2948_cov_290","Nsylvestris_NODE_5542_length_2852_cov_228",94.423,2618,132,7,336,2948,2804,196,0,4013,2612,2608
"21611","Ntome_NODE_5571_length_2945_cov_209","Nsylvestris_NODE_5484_length_2865_cov_133",79.765,1448,260,26,25,1449,1534,97,0,1020,1424,1437
"21617","Ntome_NODE_5574_length_2945_cov_107","Nsylvestris_NODE_2281_length_3901_cov_146",95.628,2928,106,6,20,2945,3869,962,0,4678,2925,2907
"21678","Ntome_NODE_5593_length_2940_cov_227","Nsylvestris_NODE_3785_length_3305_cov_170",94.801,2866,109,10,84,2940,1,2835,0,4431,2856,2834
"21812","Ntome_NODE_5634_length_2931_cov_260","Nsylvestris_NODE_5708_length_2818_cov_224",96.503,2774,85,8,96,2860,48,2818,0,4575,2764,2770
"21841","Ntome_NODE_5642_length_2929_cov_288","Nsylvestris_NODE_5330_length_2900_cov_172",96.113,2624,76,12,309,2929,104,2704,0,4257,2620,2600
"21898","Ntome_NODE_5658_length_2925_cov_283","Nsylvestris_NODE_5677_length_2823_cov_29",95.993,2720,85,10,129,2833,2711,1,0,4397,2704,2710
"21923","Ntome_NODE_5665_length_2924_cov_102","Nsylvestris_NODE_5169_length_2933_cov_127",96.549,2811,56,15,87,2879,146,2933,0,4615,2792,2787
"21924","Ntome_NODE_5666_length_2924_cov_31","Nsylvestris_NODE_4804_length_3021_cov_114",82.091,1234,194,14,1491,2721,1637,2846,0,1029,1230,1209
"21937","Ntome_NODE_5670_length_2923_cov_171","Nsylvestris_NODE_4689_length_3047_cov_190",94.39,2959,85,23,3,2922,4,2920,0,4470,2919,2916
"21944","Ntome_NODE_5673_length_2922_cov_33","Nsylvestris_NODE_914_length_5072_cov_55",95.778,2795,114,4,1,2794,57,2848,0,4505,2793,2791
"21986","Ntome_NODE_5687_length_2921_cov_104","Nsylvestris_NODE_8518_length_2322_cov_159",95.469,2207,92,6,389,2594,72,2271,0,3515,2205,2199
"22036","Ntome_NODE_5700_length_2918_cov_74","Nsylvestris_NODE_29502_length_563_cov_12",91.963,535,27,8,1019,1544,560,33,0,736,525,527
"22086","Ntome_NODE_5714_length_2914_cov_171","Nsylvestris_NODE_13983_length_1652_cov_146",94.295,1595,69,6,65,1637,56,1650,0,2422,1572,1594
"22105","Ntome_NODE_5721_length_2913_cov_93","Nsylvestris_NODE_12869_length_1778_cov_218",95.339,708,22,3,102,809,171,867,0,1114,707,696
"22116","Ntome_NODE_5725_length_2912_cov_227","Nsylvestris_NODE_5952_length_2769_cov_161",94.691,2769,138,3,47,2808,2767,1,0,4290,2761,2766
"22147","Ntome_NODE_5734_length_2909_cov_243","Nsylvestris_NODE_3368_length_3450_cov_203",97.846,2878,57,3,36,2909,133,3009,0,4966,2873,2876
"22153","Ntome_NODE_5736_length_2909_cov_151","Nsylvestris_NODE_11401_length_1942_cov_11",95.984,1942,78,0,860,2801,1,1942,0,3155,1941,1941
"22241","Ntome_NODE_5763_length_2904_cov_296","Nsylvestris_NODE_757_length_5332_cov_197",97.764,2728,49,2,180,2904,2988,270,0,4689,2724,2718
"22242","Ntome_NODE_5764_length_2904_cov_296","Nsylvestris_NODE_1433_length_4465_cov_232",97.695,1996,46,0,909,2904,4422,2427,0,3432,1995,1995
"22250","Ntome_NODE_5767_length_2904_cov_226","Nsylvestris_NODE_4770_length_3029_cov_199",98.561,2502,34,2,36,2537,1,2500,0,4420,2501,2499
"22280","Ntome_NODE_5777_length_2900_cov_306","Nsylvestris_NODE_861_length_5148_cov_192",96.403,2919,84,2,3,2900,3003,85,0,4789,2897,2918
"22288","Ntome_NODE_5780_length_2900_cov_261","Nsylvestris_NODE_1664_length_4277_cov_124",92.756,2816,163,20,80,2870,4277,1478,0,4032,2790,2799
"22363","Ntome_NODE_5801_length_2894_cov_95","Nsylvestris_NODE_5846_length_2793_cov_69",94.434,2767,102,24,68,2808,2792,52,0,4209,2740,2740
"22398","Ntome_NODE_5809_length_2892_cov_178","Nsylvestris_NODE_599_length_5708_cov_168",95.803,2859,72,19,15,2839,3001,157,0,4571,2824,2844
"22592","Ntome_NODE_5864_length_2881_cov_29","Nsylvestris_NODE_4509_length_3096_cov_197",94.677,2893,114,16,1,2877,3031,163,0,4453,2876,2868
"22596","Ntome_NODE_5866_length_2880_cov_247","Nsylvestris_NODE_2323_length_3882_cov_149",97.778,2880,64,0,1,2880,3114,235,0,4964,2879,2879
"22608","Ntome_NODE_5869_length_2880_cov_43","Nsylvestris_NODE_1844_length_4151_cov_97",86.53,683,57,19,2183,2854,3095,2437,0,719,671,658
"22660","Ntome_NODE_5884_length_2874_cov_259","Nsylvestris_NODE_5260_length_2913_cov_183",94.299,2859,139,10,17,2868,50,2891,0,4355,2851,2841
"22723","Ntome_NODE_5900_length_2871_cov_282","Nsylvestris_NODE_5888_length_2786_cov_221",96.105,2619,84,6,1,2606,88,2701,0,4255,2605,2613
"22757","Ntome_NODE_5909_length_2870_cov_176","Nsylvestris_NODE_5437_length_2867_cov_213",93.858,2882,109,29,4,2870,2867,39,0,4279,2866,2828
"22760","Ntome_NODE_5911_length_2870_cov_71","Nsylvestris_NODE_997_length_4960_cov_218",89.041,146,16,0,65,210,2908,2763,2.56e-44,182,145,145
"22777","Ntome_NODE_5916_length_2868_cov_112","Nsylvestris_NODE_6019_length_2757_cov_97",94.488,2413,130,3,404,2814,188,2599,0,3716,2410,2411
"22818","Ntome_NODE_5927_length_2867_cov_54","Nsylvestris_NODE_2714_length_3698_cov_83",87.531,1612,132,33,1267,2848,1112,2684,0,1799,1581,1572
"22838","Ntome_NODE_5932_length_2865_cov_261","Nsylvestris_NODE_2891_length_3624_cov_203",89.498,2352,175,35,1,2311,2533,213,0,2909,2310,2320
"22841","Ntome_NODE_5934_length_2865_cov_140","Nsylvestris_NODE_4655_length_3055_cov_192",93.993,2697,119,11,72,2750,141,2812,0,4043,2678,2671
"22851","Ntome_NODE_5937_length_2864_cov_63","Nsylvestris_NODE_401_length_6270_cov_204",92,75,4,2,1,74,4772,4845,5.68e-21,104,73,73
"22882","Ntome_NODE_5948_length_2861_cov_275","Nsylvestris_NODE_4921_length_2991_cov_228",94.244,2797,132,20,47,2819,2842,51,0,4246,2772,2791
"22905","Ntome_NODE_5954_length_2860_cov_197","Nsylvestris_NODE_22927_length_895_cov_227",88.502,574,64,2,264,836,77,649,0,693,572,572
"22916","Ntome_NODE_5957_length_2859_cov_229","Nsylvestris_NODE_7420_length_2501_cov_169",97.144,2451,47,3,83,2521,53,2492,0,4117,2438,2439
"22929","Ntome_NODE_5962_length_2857_cov_24","Nsylvestris_NODE_5638_length_2831_cov_29",97.272,2273,49,3,90,2350,29,2300,0,3842,2260,2271
"22946","Ntome_NODE_5969_length_2855_cov_97","Nsylvestris_NODE_692_length_5458_cov_100",96.465,2857,99,2,1,2855,2096,4952,0,4715,2854,2856
"22947","Ntome_NODE_5970_length_2855_cov_87","Nsylvestris_NODE_11676_length_1908_cov_225",96.302,1271,46,1,1355,2625,1536,267,0,2085,1270,1269
"23059","Ntome_NODE_6001_length_2847_cov_36","Nsylvestris_NODE_178_length_7523_cov_18",81.319,1713,314,6,1137,2847,4034,2326,0,1386,1710,1708
"23070","Ntome_NODE_6004_length_2846_cov_261","Nsylvestris_NODE_5627_length_2832_cov_223",96.401,2806,72,7,1,2784,2812,14,0,4595,2783,2798
"23128","Ntome_NODE_6021_length_2843_cov_285","Nsylvestris_NODE_6894_length_2586_cov_205",96.331,2589,91,3,244,2831,2586,1,0,4252,2587,2585
"23251","Ntome_NODE_6055_length_2837_cov_300","Nsylvestris_NODE_598_length_5712_cov_232",97.543,2808,50,8,48,2837,5695,2889,0,4785,2789,2806
"23252","Ntome_NODE_6056_length_2837_cov_283","Nsylvestris_NODE_3388_length_3442_cov_206",97.271,2785,53,4,1,2765,661,3442,0,4700,2764,2781
"23270","Ntome_NODE_6062_length_2837_cov_50","Nsylvestris_NODE_24952_length_774_cov_20",95.758,165,7,0,1296,1460,689,525,6.79e-70,267,164,164
"23278","Ntome_NODE_6065_length_2836_cov_222","Nsylvestris_NODE_6048_length_2750_cov_146",95.398,2716,115,4,44,2756,42,2750,0,4314,2712,2708
"23345","Ntome_NODE_6084_length_2833_cov_94","Nsylvestris_NODE_5315_length_2902_cov_142",97.215,2801,51,8,1,2791,2786,3,0,4715,2790,2783
"23419","Ntome_NODE_6104_length_2830_cov_50","Nsylvestris_NODE_14085_length_1641_cov_190",93.6,1500,64,11,1,1474,72,1565,0,2209,1473,1493
"23420","Ntome_NODE_6105_length_2829_cov_301","Nsylvestris_NODE_5420_length_2881_cov_149",87.636,736,89,2,297,1031,379,1113,0,854,734,734
"23458","Ntome_NODE_6117_length_2828_cov_71","Nsylvestris_NODE_14833_length_1566_cov_98",78.453,181,36,2,14,192,1420,1241,2.59e-24,115,178,179
"23484","Ntome_NODE_6125_length_2827_cov_22","Nsylvestris_NODE_1360_length_4535_cov_71",97.559,2827,68,1,1,2827,759,3584,0,4837,2826,2825
"23493","Ntome_NODE_6129_length_2826_cov_83","Nsylvestris_NODE_1415_length_4483_cov_192",98.086,2821,53,1,6,2826,4067,1248,0,4909,2820,2819
"23566","Ntome_NODE_6150_length_2823_cov_60","Nsylvestris_NODE_6403_length_2679_cov_155",88.82,644,71,1,2153,2796,643,1,0,789,643,642
"23651","Ntome_NODE_6173_length_2817_cov_242","Nsylvestris_NODE_4971_length_2980_cov_211",96.796,2778,52,12,47,2817,165,2912,0,4602,2770,2747
"23848","Ntome_NODE_6226_length_2805_cov_50","Nsylvestris_NODE_17100_length_1348_cov_180",98.148,54,1,0,2752,2805,696,643,3.35e-18,95.3,53,53
"23873","Ntome_NODE_6234_length_2802_cov_59","Nsylvestris_NODE_6723_length_2618_cov_15",96.622,2546,86,0,96,2641,2618,73,0,4226,2545,2545
"23874","Ntome_NODE_6235_length_2801_cov_252","Nsylvestris_NODE_1780_length_4188_cov_237",94.855,2760,133,2,1,2751,4028,1269,0,4301,2750,2759
"24025","Ntome_NODE_6273_length_2792_cov_37","Nsylvestris_NODE_36381_length_264_cov_120",92.857,126,7,1,159,284,208,85,2.49e-44,182,125,123
"24063","Ntome_NODE_6279_length_2792_cov_56","Nsylvestris_NODE_6240_length_2709_cov_88",94.519,2536,115,5,78,2609,89,2604,0,3892,2531,2515
"24074","Ntome_NODE_6283_length_2790_cov_278","Nsylvestris_NODE_5305_length_2905_cov_178",95.68,2662,96,5,45,2689,2883,224,0,4261,2644,2659
"24124","Ntome_NODE_6295_length_2789_cov_59","Nsylvestris_NODE_5292_length_2907_cov_184",95.294,2805,84,19,4,2789,2859,84,0,4405,2785,2775
"24140","Ntome_NODE_6301_length_2787_cov_265","Nsylvestris_NODE_3839_length_3289_cov_119",95.658,2787,92,11,12,2774,1,2782,0,4449,2762,2781
"24173","Ntome_NODE_6310_length_2786_cov_166","Nsylvestris_NODE_1221_length_4684_cov_217",95.431,1751,59,14,1039,2770,7,1755,0,2771,1731,1748
"24239","Ntome_NODE_6329_length_2782_cov_170","Nsylvestris_NODE_9285_length_2209_cov_91",93.649,2173,121,11,555,2724,2209,51,0,3232,2169,2158
"24281","Ntome_NODE_6339_length_2781_cov_69","Nsylvestris_NODE_6647_length_2634_cov_147",95.526,2593,109,5,61,2649,2634,45,0,4139,2588,2589
"24344","Ntome_NODE_6352_length_2777_cov_153","Nsylvestris_NODE_9863_length_2132_cov_112",93.692,2061,114,6,231,2290,35,2080,0,3072,2059,2045
"24356","Ntome_NODE_6356_length_2777_cov_19","Nsylvestris_NODE_31414_length_425_cov_3",96.682,422,14,0,752,1173,1,422,0,702,421,421
"24357","Ntome_NODE_6357_length_2776_cov_203","Nsylvestris_NODE_2300_length_3893_cov_23",95.639,2591,106,5,44,2631,61,2647,0,4152,2587,2586
"24372","Ntome_NODE_6361_length_2775_cov_221","Nsylvestris_NODE_5404_length_2885_cov_27",96.923,65,1,1,127,191,125,188,4.26e-22,108,64,63
"24377","Ntome_NODE_6363_length_2775_cov_39","Nsylvestris_NODE_32125_length_388_cov_195",93.651,315,19,1,73,386,367,53,4.71e-131,470,313,314
"24403","Ntome_NODE_6371_length_2773_cov_264","Nsylvestris_NODE_1271_length_4622_cov_101",94.921,2717,131,6,61,2773,1577,4290,0,4246,2712,2713
"24404","Ntome_NODE_6372_length_2773_cov_92","Nsylvestris_NODE_7489_length_2476_cov_138",95.374,1405,49,12,64,1466,2110,720,0,2220,1402,1390
"24431","Ntome_NODE_6383_length_2770_cov_221","Nsylvestris_NODE_4753_length_3033_cov_126",93.897,2507,145,5,216,2718,2544,42,0,3775,2502,2502
"24455","Ntome_NODE_6392_length_2769_cov_86","Nsylvestris_NODE_6326_length_2693_cov_67",94.059,2693,134,9,8,2695,22,2693,0,4063,2687,2671
"24456","Ntome_NODE_6393_length_2769_cov_50","Nsylvestris_NODE_10718_length_2023_cov_183",100,28,0,0,2599,2626,36,9,2.02e-05,52.8,27,27
"24492","Ntome_NODE_6405_length_2766_cov_114","Nsylvestris_NODE_5693_length_2821_cov_111",95.668,2678,101,7,74,2738,2775,100,0,4289,2664,2675
"24498","Ntome_NODE_6407_length_2765_cov_12","Nsylvestris_NODE_29221_length_574_cov_13",81.068,206,24,11,990,1192,159,352,6.95e-35,150,202,193
"24511","Ntome_NODE_6411_length_2765_cov_113","Nsylvestris_NODE_7894_length_2422_cov_99",94.768,2389,66,10,1,2376,37,2379,0,3664,2375,2342
"24526","Ntome_NODE_6416_length_2764_cov_192","Nsylvestris_NODE_5505_length_2861_cov_131",94.39,2674,104,19,82,2742,2820,180,0,4065,2660,2640
"24546","Ntome_NODE_6424_length_2762_cov_236","Nsylvestris_NODE_8061_length_2393_cov_40",95.596,2384,89,10,241,2610,2382,1,0,3807,2369,2381
"24552","Ntome_NODE_6426_length_2762_cov_71","Nsylvestris_NODE_7133_length_2549_cov_20",96.4,2500,86,2,159,2654,2545,46,0,4115,2495,2499
"24558","Ntome_NODE_6429_length_2760_cov_278","Nsylvestris_NODE_5166_length_2933_cov_208",92.316,2629,150,17,132,2740,2607,11,0,3688,2608,2596
"24621","Ntome_NODE_6446_length_2758_cov_48","Nsylvestris_NODE_63_length_9186_cov_130",95.959,2648,90,4,117,2755,224,2863,0,4281,2638,2639
"24630","Ntome_NODE_6449_length_2758_cov_16","Nsylvestris_NODE_8968_length_2255_cov_225",95.161,62,2,1,2697,2758,1119,1059,9.16e-19,97.1,61,60
"24680","Ntome_NODE_6466_length_2754_cov_302","Nsylvestris_NODE_4198_length_3176_cov_225",96.478,2726,93,1,32,2754,3176,451,0,4499,2722,2725
"24696","Ntome_NODE_6473_length_2753_cov_285","Nsylvestris_NODE_374_length_6403_cov_158",98.082,2711,41,1,54,2753,77,2787,0,4708,2699,2710
"24717","Ntome_NODE_6481_length_2751_cov_246","Nsylvestris_NODE_7016_length_2567_cov_108",96.003,2527,77,14,83,2600,51,2562,0,4085,2517,2511
"24776","Ntome_NODE_6498_length_2749_cov_74","Nsylvestris_NODE_1120_length_4801_cov_124",93.061,2522,120,26,1,2492,2140,4636,0,3637,2491,2496
"24808","Ntome_NODE_6508_length_2747_cov_88","Nsylvestris_NODE_11423_length_1938_cov_225",98.182,55,1,0,2693,2747,1199,1145,9.12e-19,97.1,54,54
"24840","Ntome_NODE_6514_length_2746_cov_126","Nsylvestris_NODE_28069_length_625_cov_179",95.291,446,21,0,2244,2689,499,54,0,708,445,445
"24946","Ntome_NODE_6543_length_2739_cov_285","Nsylvestris_NODE_5751_length_2810_cov_131",94.39,2674,118,9,46,2700,150,2810,0,4078,2654,2660
"24974","Ntome_NODE_6553_length_2738_cov_13","Nsylvestris_NODE_2934_length_3609_cov_15",95.642,2685,113,4,1,2684,2985,304,0,4307,2683,2681
"25026","Ntome_NODE_6564_length_2736_cov_124","Nsylvestris_NODE_6702_length_2622_cov_122",94.702,2605,93,18,56,2636,37,2620,0,4004,2580,2583
"25037","Ntome_NODE_6567_length_2735_cov_294","Nsylvestris_NODE_2214_length_3931_cov_223",96.757,2683,70,11,1,2674,1,2675,0,4457,2673,2674
"25042","Ntome_NODE_6569_length_2735_cov_123","Nsylvestris_NODE_16767_length_1375_cov_88",88.636,220,19,4,250,465,53,270,8.46e-69,263,215,217
"25113","Ntome_NODE_6593_length_2732_cov_44","Nsylvestris_NODE_7681_length_2454_cov_67",77.177,666,138,5,979,1640,1727,2382,1.04e-102,375,661,655
"25152","Ntome_NODE_6605_length_2729_cov_185","Nsylvestris_NODE_7075_length_2558_cov_132",97.654,2558,55,2,42,2594,2558,1,0,4386,2552,2557
"25168","Ntome_NODE_6611_length_2728_cov_200","Nsylvestris_NODE_6572_length_2648_cov_59",95.51,2695,58,24,40,2718,1,2648,0,4248,2678,2647
"25172","Ntome_NODE_6614_length_2727_cov_108","Nsylvestris_NODE_366_length_6419_cov_87",97.232,2095,56,2,178,2270,562,2656,0,3546,2092,2094
"25191","Ntome_NODE_6619_length_2726_cov_40","Nsylvestris_NODE_6772_length_2609_cov_44",94.045,2351,128,9,328,2674,138,2480,0,3555,2346,2342
"25216","Ntome_NODE_6627_length_2724_cov_267","Nsylvestris_NODE_6293_length_2698_cov_227",96.813,2667,59,14,9,2666,2655,6,0,4431,2657,2649
"25217","Ntome_NODE_6628_length_2724_cov_251","Nsylvestris_NODE_6664_length_2631_cov_136",91.504,2554,134,35,41,2547,2566,49,0,3437,2506,2517
"25224","Ntome_NODE_6632_length_2723_cov_249","Nsylvestris_NODE_6331_length_2692_cov_220",94.668,2682,105,13,1,2668,1,2658,0,4126,2667,2657
"25256","Ntome_NODE_6642_length_2722_cov_36","Nsylvestris_NODE_28366_length_611_cov_179",79.396,364,49,12,276,613,545,182,6.6e-60,233,337,363
"25257","Ntome_NODE_6643_length_2721_cov_280","Nsylvestris_NODE_6104_length_2736_cov_188",97.229,2634,63,4,47,2673,5,2635,0,4451,2626,2630
"25297","Ntome_NODE_6655_length_2719_cov_288","Nsylvestris_NODE_1074_length_4848_cov_193",97.772,2648,45,6,1,2637,1452,4096,0,4551,2636,2644
"25298","Ntome_NODE_6656_length_2719_cov_275","Nsylvestris_NODE_2516_length_3784_cov_153",97.663,2653,62,0,1,2653,2685,33,0,4556,2652,2652
"25361","Ntome_NODE_6673_length_2717_cov_27","Nsylvestris_NODE_6716_length_2619_cov_34",95.845,2431,95,3,162,2586,189,2619,0,3925,2424,2430
"25382","Ntome_NODE_6680_length_2716_cov_133","Nsylvestris_NODE_5814_length_2798_cov_95",96.502,2659,84,4,1,2654,47,2701,0,4386,2653,2654
"25422","Ntome_NODE_6690_length_2715_cov_12","Nsylvestris_NODE_3579_length_3372_cov_28",96.62,2367,77,1,352,2715,450,2816,0,3925,2363,2366
"25481","Ntome_NODE_6705_length_2713_cov_131","Nsylvestris_NODE_8166_length_2376_cov_75",92.527,2355,129,14,276,2612,46,2371,0,3330,2336,2325
"25504","Ntome_NODE_6711_length_2712_cov_143","Nsylvestris_NODE_15358_length_1516_cov_56",92.686,752,26,11,1468,2200,401,1142,0,1057,732,741
"25568","Ntome_NODE_6729_length_2707_cov_30","Nsylvestris_NODE_4590_length_3075_cov_227",94.203,69,2,1,2641,2707,1083,1151,5.37e-21,104,66,68
"25578","Ntome_NODE_6732_length_2706_cov_250","Nsylvestris_NODE_6634_length_2636_cov_172",94.319,2658,101,29,55,2684,2636,1,0,4026,2629,2635
"25586","Ntome_NODE_6734_length_2706_cov_86","Nsylvestris_NODE_27369_length_657_cov_91",90.533,338,23,5,2,331,58,394,1.3e-121,438,329,336
"25597","Ntome_NODE_6737_length_2705_cov_207","Nsylvestris_NODE_8843_length_2273_cov_210",96.444,1884,58,5,153,2030,117,1997,0,3099,1877,1880
"25633","Ntome_NODE_6748_length_2704_cov_179","Nsylvestris_NODE_6872_length_2590_cov_154",96.071,2469,82,9,140,2601,69,2529,0,4008,2461,2460
"25634","Ntome_NODE_6749_length_2704_cov_152","Nsylvestris_NODE_4023_length_3226_cov_150",98.254,1317,23,0,1148,2464,1909,3225,0,2305,1316,1316
"25641","Ntome_NODE_6752_length_2703_cov_287","Nsylvestris_NODE_274_length_6832_cov_223",97.822,2663,49,6,47,2703,43,2702,0,4588,2656,2659
"25653","Ntome_NODE_6755_length_2703_cov_38","Nsylvestris_NODE_6060_length_2747_cov_34",94.205,2709,132,8,8,2701,1,2699,0,4109,2693,2698
"25678","Ntome_NODE_6765_length_2700_cov_110","Nsylvestris_NODE_17300_length_1331_cov_225",96.446,619,21,1,284,902,316,933,0,1020,618,617
"25685","Ntome_NODE_6768_length_2700_cov_53","Nsylvestris_NODE_11462_length_1935_cov_16",97.09,1821,51,2,221,2039,1,1821,0,3068,1818,1820
"25721","Ntome_NODE_6778_length_2698_cov_63","Nsylvestris_NODE_6208_length_2715_cov_79",93.129,2707,166,7,1,2698,18,2713,0,3951,2697,2695
"25729","Ntome_NODE_6781_length_2698_cov_161","Nsylvestris_NODE_6944_length_2578_cov_146",94.052,2253,84,26,199,2427,50,2276,0,3373,2228,2226
"25744","Ntome_NODE_6787_length_2696_cov_222","Nsylvestris_NODE_1871_length_4135_cov_183",95.94,1995,75,2,253,2247,2095,4083,0,3230,1994,1988
"25745","Ntome_NODE_6788_length_2695_cov_179","Nsylvestris_NODE_4434_length_3113_cov_64",95.976,1317,53,0,804,2120,55,1371,0,2139,1316,1316
"25818","Ntome_NODE_6806_length_2694_cov_128","Nsylvestris_NODE_8337_length_2350_cov_119",97.419,2092,39,3,25,2101,70,2161,0,3550,2076,2091
"25879","Ntome_NODE_6821_length_2690_cov_145","Nsylvestris_NODE_5960_length_2768_cov_59",94.819,2683,110,15,1,2670,19,2685,0,4157,2669,2666
"25934","Ntome_NODE_6836_length_2687_cov_206","Nsylvestris_NODE_9808_length_2139_cov_50",93.988,2129,94,15,43,2143,1,2123,0,3192,2100,2122
"25961","Ntome_NODE_6844_length_2686_cov_194","Nsylvestris_NODE_5950_length_2769_cov_206",96.426,2686,70,13,1,2683,2732,70,0,4405,2682,2662
"25978","Ntome_NODE_6849_length_2685_cov_119","Nsylvestris_NODE_6038_length_2753_cov_209",95.303,2661,111,3,2,2653,2734,79,0,4209,2651,2655
"25992","Ntome_NODE_6854_length_2684_cov_196","Nsylvestris_NODE_30428_length_492_cov_10",76.308,325,57,16,2155,2472,492,181,1.45e-36,156,317,311
"26011","Ntome_NODE_6861_length_2683_cov_61","Nsylvestris_NODE_1726_length_4230_cov_53",84.69,516,57,18,2022,2529,1826,1325,7.51e-139,496,507,501
"26028","Ntome_NODE_6865_length_2682_cov_179","Nsylvestris_NODE_5349_length_2897_cov_52",95.408,2265,98,2,55,2313,244,2508,0,3602,2258,2264
"26035","Ntome_NODE_6868_length_2682_cov_13","Nsylvestris_NODE_35752_length_278_cov_5",94.619,223,11,1,2460,2682,1,222,2.88e-93,344,222,221
"26070","Ntome_NODE_6879_length_2678_cov_254","Nsylvestris_NODE_6928_length_2580_cov_228",95.624,2582,84,11,6,2578,2562,1,0,4115,2572,2561
"26091","Ntome_NODE_6886_length_2677_cov_133","Nsylvestris_NODE_7201_length_2534_cov_190",97.083,1474,41,1,99,1572,268,1739,0,2483,1473,1471
"26115","Ntome_NODE_6893_length_2676_cov_40","Nsylvestris_NODE_5873_length_2789_cov_39",93.321,1078,71,1,1500,2576,2664,1587,0,1591,1076,1077
"26120","Ntome_NODE_6895_length_2675_cov_282","Nsylvestris_NODE_6289_length_2699_cov_224",95.133,2630,121,5,1,2624,2668,40,0,4141,2623,2628
"26234","Ntome_NODE_6930_length_2667_cov_198","Nsylvestris_NODE_480_length_6013_cov_129",96.849,1460,42,4,193,1651,4956,3500,0,2438,1458,1456
"26243","Ntome_NODE_6934_length_2666_cov_264","Nsylvestris_NODE_3219_length_3500_cov_131",97.876,2636,40,7,1,2634,2622,1,0,4543,2633,2621
"26244","Ntome_NODE_6935_length_2666_cov_255","Nsylvestris_NODE_6792_length_2604_cov_208",89.951,2428,150,33,116,2523,251,2604,0,3046,2407,2353
"26255","Ntome_NODE_6939_length_2666_cov_88","Nsylvestris_NODE_6550_length_2651_cov_182",91.936,2567,121,20,1,2537,90,2600,0,3515,2536,2510
"26278","Ntome_NODE_6946_length_2664_cov_239","Nsylvestris_NODE_6108_length_2735_cov_170",94.406,2628,115,10,57,2664,2629,14,0,4010,2607,2615
"26315","Ntome_NODE_6956_length_2657_cov_203","Nsylvestris_NODE_5504_length_2861_cov_158",97.158,2604,64,6,2,2598,102,2702,0,4390,2596,2600
"26316","Ntome_NODE_6957_length_2662_cov_108","Nsylvestris_NODE_6341_length_2690_cov_235",95.884,2648,68,17,15,2637,17,2648,0,4248,2622,2631
"26330","Ntome_NODE_6961_length_2661_cov_251","Nsylvestris_NODE_606_length_5689_cov_130",91.371,2677,156,40,30,2661,5254,2608,0,3594,2631,2646
"26378","Ntome_NODE_6977_length_2659_cov_19","Nsylvestris_NODE_17030_length_1355_cov_32",97.897,1141,21,1,1424,2561,1250,110,0,1971,1137,1140
"26420","Ntome_NODE_6989_length_2657_cov_91","Nsylvestris_NODE_15588_length_1492_cov_23",94.58,1439,32,15,35,1443,1491,69,0,2183,1408,1422
"26425","Ntome_NODE_6991_length_2656_cov_173","Nsylvestris_NODE_6830_length_2598_cov_165",94.315,2533,116,10,1,2520,37,2554,0,3855,2519,2517
"26491","Ntome_NODE_7011_length_2652_cov_289","Nsylvestris_NODE_783_length_5263_cov_121",96.731,2600,70,13,56,2643,2597,1,0,4316,2587,2596
"26528","Ntome_NODE_7022_length_2652_cov_36","Nsylvestris_NODE_5729_length_2816_cov_153",95.71,2611,110,2,4,2614,2612,4,0,4200,2610,2608
"26554","Ntome_NODE_7031_length_2650_cov_79","Nsylvestris_NODE_8468_length_2330_cov_23",95.662,2236,88,4,1,2230,2278,46,0,3583,2229,2232
"26596","Ntome_NODE_7045_length_2647_cov_184","Nsylvestris_NODE_1286_length_4606_cov_150",93.745,2590,107,21,1,2556,3359,791,0,3834,2555,2568
"26654","Ntome_NODE_7062_length_2645_cov_35","Nsylvestris_NODE_10288_length_2077_cov_159",95.06,2004,82,7,350,2343,2039,43,0,3136,1993,1996
"26662","Ntome_NODE_7064_length_2644_cov_287","Nsylvestris_NODE_6400_length_2680_cov_156",96.227,2465,93,0,54,2518,2471,7,0,4037,2464,2464
"26687","Ntome_NODE_7072_length_2643_cov_146","Nsylvestris_NODE_7323_length_2516_cov_173",94.247,2451,114,9,131,2569,42,2477,0,3720,2438,2435
"26693","Ntome_NODE_7075_length_2643_cov_26","Nsylvestris_NODE_6535_length_2655_cov_66",95.645,2549,101,9,1,2545,49,2591,0,4084,2544,2542
"26694","Ntome_NODE_7076_length_2642_cov_288","Nsylvestris_NODE_8619_length_2306_cov_217",94.73,2258,112,3,34,2284,2305,48,0,3504,2250,2257
"26695","Ntome_NODE_7077_length_2642_cov_228","Nsylvestris_NODE_4980_length_2979_cov_103",97.347,2224,45,6,429,2642,2230,11,0,3768,2213,2219
"26721","Ntome_NODE_7084_length_2642_cov_14","Nsylvestris_NODE_4312_length_3147_cov_26",92.768,2641,188,3,5,2642,434,3074,0,3816,2637,2640
"26722","Ntome_NODE_7085_length_2641_cov_248","Nsylvestris_NODE_7971_length_2409_cov_199",95.709,2307,81,11,283,2588,2326,37,0,3696,2305,2289
"26792","Ntome_NODE_7108_length_2636_cov_252","Nsylvestris_NODE_4111_length_3199_cov_196",95.994,2596,98,4,44,2636,26,2618,0,4213,2592,2592
"26866","Ntome_NODE_7132_length_2633_cov_262","Nsylvestris_NODE_6417_length_2676_cov_124",94.788,2571,127,3,25,2595,2604,41,0,3999,2570,2563
"26884","Ntome_NODE_7138_length_2632_cov_37","Nsylvestris_NODE_2816_length_3655_cov_133",81.98,788,103,15,282,1036,1634,853,5.38e-180,632,754,781
"26935","Ntome_NODE_7154_length_2630_cov_20","Nsylvestris_NODE_5536_length_2855_cov_36",95.404,2633,117,3,1,2630,124,2755,0,4189,2629,2631
"26943","Ntome_NODE_7158_length_2629_cov_180","Nsylvestris_NODE_606_length_5689_cov_130",95.646,2641,84,18,1,2616,2662,28,0,4211,2615,2634
"26971","Ntome_NODE_7168_length_2628_cov_84","Nsylvestris_NODE_7122_length_2550_cov_45",96.436,2553,79,3,3,2546,2550,1,0,4200,2543,2549
"26991","Ntome_NODE_7174_length_2626_cov_253","Nsylvestris_NODE_3583_length_3370_cov_219",96.433,2411,72,6,106,2511,910,3311,0,3964,2405,2401
"27006","Ntome_NODE_7180_length_2625_cov_161","Nsylvestris_NODE_5490_length_2864_cov_89",95.946,2590,84,8,1,2577,28,2609,0,4181,2576,2581
"27079","Ntome_NODE_7200_length_2622_cov_120","Nsylvestris_NODE_7968_length_2410_cov_97",96.749,2399,67,8,203,2593,2396,1,0,3988,2390,2395
"27143","Ntome_NODE_7217_length_2619_cov_53","Nsylvestris_NODE_11161_length_1967_cov_141",84.718,301,43,3,2005,2305,413,710,2.22e-79,298,300,297
"27196","Ntome_NODE_7234_length_2617_cov_189","Nsylvestris_NODE_6138_length_2728_cov_155",93.953,2580,126,20,13,2573,120,2688,0,3873,2560,2568
"27271","Ntome_NODE_7256_length_2612_cov_236","Nsylvestris_NODE_667_length_5511_cov_154",96.679,2499,67,8,127,2612,1826,4321,0,4141,2485,2495
"27291","Ntome_NODE_7262_length_2611_cov_228","Nsylvestris_NODE_6437_length_2671_cov_158",93.89,2553,127,15,60,2605,2534,4,0,3823,2545,2530
"27303","Ntome_NODE_7266_length_2611_cov_15","Nsylvestris_NODE_13346_length_1724_cov_159",87.097,62,1,2,2557,2611,193,132,8.79e-09,63.9,54,61
"27329","Ntome_NODE_7274_length_2610_cov_51","Nsylvestris_NODE_7741_length_2446_cov_45",96.136,2407,76,6,27,2432,2391,1,0,3914,2405,2390
"27393","Ntome_NODE_7293_length_2605_cov_292","Nsylvestris_NODE_7167_length_2540_cov_216",96.697,2452,42,10,1,2425,30,2469,0,4043,2424,2439
"27505","Ntome_NODE_7323_length_2600_cov_198","Nsylvestris_NODE_3233_length_3496_cov_100",96.323,2529,77,6,1,2526,2516,1,0,4141,2525,2515
"27509","Ntome_NODE_7325_length_2600_cov_62","Nsylvestris_NODE_26823_length_682_cov_9",92.371,603,30,2,95,685,84,682,0,845,590,598
"27528","Ntome_NODE_7332_length_2598_cov_59","Nsylvestris_NODE_6950_length_2577_cov_58",94.941,2530,122,4,71,2598,2577,52,0,3958,2527,2525
"27545","Ntome_NODE_7338_length_2596_cov_304","Nsylvestris_NODE_6065_length_2746_cov_155",96.547,1998,66,3,217,2213,2559,564,0,3304,1996,1995
"27546","Ntome_NODE_7339_length_2596_cov_177","Nsylvestris_NODE_5159_length_2935_cov_130",86.971,921,103,8,31,948,1323,2229,0,1020,917,906
"27570","Ntome_NODE_7346_length_2595_cov_137","Nsylvestris_NODE_6085_length_2741_cov_95",94.636,2442,59,19,148,2580,2380,2,0,3718,2432,2378
"27571","Ntome_NODE_7347_length_2595_cov_137","Nsylvestris_NODE_9780_length_2143_cov_111",93.372,2052,73,19,5,2013,2,2033,0,2977,2008,2031
"27575","Ntome_NODE_7349_length_2595_cov_27","Nsylvestris_NODE_2017_length_4042_cov_213",98.242,2161,38,0,298,2458,1673,3833,0,3781,2160,2160
"27586","Ntome_NODE_7351_length_2594_cov_282","Nsylvestris_NODE_8389_length_2342_cov_235",98.352,2184,36,0,299,2482,2184,1,0,3834,2183,2183
"27627","Ntome_NODE_7365_length_2592_cov_69","Nsylvestris_NODE_17237_length_1337_cov_135",91.736,1319,80,5,1159,2451,1337,22,0,1805,1292,1315
"27658","Ntome_NODE_7375_length_2590_cov_15","Nsylvestris_NODE_5171_length_2932_cov_67",96.86,2357,71,1,237,2590,293,2649,0,3940,2353,2356
"27668","Ntome_NODE_7381_length_2589_cov_62","Nsylvestris_NODE_15419_length_1511_cov_12",87.719,57,4,3,560,616,813,760,8.71e-09,63.9,56,53
"27732","Ntome_NODE_7400_length_2585_cov_99","Nsylvestris_NODE_6201_length_2717_cov_44",97.297,2368,55,2,215,2573,348,2715,0,4010,2358,2367
"27756","Ntome_NODE_7404_length_2585_cov_29","Nsylvestris_NODE_215_length_7253_cov_87",93.359,2093,126,8,205,2285,5224,3133,0,3083,2080,2091
"27765","Ntome_NODE_7407_length_2584_cov_243","Nsylvestris_NODE_7208_length_2532_cov_183",95.474,2541,58,25,6,2532,2508,11,0,4002,2526,2497
"27806","Ntome_NODE_7420_length_2583_cov_120","Nsylvestris_NODE_3039_length_3572_cov_177",94.609,2504,93,17,86,2579,2516,45,0,3838,2493,2471
"27807","Ntome_NODE_7421_length_2583_cov_15","Nsylvestris_NODE_6595_length_2644_cov_37",97.712,2448,56,0,136,2583,51,2498,0,4211,2447,2447
"27817","Ntome_NODE_7424_length_2582_cov_180","Nsylvestris_NODE_2759_length_3680_cov_131",91.421,2203,123,30,187,2357,3632,1464,0,2961,2170,2168
"27821","Ntome_NODE_7426_length_2582_cov_135","Nsylvestris_NODE_3771_length_3312_cov_95",96.285,2557,66,5,32,2582,3308,775,0,4169,2550,2533
"27874","Ntome_NODE_7446_length_2578_cov_247","Nsylvestris_NODE_7601_length_2470_cov_221",97.743,2348,41,6,6,2349,2449,110,0,4032,2343,2339
"27897","Ntome_NODE_7454_length_2577_cov_224","Nsylvestris_NODE_241_length_7050_cov_29",97.122,2363,59,1,1,2363,2787,5140,0,3978,2362,2353
"27934","Ntome_NODE_7464_length_2576_cov_13","Nsylvestris_NODE_3002_length_3587_cov_188",96.364,55,2,0,2522,2576,516,462,3.98e-17,91.6,54,54
"27938","Ntome_NODE_7466_length_2575_cov_189","Nsylvestris_NODE_5777_length_2805_cov_192",94.635,2535,112,12,1,2522,59,2582,0,3906,2521,2523
"28057","Ntome_NODE_7499_length_2571_cov_69","Nsylvestris_NODE_29676_length_555_cov_149",96.364,55,2,0,1,55,414,360,3.97e-17,91.6,54,54
"28091","Ntome_NODE_7509_length_2570_cov_45","Nsylvestris_NODE_5453_length_2873_cov_23",95.932,2286,92,1,81,2366,2870,586,0,3705,2285,2284
"28133","Ntome_NODE_7520_length_2567_cov_157","Nsylvestris_NODE_6604_length_2641_cov_186",94.502,2401,100,18,86,2465,2459,70,0,3674,2379,2389
"28136","Ntome_NODE_7522_length_2567_cov_106","Nsylvestris_NODE_1117_length_4804_cov_122",95.814,2580,58,12,1,2537,2601,29,0,4120,2536,2572
"28143","Ntome_NODE_7525_length_2566_cov_229","Nsylvestris_NODE_8019_length_2400_cov_134",96.162,2423,62,10,116,2534,2396,1,0,3930,2418,2395
"28174","Ntome_NODE_7536_length_2565_cov_33","Nsylvestris_NODE_4443_length_3111_cov_80",90.25,1159,94,13,1005,2154,1185,37,0,1496,1149,1148
"28175","Ntome_NODE_7537_length_2565_cov_17","Nsylvestris_NODE_5484_length_2865_cov_133",82.191,2611,374,55,4,2565,2699,131,0,2161,2561,2568
"28176","Ntome_NODE_7538_length_2564_cov_290","Nsylvestris_NODE_14496_length_1600_cov_212",97.878,1555,27,4,971,2521,45,1597,0,2684,1550,1552
"28194","Ntome_NODE_7544_length_2564_cov_121","Nsylvestris_NODE_6633_length_2636_cov_207",93.93,2356,121,10,173,2520,113,2454,0,3539,2347,2341
"28240","Ntome_NODE_7557_length_2562_cov_160","Nsylvestris_NODE_7661_length_2459_cov_170",94.53,2468,109,15,39,2502,14,2459,0,3786,2463,2445
"28247","Ntome_NODE_7560_length_2561_cov_292","Nsylvestris_NODE_9528_length_2172_cov_227",94.699,2094,102,5,369,2461,2133,48,0,3243,2092,2085
"28270","Ntome_NODE_7569_length_2559_cov_40","Nsylvestris_NODE_1820_length_4162_cov_173",93.838,2126,121,3,206,2330,55,2171,0,3192,2124,2116
"28285","Ntome_NODE_7575_length_2558_cov_32","Nsylvestris_NODE_7104_length_2553_cov_22",94.106,2562,105,19,22,2557,6,2547,0,3853,2535,2541
"28317","Ntome_NODE_7584_length_2557_cov_145","Nsylvestris_NODE_1850_length_4149_cov_72",96.424,2489,85,3,1,2485,1661,4149,0,4100,2484,2488
"28329","Ntome_NODE_7589_length_2556_cov_247","Nsylvestris_NODE_6491_length_2662_cov_192",97.279,2462,44,4,46,2493,2501,49,0,4154,2447,2452
"28336","Ntome_NODE_7592_length_2555_cov_171","Nsylvestris_NODE_11960_length_1874_cov_191",96.183,1179,41,2,394,1571,1,1176,0,1925,1177,1175
"28359","Ntome_NODE_7600_length_2554_cov_9","Nsylvestris_NODE_13550_length_1700_cov_226",98.182,55,1,0,2500,2554,813,759,8.47e-19,97.1,54,54
"28360","Ntome_NODE_7601_length_2553_cov_294","Nsylvestris_NODE_7213_length_2531_cov_226",96.862,2390,62,6,23,2409,105,2484,0,3986,2386,2379
"28388","Ntome_NODE_7609_length_2552_cov_284","Nsylvestris_NODE_4404_length_3124_cov_208",98,2550,47,4,1,2549,569,3115,0,4423,2548,2546
"28398","Ntome_NODE_7611_length_2552_cov_257","Nsylvestris_NODE_11637_length_1914_cov_193",96.918,1882,41,11,669,2541,1874,1,0,3138,1872,1873
"28430","Ntome_NODE_7621_length_2551_cov_259","Nsylvestris_NODE_6937_length_2579_cov_211",97.47,2490,60,3,50,2537,88,2576,0,4246,2487,2488
"28484","Ntome_NODE_7637_length_2549_cov_283","Nsylvestris_NODE_7736_length_2446_cov_220",96.053,2407,47,9,62,2443,2442,59,0,3875,2381,2383
"28530","Ntome_NODE_7651_length_2548_cov_14","Nsylvestris_NODE_4319_length_3146_cov_24",92.712,2168,122,17,415,2548,2501,336,0,3096,2133,2165
"28553","Ntome_NODE_7658_length_2547_cov_49","Nsylvestris_NODE_7092_length_2554_cov_90",96.033,2521,78,5,1,2513,32,2538,0,4082,2512,2506
"28560","Ntome_NODE_7661_length_2546_cov_290","Nsylvestris_NODE_2338_length_3878_cov_228",96.953,2527,54,5,1,2523,1370,3877,0,4218,2522,2507
"28614","Ntome_NODE_7678_length_2544_cov_195","Nsylvestris_NODE_7616_length_2468_cov_210",94.652,2431,95,13,49,2467,3,2410,0,3736,2418,2407
"28637","Ntome_NODE_7684_length_2543_cov_242","Nsylvestris_NODE_2374_length_3855_cov_206",93.498,2184,100,16,71,2239,87,2243,0,3208,2168,2156
"28672","Ntome_NODE_7695_length_2542_cov_13","Nsylvestris_NODE_24418_length_806_cov_10",88.235,544,60,4,1386,1927,1,542,0,647,541,541
"28685","Ntome_NODE_7700_length_2540_cov_302","Nsylvestris_NODE_6758_length_2611_cov_233",92.338,2506,133,28,55,2540,126,2592,0,3509,2485,2466
"28703","Ntome_NODE_7707_length_2539_cov_45","Nsylvestris_NODE_7103_length_2553_cov_97",96.301,2460,74,9,7,2458,2499,49,0,4023,2451,2450
"28743","Ntome_NODE_7722_length_2537_cov_221","Nsylvestris_NODE_20048_length_1098_cov_98",92.844,1118,40,11,1303,2400,1,1098,0,1585,1097,1097
"28766","Ntome_NODE_7728_length_2536_cov_244","Nsylvestris_NODE_8269_length_2359_cov_210",96.706,2277,62,9,16,2289,44,2310,0,3777,2273,2266
"28770","Ntome_NODE_7730_length_2536_cov_106","Nsylvestris_NODE_16587_length_1392_cov_166",95.426,962,41,1,97,1055,1342,381,0,1530,958,961
"28807","Ntome_NODE_7743_length_2533_cov_286","Nsylvestris_NODE_7948_length_2412_cov_219",97.703,2394,49,4,120,2513,22,2409,0,4111,2393,2387
"28820","Ntome_NODE_7748_length_2533_cov_74","Nsylvestris_NODE_4338_length_3142_cov_186",94.925,2483,98,14,55,2533,3000,542,0,3862,2478,2458
"28821","Ntome_NODE_7749_length_2533_cov_71","Nsylvestris_NODE_7414_length_2502_cov_199",95.376,2422,89,11,1,2418,2439,37,0,3831,2417,2402
"28836","Ntome_NODE_7753_length_2532_cov_79","Nsylvestris_NODE_6726_length_2617_cov_36",94.261,2457,94,23,66,2499,185,2617,0,3712,2433,2432
"28841","Ntome_NODE_7755_length_2518_cov_300","Nsylvestris_NODE_5910_length_2779_cov_217",96.766,2412,74,3,35,2446,2456,49,0,4019,2411,2407
"28869","Ntome_NODE_7764_length_2530_cov_80","Nsylvestris_NODE_7425_length_2500_cov_123",95.997,2473,75,10,20,2490,2454,4,0,3997,2470,2450
"28904","Ntome_NODE_7774_length_2528_cov_297","Nsylvestris_NODE_6884_length_2588_cov_225",93.638,2452,115,19,75,2507,40,2469,0,3626,2432,2429
"28911","Ntome_NODE_7777_length_2528_cov_63","Nsylvestris_NODE_17195_length_1341_cov_9",92.068,1185,94,0,1205,2389,1185,1,0,1668,1184,1184
"28926","Ntome_NODE_7782_length_2527_cov_213","Nsylvestris_NODE_7239_length_2528_cov_198",97.059,2142,62,1,94,2235,2479,339,0,3605,2141,2140
"28941","Ntome_NODE_7787_length_2526_cov_264","Nsylvestris_NODE_8037_length_2397_cov_169",94.766,2178,104,4,159,2327,169,2345,0,3382,2168,2176
"28963","Ntome_NODE_7794_length_2525_cov_311","Nsylvestris_NODE_1505_length_4394_cov_224",96.634,2525,85,0,1,2525,3762,1238,0,4193,2524,2524
"28973","Ntome_NODE_7797_length_2525_cov_226","Nsylvestris_NODE_8128_length_2383_cov_172",94.256,2385,121,10,140,2512,3,2383,0,3631,2372,2380
"28974","Ntome_NODE_7798_length_2525_cov_218","Nsylvestris_NODE_5928_length_2775_cov_161",93.953,2398,110,17,50,2422,335,2722,0,3592,2372,2387
"28990","Ntome_NODE_7804_length_2524_cov_132","Nsylvestris_NODE_7856_length_2427_cov_74",91.069,2497,120,40,27,2493,2424,1,0,3280,2466,2423
"29037","Ntome_NODE_7818_length_2521_cov_223","Nsylvestris_NODE_4636_length_3061_cov_101",91.116,2420,151,27,1,2370,656,3061,0,3219,2369,2405
"29052","Ntome_NODE_7822_length_2520_cov_288","Nsylvestris_NODE_7307_length_2518_cov_222",93.783,2445,116,16,57,2474,2436,1,0,3640,2417,2435
"29081","Ntome_NODE_7831_length_2518_cov_286","Nsylvestris_NODE_7672_length_2457_cov_227",96.364,2365,67,6,96,2452,2451,98,0,3873,2356,2353
"29082","Ntome_NODE_7832_length_2518_cov_269","Nsylvestris_NODE_6854_length_2593_cov_232",94.047,2503,111,9,48,2518,88,2584,0,3762,2470,2496
"29112","Ntome_NODE_7841_length_2516_cov_295","Nsylvestris_NODE_6846_length_2594_cov_222",96.522,2214,67,3,104,2308,55,2267,0,3653,2204,2212
"29113","Ntome_NODE_7842_length_2517_cov_241","Nsylvestris_NODE_5097_length_2949_cov_228",97.746,2440,44,3,1,2436,2527,95,0,4191,2435,2432
"29136","Ntome_NODE_7849_length_2517_cov_41","Nsylvestris_NODE_7161_length_2542_cov_41",96.376,2511,49,4,48,2517,2539,30,0,4095,2469,2509
"29137","Ntome_NODE_7850_length_2516_cov_17","Nsylvestris_NODE_3797_length_3301_cov_51",90.749,227,21,0,619,845,3068,2842,4.58e-81,303,226,226
"29188","Ntome_NODE_7868_length_2513_cov_125","Nsylvestris_NODE_19404_length_1152_cov_11",100,38,0,0,705,742,995,1032,5.05e-11,71.3,37,37
"29312","Ntome_NODE_7905_length_2505_cov_251","Nsylvestris_NODE_7264_length_2524_cov_219",95.878,2426,71,6,80,2501,124,2524,0,3899,2421,2400
"29339","Ntome_NODE_7912_length_2504_cov_244","Nsylvestris_NODE_6607_length_2641_cov_154",94.208,2210,107,8,81,2284,2398,204,0,3352,2203,2194
"29359","Ntome_NODE_7918_length_2504_cov_111","Nsylvestris_NODE_7826_length_2433_cov_75",95.74,2418,62,15,2,2417,2423,45,0,3856,2415,2378
"29373","Ntome_NODE_7922_length_2502_cov_229","Nsylvestris_NODE_15974_length_1451_cov_210",100,53,0,0,1,53,980,1032,2.31e-19,99,52,52
"29378","Ntome_NODE_7924_length_2502_cov_140","Nsylvestris_NODE_8867_length_2269_cov_182",96.033,1588,39,8,42,1618,2266,692,0,2562,1576,1574
"29381","Ntome_NODE_7926_length_2502_cov_72","Nsylvestris_NODE_7227_length_2530_cov_64",97.889,2511,43,4,1,2502,2528,19,0,4335,2501,2509
"29392","Ntome_NODE_7930_length_2500_cov_203","Nsylvestris_NODE_3373_length_3447_cov_155",95.014,1825,74,4,561,2379,102,1915,0,2850,1818,1813
"29399","Ntome_NODE_7933_length_2500_cov_155","Nsylvestris_NODE_8194_length_2372_cov_193",94.996,2378,85,17,9,2363,2369,3,0,3701,2354,2366
"29447","Ntome_NODE_7948_length_2498_cov_283","Nsylvestris_NODE_35365_length_287_cov_4",94.138,290,14,1,1667,1956,1,287,1.19e-121,438,289,286
"29448","Ntome_NODE_7949_length_2498_cov_276","Nsylvestris_NODE_7509_length_2484_cov_213",95.686,2457,68,18,2,2434,2443,1,0,3916,2432,2442
"29498","Ntome_NODE_7964_length_2496_cov_32","Nsylvestris_NODE_2325_length_3882_cov_113",72.456,737,177,20,2,729,994,1713,7.88e-54,213,727,719
"29528","Ntome_NODE_7973_length_2494_cov_227","Nsylvestris_NODE_8344_length_2349_cov_195",94.792,2304,89,13,140,2424,2292,1,0,3561,2284,2291
"29540","Ntome_NODE_7977_length_2494_cov_137","Nsylvestris_NODE_8878_length_2267_cov_80",95.418,2226,86,10,6,2227,4,2217,0,3531,2221,2213
"29541","Ntome_NODE_7979_length_2494_cov_15","Nsylvestris_NODE_26384_length_701_cov_11",89.158,701,76,0,1613,2313,701,1,0,874,700,700
"29558","Ntome_NODE_7983_length_2493_cov_118","Nsylvestris_NODE_13040_length_1759_cov_101",96.364,55,2,0,2439,2493,531,585,3.85e-17,91.6,54,54
"29583","Ntome_NODE_7991_length_2492_cov_13","Nsylvestris_NODE_16015_length_1448_cov_195",92.727,55,4,0,2438,2492,847,901,8.32e-14,80.5,54,54
"29584","Ntome_NODE_7992_length_2491_cov_283","Nsylvestris_NODE_7494_length_2486_cov_172",95.52,2232,82,7,125,2353,1,2217,0,3552,2228,2216
"29588","Ntome_NODE_7994_length_2491_cov_213","Nsylvestris_NODE_8394_length_2342_cov_71",96.536,1501,52,0,855,2355,47,1547,0,2484,1500,1500
"29618","Ntome_NODE_8004_length_2490_cov_248","Nsylvestris_NODE_6789_length_2605_cov_142",94.335,2383,107,13,1,2381,2423,67,0,3627,2380,2356
"29629","Ntome_NODE_8007_length_2490_cov_160","Nsylvestris_NODE_7001_length_2569_cov_126",94.807,1502,65,6,72,1569,154,1646,0,2329,1497,1492
"29661","Ntome_NODE_8014_length_2489_cov_135","Nsylvestris_NODE_5298_length_2906_cov_162",91.708,1206,55,11,1,1200,1788,622,0,1631,1199,1166
"29673","Ntome_NODE_8018_length_2488_cov_298","Nsylvestris_NODE_7911_length_2418_cov_228",94.826,2358,93,18,61,2413,2367,34,0,3651,2352,2333
"29674","Ntome_NODE_8019_length_2488_cov_296","Nsylvestris_NODE_7252_length_2526_cov_201",95.452,2199,95,2,239,2437,132,2325,0,3502,2198,2193
"29717","Ntome_NODE_8032_length_2486_cov_44","Nsylvestris_NODE_6921_length_2582_cov_16",93.224,2450,101,21,47,2462,2419,1,0,3544,2415,2418
"29746","Ntome_NODE_8043_length_2484_cov_270","Nsylvestris_NODE_7763_length_2443_cov_162",95.041,2420,86,6,1,2386,2420,1,0,3773,2385,2419
"29774","Ntome_NODE_8051_length_2483_cov_211","Nsylvestris_NODE_7409_length_2503_cov_176",95.918,2401,57,12,40,2438,2385,24,0,3853,2398,2361
"29796","Ntome_NODE_8058_length_2482_cov_96","Nsylvestris_NODE_7287_length_2521_cov_103",95.395,2454,72,19,6,2431,2469,29,0,3868,2425,2440
"29818","Ntome_NODE_8065_length_2481_cov_122","Nsylvestris_NODE_6267_length_2704_cov_103",97.437,2068,51,2,308,2374,2073,7,0,3524,2066,2066
"29848","Ntome_NODE_8075_length_2479_cov_37","Nsylvestris_NODE_7850_length_2428_cov_33",86.561,1451,169,12,142,1573,89,1532,0,1576,1431,1443
"29872","Ntome_NODE_8083_length_2477_cov_210","Nsylvestris_NODE_4542_length_3088_cov_86",92.219,2159,146,12,211,2355,378,2528,0,3037,2144,2150
"29887","Ntome_NODE_8089_length_2476_cov_158","Nsylvestris_NODE_241_length_7050_cov_29",97.315,2421,65,0,1,2421,2580,160,0,4111,2420,2420
"29894","Ntome_NODE_8091_length_2476_cov_122","Nsylvestris_NODE_7327_length_2516_cov_59",97.217,2479,63,2,1,2473,2479,1,0,4191,2472,2478
"29909","Ntome_NODE_8096_length_2475_cov_190","Nsylvestris_NODE_9330_length_2203_cov_185",94.224,2095,88,15,222,2297,2127,47,0,3168,2075,2080
"29952","Ntome_NODE_8110_length_2473_cov_291","Nsylvestris_NODE_7674_length_2457_cov_159",96.338,2403,62,16,44,2442,2433,53,0,3927,2398,2380
"29977","Ntome_NODE_8117_length_2473_cov_36","Nsylvestris_NODE_8399_length_2341_cov_19",94.316,2340,119,9,1,2328,1,2338,0,3572,2327,2337
"29986","Ntome_NODE_8120_length_2472_cov_264","Nsylvestris_NODE_3332_length_3464_cov_82",98.587,2265,32,0,208,2472,3179,915,0,4006,2264,2264
"30010","Ntome_NODE_8128_length_2471_cov_218","Nsylvestris_NODE_7527_length_2481_cov_184",94.403,2412,71,26,41,2421,32,2410,0,3648,2380,2378
"30050","Ntome_NODE_8140_length_2469_cov_257","Nsylvestris_NODE_7556_length_2476_cov_198",96.907,2425,59,11,48,2469,2412,1,0,4048,2421,2411
"30055","Ntome_NODE_8142_length_2469_cov_146","Nsylvestris_NODE_1684_length_4268_cov_97",91.997,1287,89,11,36,1317,1282,5,0,1794,1281,1277
"30120","Ntome_NODE_8163_length_2466_cov_20","Nsylvestris_NODE_17290_length_1333_cov_74",96.364,55,2,0,2412,2466,600,654,3.8e-17,91.6,54,54
"30121","Ntome_NODE_8164_length_2465_cov_267","Nsylvestris_NODE_651_length_5549_cov_114",95.58,2353,66,11,13,2359,2349,29,0,3735,2346,2320
"30126","Ntome_NODE_8166_length_2465_cov_233","Nsylvestris_NODE_8175_length_2375_cov_65",95.435,2344,94,9,48,2382,2370,31,0,3723,2334,2339
"30235","Ntome_NODE_8198_length_2460_cov_178","Nsylvestris_NODE_806_length_5237_cov_108",95.151,2021,88,3,441,2460,2407,396,0,3181,2019,2011
"30238","Ntome_NODE_8200_length_2460_cov_10","Nsylvestris_NODE_11757_length_1898_cov_231",100,55,0,0,2406,2460,783,837,1.75e-20,102,54,54
"30274","Ntome_NODE_8211_length_2458_cov_236","Nsylvestris_NODE_3900_length_3268_cov_175",96.574,2306,51,11,6,2287,255,2556,0,3795,2281,2301
"30330","Ntome_NODE_8227_length_2454_cov_283","Nsylvestris_NODE_8170_length_2375_cov_201",96.119,2190,79,4,223,2408,2375,188,0,3568,2185,2187
"30350","Ntome_NODE_8233_length_2454_cov_37","Nsylvestris_NODE_24638_length_792_cov_171",96.364,55,2,0,2400,2454,304,358,3.79e-17,91.6,54,54
"30378","Ntome_NODE_8240_length_2453_cov_182","Nsylvestris_NODE_7914_length_2418_cov_82",97.358,1930,51,0,333,2262,2278,349,0,3282,1929,1929
"30400","Ntome_NODE_8247_length_2451_cov_287","Nsylvestris_NODE_3486_length_3405_cov_148",95.359,2198,82,7,246,2426,1187,3381,0,3476,2180,2194
"30440","Ntome_NODE_8261_length_2448_cov_84","Nsylvestris_NODE_17933_length_1273_cov_193",96.793,873,22,5,52,922,1227,359,0,1452,870,868
"30441","Ntome_NODE_8262_length_2447_cov_291","Nsylvestris_NODE_7308_length_2518_cov_219",95.562,2321,59,6,31,2332,40,2335,0,3675,2301,2295
"30495","Ntome_NODE_8277_length_2445_cov_305","Nsylvestris_NODE_4462_length_3107_cov_171",97.738,2432,50,3,1,2428,604,3034,0,4181,2427,2430
"30527","Ntome_NODE_8287_length_2443_cov_283","Nsylvestris_NODE_8155_length_2379_cov_208",95.354,2389,77,16,1,2369,2379,5,0,3766,2368,2374
"30548","Ntome_NODE_8294_length_2442_cov_171","Nsylvestris_NODE_2396_length_3842_cov_147",97.835,2171,42,4,12,2178,131,2300,0,3744,2166,2169
"30549","Ntome_NODE_8295_length_2442_cov_147","Nsylvestris_NODE_7772_length_2442_cov_115",96.352,2111,73,2,34,2140,3,2113,0,3469,2106,2110
"30603","Ntome_NODE_8311_length_2440_cov_165","Nsylvestris_NODE_734_length_5380_cov_210",92.903,944,40,8,1331,2271,147,1066,0,1347,940,919
"30609","Ntome_NODE_8314_length_2440_cov_110","Nsylvestris_NODE_7991_length_2405_cov_125",96.077,2396,68,10,62,2440,2405,19,0,3880,2378,2386
"30630","Ntome_NODE_8321_length_2439_cov_131","Nsylvestris_NODE_15759_length_1487_cov_94",90.39,1436,63,32,851,2278,3,1371,0,1818,1427,1368
"30688","Ntome_NODE_8339_length_2437_cov_11","Nsylvestris_NODE_6273_length_2703_cov_54",97.542,2360,58,0,2,2361,2629,270,0,4037,2359,2359
"30704","Ntome_NODE_8345_length_2435_cov_219","Nsylvestris_NODE_3865_length_3280_cov_126",96.907,2425,57,8,1,2411,2429,9,0,4047,2410,2420
"30705","Ntome_NODE_8346_length_2435_cov_219","Nsylvestris_NODE_10048_length_2110_cov_219",94.055,1783,64,8,628,2388,1819,57,0,2667,1760,1762
"30758","Ntome_NODE_8361_length_2433_cov_79","Nsylvestris_NODE_11316_length_1949_cov_185",96.177,654,25,0,28,681,58,711,0,1070,653,653
"30860","Ntome_NODE_8388_length_2428_cov_295","Nsylvestris_NODE_7184_length_2537_cov_237",96.636,2319,44,7,128,2428,9,2311,0,3819,2300,2302
"30882","Ntome_NODE_8396_length_2428_cov_70","Nsylvestris_NODE_3384_length_3444_cov_105",94.212,2246,88,11,194,2428,2708,494,0,3389,2234,2214
"30920","Ntome_NODE_8410_length_2425_cov_185","Nsylvestris_NODE_6621_length_2638_cov_188",96.089,2327,76,9,1,2319,2541,222,0,3779,2318,2319
"30935","Ntome_NODE_8415_length_2425_cov_51","Nsylvestris_NODE_8712_length_2293_cov_128",95.342,2061,71,13,2,2039,182,2240,0,3251,2037,2058
"30940","Ntome_NODE_8418_length_2424_cov_117","Nsylvestris_NODE_8766_length_2284_cov_55",96.842,2058,61,3,219,2275,178,2232,0,3437,2056,2054
"31038","Ntome_NODE_8450_length_2420_cov_178","Nsylvestris_NODE_13501_length_1706_cov_83",93.363,226,15,0,77,302,1698,1473,1.56e-90,335,225,225
"31044","Ntome_NODE_8452_length_2420_cov_27","Nsylvestris_NODE_5180_length_2930_cov_155",95.82,2416,88,5,9,2420,2910,504,0,3890,2411,2406
"31045","Ntome_NODE_8453_length_2420_cov_27","Nsylvestris_NODE_378_length_6396_cov_152",84.805,2356,344,11,17,2368,5308,2963,0,2355,2351,2345
"31062","Ntome_NODE_8461_length_2419_cov_87","Nsylvestris_NODE_3771_length_3312_cov_95",98.333,60,1,0,1,60,829,770,1.33e-21,106,59,59
"31072","Ntome_NODE_8466_length_2417_cov_269","Nsylvestris_NODE_7346_length_2513_cov_190",94.659,2378,76,23,32,2384,125,2476,0,3640,2352,2351
"31157","Ntome_NODE_8490_length_2414_cov_155","Nsylvestris_NODE_4194_length_3178_cov_105",92.079,2184,113,28,233,2382,1005,3162,0,3020,2149,2157
"31244","Ntome_NODE_8513_length_2411_cov_236","Nsylvestris_NODE_6079_length_2742_cov_155",93.66,2161,108,13,84,2236,2677,538,0,3205,2152,2139
"31310","Ntome_NODE_8537_length_2407_cov_273","Nsylvestris_NODE_6274_length_2702_cov_200",97.297,2368,62,2,2,2368,336,2702,0,4017,2366,2366
"31323","Ntome_NODE_8542_length_2407_cov_26","Nsylvestris_NODE_6383_length_2682_cov_110",89.203,2019,193,10,312,2325,372,2370,0,2497,2013,1998
"31353","Ntome_NODE_8553_length_2406_cov_53","Nsylvestris_NODE_8416_length_2337_cov_65",89.104,670,38,8,279,939,2144,1501,0,800,660,643
"31366","Ntome_NODE_8558_length_2404_cov_279","Nsylvestris_NODE_61_length_9229_cov_221",95.491,2218,81,11,25,2232,9228,7020,0,3524,2207,2208
"31442","Ntome_NODE_8586_length_2400_cov_296","Nsylvestris_NODE_8090_length_2388_cov_236",95.468,2295,77,7,70,2359,62,2334,0,3637,2289,2272
"31461","Ntome_NODE_8592_length_2399_cov_289","Nsylvestris_NODE_7860_length_2426_cov_211",96.802,2126,55,10,227,2348,264,2380,0,3537,2121,2116
"31462","Ntome_NODE_8593_length_2399_cov_280","Nsylvestris_NODE_1255_length_4636_cov_133",97.692,2080,41,4,255,2331,703,2778,0,3568,2076,2075
"31476","Ntome_NODE_8599_length_2399_cov_54","Nsylvestris_NODE_9826_length_2136_cov_219",100,55,0,0,2345,2399,1827,1773,1.71e-20,102,54,54
"31477","Ntome_NODE_8600_length_2399_cov_28","Nsylvestris_NODE_7207_length_2533_cov_26",94.38,1993,110,2,408,2399,2003,12,0,3059,1991,1991
"31490","Ntome_NODE_8604_length_2398_cov_260","Nsylvestris_NODE_638_length_5587_cov_205",100,55,0,0,1,55,1859,1805,1.71e-20,102,54,54
"31494","Ntome_NODE_8606_length_2398_cov_206","Nsylvestris_NODE_9562_length_2168_cov_194",97.353,1662,38,5,738,2396,1682,24,0,2820,1658,1658
"31523","Ntome_NODE_8615_length_2396_cov_275","Nsylvestris_NODE_217_length_7234_cov_135",96.342,2187,68,5,45,2219,52,2238,0,3585,2174,2186
"31568","Ntome_NODE_8629_length_2394_cov_298","Nsylvestris_NODE_856_length_5155_cov_44",91.718,2101,154,12,44,2132,30,2122,0,2898,2088,2092
"31580","Ntome_NODE_8633_length_2394_cov_126","Nsylvestris_NODE_8893_length_2265_cov_49",97.071,2219,63,2,76,2293,2218,1,0,3736,2217,2217
"31592","Ntome_NODE_8638_length_2393_cov_248","Nsylvestris_NODE_435_length_6151_cov_222",94.953,2001,72,15,57,2044,3924,5908,0,3109,1987,1984
"31618","Ntome_NODE_8645_length_2393_cov_75","Nsylvestris_NODE_2251_length_3916_cov_139",93.412,2216,95,11,211,2393,217,2414,0,3236,2182,2197
"31625","Ntome_NODE_8648_length_2393_cov_21","Nsylvestris_NODE_8882_length_2266_cov_179",98.182,55,1,0,1,55,1024,1078,7.93e-19,97.1,54,54
"31630","Ntome_NODE_8650_length_2393_cov_16","Nsylvestris_NODE_4984_length_2978_cov_39",95.599,2386,104,1,5,2389,2397,12,0,3823,2384,2385
"31647","Ntome_NODE_8656_length_2392_cov_72","Nsylvestris_NODE_389_length_6338_cov_128",94.828,2088,95,6,265,2343,237,2320,0,3245,2078,2083
"31701","Ntome_NODE_8670_length_2390_cov_21","Nsylvestris_NODE_14165_length_1634_cov_71",93.694,1459,76,5,872,2317,142,1597,0,2170,1445,1455
"31709","Ntome_NODE_8673_length_2389_cov_83","Nsylvestris_NODE_9652_length_2158_cov_151",90.323,93,6,3,1274,1365,1816,1726,1.69e-25,119,91,90
"31712","Ntome_NODE_8675_length_2388_cov_282","Nsylvestris_NODE_4187_length_3179_cov_211",97.277,2277,52,2,113,2388,1,2268,0,3853,2275,2267
"31746","Ntome_NODE_8684_length_2387_cov_122","Nsylvestris_NODE_10078_length_2106_cov_50",92.16,727,33,9,1648,2370,708,2,0,1005,722,706
"31755","Ntome_NODE_8688_length_2386_cov_278","Nsylvestris_NODE_1031_length_4896_cov_213",96.569,2390,67,8,1,2386,2379,1,0,3945,2385,2378
"31812","Ntome_NODE_8707_length_2383_cov_209","Nsylvestris_NODE_184_length_7486_cov_169",94.351,2018,98,6,121,2122,5469,7486,0,3081,2001,2017
"31824","Ntome_NODE_8711_length_2382_cov_302","Nsylvestris_NODE_5016_length_2968_cov_217",97.915,2254,47,0,129,2382,56,2309,0,3903,2253,2253
"31887","Ntome_NODE_8729_length_2380_cov_309","Nsylvestris_NODE_819_length_5213_cov_214",96.87,2332,57,7,1,2320,2837,5164,0,3888,2319,2327
"31891","Ntome_NODE_8731_length_2380_cov_271","Nsylvestris_NODE_9594_length_2165_cov_198",95.325,1968,63,10,157,2105,2165,208,0,3097,1948,1957
"31899","Ntome_NODE_8734_length_2380_cov_219","Nsylvestris_NODE_8609_length_2307_cov_206",96.844,2250,57,8,136,2374,2248,2,0,3749,2238,2246
"31904","Ntome_NODE_8736_length_2379_cov_28","Nsylvestris_NODE_11513_length_1929_cov_96",89.891,366,22,9,51,404,1689,1327,3.14e-127,457,353,362
"31976","Ntome_NODE_8756_length_2377_cov_97","Nsylvestris_NODE_8768_length_2285_cov_10",96.435,2188,77,1,123,2309,98,2285,0,3607,2186,2187
"31977","Ntome_NODE_8757_length_2377_cov_65","Nsylvestris_NODE_7706_length_2452_cov_78",95.298,2382,107,4,1,2377,67,2448,0,3773,2376,2381
"31978","Ntome_NODE_8758_length_2377_cov_35","Nsylvestris_NODE_10719_length_2023_cov_178",91.066,347,19,3,77,411,6,352,8.72e-128,459,334,346
"31993","Ntome_NODE_8764_length_2375_cov_258","Nsylvestris_NODE_306_length_6693_cov_164",96.965,2339,57,8,1,2339,2373,49,0,3914,2338,2324
"32017","Ntome_NODE_8772_length_2374_cov_104","Nsylvestris_NODE_7456_length_2494_cov_226",95.487,2393,78,12,6,2374,90,2476,0,3794,2368,2386
"32036","Ntome_NODE_8778_length_2373_cov_184","Nsylvestris_NODE_8510_length_2323_cov_142",91.942,2358,131,31,28,2361,1,2323,0,3247,2333,2322
"32105","Ntome_NODE_8799_length_2370_cov_166","Nsylvestris_NODE_57_length_9298_cov_111",84.146,164,20,5,209,371,9082,8924,4.6e-36,154,162,158
"32125","Ntome_NODE_8806_length_2369_cov_163","Nsylvestris_NODE_3315_length_3470_cov_171",98.355,2128,35,0,2,2129,157,2284,0,3736,2127,2127
"32162","Ntome_NODE_8816_length_2367_cov_295","Nsylvestris_NODE_5784_length_2803_cov_191",96.373,2233,62,6,19,2245,2803,584,0,3657,2226,2219
"32170","Ntome_NODE_8820_length_2367_cov_153","Nsylvestris_NODE_7147_length_2544_cov_210",95.857,2293,69,6,37,2317,68,2346,0,3685,2280,2278
"32184","Ntome_NODE_8826_length_2365_cov_130","Nsylvestris_NODE_3175_length_3517_cov_118",95.305,2194,74,15,118,2292,2194,11,0,3454,2174,2183
"32185","Ntome_NODE_8827_length_2365_cov_39","Nsylvestris_NODE_4589_length_3076_cov_73",96.425,2154,77,0,164,2317,3051,898,0,3552,2153,2153
"32237","Ntome_NODE_8844_length_2362_cov_210","Nsylvestris_NODE_7401_length_2501_cov_195",94.479,2246,104,8,127,2361,264,2500,0,3443,2234,2236
"32261","Ntome_NODE_8851_length_2361_cov_241","Nsylvestris_NODE_4406_length_3123_cov_134",96.243,1810,53,4,428,2232,1324,3123,0,2952,1804,1799
"32284","Ntome_NODE_8858_length_2361_cov_93","Nsylvestris_NODE_16833_length_1369_cov_202",97.422,892,12,2,1192,2083,487,1367,0,1509,891,880
"32301","Ntome_NODE_8863_length_2360_cov_128","Nsylvestris_NODE_469_length_6038_cov_139",100,55,0,0,2306,2360,88,142,1.68e-20,102,54,54
"32315","Ntome_NODE_8868_length_2359_cov_291","Nsylvestris_NODE_8414_length_2337_cov_227",96.906,2327,52,5,48,2359,2332,11,0,3880,2311,2321
"32346","Ntome_NODE_8879_length_2358_cov_119","Nsylvestris_NODE_1173_length_4727_cov_157",97.249,1236,26,2,993,2228,3339,4566,0,2087,1235,1227
"32397","Ntome_NODE_8896_length_2355_cov_6","Nsylvestris_NODE_3003_length_3587_cov_72",95.869,2227,83,3,3,2229,2414,197,0,3594,2226,2217
"32411","Ntome_NODE_8902_length_2353_cov_289","Nsylvestris_NODE_7838_length_2430_cov_207",94.418,2096,108,6,200,2291,290,2380,0,3214,2091,2090
"32447","Ntome_NODE_8915_length_2351_cov_207","Nsylvestris_NODE_2232_length_3922_cov_179",94.391,1979,52,19,159,2124,160,2092,0,2985,1965,1932
"32465","Ntome_NODE_8921_length_2351_cov_30","Nsylvestris_NODE_7042_length_2563_cov_31",95.389,2342,88,8,22,2351,2468,135,0,3709,2329,2333
"32476","Ntome_NODE_8926_length_2350_cov_61","Nsylvestris_NODE_16271_length_1422_cov_104",91.176,782,36,11,782,1559,245,997,0,1031,777,752
"32491","Ntome_NODE_8932_length_2349_cov_44","Nsylvestris_NODE_15303_length_1521_cov_62",76.786,280,51,12,16,287,1520,1247,2.74e-33,145,271,273
"32510","Ntome_NODE_8938_length_2347_cov_281","Nsylvestris_NODE_9145_length_2230_cov_203",95.86,2198,62,14,95,2289,2182,11,0,3528,2194,2171
"32513","Ntome_NODE_8940_length_2347_cov_195","Nsylvestris_NODE_12095_length_1858_cov_217",92.677,1707,74,16,15,1694,1747,65,0,2412,1679,1682
"32514","Ntome_NODE_8941_length_2347_cov_142","Nsylvestris_NODE_8308_length_2354_cov_136",93.533,2304,96,24,80,2345,2291,3,0,3380,2265,2288
"32578","Ntome_NODE_8963_length_2344_cov_12","Nsylvestris_NODE_6710_length_2620_cov_53",94.062,2223,115,8,60,2266,2319,98,0,3358,2206,2221
"32661","Ntome_NODE_8990_length_2340_cov_170","Nsylvestris_NODE_9736_length_2149_cov_81",94.517,2152,101,6,188,2328,2149,4,0,3304,2140,2145
"32675","Ntome_NODE_8997_length_2339_cov_263","Nsylvestris_NODE_7881_length_2423_cov_225",96.898,2353,47,8,4,2338,2423,79,0,3917,2334,2344
"32731","Ntome_NODE_9016_length_2337_cov_11","Nsylvestris_NODE_3133_length_3533_cov_62",76.064,1809,299,81,546,2328,808,2508,0,819,1782,1700
"32732","Ntome_NODE_9017_length_2336_cov_303","Nsylvestris_NODE_2240_length_3918_cov_233",96.234,2337,52,10,26,2336,46,2372,0,3795,2310,2326
"32742","Ntome_NODE_9021_length_2336_cov_214","Nsylvestris_NODE_9271_length_2211_cov_27",95.13,2033,99,0,6,2038,125,2157,0,3206,2032,2032
"32758","Ntome_NODE_9027_length_2335_cov_156","Nsylvestris_NODE_9000_length_2251_cov_113",92.538,1970,98,20,363,2292,246,2206,0,2778,1929,1960
"32759","Ntome_NODE_9028_length_2335_cov_118","Nsylvestris_NODE_8667_length_2298_cov_147",96,2175,77,7,159,2332,88,2253,0,3526,2173,2165
"32763","Ntome_NODE_9030_length_2335_cov_79","Nsylvestris_NODE_5945_length_2770_cov_132",84.437,861,126,7,176,1032,50,906,0,841,856,856
"32781","Ntome_NODE_9038_length_2332_cov_217","Nsylvestris_NODE_9592_length_2165_cov_209",96.388,2104,68,5,2,2098,56,2158,0,3458,2096,2102
"32800","Ntome_NODE_9044_length_2331_cov_289","Nsylvestris_NODE_8828_length_2275_cov_193",95.149,2247,105,3,38,2283,3,2246,0,3542,2245,2243
"32806","Ntome_NODE_9046_length_2331_cov_178","Nsylvestris_NODE_7528_length_2481_cov_161",92.529,1111,66,6,23,1127,984,2083,0,1576,1104,1099
"32820","Ntome_NODE_9051_length_2330_cov_313","Nsylvestris_NODE_2316_length_3886_cov_225",96.352,2330,83,2,1,2328,2619,290,0,3831,2327,2329
"32859","Ntome_NODE_9064_length_2328_cov_249","Nsylvestris_NODE_15513_length_1502_cov_3",93.422,1505,95,4,11,1514,1502,1,0,2228,1503,1501
"32886","Ntome_NODE_9073_length_2327_cov_201","Nsylvestris_NODE_4958_length_2983_cov_180",95.366,1640,44,18,656,2289,2976,1363,0,2579,1633,1613
"32945","Ntome_NODE_9088_length_2325_cov_64","Nsylvestris_NODE_5176_length_2930_cov_58",95.588,68,3,0,1885,1952,630,563,9.9e-23,110,67,67
"32946","Ntome_NODE_9089_length_2325_cov_32","Nsylvestris_NODE_8803_length_2279_cov_69",95.386,1734,69,5,101,1830,2277,551,0,2748,1729,1726
"32953","Ntome_NODE_9092_length_2324_cov_266","Nsylvestris_NODE_12631_length_1802_cov_163",98.182,55,1,0,2270,2324,611,665,7.7e-19,97.1,54,54
"32973","Ntome_NODE_9099_length_2324_cov_71","Nsylvestris_NODE_9069_length_2243_cov_41",92.146,1668,113,14,287,1951,303,1955,0,2338,1664,1652
"32974","Ntome_NODE_9100_length_2323_cov_271","Nsylvestris_NODE_5922_length_2777_cov_203",94.541,2235,96,16,95,2323,485,2699,0,3428,2228,2214
"33144","Ntome_NODE_9150_length_2318_cov_71","Nsylvestris_NODE_7678_length_2457_cov_94",94.895,2057,75,14,222,2265,2086,47,0,3190,2043,2039
"33145","Ntome_NODE_9151_length_2318_cov_12","Nsylvestris_NODE_9347_length_2201_cov_168",97.143,35,1,0,509,543,1928,1962,1.01e-07,60.2,34,34
"33171","Ntome_NODE_9158_length_2317_cov_206","Nsylvestris_NODE_9120_length_2233_cov_222",95.917,2204,64,11,96,2292,2187,3,0,3548,2196,2184
"33212","Ntome_NODE_9171_length_2314_cov_10","Nsylvestris_NODE_22594_length_916_cov_28",98.182,55,1,0,1,55,401,455,7.67e-19,97.1,54,54
"33219","Ntome_NODE_9174_length_2313_cov_41","Nsylvestris_NODE_12423_length_1824_cov_235",98.182,55,1,0,2259,2313,774,828,7.66e-19,97.1,54,54
"33251","Ntome_NODE_9185_length_2311_cov_98","Nsylvestris_NODE_861_length_5148_cov_192",95.254,1770,82,2,208,1976,3028,4796,0,2802,1768,1768
"33287","Ntome_NODE_9198_length_2308_cov_253","Nsylvestris_NODE_8782_length_2282_cov_141",96.251,2214,74,3,1,2205,23,2236,0,3620,2204,2213
"33305","Ntome_NODE_9205_length_2308_cov_129","Nsylvestris_NODE_14676_length_1581_cov_210",96.737,950,16,4,32,977,1573,635,0,1568,945,938
"33306","Ntome_NODE_9206_length_2308_cov_82","Nsylvestris_NODE_692_length_5458_cov_100",96.113,2161,69,6,1,2157,2150,1,0,3511,2156,2149
"33318","Ntome_NODE_9210_length_2307_cov_294","Nsylvestris_NODE_1700_length_4254_cov_187",95.62,2169,89,3,1,2168,1189,3352,0,3474,2167,2163
"33355","Ntome_NODE_9220_length_2306_cov_237","Nsylvestris_NODE_14109_length_1639_cov_211",96.952,1345,31,2,66,1410,1593,259,0,2248,1344,1334
"33360","Ntome_NODE_9223_length_2306_cov_142","Nsylvestris_NODE_14100_length_1640_cov_134",91.009,823,50,10,201,999,1490,668,0,1088,798,822
"33389","Ntome_NODE_9232_length_2304_cov_288","Nsylvestris_NODE_8674_length_2297_cov_227",96.987,2257,57,7,32,2284,2297,48,0,3781,2252,2249
"33426","Ntome_NODE_9242_length_2303_cov_119","Nsylvestris_NODE_8635_length_2304_cov_28",94.228,2183,84,14,63,2228,10,2167,0,3295,2165,2157
"33520","Ntome_NODE_9273_length_2300_cov_31","Nsylvestris_NODE_8847_length_2273_cov_24",95.679,2268,85,5,10,2266,8,2273,0,3633,2256,2265
"33535","Ntome_NODE_9278_length_2298_cov_244","Nsylvestris_NODE_9765_length_2145_cov_207",95.148,2061,68,18,167,2210,2046,1,0,3223,2043,2045
"33565","Ntome_NODE_9287_length_2297_cov_222","Nsylvestris_NODE_12849_length_1781_cov_218",94.719,1742,63,8,200,1916,1781,44,0,2680,1716,1737
"33625","Ntome_NODE_9309_length_2294_cov_155","Nsylvestris_NODE_15646_length_1485_cov_165",96.339,1393,28,13,47,1420,50,1438,0,2268,1373,1388
"33638","Ntome_NODE_9313_length_2293_cov_272","Nsylvestris_NODE_7876_length_2424_cov_206",94.292,2190,91,12,23,2203,2225,61,0,3321,2180,2164
"33650","Ntome_NODE_9317_length_2293_cov_63","Nsylvestris_NODE_1945_length_4089_cov_86",94.094,1744,80,11,1,1735,4027,2298,0,2628,1734,1729
"33651","Ntome_NODE_9318_length_2292_cov_253","Nsylvestris_NODE_8304_length_2354_cov_197",94.271,2077,95,14,207,2277,289,2347,0,3155,2070,2058
"33678","Ntome_NODE_9329_length_2292_cov_10","Nsylvestris_NODE_8640_length_2302_cov_201",100,55,0,0,1,55,525,471,1.63e-20,102,54,54
"33679","Ntome_NODE_9330_length_2291_cov_295","Nsylvestris_NODE_9777_length_2143_cov_231",95.2,2146,78,15,1,2124,1,2143,0,3369,2123,2142
"33698","Ntome_NODE_9337_length_2291_cov_90","Nsylvestris_NODE_8460_length_2330_cov_157",97.516,2254,37,5,54,2291,2268,18,0,3834,2237,2250
"33699","Ntome_NODE_9338_length_2291_cov_49","Nsylvestris_NODE_8906_length_2263_cov_90",97.098,2240,64,1,1,2239,21,2260,0,3775,2238,2239
"33771","Ntome_NODE_9359_length_2288_cov_107","Nsylvestris_NODE_12233_length_1844_cov_143",92.071,1526,105,8,728,2249,193,1706,0,2134,1521,1513
"33809","Ntome_NODE_9370_length_2286_cov_292","Nsylvestris_NODE_8341_length_2349_cov_221",96.792,2213,54,8,24,2224,2348,141,0,3677,2200,2207
"33813","Ntome_NODE_9372_length_2286_cov_114","Nsylvestris_NODE_4169_length_3185_cov_101",96.403,2224,64,4,6,2220,890,3106,0,3650,2214,2216
"33829","Ntome_NODE_9378_length_2285_cov_93","Nsylvestris_NODE_9100_length_2237_cov_93",95.15,1938,77,11,316,2248,1926,1,0,3042,1932,1925
"33835","Ntome_NODE_9380_length_2285_cov_45","Nsylvestris_NODE_1740_length_4218_cov_204",100,52,0,0,1,52,3730,3781,7.57e-19,97.1,51,51
"33849","Ntome_NODE_9385_length_2284_cov_66","Nsylvestris_NODE_6817_length_2601_cov_33",96.295,2159,65,6,122,2279,2599,455,0,3530,2157,2144
"33850","Ntome_NODE_9386_length_2283_cov_171","Nsylvestris_NODE_20795_length_1043_cov_210",88.901,919,61,20,1351,2245,906,5,0,1094,894,901
"33894","Ntome_NODE_9401_length_2281_cov_32","Nsylvestris_NODE_10547_length_2044_cov_96",93.757,1810,99,8,343,2147,2039,239,0,2704,1804,1800
"33949","Ntome_NODE_9417_length_2278_cov_252","Nsylvestris_NODE_5493_length_2863_cov_191",96.965,2076,51,6,1,2067,2073,1,0,3474,2066,2072
"33986","Ntome_NODE_9429_length_2278_cov_71","Nsylvestris_NODE_7912_length_2418_cov_221",82.05,1493,224,36,163,1630,485,1958,0,1232,1467,1473
"33999","Ntome_NODE_9435_length_2276_cov_288","Nsylvestris_NODE_9842_length_2134_cov_231",95.819,2033,66,10,91,2107,59,2088,0,3265,2016,2029
"34034","Ntome_NODE_9446_length_2276_cov_62","Nsylvestris_NODE_4985_length_2977_cov_165",92.15,2293,116,27,3,2257,1,2267,0,3179,2254,2266
"34035","Ntome_NODE_9447_length_2275_cov_244","Nsylvestris_NODE_12731_length_1792_cov_217",92.922,1752,51,15,260,1981,24,1732,0,2481,1721,1708
"34043","Ntome_NODE_9451_length_2274_cov_281","Nsylvestris_NODE_10089_length_2104_cov_175",95.684,2039,83,5,12,2049,70,2104,0,3273,2037,2034
"34081","Ntome_NODE_9464_length_2273_cov_234","Nsylvestris_NODE_5828_length_2796_cov_102",92.242,2217,135,15,1,2189,567,2774,0,3107,2188,2207
"34082","Ntome_NODE_9465_length_2273_cov_211","Nsylvestris_NODE_196_length_7397_cov_98",94.052,2236,98,12,4,2234,2206,1,0,3360,2230,2205
"34133","Ntome_NODE_9482_length_2272_cov_18","Nsylvestris_NODE_8372_length_2345_cov_18",92.391,1945,121,17,312,2246,374,2301,0,2747,1934,1927
"34134","Ntome_NODE_9483_length_2272_cov_14","Nsylvestris_NODE_1914_length_4103_cov_100",96.123,2244,87,0,26,2269,50,2293,0,3663,2243,2243
"34196","Ntome_NODE_9501_length_2269_cov_298","Nsylvestris_NODE_9052_length_2244_cov_226",95.066,2128,65,22,62,2155,2197,76,0,3312,2093,2121
"34199","Ntome_NODE_9503_length_2269_cov_217","Nsylvestris_NODE_15325_length_1520_cov_21",97.237,1520,37,2,315,1830,1,1519,0,2569,1515,1518
"34224","Ntome_NODE_9511_length_2268_cov_142","Nsylvestris_NODE_881_length_5109_cov_127",92.384,2022,108,18,1,2003,3026,5020,0,2839,2002,1994
"34241","Ntome_NODE_9516_length_2268_cov_14","Nsylvestris_NODE_1739_length_4222_cov_94",98.182,55,1,0,2214,2268,2763,2709,7.51e-19,97.1,54,54
"34269","Ntome_NODE_9525_length_2266_cov_286","Nsylvestris_NODE_10237_length_2083_cov_212",94.61,1985,84,3,60,2040,118,2083,0,3051,1980,1965
"34291","Ntome_NODE_9534_length_2265_cov_288","Nsylvestris_NODE_3292_length_3478_cov_160",86.656,1866,232,12,1,1856,2663,805,0,2050,1855,1858
"34340","Ntome_NODE_9550_length_2262_cov_103","Nsylvestris_NODE_888_length_5103_cov_159",98.361,61,1,0,1,61,1265,1205,3.46e-22,108,60,60
"34351","Ntome_NODE_9555_length_2260_cov_126","Nsylvestris_NODE_9815_length_2138_cov_173",95.015,1986,77,16,45,2021,120,2092,0,3099,1976,1972
"34387","Ntome_NODE_9567_length_2258_cov_162","Nsylvestris_NODE_6167_length_2723_cov_82",94.326,1921,75,23,3,1913,2694,798,0,2913,1910,1896
"34423","Ntome_NODE_9579_length_2257_cov_91","Nsylvestris_NODE_5881_length_2788_cov_81",93.156,789,48,5,1470,2257,121,904,0,1153,787,783
"34523","Ntome_NODE_9611_length_2252_cov_86","Nsylvestris_NODE_5799_length_2800_cov_195",81.271,2109,341,32,109,2183,494,2582,0,1657,2074,2088
"34524","Ntome_NODE_9612_length_2252_cov_77","Nsylvestris_NODE_6592_length_2644_cov_144",91.797,256,20,1,1919,2174,8,262,1.11e-96,355,255,254
"34553","Ntome_NODE_9621_length_2250_cov_264","Nsylvestris_NODE_9338_length_2202_cov_177",93.753,2241,96,12,13,2250,2202,3,0,3323,2237,2199
"34554","Ntome_NODE_9622_length_2250_cov_183","Nsylvestris_NODE_4395_length_3128_cov_80",95.67,2240,69,13,21,2243,886,3114,0,3574,2222,2228
"34555","Ntome_NODE_9623_length_2250_cov_73","Nsylvestris_NODE_8405_length_2339_cov_199",82.09,268,45,3,1,265,1804,2071,9.11e-58,226,264,267
"34558","Ntome_NODE_9625_length_2250_cov_35","Nsylvestris_NODE_1831_length_4158_cov_126",95.52,2143,87,7,51,2185,5,2146,0,3417,2134,2141
"34559","Ntome_NODE_9626_length_2250_cov_11","Nsylvestris_NODE_34293_length_314_cov_2",90.123,324,18,11,325,645,313,1,8.43e-113,409,320,312
"34617","Ntome_NODE_9645_length_2246_cov_195","Nsylvestris_NODE_9796_length_2141_cov_159",92.52,2139,90,28,59,2159,2141,35,0,3000,2100,2106
"34646","Ntome_NODE_9655_length_2245_cov_248","Nsylvestris_NODE_9194_length_2224_cov_216",96.511,2207,49,11,17,2214,2212,25,0,3624,2197,2187
"34690","Ntome_NODE_9672_length_2243_cov_109","Nsylvestris_NODE_6420_length_2675_cov_170",96.808,1911,55,3,39,1943,63,1973,0,3186,1904,1910
"34763","Ntome_NODE_9698_length_2240_cov_32","Nsylvestris_NODE_2234_length_3921_cov_231",100,55,0,0,1,55,3006,2952,1.59e-20,102,54,54
"34864","Ntome_NODE_9731_length_2236_cov_65","Nsylvestris_NODE_640_length_5580_cov_64",83.74,123,16,3,1685,1805,385,265,7.35e-24,113,120,120
"34865","Ntome_NODE_9732_length_2236_cov_10","Nsylvestris_NODE_838_length_5171_cov_34",77.602,442,61,24,1611,2043,731,319,5.41e-60,233,432,412
"34897","Ntome_NODE_9743_length_2233_cov_278","Nsylvestris_NODE_520_length_5897_cov_222",96.263,1980,48,12,235,2189,3886,5864,0,3223,1954,1978
"34909","Ntome_NODE_9748_length_2233_cov_60","Nsylvestris_NODE_2031_length_4032_cov_153",92.574,606,19,7,1637,2233,515,1103,0,846,596,588
"34913","Ntome_NODE_9750_length_2232_cov_49","Nsylvestris_NODE_286_length_6785_cov_193",82.331,266,38,8,1145,1407,2935,3194,1.17e-56,222,262,259
"34936","Ntome_NODE_9757_length_2230_cov_187","Nsylvestris_NODE_691_length_5458_cov_182",94.335,2030,101,5,33,2058,320,2339,0,3099,2025,2019
"34974","Ntome_NODE_9769_length_2229_cov_147","Nsylvestris_NODE_9906_length_2127_cov_24",95.841,2140,62,10,42,2173,2124,4,0,3434,2131,2120
"35005","Ntome_NODE_9777_length_2228_cov_256","Nsylvestris_NODE_9289_length_2208_cov_217",96.78,2081,49,10,134,2211,2146,81,0,3456,2077,2065
"35013","Ntome_NODE_9780_length_2228_cov_153","Nsylvestris_NODE_2117_length_3980_cov_224",96.617,739,23,2,125,862,1958,1221,0,1225,737,737
"35023","Ntome_NODE_9783_length_2228_cov_45","Nsylvestris_NODE_9038_length_2246_cov_129",95.418,2008,64,12,217,2219,127,2111,0,3173,2002,1984
"35057","Ntome_NODE_9795_length_2226_cov_81","Nsylvestris_NODE_15240_length_1527_cov_172",77.866,253,49,4,803,1050,50,300,5.58e-35,150,247,250
"35074","Ntome_NODE_9801_length_2225_cov_177","Nsylvestris_NODE_757_length_5332_cov_197",96.681,1808,41,5,12,1801,5273,3467,0,2988,1789,1806
"35096","Ntome_NODE_9809_length_2224_cov_70","Nsylvestris_NODE_9992_length_2117_cov_78",97.505,2084,52,0,14,2097,1,2084,0,3561,2083,2083
"35114","Ntome_NODE_9815_length_2223_cov_62","Nsylvestris_NODE_1634_length_4306_cov_67",95.205,2044,73,9,1,2023,2042,3,0,3208,2022,2039
"35117","Ntome_NODE_9817_length_2222_cov_291","Nsylvestris_NODE_3371_length_3448_cov_210",93.147,2043,101,14,1,2039,3422,1415,0,2961,2038,2007
"35122","Ntome_NODE_9819_length_2222_cov_239","Nsylvestris_NODE_600_length_5707_cov_34",92.469,239,12,2,1381,1614,5273,5036,3.98e-91,337,233,237
"35153","Ntome_NODE_9829_length_2222_cov_29","Nsylvestris_NODE_2928_length_3610_cov_64",96.883,2214,69,0,1,2214,2268,55,0,3707,2213,2213
"35170","Ntome_NODE_9833_length_2221_cov_181","Nsylvestris_NODE_1960_length_4077_cov_162",98.604,1934,27,0,240,2173,3360,1427,0,3422,1933,1933
"35190","Ntome_NODE_9841_length_2220_cov_89","Nsylvestris_NODE_8984_length_2253_cov_115",94.562,2170,91,12,50,2209,101,2253,0,3328,2159,2152
"35191","Ntome_NODE_9842_length_2220_cov_23","Nsylvestris_NODE_10591_length_2039_cov_47",94.023,1673,96,4,550,2220,1755,85,0,2532,1670,1670
"35206","Ntome_NODE_9847_length_2219_cov_38","Nsylvestris_NODE_34699_length_303_cov_3",87.981,208,18,3,985,1190,234,32,1.15e-61,239,205,202
"35217","Ntome_NODE_9851_length_2218_cov_244","Nsylvestris_NODE_10135_length_2098_cov_204",94.857,2061,89,14,118,2169,2053,1,0,3203,2051,2052
"35244","Ntome_NODE_9860_length_2217_cov_237","Nsylvestris_NODE_2568_length_3761_cov_111",96.604,2061,67,3,108,2168,2189,132,0,3415,2060,2057
"35245","Ntome_NODE_9861_length_2217_cov_189","Nsylvestris_NODE_1470_length_4425_cov_134",93.174,1377,85,8,741,2111,2845,4218,0,2013,1370,1373
"35283","Ntome_NODE_9874_length_2216_cov_81","Nsylvestris_NODE_7711_length_2451_cov_96",96.798,2186,51,4,32,2216,2231,64,0,3631,2184,2167
"35297","Ntome_NODE_9878_length_2215_cov_258","Nsylvestris_NODE_10461_length_2055_cov_82",94.105,1934,68,12,95,2022,2,1895,0,2898,1927,1893
"35320","Ntome_NODE_9885_length_2215_cov_87","Nsylvestris_NODE_8392_length_2342_cov_97",93.579,2087,129,3,53,2135,2187,102,0,3107,2082,2085
"35327","Ntome_NODE_9888_length_2215_cov_15","Nsylvestris_NODE_26825_length_682_cov_8",94,50,1,2,3,52,115,162,3.44e-12,75,49,47
"35333","Ntome_NODE_9891_length_2214_cov_128","Nsylvestris_NODE_10432_length_2059_cov_28",92.181,2059,115,22,36,2075,2059,28,0,2868,2039,2031
"35334","Ntome_NODE_9892_length_2214_cov_126","Nsylvestris_NODE_36782_length_256_cov_3",97.976,247,5,0,1036,1282,1,247,6.36e-119,429,246,246
"35387","Ntome_NODE_9910_length_2211_cov_306","Nsylvestris_NODE_8488_length_2326_cov_223",95.377,2098,92,3,1,2094,225,2321,0,3332,2093,2096
"35392","Ntome_NODE_9912_length_2211_cov_266","Nsylvestris_NODE_9897_length_2128_cov_159",94.062,2105,98,11,97,2177,18,2119,0,3169,2080,2101
"35459","Ntome_NODE_9933_length_2208_cov_290","Nsylvestris_NODE_9593_length_2165_cov_206",96.437,2105,61,11,72,2166,13,2113,0,3459,2094,2100
"35513","Ntome_NODE_9948_length_2206_cov_147","Nsylvestris_NODE_6833_length_2598_cov_135",96.275,1557,44,7,546,2102,1588,46,0,2542,1556,1542
"35514","Ntome_NODE_9949_length_2206_cov_6","Nsylvestris_NODE_7931_length_2415_cov_20",95.188,2203,102,2,1,2203,198,2396,0,3478,2202,2198
"35527","Ntome_NODE_9954_length_2205_cov_110","Nsylvestris_NODE_28462_length_607_cov_189",98.039,51,1,0,1,51,541,491,1.22e-16,89.8,50,50
"35532","Ntome_NODE_9956_length_2205_cov_17","Nsylvestris_NODE_17996_length_1269_cov_13",97.674,43,1,0,74,116,200,158,3.42e-12,75,42,42
"35564","Ntome_NODE_9966_length_2204_cov_50","Nsylvestris_NODE_24819_length_782_cov_51",100,36,0,0,2003,2038,57,22,5.72e-10,67.6,35,35
"35571","Ntome_NODE_9969_length_2203_cov_293","Nsylvestris_NODE_9193_length_2224_cov_222",95.758,2169,74,7,36,2203,40,2191,0,3480,2167,2151
"35612","Ntome_NODE_9985_length_2201_cov_23","Nsylvestris_NODE_6708_length_2621_cov_111",91.549,71,6,0,68,138,1512,1582,2.03e-19,99,70,70
"35613","Ntome_NODE_9986_length_2200_cov_282","Nsylvestris_NODE_56_length_9302_cov_160",92.356,1923,113,20,257,2159,6421,4513,0,2706,1902,1908
"35617","Ntome_NODE_9988_length_2200_cov_271","Nsylvestris_NODE_9449_length_2185_cov_229",97.765,2058,42,4,145,2200,1,2056,0,3542,2055,2055
"35620","Ntome_NODE_9990_length_2200_cov_221","Nsylvestris_NODE_2233_length_3922_cov_145",96.061,1777,70,0,95,1871,1919,143,0,2894,1776,1776
"35621","Ntome_NODE_9991_length_2200_cov_130","Nsylvestris_NODE_2729_length_3690_cov_114",91.302,2219,160,20,1,2200,41,2245,0,2998,2199,2204
"35650","Ntome_NODE_9999_length_2199_cov_173","Nsylvestris_NODE_11386_length_1943_cov_222",92.93,1853,113,13,211,2051,67,1913,0,2680,1840,1846
"35661","Ntome_NODE_10002_length_2199_cov_71","Nsylvestris_NODE_5859_length_2790_cov_176",93.962,265,13,2,1825,2086,1835,1571,1.78e-109,398,261,264
"35714","Ntome_NODE_10019_length_2197_cov_195","Nsylvestris_NODE_10931_length_1996_cov_184",95.278,1906,78,7,103,2003,1947,49,0,3011,1900,1898
"35725","Ntome_NODE_10024_length_2196_cov_256","Nsylvestris_NODE_11153_length_1968_cov_224",94.9,1647,77,5,315,1959,1944,303,0,2569,1644,1641
"35744","Ntome_NODE_10029_length_2196_cov_77","Nsylvestris_NODE_14389_length_1611_cov_116",95.816,980,41,0,1007,1986,302,1281,0,1583,979,979
"35751","Ntome_NODE_10032_length_2195_cov_268","Nsylvestris_NODE_4136_length_3192_cov_234",96.682,1899,52,8,291,2180,1251,3147,0,3147,1889,1896
"35759","Ntome_NODE_10036_length_2195_cov_133","Nsylvestris_NODE_9097_length_2237_cov_142",95.618,2191,73,13,11,2195,50,2223,0,3493,2184,2173
"35771","Ntome_NODE_10040_length_2194_cov_213","Nsylvestris_NODE_9009_length_2250_cov_110",95.249,2210,76,10,1,2194,52,2248,0,3472,2193,2196
"35807","Ntome_NODE_10052_length_2193_cov_229","Nsylvestris_NODE_9352_length_2200_cov_198",95.471,2208,62,13,2,2185,1,2194,0,3489,2183,2193
"35827","Ntome_NODE_10059_length_2191_cov_300","Nsylvestris_NODE_3683_length_3340_cov_179",94.737,2052,83,15,89,2128,3166,1128,0,3168,2039,2038
"35853","Ntome_NODE_10066_length_2191_cov_108","Nsylvestris_NODE_3694_length_3337_cov_136",94.389,1889,99,4,307,2191,1963,78,0,2894,1884,1885
"35888","Ntome_NODE_10078_length_2189_cov_300","Nsylvestris_NODE_1073_length_4850_cov_130",94.512,2041,85,8,74,2097,47,2077,0,3123,2023,2030
"35907","Ntome_NODE_10084_length_2188_cov_300","Nsylvestris_NODE_238_length_7063_cov_194",96.731,2080,67,1,45,2124,4933,7011,0,3463,2079,2078
"35934","Ntome_NODE_10093_length_2187_cov_241","Nsylvestris_NODE_16234_length_1426_cov_183",94.054,1396,46,9,357,1737,8,1381,0,2084,1380,1373
"35994","Ntome_NODE_10114_length_2183_cov_251","Nsylvestris_NODE_4041_length_3219_cov_231",94.692,2110,101,5,75,2183,2130,31,0,3265,2108,2099
"36002","Ntome_NODE_10117_length_2183_cov_139","Nsylvestris_NODE_8080_length_2390_cov_202",95.608,2049,80,6,140,2183,2144,101,0,3277,2043,2043
"36012","Ntome_NODE_10121_length_2183_cov_45","Nsylvestris_NODE_9192_length_2225_cov_44",94.627,2066,81,10,9,2047,2212,150,0,3173,2038,2062
"36018","Ntome_NODE_10123_length_2182_cov_262","Nsylvestris_NODE_12627_length_1802_cov_231",95.759,1745,62,6,259,1996,1755,16,0,2802,1737,1739
"36027","Ntome_NODE_10128_length_2181_cov_301","Nsylvestris_NODE_224_length_7162_cov_204",95.965,2181,88,0,1,2181,2044,4224,0,3541,2180,2180
"36031","Ntome_NODE_10130_length_2181_cov_268","Nsylvestris_NODE_10198_length_2088_cov_224",97.793,2084,42,3,2,2085,9,2088,0,3591,2083,2079
"36035","Ntome_NODE_10132_length_2181_cov_79","Nsylvestris_NODE_2387_length_3847_cov_175",96.199,2131,79,2,1,2131,3832,1704,0,3485,2130,2128
"36043","Ntome_NODE_10135_length_2180_cov_285","Nsylvestris_NODE_5844_length_2793_cov_164",95.552,1776,74,5,166,1937,1,1775,0,2837,1771,1774
"36072","Ntome_NODE_10145_length_2179_cov_24","Nsylvestris_NODE_13966_length_1655_cov_18",83.158,190,31,1,79,267,1125,936,1.17e-41,172,188,189
"36085","Ntome_NODE_10152_length_2177_cov_200","Nsylvestris_NODE_11446_length_1936_cov_163",95.338,1952,70,7,229,2177,1936,3,0,3081,1948,1933
"36086","Ntome_NODE_10153_length_2177_cov_159","Nsylvestris_NODE_10527_length_2047_cov_113",96.154,2054,67,10,71,2119,1,2047,0,3345,2048,2046
"36087","Ntome_NODE_10154_length_2177_cov_113","Nsylvestris_NODE_5685_length_2822_cov_42",95.027,1830,67,4,131,1960,1940,135,0,2854,1829,1805
"36097","Ntome_NODE_10157_length_2176_cov_262","Nsylvestris_NODE_11192_length_1963_cov_202",93.638,1792,89,11,135,1912,1941,161,0,2654,1777,1780
"36128","Ntome_NODE_10167_length_2175_cov_209","Nsylvestris_NODE_15705_length_1479_cov_229",92.603,1433,88,10,635,2050,1476,45,0,2043,1415,1431
"36144","Ntome_NODE_10173_length_2174_cov_284","Nsylvestris_NODE_7142_length_2546_cov_202",94.214,2022,75,21,106,2119,446,2433,0,3048,2013,1987
"36153","Ntome_NODE_10177_length_2174_cov_25","Nsylvestris_NODE_13032_length_1760_cov_37",92.063,315,24,1,578,891,315,1,8.03e-123,442,313,314
"36166","Ntome_NODE_10181_length_2174_cov_193","Nsylvestris_NODE_8971_length_2255_cov_174",94.458,2111,86,11,66,2166,121,2210,0,3221,2100,2089
"36240","Ntome_NODE_10204_length_2170_cov_256","Nsylvestris_NODE_8728_length_2290_cov_221",96.824,1826,52,3,77,1902,174,1993,0,3046,1825,1819
"36261","Ntome_NODE_10211_length_2169_cov_116","Nsylvestris_NODE_8760_length_2286_cov_95",93.33,2159,94,15,50,2169,129,2276,0,3144,2119,2147
"36262","Ntome_NODE_10212_length_2169_cov_101","Nsylvestris_NODE_12289_length_1838_cov_155",77.861,1328,247,35,305,1605,1602,295,0,780,1300,1307
"36267","Ntome_NODE_10215_length_2168_cov_250","Nsylvestris_NODE_10865_length_2005_cov_209",92.083,1882,84,35,281,2117,1,1862,0,2590,1836,1861
"36319","Ntome_NODE_10228_length_2166_cov_99","Nsylvestris_NODE_2853_length_3637_cov_123",93.018,1948,84,24,213,2151,2077,173,0,2796,1938,1904
"36324","Ntome_NODE_10230_length_2166_cov_32","Nsylvestris_NODE_8030_length_2398_cov_130",92.801,2167,137,8,1,2166,2270,122,0,3120,2165,2148
"36328","Ntome_NODE_10232_length_2165_cov_309","Nsylvestris_NODE_8747_length_2288_cov_224",96.006,2103,80,2,1,2103,2288,190,0,3415,2102,2098
"36338","Ntome_NODE_10236_length_2165_cov_162","Nsylvestris_NODE_10116_length_2101_cov_125",96.296,54,2,0,2112,2165,1679,1626,1.2e-16,89.8,53,53
"36339","Ntome_NODE_10237_length_2165_cov_145","Nsylvestris_NODE_18536_length_1221_cov_161",94.915,59,3,0,2107,2165,556,498,9.27e-18,93.5,58,58
"36343","Ntome_NODE_10239_length_2165_cov_102","Nsylvestris_NODE_20971_length_1030_cov_144",90.222,992,63,22,1080,2052,51,1027,0,1264,972,976
"36350","Ntome_NODE_10244_length_2164_cov_150","Nsylvestris_NODE_14960_length_1554_cov_49",86.525,141,9,6,1673,1804,191,52,7.01e-34,147,131,139
"36467","Ntome_NODE_10283_length_2158_cov_191","Nsylvestris_NODE_7663_length_2459_cov_77",95.952,2100,67,6,52,2145,372,2459,0,3391,2093,2087
"36471","Ntome_NODE_10285_length_2158_cov_99","Nsylvestris_NODE_10528_length_2047_cov_34",91.389,2044,147,17,101,2125,12,2045,0,2772,2024,2033
"36479","Ntome_NODE_10288_length_2158_cov_9","Nsylvestris_NODE_15371_length_1516_cov_30",93.349,436,28,1,1446,1881,1412,978,0,643,435,434
"36506","Ntome_NODE_10297_length_2157_cov_89","Nsylvestris_NODE_15089_length_1542_cov_211",92.881,590,36,6,1300,1884,1473,885,0,852,584,588
"36520","Ntome_NODE_10303_length_2156_cov_277","Nsylvestris_NODE_9374_length_2197_cov_205",95.835,2041,79,4,120,2156,2176,138,0,3293,2036,2038
"36575","Ntome_NODE_10323_length_2154_cov_289","Nsylvestris_NODE_3581_length_3371_cov_225",97.589,2032,44,2,125,2154,30,2058,0,3476,2029,2028
"36633","Ntome_NODE_10342_length_2152_cov_260","Nsylvestris_NODE_11219_length_1960_cov_212",95.899,1829,62,4,194,2011,51,1877,0,2950,1817,1826
"36642","Ntome_NODE_10345_length_2152_cov_211","Nsylvestris_NODE_8644_length_2302_cov_178",97.318,2051,54,1,52,2101,160,2210,0,3482,2049,2050
"36670","Ntome_NODE_10354_length_2152_cov_19","Nsylvestris_NODE_9636_length_2160_cov_29",95.366,2050,70,6,94,2121,43,2089,0,3236,2027,2046
"36720","Ntome_NODE_10371_length_2149_cov_96","Nsylvestris_NODE_2642_length_3725_cov_61",85.346,853,80,18,1301,2145,867,52,0,841,844,815
"36728","Ntome_NODE_10374_length_2149_cov_56","Nsylvestris_NODE_10727_length_2022_cov_221",94.697,1999,80,10,153,2149,47,2021,0,3081,1996,1974
"36742","Ntome_NODE_10380_length_2148_cov_187","Nsylvestris_NODE_13924_length_1659_cov_220",85.653,467,63,4,124,588,1542,1078,1e-136,488,464,464
"36772","Ntome_NODE_10392_length_2146_cov_263","Nsylvestris_NODE_11022_length_1984_cov_211",94.808,1926,93,5,12,1933,9,1931,0,2996,1921,1922
"36805","Ntome_NODE_10403_length_2145_cov_61","Nsylvestris_NODE_11823_length_1890_cov_30",95.031,1791,82,2,324,2107,100,1890,0,2808,1783,1790
"36806","Ntome_NODE_10404_length_2144_cov_297","Nsylvestris_NODE_1702_length_4250_cov_141",96.972,1618,49,0,476,2093,4204,2587,0,2717,1617,1617
"36817","Ntome_NODE_10409_length_2144_cov_229","Nsylvestris_NODE_12121_length_1855_cov_213",93.923,1810,67,7,61,1837,7,1806,0,2693,1776,1799
"36838","Ntome_NODE_10415_length_2144_cov_43","Nsylvestris_NODE_6147_length_2727_cov_26",79.208,909,152,31,642,1525,1814,918,1.6e-169,597,883,896
"36839","Ntome_NODE_10416_length_2143_cov_317","Nsylvestris_NODE_483_length_6004_cov_227",96.355,2140,66,4,1,2140,3820,5947,0,3509,2139,2127
"36842","Ntome_NODE_10418_length_2143_cov_231","Nsylvestris_NODE_9154_length_2229_cov_198",97.2,2107,44,4,50,2143,2145,41,0,3550,2093,2104
"36850","Ntome_NODE_10422_length_2143_cov_67","Nsylvestris_NODE_10537_length_2046_cov_129",94.553,2038,57,23,11,2029,18,2020,0,3099,2018,2002
"36851","Ntome_NODE_10424_length_2143_cov_29","Nsylvestris_NODE_10976_length_1991_cov_59",93.953,1935,97,5,21,1949,1970,50,0,2907,1928,1920
"36903","Ntome_NODE_10439_length_2140_cov_245","Nsylvestris_NODE_747_length_5354_cov_175",92.208,77,6,0,547,623,4931,4855,9.1e-23,110,76,76
"36966","Ntome_NODE_10457_length_2137_cov_295","Nsylvestris_NODE_8322_length_2352_cov_223",97.685,1944,36,1,203,2137,170,2113,0,3332,1934,1943
"36999","Ntome_NODE_10468_length_2136_cov_162","Nsylvestris_NODE_4256_length_3160_cov_102",92.473,93,6,1,2024,2116,164,255,1.94e-29,132,92,91
"37010","Ntome_NODE_10472_length_2135_cov_206","Nsylvestris_NODE_7360_length_2511_cov_144",96.188,1810,65,4,103,1910,2471,664,0,2957,1807,1807
"37020","Ntome_NODE_10476_length_2135_cov_14","Nsylvestris_NODE_18814_length_1200_cov_204",96.721,61,1,1,2076,2135,556,496,5.46e-20,100,59,60
"37027","Ntome_NODE_10478_length_2134_cov_296","Nsylvestris_NODE_3602_length_3364_cov_211",96.579,2134,73,0,1,2134,982,3115,0,3537,2133,2133
"37030","Ntome_NODE_10480_length_2134_cov_226","Nsylvestris_NODE_9782_length_2142_cov_228",94.312,2145,84,18,9,2133,2142,16,0,3251,2124,2126
"37050","Ntome_NODE_10487_length_2133_cov_220","Nsylvestris_NODE_4467_length_3106_cov_218",95.176,1679,46,12,83,1727,3069,1392,0,2619,1644,1677
"37121","Ntome_NODE_10509_length_2130_cov_310","Nsylvestris_NODE_458_length_6074_cov_225",97.981,2130,43,0,1,2130,4110,1981,0,3696,2129,2129
"37122","Ntome_NODE_10510_length_2130_cov_296","Nsylvestris_NODE_9978_length_2118_cov_223",95.747,2069,64,11,41,2090,52,2115,0,3312,2049,2063
"37125","Ntome_NODE_10512_length_2130_cov_287","Nsylvestris_NODE_10310_length_2074_cov_143",92.056,1863,90,35,83,1941,1895,87,0,2567,1858,1808
"37139","Ntome_NODE_10517_length_2130_cov_196","Nsylvestris_NODE_2260_length_3910_cov_75",96.979,1920,56,2,1,1919,1908,3826,0,3223,1918,1918
"37161","Ntome_NODE_10524_length_2129_cov_97","Nsylvestris_NODE_15312_length_1520_cov_166",100,55,0,0,1,55,1199,1145,1.51e-20,102,54,54
"37217","Ntome_NODE_10540_length_2127_cov_114","Nsylvestris_NODE_10574_length_2041_cov_30",95.748,2046,69,4,55,2091,5,2041,0,3280,2036,2036
"37223","Ntome_NODE_10543_length_2126_cov_273","Nsylvestris_NODE_10818_length_2011_cov_219",92.044,1986,111,21,62,2029,52,2008,0,2748,1967,1956
"37224","Ntome_NODE_10544_length_2126_cov_269","Nsylvestris_NODE_3445_length_3421_cov_231",97.738,2122,48,0,1,2122,2159,38,0,3653,2121,2121
"37225","Ntome_NODE_10546_length_2126_cov_224","Nsylvestris_NODE_2588_length_3750_cov_164",96.463,1470,45,4,86,1549,24,1492,0,2420,1463,1468
"37241","Ntome_NODE_10552_length_2126_cov_34","Nsylvestris_NODE_663_length_5525_cov_90",88.889,135,13,2,541,675,5214,5346,1.9e-39,165,134,132
"37300","Ntome_NODE_10570_length_2124_cov_80","Nsylvestris_NODE_17159_length_1343_cov_171",93.702,1302,57,10,801,2086,1,1293,0,1927,1285,1292
"37321","Ntome_NODE_10577_length_2122_cov_276","Nsylvestris_NODE_9003_length_2250_cov_200",98.246,2110,33,2,14,2120,139,2247,0,3688,2106,2108
"37350","Ntome_NODE_10586_length_2122_cov_97","Nsylvestris_NODE_8998_length_2251_cov_166",93.823,1279,68,3,719,1993,718,1989,0,1914,1274,1271
"37351","Ntome_NODE_10587_length_2122_cov_56","Nsylvestris_NODE_7879_length_2424_cov_112",95.724,2128,85,1,1,2122,2344,217,0,3421,2121,2127
"37379","Ntome_NODE_10597_length_2121_cov_17","Nsylvestris_NODE_9751_length_2147_cov_17",96.463,2092,69,3,23,2109,2094,3,0,3448,2086,2091
"37439","Ntome_NODE_10615_length_2117_cov_277","Nsylvestris_NODE_2345_length_3873_cov_229",97.104,2106,60,1,1,2105,2106,1,0,3550,2104,2105
"37440","Ntome_NODE_10616_length_2117_cov_275","Nsylvestris_NODE_929_length_5047_cov_157",96.463,1781,58,1,339,2114,6,1786,0,2935,1775,1780
"37448","Ntome_NODE_10619_length_2116_cov_297","Nsylvestris_NODE_6373_length_2684_cov_149",96.021,2061,58,3,1,2057,644,2684,0,3330,2056,2040
"37486","Ntome_NODE_10631_length_2115_cov_31","Nsylvestris_NODE_1367_length_4529_cov_119",90.952,210,9,2,1,201,2504,2712,3.01e-72,274,200,208
"37494","Ntome_NODE_10634_length_2114_cov_178","Nsylvestris_NODE_24137_length_823_cov_204",95.646,735,29,3,75,808,780,48,0,1177,733,732
"37495","Ntome_NODE_10635_length_2114_cov_173","Nsylvestris_NODE_10426_length_2059_cov_166",97.701,2044,43,2,27,2070,1,2040,0,3511,2043,2039
"37533","Ntome_NODE_10652_length_2113_cov_9","Nsylvestris_NODE_17459_length_1317_cov_208",100,55,0,0,2059,2113,666,612,1.5e-20,102,54,54
"37591","Ntome_NODE_10674_length_2110_cov_105","Nsylvestris_NODE_5977_length_2765_cov_173",95.745,47,2,0,1,47,1515,1561,9.1e-13,76.8,46,46
"37614","Ntome_NODE_10682_length_2109_cov_47","Nsylvestris_NODE_10157_length_2094_cov_69",91.996,2024,116,23,47,2051,1,1997,0,2798,2004,1996
"37628","Ntome_NODE_10687_length_2108_cov_224","Nsylvestris_NODE_8669_length_2298_cov_125",94.464,2023,95,6,38,2059,2243,237,0,3099,2021,2006
"37642","Ntome_NODE_10692_length_2108_cov_15","Nsylvestris_NODE_9314_length_2206_cov_77",95.553,2114,73,10,8,2103,2179,69,0,3363,2095,2110
"37655","Ntome_NODE_10696_length_2107_cov_41","Nsylvestris_NODE_26230_length_708_cov_60",83.784,148,19,5,132,278,488,631,1.48e-30,135,146,143
"37656","Ntome_NODE_10697_length_2107_cov_34","Nsylvestris_NODE_3191_length_3509_cov_195",96.703,91,2,1,261,350,1156,1246,5.28e-35,150,89,90
"37657","Ntome_NODE_10698_length_2107_cov_12","Nsylvestris_NODE_1675_length_4270_cov_177",81.235,2105,379,11,8,2107,3996,1903,0,1685,2099,2093
"37658","Ntome_NODE_10699_length_2106_cov_284","Nsylvestris_NODE_8514_length_2322_cov_196",92.449,2013,99,25,51,2038,171,2155,0,2826,1987,1984
"37659","Ntome_NODE_10700_length_2106_cov_282","Nsylvestris_NODE_3368_length_3450_cov_203",96.875,64,2,0,1,64,749,812,3.22e-22,108,63,63
"37671","Ntome_NODE_10704_length_2106_cov_234","Nsylvestris_NODE_12256_length_1842_cov_42",95.185,1537,58,7,100,1630,20,1546,0,2414,1530,1526
"37712","Ntome_NODE_10718_length_2105_cov_214","Nsylvestris_NODE_13177_length_1741_cov_104",94.158,1763,69,14,10,1760,1,1741,0,2654,1750,1740
"37718","Ntome_NODE_10720_length_2105_cov_118","Nsylvestris_NODE_19382_length_1153_cov_148",87.984,982,89,20,860,1833,1000,40,0,1133,973,960
"37783","Ntome_NODE_10739_length_2103_cov_70","Nsylvestris_NODE_2541_length_3773_cov_203",100,64,0,0,2040,2103,257,320,1.49e-25,119,63,63
"37806","Ntome_NODE_10748_length_2101_cov_163","Nsylvestris_NODE_10339_length_2070_cov_166",93.774,1301,44,21,820,2094,1333,44,0,1919,1274,1289
"37840","Ntome_NODE_10759_length_2100_cov_32","Nsylvestris_NODE_9960_length_2121_cov_39",83.582,1742,278,8,238,1975,353,2090,0,1626,1737,1737
"37841","Ntome_NODE_10760_length_2100_cov_11","Nsylvestris_NODE_786_length_5256_cov_132",97.406,2043,51,2,59,2100,3237,1196,0,3478,2041,2041
"37842","Ntome_NODE_10761_length_2099_cov_294","Nsylvestris_NODE_1198_length_4706_cov_216",94.463,2113,88,6,15,2099,52,2163,0,3227,2084,2111
"37869","Ntome_NODE_10771_length_2099_cov_84","Nsylvestris_NODE_9791_length_2141_cov_209",95.394,2106,71,13,6,2099,7,2098,0,3328,2093,2091
"37900","Ntome_NODE_10782_length_2098_cov_137","Nsylvestris_NODE_5143_length_2939_cov_129",93.095,2129,96,23,1,2098,813,2921,0,3070,2097,2108
"37908","Ntome_NODE_10786_length_2098_cov_12","Nsylvestris_NODE_9315_length_2206_cov_39",93.379,2054,109,9,14,2058,2180,145,0,3014,2044,2035
"37921","Ntome_NODE_10790_length_2097_cov_190","Nsylvestris_NODE_9690_length_2153_cov_145",94.899,1588,64,9,512,2094,518,2093,0,2468,1582,1575
"37925","Ntome_NODE_10792_length_2097_cov_112","Nsylvestris_NODE_10233_length_2084_cov_105",97.382,1719,42,3,55,1772,2083,367,0,2922,1717,1716
"37943","Ntome_NODE_10798_length_2096_cov_99","Nsylvestris_NODE_10541_length_2045_cov_85",91.397,2069,105,33,1,2020,2045,1,0,2767,2019,2044
"37950","Ntome_NODE_10801_length_2095_cov_281","Nsylvestris_NODE_2560_length_3764_cov_151",93.798,2080,108,12,25,2095,2145,78,0,3107,2070,2067
"37981","Ntome_NODE_10810_length_2094_cov_279","Nsylvestris_NODE_9680_length_2155_cov_191",92.906,2044,89,21,23,2041,106,2118,0,2920,2018,2012
"37989","Ntome_NODE_10813_length_2094_cov_238","Nsylvestris_NODE_1363_length_4531_cov_116",96.227,2094,67,2,1,2094,4214,2133,0,3419,2093,2081
"37995","Ntome_NODE_10816_length_2094_cov_170","Nsylvestris_NODE_9926_length_2125_cov_139",94.089,2064,63,22,40,2066,52,2093,0,3081,2026,2041
"38033","Ntome_NODE_10827_length_2093_cov_20","Nsylvestris_NODE_25646_length_737_cov_49",91.304,69,5,1,1,69,334,267,8.97e-18,93.5,68,67
"38044","Ntome_NODE_10831_length_2092_cov_213","Nsylvestris_NODE_11470_length_1933_cov_208",92.352,1922,84,26,76,1981,7,1881,0,2676,1905,1874
"38068","Ntome_NODE_10840_length_2091_cov_258","Nsylvestris_NODE_10507_length_2049_cov_222",94.779,1877,87,6,32,1907,1913,47,0,2913,1875,1866
"38131","Ntome_NODE_10863_length_2089_cov_173","Nsylvestris_NODE_10242_length_2083_cov_28",96.211,1874,65,3,71,1943,55,1923,0,3062,1872,1868
"38135","Ntome_NODE_10865_length_2089_cov_9","Nsylvestris_NODE_15115_length_1539_cov_150",76.199,1147,221,35,1,1121,341,1461,7.34e-158,558,1120,1120
"38145","Ntome_NODE_10868_length_2088_cov_216","Nsylvestris_NODE_10428_length_2058_cov_162",94.058,2070,91,17,27,2088,2058,13,0,3112,2061,2045
"38166","Ntome_NODE_10876_length_2087_cov_247","Nsylvestris_NODE_707_length_5413_cov_201",94.477,1901,67,15,53,1916,337,2236,0,2894,1863,1899
"38257","Ntome_NODE_10904_length_2084_cov_116","Nsylvestris_NODE_1206_length_4699_cov_133",90.191,1254,82,31,825,2051,3460,4699,0,1596,1226,1239
"38292","Ntome_NODE_10915_length_2083_cov_166","Nsylvestris_NODE_335_length_6535_cov_63",89.655,58,5,1,803,859,5710,5653,1.16e-11,73.1,56,57
"38307","Ntome_NODE_10922_length_2082_cov_290","Nsylvestris_NODE_9249_length_2215_cov_234",94.249,2017,53,17,122,2082,2167,158,0,3024,1960,2009
"38312","Ntome_NODE_10924_length_2082_cov_193","Nsylvestris_NODE_13995_length_1649_cov_220",96.925,1073,31,2,113,1183,78,1150,0,1797,1070,1072
"38324","Ntome_NODE_10928_length_2082_cov_117","Nsylvestris_NODE_10753_length_2019_cov_62",95.028,1951,74,13,97,2032,2012,70,0,3044,1935,1942
"38341","Ntome_NODE_10933_length_2082_cov_40","Nsylvestris_NODE_24046_length_829_cov_96",89.474,323,25,3,1580,1894,327,6,4.69e-110,399,314,321
"38345","Ntome_NODE_10935_length_2082_cov_14","Nsylvestris_NODE_8532_length_2321_cov_28",95.926,2111,48,8,1,2082,2302,201,0,3387,2081,2101
"38356","Ntome_NODE_10939_length_2081_cov_15","Nsylvestris_NODE_8000_length_2404_cov_29",93.295,2088,117,17,1,2081,83,2154,0,3059,2080,2071
"38357","Ntome_NODE_10940_length_2080_cov_292","Nsylvestris_NODE_9062_length_2243_cov_201",94.617,1969,80,16,79,2030,2188,229,0,3025,1951,1959
"38412","Ntome_NODE_10957_length_2079_cov_155","Nsylvestris_NODE_10055_length_2110_cov_115",95.033,1953,64,17,137,2063,1946,1,0,3038,1926,1945
"38416","Ntome_NODE_10959_length_2078_cov_296","Nsylvestris_NODE_3912_length_3264_cov_174",97.15,1719,49,0,1,1719,1782,64,0,2904,1718,1718
"38421","Ntome_NODE_10962_length_2078_cov_100","Nsylvestris_NODE_14273_length_1622_cov_181",91.187,1634,94,25,103,1707,1613,1,0,2174,1604,1612
"38494","Ntome_NODE_10988_length_2075_cov_17","Nsylvestris_NODE_25917_length_723_cov_9",79.279,111,16,7,1455,1561,419,312,4.17e-11,71.3,106,107
"38527","Ntome_NODE_10999_length_2073_cov_142","Nsylvestris_NODE_23519_length_858_cov_79",87.083,480,47,9,1604,2070,347,824,5.71e-149,529,466,477
"38528","Ntome_NODE_11000_length_2073_cov_123","Nsylvestris_NODE_15558_length_1494_cov_209",97.517,725,16,1,25,747,1,725,0,1238,722,724
"38531","Ntome_NODE_11002_length_2073_cov_68","Nsylvestris_NODE_539_length_5843_cov_119",87.304,638,54,13,57,690,2904,3518,0,704,633,614
"38558","Ntome_NODE_11013_length_2071_cov_161","Nsylvestris_NODE_11044_length_1982_cov_185",95.944,1849,52,6,54,1882,93,1938,0,2977,1828,1845
"38563","Ntome_NODE_11015_length_2071_cov_54","Nsylvestris_NODE_18333_length_1238_cov_200",86.114,965,96,14,31,989,1183,251,0,1005,958,932
"38568","Ntome_NODE_11017_length_2070_cov_275","Nsylvestris_NODE_9832_length_2135_cov_217",94.45,2018,87,9,9,2002,119,2135,0,3083,1993,2016
"38583","Ntome_NODE_11023_length_2070_cov_16","Nsylvestris_NODE_9016_length_2249_cov_145",94.879,2070,85,7,1,2069,2138,89,0,3216,2068,2049
"38600","Ntome_NODE_11030_length_2068_cov_240","Nsylvestris_NODE_12275_length_1840_cov_80",95.284,1675,67,7,292,1955,1713,40,0,2645,1663,1673
"38618","Ntome_NODE_11036_length_2068_cov_49","Nsylvestris_NODE_31083_length_446_cov_6",90.164,61,4,1,2006,2066,389,331,2.48e-13,78.7,60,58
"38621","Ntome_NODE_11039_length_2067_cov_264","Nsylvestris_NODE_10509_length_2049_cov_198",95.311,2026,78,10,53,2066,2047,27,0,3199,2013,2020
"38632","Ntome_NODE_11045_length_2067_cov_14","Nsylvestris_NODE_5556_length_2851_cov_31",96.818,2074,58,7,1,2067,129,2201,0,3458,2066,2072
"38639","Ntome_NODE_11049_length_2066_cov_271","Nsylvestris_NODE_976_length_4985_cov_166",96.021,2061,60,6,24,2066,90,2146,0,3332,2042,2056
"38645","Ntome_NODE_11052_length_2066_cov_206","Nsylvestris_NODE_14178_length_1632_cov_226",98.182,55,1,0,1,55,600,654,6.84e-19,97.1,54,54
"38676","Ntome_NODE_11062_length_2066_cov_19","Nsylvestris_NODE_6317_length_2695_cov_53",95.085,1892,75,1,113,2004,1937,64,0,2963,1891,1873
"38728","Ntome_NODE_11077_length_2064_cov_226","Nsylvestris_NODE_12445_length_1822_cov_131",95.762,1817,68,8,14,1826,1817,6,0,2920,1812,1811
"38738","Ntome_NODE_11080_length_2064_cov_144","Nsylvestris_NODE_9611_length_2163_cov_154",94.978,2051,76,10,35,2064,2089,45,0,3192,2029,2044
"38743","Ntome_NODE_11082_length_2064_cov_80","Nsylvestris_NODE_21788_length_970_cov_201",89.183,453,25,10,182,612,104,554,2.03e-153,544,430,450
"38752","Ntome_NODE_11086_length_2063_cov_72","Nsylvestris_NODE_22230_length_940_cov_84",88.95,181,18,2,886,1065,553,732,1.08e-56,222,179,179
"38810","Ntome_NODE_11104_length_2060_cov_35","Nsylvestris_NODE_10797_length_2014_cov_114",96.838,1866,54,3,143,2006,1983,121,0,3114,1863,1862
"38833","Ntome_NODE_11114_length_2058_cov_136","Nsylvestris_NODE_11258_length_1956_cov_114",96.217,1956,33,11,86,2024,1956,25,0,3164,1938,1931
"38834","Ntome_NODE_11115_length_2058_cov_120","Nsylvestris_NODE_15410_length_1511_cov_227",96.888,739,23,0,4,742,1014,276,0,1238,738,738
"38883","Ntome_NODE_11130_length_2056_cov_270","Nsylvestris_NODE_414_length_6229_cov_170",96.751,1939,45,1,118,2056,1,1921,0,3216,1938,1920
"38884","Ntome_NODE_11131_length_2056_cov_243","Nsylvestris_NODE_12287_length_1838_cov_219",94.364,1792,85,9,82,1859,1,1790,0,2736,1777,1789
"38885","Ntome_NODE_11132_length_2056_cov_230","Nsylvestris_NODE_7725_length_2448_cov_222",85.423,933,121,11,72,994,330,1257,0,955,922,927
"38902","Ntome_NODE_11138_length_2056_cov_81","Nsylvestris_NODE_12775_length_1789_cov_147",95.558,1756,53,15,73,1809,40,1789,0,2787,1736,1749
"38911","Ntome_NODE_11143_length_2056_cov_16","Nsylvestris_NODE_6500_length_2660_cov_177",97.128,2054,59,0,1,2054,441,2494,0,3467,2053,2053
"38916","Ntome_NODE_11145_length_2055_cov_283","Nsylvestris_NODE_1528_length_4374_cov_222",94.231,1768,94,6,183,1950,159,1918,0,2693,1767,1759
"38937","Ntome_NODE_11153_length_2054_cov_288","Nsylvestris_NODE_11108_length_1975_cov_132",97.212,1973,49,4,33,2000,1975,4,0,3334,1967,1971
"38938","Ntome_NODE_11154_length_2054_cov_216","Nsylvestris_NODE_8860_length_2273_cov_145",93.414,1822,110,7,23,1843,1979,167,0,2691,1820,1812
"38993","Ntome_NODE_11169_length_2053_cov_31","Nsylvestris_NODE_9302_length_2207_cov_98",95.084,1973,85,5,51,2022,1994,33,0,3096,1971,1961
"38998","Ntome_NODE_11171_length_2052_cov_280","Nsylvestris_NODE_8038_length_2397_cov_164",95.719,2032,64,9,42,2052,349,2378,0,3249,2010,2029
"39008","Ntome_NODE_11175_length_2052_cov_167","Nsylvestris_NODE_10159_length_2094_cov_14",92.065,1903,123,19,46,1925,1898,1,0,2652,1879,1897
"39025","Ntome_NODE_11182_length_2051_cov_132","Nsylvestris_NODE_12891_length_1776_cov_45",94.477,1684,74,5,276,1954,78,1747,0,2577,1678,1669
"39032","Ntome_NODE_11184_length_2051_cov_105","Nsylvestris_NODE_31313_length_431_cov_6",97.436,39,1,0,1548,1586,294,332,5.33e-10,67.6,38,38
"39038","Ntome_NODE_11187_length_2050_cov_280","Nsylvestris_NODE_10490_length_2051_cov_221",96.256,2003,37,9,84,2050,48,2048,0,3249,1966,2000
"39039","Ntome_NODE_11188_length_2050_cov_271","Nsylvestris_NODE_10673_length_2029_cov_191",96.729,1865,56,3,9,1871,20,1881,0,3101,1862,1861
"39047","Ntome_NODE_11191_length_2050_cov_246","Nsylvestris_NODE_11136_length_1971_cov_83",94.786,1918,96,1,136,2049,49,1966,0,2985,1913,1917
"39048","Ntome_NODE_11192_length_2050_cov_230","Nsylvestris_NODE_11404_length_1941_cov_196",92.845,1747,95,19,197,1937,124,1846,0,2507,1740,1722
"39123","Ntome_NODE_11219_length_2047_cov_207","Nsylvestris_NODE_2662_length_3718_cov_161",96.847,1237,34,4,140,1374,2300,3533,0,2063,1234,1233
"39178","Ntome_NODE_11236_length_2045_cov_236","Nsylvestris_NODE_11613_length_1917_cov_216",93.291,1908,90,13,99,1974,2,1903,0,2780,1875,1901
"39188","Ntome_NODE_11241_length_2044_cov_302","Nsylvestris_NODE_4385_length_3130_cov_81",93.17,2035,75,21,59,2044,147,2166,0,2929,1985,2019
"39193","Ntome_NODE_11244_length_2044_cov_210","Nsylvestris_NODE_9887_length_2129_cov_189",95.339,1974,74,10,1,1966,48,2011,0,3120,1965,1963
"39194","Ntome_NODE_11245_length_2043_cov_209","Nsylvestris_NODE_19486_length_1145_cov_9",93.103,1160,65,4,758,1917,1,1145,0,1685,1159,1144
"39280","Ntome_NODE_11278_length_2040_cov_265","Nsylvestris_NODE_13651_length_1690_cov_198",93.858,1677,70,11,339,1989,1,1670,0,2495,1650,1669
"39281","Ntome_NODE_11279_length_2040_cov_203","Nsylvestris_NODE_493_length_5980_cov_105",97.458,1967,33,1,1,1967,3981,5930,0,3339,1966,1949
"39305","Ntome_NODE_11287_length_2039_cov_148","Nsylvestris_NODE_10724_length_2023_cov_46",93.098,1927,100,15,77,1993,1909,6,0,2791,1916,1903
"39318","Ntome_NODE_11291_length_2039_cov_38","Nsylvestris_NODE_3032_length_3574_cov_158",94.912,1926,78,9,1,1912,72,1991,0,2996,1911,1919
"39319","Ntome_NODE_11292_length_2038_cov_280","Nsylvestris_NODE_10121_length_2100_cov_201",95.413,1853,79,5,1,1851,206,2054,0,2946,1850,1848
"39324","Ntome_NODE_11295_length_2038_cov_125","Nsylvestris_NODE_9399_length_2193_cov_168",94.641,1978,81,7,1,1968,2081,119,0,3042,1967,1962
"39345","Ntome_NODE_11304_length_2036_cov_285","Nsylvestris_NODE_6409_length_2677_cov_179",94.231,2028,82,18,7,2026,2677,677,0,3064,2019,2000
"39367","Ntome_NODE_11311_length_2036_cov_109","Nsylvestris_NODE_897_length_5091_cov_45",91.228,57,5,0,883,939,1096,1040,2.44e-13,78.7,56,56
"39368","Ntome_NODE_11312_length_2036_cov_55","Nsylvestris_NODE_10677_length_2029_cov_42",94.361,2004,55,16,19,1990,1978,1,0,3022,1971,1977
"39403","Ntome_NODE_11322_length_2034_cov_141","Nsylvestris_NODE_667_length_5511_cov_154",94.486,1469,77,3,278,1745,48,1513,0,2261,1467,1465
"39443","Ntome_NODE_11334_length_2033_cov_172","Nsylvestris_NODE_10858_length_2006_cov_136",96.006,1928,74,3,30,1957,1925,1,0,3131,1927,1924
"39449","Ntome_NODE_11337_length_2033_cov_88","Nsylvestris_NODE_13122_length_1748_cov_119",94.971,517,14,3,1509,2018,1107,596,0,800,509,511
"39474","Ntome_NODE_11345_length_2032_cov_109","Nsylvestris_NODE_10660_length_2030_cov_188",96.364,55,2,0,1,55,1323,1377,3.13e-17,91.6,54,54
"39507","Ntome_NODE_11357_length_2030_cov_78","Nsylvestris_NODE_10306_length_2074_cov_199",96.543,1909,43,11,57,1954,2024,128,0,3138,1897,1896
"39566","Ntome_NODE_11377_length_2028_cov_105","Nsylvestris_NODE_6144_length_2727_cov_95",92.279,1865,77,20,114,1941,2672,838,0,2584,1827,1834
"39567","Ntome_NODE_11378_length_2028_cov_70","Nsylvestris_NODE_10650_length_2031_cov_196",96.66,1976,60,5,50,2023,15,1986,0,3278,1973,1971
"39583","Ntome_NODE_11384_length_2027_cov_175","Nsylvestris_NODE_10606_length_2036_cov_127",94.968,2027,90,6,1,2021,16,2036,0,3168,2020,2020
"39605","Ntome_NODE_11390_length_2026_cov_277","Nsylvestris_NODE_10483_length_2052_cov_214",92.949,2014,70,35,17,2001,82,2052,0,2867,1984,1970
"39618","Ntome_NODE_11395_length_2026_cov_80","Nsylvestris_NODE_9223_length_2220_cov_80",93.375,1932,84,19,1,1913,1911,5,0,2819,1912,1906
"39646","Ntome_NODE_11404_length_2025_cov_228","Nsylvestris_NODE_11265_length_1955_cov_184",93.776,1912,85,15,107,2011,1894,10,0,2841,1904,1884
"39676","Ntome_NODE_11414_length_2023_cov_293","Nsylvestris_NODE_9805_length_2139_cov_201",94.997,1839,84,7,190,2022,2080,244,0,2880,1832,1836
"39694","Ntome_NODE_11420_length_2023_cov_167","Nsylvestris_NODE_11643_length_1913_cov_216",95.486,1883,64,9,68,1949,1863,1,0,2987,1881,1862
"39695","Ntome_NODE_11421_length_2023_cov_152","Nsylvestris_NODE_59_length_9263_cov_64",95.946,1480,56,4,508,1985,8716,7239,0,2398,1477,1477
"39737","Ntome_NODE_11434_length_2021_cov_286","Nsylvestris_NODE_4281_length_3156_cov_124",95.019,1586,75,3,289,1874,3079,1498,0,2488,1585,1581
"39743","Ntome_NODE_11436_length_2021_cov_224","Nsylvestris_NODE_11911_length_1879_cov_142",92.128,1880,109,18,4,1852,3,1874,0,2615,1848,1871
"39766","Ntome_NODE_11443_length_2020_cov_125","Nsylvestris_NODE_164_length_7615_cov_33",82.278,79,11,2,1142,1219,7006,7082,1.89e-09,65.8,77,76
"39770","Ntome_NODE_11445_length_2020_cov_72","Nsylvestris_NODE_9687_length_2154_cov_62",93.731,1962,84,11,46,1973,2154,198,0,2905,1927,1956
"39771","Ntome_NODE_11446_length_2020_cov_35","Nsylvestris_NODE_14446_length_1606_cov_11",94.763,1394,73,0,279,1672,1394,1,0,2170,1393,1393
"39810","Ntome_NODE_11459_length_2018_cov_217","Nsylvestris_NODE_10710_length_2024_cov_126",93.064,2033,73,26,2,2018,1,1981,0,2911,2016,1980
"39821","Ntome_NODE_11462_length_2018_cov_200","Nsylvestris_NODE_13936_length_1658_cov_194",95.184,1225,58,1,749,1972,1530,306,0,1934,1223,1224
"39834","Ntome_NODE_11467_length_2017_cov_287","Nsylvestris_NODE_638_length_5587_cov_205",97.62,2017,34,3,1,2017,2034,32,0,3446,2016,2002
"39898","Ntome_NODE_11489_length_2015_cov_286","Nsylvestris_NODE_11906_length_1879_cov_222",95.158,1838,75,6,115,1945,1831,1,0,2889,1830,1830
"39941","Ntome_NODE_11503_length_2014_cov_90","Nsylvestris_NODE_10021_length_2113_cov_116",97.165,1975,56,0,10,1984,139,2113,0,3338,1974,1974
"39951","Ntome_NODE_11506_length_2014_cov_27","Nsylvestris_NODE_3922_length_3262_cov_175",87.681,276,22,10,1,274,2489,2224,2.19e-83,311,273,265
"39992","Ntome_NODE_11520_length_2012_cov_10","Nsylvestris_NODE_2899_length_3621_cov_40",97.164,2010,53,1,1,2010,1555,3560,0,3393,2009,2005
"40033","Ntome_NODE_11533_length_2010_cov_260","Nsylvestris_NODE_9548_length_2170_cov_197",96.532,1759,61,0,159,1917,82,1840,0,2911,1758,1758
"40038","Ntome_NODE_11535_length_2010_cov_202","Nsylvestris_NODE_8053_length_2394_cov_112",95.584,1970,72,9,47,2010,417,2377,0,3142,1963,1960
"40042","Ntome_NODE_11537_length_2009_cov_311","Nsylvestris_NODE_11298_length_1951_cov_220",95.132,1787,81,5,180,1965,54,1835,0,2813,1785,1781
"40054","Ntome_NODE_11543_length_2009_cov_113","Nsylvestris_NODE_11447_length_1936_cov_163",96.083,1838,48,7,120,1939,1932,101,0,2974,1819,1831
"40055","Ntome_NODE_11544_length_2009_cov_103","Nsylvestris_NODE_13995_length_1649_cov_220",91.874,443,23,9,163,598,1566,1130,2.49e-172,606,435,436
"40103","Ntome_NODE_11562_length_2007_cov_28","Nsylvestris_NODE_8280_length_2358_cov_42",77.778,225,35,8,766,977,791,1013,3.05e-27,124,211,222
"40120","Ntome_NODE_11570_length_2006_cov_148","Nsylvestris_NODE_11141_length_1970_cov_96",93.763,1940,71,20,36,1958,1907,1,0,2867,1922,1906
"40131","Ntome_NODE_11574_length_2005_cov_290","Nsylvestris_NODE_2937_length_3606_cov_213",95.462,1763,66,8,99,1853,777,2533,0,2800,1754,1756
"40132","Ntome_NODE_11575_length_2005_cov_269","Nsylvestris_NODE_9170_length_2227_cov_139",95.633,1855,48,10,88,1912,1901,50,0,2946,1824,1851
"40136","Ntome_NODE_11577_length_2005_cov_213","Nsylvestris_NODE_2335_length_3879_cov_216",96.965,1417,40,1,358,1771,1466,50,0,2375,1413,1416
"40141","Ntome_NODE_11579_length_2005_cov_118","Nsylvestris_NODE_13895_length_1663_cov_216",94.017,468,19,1,991,1449,858,391,0,701,458,467
"40145","Ntome_NODE_11581_length_2005_cov_47","Nsylvestris_NODE_18898_length_1193_cov_16",95.39,1193,46,1,626,1809,1193,1,0,1890,1183,1192
"40146","Ntome_NODE_11582_length_2000_cov_45","Nsylvestris_NODE_14551_length_1595_cov_8",94.719,890,47,0,454,1343,1,890,0,1384,889,889
"40155","Ntome_NODE_11585_length_2004_cov_247","Nsylvestris_NODE_15578_length_1492_cov_231",94.915,1416,52,10,415,1824,43,1444,0,2198,1409,1401
"40176","Ntome_NODE_11591_length_2004_cov_10","Nsylvestris_NODE_273_length_6841_cov_83",84.127,126,16,4,1,124,6040,6163,1.42e-25,119,123,123
"40219","Ntome_NODE_11605_length_2002_cov_273","Nsylvestris_NODE_10417_length_2060_cov_137",95.995,1648,62,1,168,1815,355,1998,0,2675,1647,1643
"40236","Ntome_NODE_11611_length_2001_cov_225","Nsylvestris_NODE_9088_length_2239_cov_216",95.631,2014,60,11,1,2001,191,2189,0,3206,2000,1998
"40241","Ntome_NODE_11613_length_2001_cov_171","Nsylvestris_NODE_14820_length_1567_cov_208",96.763,865,26,1,277,1139,86,950,0,1441,862,864
"40278","Ntome_NODE_11624_length_2000_cov_211","Nsylvestris_NODE_8256_length_2362_cov_153",88.992,1944,109,46,116,2000,41,1938,0,2307,1884,1897
"40355","Ntome_NODE_11648_length_1997_cov_97","Nsylvestris_NODE_4334_length_3143_cov_109",95.382,2014,71,5,5,1997,1,2013,0,3184,1992,2012
"40364","Ntome_NODE_11651_length_1997_cov_23","Nsylvestris_NODE_36555_length_261_cov_4",95.769,260,11,0,1680,1939,1,260,3.45e-116,420,259,259
"40365","Ntome_NODE_11652_length_1997_cov_9","Nsylvestris_NODE_2835_length_3643_cov_153",100,55,0,0,1943,1997,3094,3040,1.42e-20,102,54,54
"40377","Ntome_NODE_11657_length_1996_cov_43","Nsylvestris_NODE_2665_length_3718_cov_35",96.154,78,3,0,1898,1975,1802,1879,2.34e-28,128,77,77
"40380","Ntome_NODE_11659_length_1999_cov_15","Nsylvestris_NODE_2559_length_3769_cov_117",99.164,1675,9,2,38,1707,2882,1208,0,3011,1669,1674
"40400","Ntome_NODE_11665_length_1995_cov_209","Nsylvestris_NODE_15508_length_1501_cov_144",95.384,1473,61,4,468,1939,12,1478,0,2337,1471,1466
"40442","Ntome_NODE_11677_length_1994_cov_29","Nsylvestris_NODE_3776_length_3309_cov_202",95.548,1797,66,7,156,1951,3135,1352,0,2863,1795,1783
"40495","Ntome_NODE_11696_length_1992_cov_29","Nsylvestris_NODE_9324_length_2204_cov_192",94.39,1943,104,2,1,1938,38,1980,0,2979,1937,1942
"40501","Ntome_NODE_11699_length_1991_cov_239","Nsylvestris_NODE_12261_length_1841_cov_194",95.18,1805,61,13,161,1953,1791,1,0,2828,1792,1790
"40502","Ntome_NODE_11700_length_1991_cov_220","Nsylvestris_NODE_12952_length_1768_cov_153",94.363,1437,62,10,555,1991,1467,50,0,2187,1436,1417
"40510","Ntome_NODE_11703_length_1991_cov_47","Nsylvestris_NODE_5413_length_2883_cov_118",95.548,1999,66,10,1,1991,69,2052,0,3177,1990,1983
"40515","Ntome_NODE_11706_length_1990_cov_261","Nsylvestris_NODE_5037_length_2963_cov_183",92.023,1730,79,24,257,1961,1769,74,0,2375,1704,1695
"40573","Ntome_NODE_11725_length_1989_cov_13","Nsylvestris_NODE_13277_length_1730_cov_176",92.982,57,3,1,1,57,1344,1289,1.84e-14,82.4,56,55
"40577","Ntome_NODE_11727_length_1988_cov_292","Nsylvestris_NODE_8588_length_2311_cov_198",97.576,1939,38,5,51,1988,61,1991,0,3312,1937,1930
"40604","Ntome_NODE_11734_length_1988_cov_178","Nsylvestris_NODE_12836_length_1782_cov_150",95.444,1690,52,9,82,1768,1668,1,0,2671,1686,1667
"40610","Ntome_NODE_11738_length_1988_cov_107","Nsylvestris_NODE_12777_length_1789_cov_104",96.718,1676,52,2,296,1971,1708,36,0,2787,1675,1672
"40673","Ntome_NODE_11761_length_1986_cov_39","Nsylvestris_NODE_11359_length_1946_cov_63",94.369,1918,72,19,64,1958,1905,1,0,2911,1894,1904
"40748","Ntome_NODE_11789_length_1982_cov_92","Nsylvestris_NODE_6643_length_2635_cov_16",83.281,640,78,20,832,1462,2586,1967,5.38e-159,562,630,619
"40756","Ntome_NODE_11792_length_1982_cov_42","Nsylvestris_NODE_3435_length_3426_cov_162",88.023,526,46,7,1350,1861,2706,2184,2.45e-172,606,511,522
"40765","Ntome_NODE_11797_length_1981_cov_140","Nsylvestris_NODE_27103_length_669_cov_9",94.09,423,25,0,1513,1935,1,423,0,643,422,422
"40771","Ntome_NODE_11800_length_1981_cov_48","Nsylvestris_NODE_10840_length_2009_cov_19",94.319,1813,75,7,182,1968,199,2009,0,2752,1786,1810
"40807","Ntome_NODE_11810_length_1980_cov_123","Nsylvestris_NODE_9584_length_2166_cov_66",97.445,1918,46,3,48,1963,249,2165,0,3267,1915,1916
"40819","Ntome_NODE_11815_length_1979_cov_247","Nsylvestris_NODE_11396_length_1942_cov_148",95.838,1946,75,6,6,1949,1,1942,0,3140,1943,1941
"40820","Ntome_NODE_11816_length_1979_cov_152","Nsylvestris_NODE_19913_length_1109_cov_190",97.196,856,23,1,1125,1979,901,46,0,1447,854,855
"40833","Ntome_NODE_11822_length_1978_cov_274","Nsylvestris_NODE_12508_length_1814_cov_198",93.066,1745,93,17,166,1905,1765,44,0,2527,1739,1721
"40902","Ntome_NODE_11843_length_1976_cov_138","Nsylvestris_NODE_11766_length_1897_cov_213",92.04,1784,83,27,109,1875,1748,7,0,2453,1766,1741
"40940","Ntome_NODE_11855_length_1975_cov_172","Nsylvestris_NODE_8627_length_2305_cov_125",92.39,1971,61,32,1,1956,395,2291,0,2726,1955,1896
"40976","Ntome_NODE_11866_length_1974_cov_128","Nsylvestris_NODE_9105_length_2236_cov_94",95.942,1651,61,2,257,1906,591,2236,0,2673,1649,1645
"40995","Ntome_NODE_11872_length_1973_cov_267","Nsylvestris_NODE_11947_length_1875_cov_192",93.189,1571,84,16,171,1731,1577,20,0,2287,1560,1557
"40999","Ntome_NODE_11874_length_1973_cov_263","Nsylvestris_NODE_14294_length_1621_cov_147",96.069,1501,53,3,75,1570,70,1569,0,2440,1495,1499
"41021","Ntome_NODE_11882_length_1972_cov_219","Nsylvestris_NODE_10703_length_2025_cov_132",95.303,1831,85,1,141,1970,20,1850,0,2904,1829,1830
"41040","Ntome_NODE_11890_length_1971_cov_19","Nsylvestris_NODE_10808_length_2013_cov_68",95.735,1829,69,7,4,1829,1962,140,0,2937,1825,1822
"41043","Ntome_NODE_11893_length_1970_cov_290","Nsylvestris_NODE_3435_length_3426_cov_162",96.182,1886,58,9,17,1900,6,1879,0,3072,1883,1873
"41047","Ntome_NODE_11895_length_1970_cov_248","Nsylvestris_NODE_1730_length_4229_cov_193",97.36,1970,52,0,1,1970,598,2567,0,3350,1969,1969
"41052","Ntome_NODE_11897_length_1970_cov_158","Nsylvestris_NODE_13392_length_1718_cov_16",93.219,1696,106,5,218,1907,1695,3,0,2486,1689,1692
"41062","Ntome_NODE_11901_length_1970_cov_25","Nsylvestris_NODE_4019_length_3229_cov_69",82.334,917,146,14,43,946,1328,415,0,782,903,913
"41065","Ntome_NODE_11903_length_1969_cov_278","Nsylvestris_NODE_11083_length_1978_cov_204",94.172,1836,95,6,84,1914,42,1870,0,2787,1830,1828
"41102","Ntome_NODE_11913_length_1968_cov_235","Nsylvestris_NODE_11512_length_1929_cov_111",94.984,1854,90,3,72,1925,79,1929,0,2905,1853,1850
"41226","Ntome_NODE_11952_length_1963_cov_134","Nsylvestris_NODE_929_length_5047_cov_157",95.093,1671,71,6,11,1680,2610,4270,0,2621,1669,1660
"41227","Ntome_NODE_11953_length_1963_cov_102","Nsylvestris_NODE_5137_length_2941_cov_101",97.695,564,10,2,157,717,930,367,0,966,560,563
"41228","Ntome_NODE_11954_length_1963_cov_67","Nsylvestris_NODE_10990_length_1989_cov_135",94.266,1866,67,19,114,1949,47,1902,0,2817,1835,1855
"41239","Ntome_NODE_11959_length_1962_cov_291","Nsylvestris_NODE_12684_length_1797_cov_222",98.606,1650,23,0,198,1847,49,1698,0,2920,1649,1649
"41247","Ntome_NODE_11962_length_1962_cov_97","Nsylvestris_NODE_14950_length_1555_cov_183",95.16,1529,73,1,210,1737,1539,11,0,2412,1527,1528
"41271","Ntome_NODE_11972_length_1961_cov_180","Nsylvestris_NODE_8099_length_2387_cov_188",94.027,1825,82,9,55,1873,264,2067,0,2741,1818,1803
"41272","Ntome_NODE_11973_length_1961_cov_175","Nsylvestris_NODE_14398_length_1610_cov_201",95.371,1037,22,9,821,1856,514,1525,0,1626,1035,1011
"41298","Ntome_NODE_11981_length_1960_cov_156","Nsylvestris_NODE_16291_length_1420_cov_226",95.313,64,2,1,1897,1960,892,830,5.02e-20,100,63,62
"41312","Ntome_NODE_11986_length_1959_cov_283","Nsylvestris_NODE_5628_length_2831_cov_167",96.586,1787,50,7,73,1857,2824,1047,0,2952,1784,1777
"41322","Ntome_NODE_11991_length_1959_cov_124","Nsylvestris_NODE_25741_length_731_cov_171",100,41,0,0,1919,1959,557,517,8.45e-13,76.8,40,40
"41329","Ntome_NODE_11994_length_1958_cov_273","Nsylvestris_NODE_15598_length_1491_cov_85",95.92,1446,43,2,512,1945,1442,1,0,2329,1433,1441
"41391","Ntome_NODE_12017_length_1955_cov_277","Nsylvestris_NODE_12562_length_1808_cov_201",97.372,1484,33,1,145,1622,49,1532,0,2519,1477,1483
"41426","Ntome_NODE_12028_length_1954_cov_178","Nsylvestris_NODE_11257_length_1956_cov_197",94.498,1854,83,6,1,1851,119,1956,0,2841,1850,1837
"41427","Ntome_NODE_12029_length_1954_cov_122","Nsylvestris_NODE_10894_length_2001_cov_175",95.476,1901,43,14,52,1945,1920,56,0,2994,1893,1864
"41468","Ntome_NODE_12043_length_1952_cov_169","Nsylvestris_NODE_12726_length_1793_cov_81",94.139,1689,97,1,30,1718,64,1750,0,2569,1688,1686
"41482","Ntome_NODE_12049_length_1952_cov_48","Nsylvestris_NODE_14453_length_1605_cov_58",94.673,1558,75,4,126,1680,51,1603,0,2410,1554,1552
"41505","Ntome_NODE_12056_length_1951_cov_9","Nsylvestris_NODE_10647_length_2032_cov_22",94.427,1866,99,3,46,1907,61,1925,0,2865,1861,1864
"41517","Ntome_NODE_12061_length_1950_cov_56","Nsylvestris_NODE_11722_length_1902_cov_176",96.483,1905,64,1,2,1906,1,1902,0,3144,1904,1901
"41531","Ntome_NODE_12065_length_1949_cov_267","Nsylvestris_NODE_12118_length_1855_cov_231",86.171,1345,172,8,408,1745,1525,188,0,1441,1337,1337
"41552","Ntome_NODE_12072_length_1948_cov_300","Nsylvestris_NODE_9803_length_2140_cov_189",98.182,55,1,0,1,55,1694,1640,6.45e-19,97.1,54,54
"41636","Ntome_NODE_12100_length_1944_cov_265","Nsylvestris_NODE_12380_length_1828_cov_205",97.086,1750,49,2,158,1906,68,1816,0,2948,1748,1748
"41637","Ntome_NODE_12101_length_1944_cov_225","Nsylvestris_NODE_18383_length_1234_cov_32",92.014,1127,52,14,715,1806,1234,111,0,1548,1091,1123
"41674","Ntome_NODE_12112_length_1943_cov_178","Nsylvestris_NODE_7871_length_2425_cov_207",97.745,1951,33,4,1,1943,1961,14,0,3349,1942,1947
"41675","Ntome_NODE_12113_length_1943_cov_162","Nsylvestris_NODE_3921_length_3262_cov_186",98.06,567,10,1,432,998,1958,2523,0,985,566,565
"41695","Ntome_NODE_12121_length_1943_cov_13","Nsylvestris_NODE_35363_length_287_cov_4",88.591,298,18,4,1032,1324,1,287,1.61e-94,348,292,286
"41699","Ntome_NODE_12123_length_1943_cov_219","Nsylvestris_NODE_63_length_9186_cov_130",95.266,1542,56,4,50,1590,5043,3518,0,2427,1540,1525
"41713","Ntome_NODE_12127_length_1942_cov_156","Nsylvestris_NODE_10915_length_1998_cov_114",85.714,539,66,8,1412,1942,429,964,6.82e-158,558,530,535
"41714","Ntome_NODE_12128_length_1942_cov_152","Nsylvestris_NODE_7751_length_2445_cov_49",94.645,1774,75,4,117,1880,2445,682,0,2732,1763,1763
"41736","Ntome_NODE_12136_length_1942_cov_33","Nsylvestris_NODE_6310_length_2683_cov_40",74.67,1212,256,31,752,1942,2148,967,2.52e-137,490,1190,1181
"41744","Ntome_NODE_12140_length_1941_cov_142","Nsylvestris_NODE_10616_length_2035_cov_161",96.007,1753,53,4,114,1865,62,1798,0,2833,1751,1736
"41752","Ntome_NODE_12145_length_1940_cov_273","Nsylvestris_NODE_11926_length_1877_cov_225",94.913,1848,81,7,95,1937,5,1844,0,2880,1842,1839
"41761","Ntome_NODE_12149_length_1940_cov_64","Nsylvestris_NODE_10870_length_2004_cov_228",98.182,55,1,0,1,55,900,846,6.42e-19,97.1,54,54
"41773","Ntome_NODE_12153_length_1939_cov_282","Nsylvestris_NODE_12559_length_1808_cov_218",93.652,1717,69,11,117,1807,1808,106,0,2531,1690,1702
"41779","Ntome_NODE_12156_length_1939_cov_87","Nsylvestris_NODE_1432_length_4466_cov_94",96.051,1418,47,7,464,1880,3054,4463,0,2300,1416,1409
"41780","Ntome_NODE_12157_length_1939_cov_84","Nsylvestris_NODE_25971_length_720_cov_30",93.304,672,41,2,308,975,719,48,0,989,667,671
"41793","Ntome_NODE_12162_length_1938_cov_249","Nsylvestris_NODE_9773_length_2144_cov_182",97.076,1847,41,7,1,1843,99,1936,0,3099,1842,1837
"41807","Ntome_NODE_12167_length_1938_cov_14","Nsylvestris_NODE_11875_length_1883_cov_7",95.749,1882,77,1,6,1887,1879,1,0,3029,1881,1878
"41826","Ntome_NODE_12173_length_1937_cov_167","Nsylvestris_NODE_10459_length_2055_cov_159",91.501,1906,114,24,54,1937,1935,56,0,2579,1883,1879
"41905","Ntome_NODE_12199_length_1931_cov_283","Nsylvestris_NODE_10700_length_2025_cov_216",95.922,1888,61,6,51,1924,120,2005,0,3046,1873,1885
"41937","Ntome_NODE_12209_length_1931_cov_284","Nsylvestris_NODE_10119_length_2100_cov_204",97.539,1788,37,5,98,1881,1834,50,0,3051,1783,1784
"41984","Ntome_NODE_12223_length_1930_cov_99","Nsylvestris_NODE_16497_length_1400_cov_39",93.397,1151,67,8,80,1222,1,1150,0,1696,1142,1149
"42006","Ntome_NODE_12230_length_1929_cov_196","Nsylvestris_NODE_14396_length_1610_cov_215",95.401,1435,57,6,138,1568,179,1608,0,2276,1430,1429
"42024","Ntome_NODE_12238_length_1929_cov_27","Nsylvestris_NODE_10395_length_2063_cov_14",90.328,1923,104,32,20,1879,2062,159,0,2446,1859,1903
"42052","Ntome_NODE_12250_length_1927_cov_9","Nsylvestris_NODE_9752_length_2146_cov_225",100,55,0,0,1,55,242,188,1.37e-20,102,54,54
"42089","Ntome_NODE_12261_length_1925_cov_286","Nsylvestris_NODE_11507_length_1929_cov_227",93.509,1818,91,14,64,1874,1875,78,0,2678,1810,1797
"42193","Ntome_NODE_12292_length_1922_cov_262","Nsylvestris_NODE_11517_length_1928_cov_194",97.108,1867,44,6,7,1868,30,1891,0,3140,1861,1861
"42197","Ntome_NODE_12294_length_1922_cov_236","Nsylvestris_NODE_14395_length_1610_cov_220",92.845,1216,55,10,521,1719,101,1301,0,1735,1198,1200
"42227","Ntome_NODE_12300_length_1921_cov_308","Nsylvestris_NODE_797_length_5248_cov_57",96.408,1921,66,1,1,1921,4475,2558,0,3162,1920,1917
"42237","Ntome_NODE_12305_length_1921_cov_134","Nsylvestris_NODE_4165_length_3184_cov_156",95.778,1421,49,6,506,1921,1710,3124,0,2281,1415,1414
"42256","Ntome_NODE_12310_length_1921_cov_35","Nsylvestris_NODE_20388_length_1080_cov_110",96.364,55,2,0,1867,1921,569,515,2.96e-17,91.6,54,54
"42278","Ntome_NODE_12318_length_1919_cov_184","Nsylvestris_NODE_488_length_5991_cov_125",96.67,1111,31,4,694,1798,556,1666,0,1842,1104,1110
"42288","Ntome_NODE_12322_length_1918_cov_261","Nsylvestris_NODE_12340_length_1833_cov_214",97.787,1672,33,2,4,1671,161,1832,0,2880,1667,1671
"42309","Ntome_NODE_12328_length_1917_cov_285","Nsylvestris_NODE_12409_length_1825_cov_209",95.063,1742,59,11,46,1769,49,1781,0,2715,1723,1732
"42367","Ntome_NODE_12347_length_1916_cov_30","Nsylvestris_NODE_13782_length_1675_cov_87",96.497,1399,47,2,352,1749,1446,49,0,2311,1397,1397
"42378","Ntome_NODE_12351_length_1915_cov_226","Nsylvestris_NODE_11170_length_1965_cov_236",94.479,1938,72,15,3,1915,1958,31,0,2953,1912,1927
"42420","Ntome_NODE_12366_length_1913_cov_154","Nsylvestris_NODE_11582_length_1921_cov_142",96.435,1150,39,2,1,1149,92,1240,0,1895,1148,1148
"42439","Ntome_NODE_12374_length_1911_cov_287","Nsylvestris_NODE_12411_length_1825_cov_189",97.087,1476,31,5,347,1815,1515,45,0,2477,1468,1470
"42449","Ntome_NODE_12378_length_1911_cov_217","Nsylvestris_NODE_11640_length_1914_cov_143",94.188,1910,79,17,3,1896,21,1914,0,2883,1893,1893
"42515","Ntome_NODE_12402_length_1908_cov_53","Nsylvestris_NODE_27563_length_648_cov_56",87.755,49,5,1,58,106,151,198,1.07e-06,56.5,48,47
"42516","Ntome_NODE_12403_length_1908_cov_37","Nsylvestris_NODE_13997_length_1649_cov_132",93.215,1297,73,10,55,1338,1546,252,0,1893,1283,1294
"42528","Ntome_NODE_12408_length_1907_cov_259","Nsylvestris_NODE_12595_length_1805_cov_185",97.148,1753,46,4,94,1843,1760,9,0,2957,1749,1751
"42550","Ntome_NODE_12415_length_1907_cov_97","Nsylvestris_NODE_10927_length_1997_cov_48",95.178,1908,72,8,1,1907,40,1928,0,2996,1906,1888
"42574","Ntome_NODE_12423_length_1906_cov_77","Nsylvestris_NODE_11440_length_1937_cov_68",88.822,1825,137,32,24,1833,1896,124,0,2178,1809,1772
"42575","Ntome_NODE_12424_length_1906_cov_60","Nsylvestris_NODE_10783_length_2016_cov_31",92.9,1676,86,9,188,1856,2016,367,0,2405,1668,1649
"42589","Ntome_NODE_12429_length_1905_cov_238","Nsylvestris_NODE_1467_length_4428_cov_218",94.48,1866,81,14,2,1847,4352,2489,0,2856,1845,1863
"42598","Ntome_NODE_12432_length_1905_cov_88","Nsylvestris_NODE_13040_length_1759_cov_101",94.873,1736,54,7,168,1869,1,1735,0,2680,1701,1734
"42624","Ntome_NODE_12441_length_1904_cov_234","Nsylvestris_NODE_12389_length_1827_cov_220",91.917,1732,110,9,131,1847,1723,7,0,2396,1716,1716
"42644","Ntome_NODE_12449_length_1903_cov_257","Nsylvestris_NODE_11186_length_1964_cov_180",94.812,1812,68,8,44,1847,1795,2,0,2802,1803,1793
"42645","Ntome_NODE_12450_length_1903_cov_243","Nsylvestris_NODE_11548_length_1924_cov_220",81.782,1515,240,31,244,1750,1666,180,0,1236,1506,1486
"42657","Ntome_NODE_12454_length_1903_cov_36","Nsylvestris_NODE_17669_length_1297_cov_68",96.364,55,2,0,1849,1903,620,566,2.93e-17,91.6,54,54
"42673","Ntome_NODE_12461_length_1901_cov_291","Nsylvestris_NODE_1952_length_4084_cov_139",95.594,1793,68,4,118,1901,108,1898,0,2863,1783,1790
"42678","Ntome_NODE_12463_length_1901_cov_213","Nsylvestris_NODE_21329_length_1004_cov_171",98.305,59,0,1,1843,1901,535,592,1.35e-20,102,58,57
"42701","Ntome_NODE_12471_length_1901_cov_19","Nsylvestris_NODE_10833_length_2009_cov_224",81.481,270,43,3,395,657,1572,1303,1.66e-54,215,262,269
"42707","Ntome_NODE_12474_length_1900_cov_231","Nsylvestris_NODE_11167_length_1966_cov_149",95.342,1288,56,2,115,1398,1916,629,0,2043,1283,1287
"42710","Ntome_NODE_12476_length_1900_cov_119","Nsylvestris_NODE_17521_length_1311_cov_61",93.548,1209,44,10,530,1736,1186,10,0,1770,1206,1176
"42736","Ntome_NODE_12484_length_1899_cov_92","Nsylvestris_NODE_10802_length_2013_cov_184",98.162,1850,34,0,48,1897,1925,76,0,3229,1849,1849
"42754","Ntome_NODE_12490_length_1898_cov_213","Nsylvestris_NODE_12674_length_1798_cov_196",95.527,1766,58,12,14,1767,1798,42,0,2804,1753,1756
"42766","Ntome_NODE_12495_length_1897_cov_226","Nsylvestris_NODE_12925_length_1771_cov_219",94.975,1771,54,9,96,1838,1771,8,0,2745,1742,1763
"42770","Ntome_NODE_12497_length_1897_cov_177","Nsylvestris_NODE_14394_length_1611_cov_11",96.201,1632,40,4,218,1849,1,1610,0,2651,1631,1609
"42792","Ntome_NODE_12505_length_1896_cov_230","Nsylvestris_NODE_9344_length_2198_cov_224",93.956,1489,68,11,372,1849,27,1504,0,2231,1477,1477
"42821","Ntome_NODE_12515_length_1896_cov_66","Nsylvestris_NODE_11989_length_1871_cov_46",94.74,1844,84,5,16,1851,33,1871,0,2856,1835,1838
"42833","Ntome_NODE_12520_length_1895_cov_257","Nsylvestris_NODE_22_length_11544_cov_169",94.5,1400,71,4,420,1816,11200,9804,0,2154,1396,1396
"42857","Ntome_NODE_12528_length_1895_cov_12","Nsylvestris_NODE_3334_length_3462_cov_46",81.234,389,73,0,392,780,813,1201,1.59e-84,315,388,388
"42877","Ntome_NODE_12533_length_1894_cov_146","Nsylvestris_NODE_1740_length_4218_cov_204",94.038,1258,67,5,1,1254,1687,2940,0,1901,1253,1253
"42885","Ntome_NODE_12536_length_1894_cov_91","Nsylvestris_NODE_13914_length_1661_cov_177",96.545,1621,44,1,274,1894,1,1609,0,2673,1620,1608
"42915","Ntome_NODE_12547_length_1893_cov_71","Nsylvestris_NODE_11467_length_1934_cov_92",95.167,1800,79,3,94,1886,33,1831,0,2835,1792,1798
"42924","Ntome_NODE_12549_length_1892_cov_289","Nsylvestris_NODE_12182_length_1849_cov_212",93.607,1752,63,16,51,1789,1779,64,0,2569,1738,1715
"42927","Ntome_NODE_12551_length_1892_cov_200","Nsylvestris_NODE_13928_length_1659_cov_151",95.242,1219,46,5,107,1325,1612,406,0,1919,1218,1206
"42928","Ntome_NODE_12552_length_1892_cov_197","Nsylvestris_NODE_13896_length_1663_cov_125",95.59,1542,54,6,355,1892,1598,67,0,2459,1537,1531
"42935","Ntome_NODE_12555_length_1892_cov_170","Nsylvestris_NODE_8900_length_2263_cov_217",96.212,1188,32,7,150,1333,1,1179,0,1932,1183,1178
"42958","Ntome_NODE_12562_length_1891_cov_296","Nsylvestris_NODE_2080_length_4005_cov_118",93.092,1766,108,9,108,1871,1755,2,0,2573,1763,1753
"42971","Ntome_NODE_12566_length_1883_cov_152","Nsylvestris_NODE_12242_length_1843_cov_36",93.136,1792,100,8,35,1809,1843,58,0,2606,1774,1785
"42982","Ntome_NODE_12570_length_1891_cov_55","Nsylvestris_NODE_12495_length_1816_cov_30",92.923,1837,81,15,44,1864,1804,1,0,2627,1820,1803
"42999","Ntome_NODE_12576_length_1890_cov_99","Nsylvestris_NODE_9516_length_2174_cov_217",96.408,529,16,3,277,803,2126,1599,0,869,526,527
"43018","Ntome_NODE_12581_length_1889_cov_293","Nsylvestris_NODE_12180_length_1849_cov_217",92.5,1840,88,25,41,1860,1810,1,0,2588,1819,1809
"43021","Ntome_NODE_12583_length_1889_cov_245","Nsylvestris_NODE_118_length_8140_cov_221",93.462,1820,69,27,87,1889,1846,60,0,2656,1802,1786
"43035","Ntome_NODE_12588_length_1889_cov_18","Nsylvestris_NODE_11452_length_1936_cov_84",97.799,1545,30,3,346,1889,1887,346,0,2662,1543,1541
"43060","Ntome_NODE_12597_length_1887_cov_47","Nsylvestris_NODE_12434_length_1823_cov_209",90.417,1774,89,37,111,1845,42,1773,0,2259,1734,1731
"43065","Ntome_NODE_12599_length_1887_cov_20","Nsylvestris_NODE_9047_length_2245_cov_74",95.977,1889,72,3,1,1887,2075,189,0,3064,1886,1886
"43086","Ntome_NODE_12607_length_1886_cov_201","Nsylvestris_NODE_1939_length_4092_cov_75",93.822,1829,90,14,3,1814,1823,1,0,2730,1811,1822
"43087","Ntome_NODE_12608_length_1886_cov_29","Nsylvestris_NODE_13265_length_1732_cov_19",94.223,1731,94,4,27,1753,1729,1,0,2638,1726,1728
"43106","Ntome_NODE_12614_length_1885_cov_253","Nsylvestris_NODE_11012_length_1986_cov_181",91.937,1786,113,11,1,1774,1964,198,0,2471,1773,1766
"43154","Ntome_NODE_12630_length_1883_cov_247","Nsylvestris_NODE_14235_length_1625_cov_181",95.421,1354,52,5,310,1654,1487,135,0,2148,1344,1352
"43194","Ntome_NODE_12646_length_1881_cov_238","Nsylvestris_NODE_15993_length_1449_cov_40",76.885,1406,268,41,333,1725,1449,88,0,743,1392,1361
"43208","Ntome_NODE_12653_length_1880_cov_261","Nsylvestris_NODE_625_length_5643_cov_197",94.851,1612,50,11,53,1662,1581,1,0,2486,1609,1580
"43209","Ntome_NODE_12654_length_1880_cov_184","Nsylvestris_NODE_34978_length_296_cov_3",82.282,333,17,5,104,431,296,1,4.51e-65,250,327,295
"43210","Ntome_NODE_12655_length_1880_cov_157","Nsylvestris_NODE_1601_length_4328_cov_227",98.113,53,1,0,1828,1880,1162,1110,8.05e-18,93.5,52,52
"43226","Ntome_NODE_12660_length_1880_cov_30","Nsylvestris_NODE_22258_length_938_cov_206",96.364,55,2,0,1826,1880,511,457,2.89e-17,91.6,54,54
"43227","Ntome_NODE_12661_length_1879_cov_289","Nsylvestris_NODE_9954_length_2121_cov_197",94.827,1875,82,11,7,1868,2015,143,0,2911,1861,1872
"43243","Ntome_NODE_12666_length_1879_cov_65","Nsylvestris_NODE_16182_length_1431_cov_173",97.619,42,1,0,1837,1878,1112,1153,1.05e-11,73.1,41,41
"43276","Ntome_NODE_12681_length_1877_cov_40","Nsylvestris_NODE_11999_length_1870_cov_137",95.213,1713,78,2,1,1713,113,1821,0,2706,1712,1708
"43277","Ntome_NODE_12682_length_1877_cov_36","Nsylvestris_NODE_9691_length_2153_cov_124",94.544,1888,64,9,2,1870,1946,79,0,2880,1868,1867
"43289","Ntome_NODE_12689_length_1875_cov_28","Nsylvestris_NODE_12694_length_1796_cov_79",94.752,1772,78,7,42,1805,19,1783,0,2743,1763,1764
"43312","Ntome_NODE_12696_length_1873_cov_268","Nsylvestris_NODE_12452_length_1821_cov_175",94.289,1716,92,6,24,1736,41,1753,0,2621,1712,1712
"43333","Ntome_NODE_12703_length_1873_cov_61","Nsylvestris_NODE_10343_length_2070_cov_45",96.107,1824,60,5,5,1823,36,1853,0,2964,1818,1817
"43367","Ntome_NODE_12719_length_1871_cov_7","Nsylvestris_NODE_3186_length_3513_cov_129",96.667,60,2,0,2,61,2262,2203,4.78e-20,100,59,59
"43380","Ntome_NODE_12725_length_1870_cov_20","Nsylvestris_NODE_10959_length_1993_cov_86",97.385,1874,43,4,1,1870,1891,20,0,3184,1869,1871
"43386","Ntome_NODE_12728_length_1863_cov_243","Nsylvestris_NODE_10113_length_2101_cov_175",94.481,1540,68,8,21,1544,2086,548,0,2357,1523,1538
"43387","Ntome_NODE_12729_length_1869_cov_236","Nsylvestris_NODE_10780_length_2016_cov_104",93.778,1816,92,12,44,1846,1808,1,0,2708,1802,1807
"43423","Ntome_NODE_12740_length_1868_cov_272","Nsylvestris_NODE_11211_length_1961_cov_220",96.598,1881,42,6,1,1866,88,1961,0,3099,1865,1873
"43428","Ntome_NODE_12743_length_1868_cov_171","Nsylvestris_NODE_11566_length_1922_cov_202",94.872,1677,85,1,89,1765,50,1725,0,2619,1676,1675
"43472","Ntome_NODE_12758_length_1867_cov_31","Nsylvestris_NODE_10879_length_2003_cov_111",96.356,1866,68,0,2,1867,1866,1,0,3070,1865,1865
"43473","Ntome_NODE_12759_length_1866_cov_297","Nsylvestris_NODE_10354_length_2068_cov_218",93.277,1785,77,8,51,1816,1904,144,0,2591,1765,1760
"43478","Ntome_NODE_12761_length_1865_cov_160","Nsylvestris_NODE_10299_length_2075_cov_135",99.223,1030,8,0,1,1030,1177,148,0,1858,1029,1029
"43485","Ntome_NODE_12764_length_1866_cov_101","Nsylvestris_NODE_3233_length_3496_cov_100",96.3,892,32,1,1,891,2462,3353,0,1463,890,891
"43486","Ntome_NODE_12765_length_1866_cov_87","Nsylvestris_NODE_11093_length_1977_cov_102",94.499,1836,75,15,53,1866,47,1878,0,2808,1813,1831
"43487","Ntome_NODE_12766_length_1866_cov_28","Nsylvestris_NODE_13582_length_1698_cov_121",96.063,1651,42,8,221,1866,51,1683,0,2667,1645,1632
"43535","Ntome_NODE_12782_length_1864_cov_233","Nsylvestris_NODE_12450_length_1821_cov_207",94.435,1797,54,12,57,1838,48,1813,0,2723,1781,1765
"43550","Ntome_NODE_12788_length_1864_cov_66","Nsylvestris_NODE_12124_length_1855_cov_42",93.784,1850,85,11,1,1845,28,1852,0,2752,1844,1824
"43562","Ntome_NODE_12792_length_1864_cov_20","Nsylvestris_NODE_30187_length_511_cov_1",87.324,71,8,1,14,84,217,286,6.21e-14,80.5,70,69
"43591","Ntome_NODE_12802_length_1862_cov_61","Nsylvestris_NODE_16096_length_1440_cov_214",94.643,112,6,0,1600,1711,574,463,2.77e-42,174,111,111
"43603","Ntome_NODE_12808_length_1861_cov_102","Nsylvestris_NODE_24195_length_819_cov_63",92.473,465,22,6,58,514,818,359,0,652,456,459
"43604","Ntome_NODE_12809_length_1861_cov_18","Nsylvestris_NODE_4128_length_3194_cov_19",94.737,1862,96,2,1,1861,15,1875,0,2894,1860,1860
"43616","Ntome_NODE_12814_length_1860_cov_81","Nsylvestris_NODE_8759_length_2286_cov_146",95.161,62,3,0,1799,1860,1022,1083,1.71e-19,99,61,61
"43620","Ntome_NODE_12816_length_1859_cov_279","Nsylvestris_NODE_12691_length_1796_cov_225",94.167,1783,82,2,70,1833,3,1782,0,2697,1763,1779
"43633","Ntome_NODE_12821_length_1859_cov_190","Nsylvestris_NODE_10747_length_2020_cov_97",86.306,1884,148,43,1,1829,23,1851,0,1949,1828,1828
"43670","Ntome_NODE_12832_length_1858_cov_263","Nsylvestris_NODE_8999_length_2251_cov_156",93.399,1833,75,11,71,1857,46,1878,0,2673,1786,1832
"43686","Ntome_NODE_12839_length_1857_cov_256","Nsylvestris_NODE_3969_length_3242_cov_229",98.182,55,1,0,1803,1857,2793,2847,6.14e-19,97.1,54,54
"43687","Ntome_NODE_12840_length_1857_cov_235","Nsylvestris_NODE_8665_length_2298_cov_186",96.154,1612,61,1,194,1804,485,2096,0,2632,1610,1611
"43695","Ntome_NODE_12842_length_1857_cov_133","Nsylvestris_NODE_10491_length_2051_cov_179",87.94,937,45,15,199,1102,2005,1104,0,1042,903,901
"43717","Ntome_NODE_12850_length_1856_cov_252","Nsylvestris_NODE_12341_length_1833_cov_213",94.585,1736,71,11,52,1774,1776,51,0,2663,1722,1725
"43739","Ntome_NODE_12858_length_1855_cov_210","Nsylvestris_NODE_4274_length_3157_cov_99",94.513,1385,66,8,52,1432,1407,29,0,2128,1380,1378
"43759","Ntome_NODE_12868_length_1854_cov_191","Nsylvestris_NODE_11865_length_1884_cov_184",96.438,1853,56,6,3,1853,36,1880,0,3048,1850,1844
"43772","Ntome_NODE_12872_length_1854_cov_45","Nsylvestris_NODE_29479_length_564_cov_5",75.918,245,59,0,355,599,281,37,7.82e-28,126,244,244
"43776","Ntome_NODE_12874_length_1854_cov_37","Nsylvestris_NODE_17109_length_1347_cov_220",95.477,199,7,1,1570,1766,199,1,4.32e-85,316,196,198
"43777","Ntome_NODE_12875_length_1854_cov_27","Nsylvestris_NODE_9409_length_2192_cov_85",94.176,1803,70,14,17,1795,2145,354,0,2715,1778,1791
"43784","Ntome_NODE_12878_length_1853_cov_273","Nsylvestris_NODE_12181_length_1849_cov_215",97.221,1691,44,3,46,1734,4,1693,0,2859,1688,1689
"43816","Ntome_NODE_12885_length_1853_cov_99","Nsylvestris_NODE_9168_length_2228_cov_73",97.305,1855,31,10,1,1848,1880,38,0,3131,1847,1842
"43846","Ntome_NODE_12894_length_1852_cov_124","Nsylvestris_NODE_12670_length_1798_cov_231",95.623,1759,58,4,29,1778,20,1768,0,2804,1749,1748
"43853","Ntome_NODE_12898_length_1852_cov_69","Nsylvestris_NODE_18859_length_1196_cov_186",93.784,370,19,1,81,446,1141,772,3.02e-156,553,365,369
"43854","Ntome_NODE_12899_length_1853_cov_68","Nsylvestris_NODE_3133_length_3533_cov_62",90.667,75,6,1,1,75,3460,3533,1.7e-19,99,74,73
"43880","Ntome_NODE_12910_length_1851_cov_165","Nsylvestris_NODE_15790_length_1471_cov_26",93.165,1507,62,16,267,1768,1,1471,0,2174,1501,1470
"43881","Ntome_NODE_12911_length_1851_cov_38","Nsylvestris_NODE_11450_length_1936_cov_113",94.351,1841,97,4,1,1835,1879,40,0,2817,1834,1839
"43896","Ntome_NODE_12917_length_1850_cov_250","Nsylvestris_NODE_16191_length_1430_cov_150",89.494,1028,72,24,592,1602,1244,236,0,1267,1010,1008
"43910","Ntome_NODE_12922_length_1850_cov_20","Nsylvestris_NODE_8559_length_2315_cov_220",80.808,297,55,2,1193,1488,1359,1654,1.61e-59,231,295,295
"43931","Ntome_NODE_12927_length_1849_cov_100","Nsylvestris_NODE_9818_length_2137_cov_207",84.917,1326,185,12,259,1575,458,1777,0,1327,1316,1319
"43938","Ntome_NODE_12930_length_1848_cov_270","Nsylvestris_NODE_13578_length_1698_cov_210",95.139,1687,65,9,135,1810,1,1681,0,2645,1675,1680
"43948","Ntome_NODE_12934_length_1848_cov_158","Nsylvestris_NODE_20_length_11989_cov_112",94.344,1662,81,5,38,1690,47,1704,0,2536,1652,1657
"43954","Ntome_NODE_12938_length_1848_cov_56","Nsylvestris_NODE_17182_length_1342_cov_16",91.818,1320,106,2,433,1750,1342,23,0,1838,1317,1319
"44005","Ntome_NODE_12960_length_1845_cov_237","Nsylvestris_NODE_14890_length_1561_cov_210",93.652,1528,79,9,272,1798,51,1561,0,2268,1526,1510
"44006","Ntome_NODE_12961_length_1845_cov_169","Nsylvestris_NODE_12896_length_1775_cov_133",95.468,1743,65,7,61,1796,34,1769,0,2769,1735,1735
"44045","Ntome_NODE_12974_length_1845_cov_11","Nsylvestris_NODE_14468_length_1603_cov_216",94.363,1561,81,6,41,1600,1555,1,0,2388,1559,1554
"44094","Ntome_NODE_12991_length_1843_cov_179","Nsylvestris_NODE_11293_length_1952_cov_218",93.333,60,4,0,1784,1843,1309,1250,1.02e-16,89.8,59,59
"44105","Ntome_NODE_12995_length_1843_cov_104","Nsylvestris_NODE_10418_length_2060_cov_114",94.89,1683,50,7,177,1841,323,1987,0,2599,1664,1664
"44136","Ntome_NODE_13007_length_1841_cov_265","Nsylvestris_NODE_11928_length_1877_cov_217",95.573,1807,56,12,30,1817,76,1877,0,2872,1787,1801
"44139","Ntome_NODE_13009_length_1841_cov_208","Nsylvestris_NODE_4765_length_3030_cov_150",93.337,1696,78,19,96,1769,14,1696,0,2473,1673,1682
"44178","Ntome_NODE_13021_length_1839_cov_211","Nsylvestris_NODE_9_length_13131_cov_62",93.352,1790,98,7,50,1839,1775,7,0,2627,1789,1768
"44203","Ntome_NODE_13029_length_1839_cov_20","Nsylvestris_NODE_7544_length_2477_cov_179",95.98,1816,68,2,24,1839,2339,529,0,2944,1815,1810
"44217","Ntome_NODE_13034_length_1838_cov_15","Nsylvestris_NODE_11086_length_1978_cov_77",97.594,1704,32,3,140,1837,113,1813,0,2911,1697,1700
"44218","Ntome_NODE_13035_length_1838_cov_12","Nsylvestris_NODE_61_length_9229_cov_221",78.75,560,90,18,259,811,4975,4438,1.52e-94,348,552,537
"44219","Ntome_NODE_13036_length_1837_cov_284","Nsylvestris_NODE_11690_length_1906_cov_228",94.793,1690,81,7,63,1748,1723,37,0,2627,1685,1686
"44220","Ntome_NODE_13037_length_1837_cov_147","Nsylvestris_NODE_8694_length_2295_cov_77",87.126,334,30,5,1078,1410,756,435,4.19e-100,366,332,321
"44235","Ntome_NODE_13043_length_1836_cov_269","Nsylvestris_NODE_13036_length_1759_cov_190",94.503,1619,69,6,1,1617,1601,1,0,2479,1616,1600
"44236","Ntome_NODE_13044_length_1836_cov_268","Nsylvestris_NODE_12442_length_1822_cov_213",94.848,1805,69,15,43,1836,15,1806,0,2796,1793,1791
"44239","Ntome_NODE_13046_length_1836_cov_187","Nsylvestris_NODE_7009_length_2566_cov_155",90.563,1208,92,15,125,1320,2532,1335,0,1580,1195,1197
"44240","Ntome_NODE_13047_length_1836_cov_177","Nsylvestris_NODE_22324_length_933_cov_216",95.884,826,27,5,139,959,59,882,0,1330,820,823
"44248","Ntome_NODE_13050_length_1836_cov_91","Nsylvestris_NODE_36025_length_272_cov_71",94.884,215,10,1,418,632,1,214,1.18e-90,335,214,213
"44277","Ntome_NODE_13061_length_1835_cov_182","Nsylvestris_NODE_1297_length_4596_cov_158",97.321,1456,39,0,1,1456,1456,1,0,2473,1455,1455
"44289","Ntome_NODE_13066_length_1834_cov_295","Nsylvestris_NODE_5567_length_2849_cov_217",97.638,1778,41,1,58,1834,2849,1072,0,3049,1776,1777
"44292","Ntome_NODE_13068_length_1834_cov_263","Nsylvestris_NODE_3006_length_3584_cov_179",96.435,1795,36,11,6,1799,2271,504,0,2935,1793,1767
"44293","Ntome_NODE_13070_length_1834_cov_178","Nsylvestris_NODE_13591_length_1697_cov_220",96.35,1041,27,7,130,1162,1,1038,0,1701,1032,1037
"44307","Ntome_NODE_13074_length_1834_cov_46","Nsylvestris_NODE_12840_length_1782_cov_57",89.878,1640,118,24,8,1640,1773,175,0,2065,1632,1598
"44314","Ntome_NODE_13077_length_1834_cov_8","Nsylvestris_NODE_9928_length_2125_cov_41",97.219,1834,48,1,1,1834,2062,232,0,3101,1833,1830
"44315","Ntome_NODE_13078_length_1833_cov_275","Nsylvestris_NODE_16619_length_1390_cov_11",93.741,1390,81,2,397,1780,1390,1,0,2080,1383,1389
"44328","Ntome_NODE_13082_length_1833_cov_105","Nsylvestris_NODE_2829_length_3648_cov_97",92.536,1755,60,17,63,1792,1709,1,0,2449,1729,1708
"44335","Ntome_NODE_13086_length_1833_cov_14","Nsylvestris_NODE_9793_length_2141_cov_203",98.148,54,1,0,2,55,1827,1774,2.18e-18,95.3,53,53
"44349","Ntome_NODE_13092_length_1832_cov_95","Nsylvestris_NODE_22153_length_945_cov_39",88,350,38,4,682,1029,457,110,1.91e-113,411,347,347
"44357","Ntome_NODE_13095_length_1832_cov_63","Nsylvestris_NODE_9197_length_2224_cov_125",94.079,1807,67,15,2,1790,388,2172,0,2708,1788,1784
"44360","Ntome_NODE_13097_length_1832_cov_13","Nsylvestris_NODE_16886_length_1366_cov_34",94.849,1262,63,2,519,1779,51,1311,0,1969,1260,1260
"44367","Ntome_NODE_13100_length_1831_cov_232","Nsylvestris_NODE_18418_length_1231_cov_29",95.451,1187,46,5,381,1565,51,1231,0,1886,1184,1180
"44382","Ntome_NODE_13106_length_1831_cov_25","Nsylvestris_NODE_4099_length_3203_cov_50",94.194,1843,86,3,1,1825,1934,95,0,2791,1824,1839
"44393","Ntome_NODE_13111_length_1830_cov_180","Nsylvestris_NODE_2615_length_3736_cov_148",93.448,1801,87,7,52,1830,112,1903,0,2643,1778,1791
"44396","Ntome_NODE_13114_length_1830_cov_16","Nsylvestris_NODE_20513_length_1063_cov_220",96.364,55,2,0,1776,1830,671,725,2.82e-17,91.6,54,54
"44403","Ntome_NODE_13117_length_1829_cov_39","Nsylvestris_NODE_7257_length_2525_cov_237",97.872,47,1,0,271,317,2138,2184,1.69e-14,82.4,46,46
"44408","Ntome_NODE_13119_length_1829_cov_30","Nsylvestris_NODE_3981_length_3238_cov_24",92.614,1029,55,6,345,1355,2161,3186,0,1459,1010,1025
"44416","Ntome_NODE_13122_length_1824_cov_291","Nsylvestris_NODE_12396_length_1824_cov_214",95.83,1343,44,2,485,1815,394,1736,0,2159,1330,1342
"44417","Ntome_NODE_13123_length_1828_cov_275","Nsylvestris_NODE_14519_length_1598_cov_111",91.587,1569,78,24,7,1548,1,1542,0,2117,1541,1541
"44418","Ntome_NODE_13124_length_1828_cov_238","Nsylvestris_NODE_10957_length_1993_cov_190",97.475,1822,36,2,1,1812,8,1829,0,3101,1811,1821
"44424","Ntome_NODE_13126_length_1828_cov_233","Nsylvestris_NODE_13421_length_1715_cov_155",96.694,1724,42,11,19,1737,1714,1,0,2854,1718,1713
"44446","Ntome_NODE_13135_length_1827_cov_175","Nsylvestris_NODE_12757_length_1791_cov_70",95.845,1733,60,8,56,1778,61,1791,0,2791,1722,1730
"44461","Ntome_NODE_13139_length_1826_cov_203","Nsylvestris_NODE_10878_length_2003_cov_204",96.653,1733,48,2,52,1783,83,1806,0,2870,1731,1723
"44478","Ntome_NODE_13146_length_1826_cov_21","Nsylvestris_NODE_12768_length_1790_cov_39",94.074,1603,70,2,246,1826,75,1674,0,2410,1580,1599
"44506","Ntome_NODE_13156_length_1824_cov_140","Nsylvestris_NODE_14953_length_1554_cov_222",89.835,787,55,11,938,1724,809,48,0,987,786,761
"44509","Ntome_NODE_13158_length_1824_cov_83","Nsylvestris_NODE_12583_length_1807_cov_36",77.515,1481,292,25,124,1579,67,1531,0,852,1455,1464
"44523","Ntome_NODE_13165_length_1824_cov_17","Nsylvestris_NODE_2360_length_3867_cov_34",94.577,1807,86,4,1,1798,2023,3826,0,2784,1797,1803
"44527","Ntome_NODE_13167_length_1823_cov_201","Nsylvestris_NODE_4328_length_3143_cov_155",94.311,1828,77,8,1,1823,3089,1284,0,2774,1822,1805
"44561","Ntome_NODE_13181_length_1821_cov_260","Nsylvestris_NODE_12564_length_1808_cov_196",96.172,1672,54,7,21,1686,1715,48,0,2724,1665,1667
"44578","Ntome_NODE_13187_length_1821_cov_16","Nsylvestris_NODE_3347_length_3457_cov_20",86.179,123,16,1,423,544,3446,3324,1.65e-29,132,121,122
"44584","Ntome_NODE_13190_length_1821_cov_10","Nsylvestris_NODE_3430_length_3427_cov_114",98.148,54,1,0,2,55,340,287,2.17e-18,95.3,53,53
"44605","Ntome_NODE_13197_length_1820_cov_72","Nsylvestris_NODE_23045_length_888_cov_169",96.569,204,7,0,1617,1820,549,346,9.06e-92,339,203,203
"44618","Ntome_NODE_13203_length_1819_cov_170","Nsylvestris_NODE_14031_length_1646_cov_74",94.589,1534,56,6,175,1683,1560,29,0,2348,1508,1531
"44627","Ntome_NODE_13208_length_1818_cov_253","Nsylvestris_NODE_167_length_7587_cov_166",95.276,1757,61,8,46,1795,5170,3429,0,2765,1749,1741
"44628","Ntome_NODE_13209_length_1818_cov_177","Nsylvestris_NODE_13121_length_1748_cov_183",93.473,1762,62,11,44,1773,1,1741,0,2567,1729,1740
"44633","Ntome_NODE_13212_length_1818_cov_86","Nsylvestris_NODE_12812_length_1785_cov_87",90.006,1721,123,26,44,1730,24,1729,0,2180,1686,1705
"44637","Ntome_NODE_13214_length_1818_cov_30","Nsylvestris_NODE_6893_length_2586_cov_208",100,55,0,0,1764,1818,907,853,1.29e-20,102,54,54
"44641","Ntome_NODE_13216_length_1818_cov_11","Nsylvestris_NODE_12593_length_1806_cov_10",94.553,1487,73,4,39,1523,56,1536,0,2290,1484,1480
"44672","Ntome_NODE_13227_length_1816_cov_286","Nsylvestris_NODE_3732_length_3325_cov_204",95.133,1356,62,2,142,1493,3265,1910,0,2135,1351,1355
"44676","Ntome_NODE_13229_length_1816_cov_263","Nsylvestris_NODE_12263_length_1841_cov_152",95.507,1736,70,5,19,1754,1781,54,0,2767,1735,1727
"44677","Ntome_NODE_13230_length_1816_cov_247","Nsylvestris_NODE_13982_length_1652_cov_147",93.397,1469,73,11,55,1514,1645,192,0,2154,1459,1453
"44687","Ntome_NODE_13234_length_1816_cov_57","Nsylvestris_NODE_1846_length_4151_cov_63",93.746,1663,60,13,161,1816,3985,2360,0,2455,1655,1625
"44692","Ntome_NODE_13236_length_1816_cov_17","Nsylvestris_NODE_195_length_7397_cov_77",79.97,664,97,21,2,633,1531,872,2.39e-127,457,631,659
"44712","Ntome_NODE_13240_length_1815_cov_239","Nsylvestris_NODE_4977_length_2979_cov_209",96.191,1654,57,3,121,1768,2765,1112,0,2700,1647,1653
"44713","Ntome_NODE_13241_length_1815_cov_211","Nsylvestris_NODE_13838_length_1669_cov_195",94.31,1617,72,7,150,1753,1618,9,0,2459,1603,1609
"44739","Ntome_NODE_13249_length_1830_cov_97","Nsylvestris_NODE_13871_length_1666_cov_153",90.991,111,10,0,385,495,1488,1598,4.58e-35,150,110,110
"44742","Ntome_NODE_13251_length_1814_cov_53","Nsylvestris_NODE_12637_length_1802_cov_65",91.881,1675,111,10,7,1657,2,1675,0,2316,1650,1673
"44759","Ntome_NODE_13258_length_1813_cov_98","Nsylvestris_NODE_11449_length_1936_cov_127",95.238,1827,55,17,1,1813,127,1935,0,2863,1812,1808
"44774","Ntome_NODE_13264_length_1812_cov_269","Nsylvestris_NODE_14807_length_1569_cov_31",97.059,34,1,0,1428,1461,330,297,2.83e-07,58.4,33,33
"44823","Ntome_NODE_13278_length_1810_cov_218","Nsylvestris_NODE_5046_length_2961_cov_127",93.723,1386,65,8,138,1520,1352,2718,0,2058,1382,1366
"44871","Ntome_NODE_13294_length_1809_cov_95","Nsylvestris_NODE_2012_length_4045_cov_122",92.5,240,13,4,5,243,2004,2239,9e-92,339,238,235
"44922","Ntome_NODE_13311_length_1807_cov_75","Nsylvestris_NODE_15739_length_1475_cov_165",86.829,782,64,15,133,894,90,852,0,837,761,762
"44923","Ntome_NODE_13312_length_1807_cov_56","Nsylvestris_NODE_19458_length_1148_cov_7",93.49,1152,59,8,227,1367,1148,2,0,1698,1140,1146
"44932","Ntome_NODE_13315_length_1807_cov_29","Nsylvestris_NODE_17499_length_1313_cov_202",98.182,55,1,0,1753,1807,495,441,5.97e-19,97.1,54,54
"44945","Ntome_NODE_13319_length_1806_cov_206","Nsylvestris_NODE_7823_length_2433_cov_150",94.887,1721,75,8,92,1806,2389,676,0,2678,1714,1713
"44949","Ntome_NODE_13321_length_1806_cov_109","Nsylvestris_NODE_13031_length_1760_cov_84",94.959,1726,80,4,60,1785,1724,6,0,2699,1725,1718
"44957","Ntome_NODE_13325_length_1805_cov_254","Nsylvestris_NODE_15627_length_1487_cov_197",96.379,1381,24,7,391,1745,1440,60,0,2250,1354,1380
"44958","Ntome_NODE_13326_length_1805_cov_220","Nsylvestris_NODE_13597_length_1696_cov_198",92.924,1611,78,7,27,1627,1657,73,0,2311,1600,1584
"44994","Ntome_NODE_13336_length_1804_cov_123","Nsylvestris_NODE_19129_length_1173_cov_162",92.336,548,37,4,1222,1767,600,1144,0,774,545,544
"45015","Ntome_NODE_13344_length_1803_cov_198","Nsylvestris_NODE_6429_length_2672_cov_232",96.401,917,33,0,227,1143,2391,1475,0,1511,916,916
"45019","Ntome_NODE_13346_length_1803_cov_125","Nsylvestris_NODE_8003_length_2403_cov_123",94.814,1832,60,12,3,1803,2347,520,0,2824,1800,1827
"45034","Ntome_NODE_13351_length_1802_cov_46","Nsylvestris_NODE_10005_length_2114_cov_217",98.182,55,1,0,1748,1802,557,503,5.96e-19,97.1,54,54
"45035","Ntome_NODE_13352_length_1802_cov_19","Nsylvestris_NODE_2522_length_3782_cov_186",100,55,0,0,1748,1802,1988,1934,1.28e-20,102,54,54
"45042","Ntome_NODE_13356_length_1801_cov_205","Nsylvestris_NODE_13343_length_1724_cov_189",94.718,1098,49,6,44,1136,1631,538,0,1698,1092,1093
"45083","Ntome_NODE_13369_length_1800_cov_266","Nsylvestris_NODE_993_length_4961_cov_158",92.955,1533,53,25,3,1507,61,1566,0,2182,1504,1505
"45105","Ntome_NODE_13376_length_1800_cov_77","Nsylvestris_NODE_8410_length_2339_cov_31",88.214,1103,111,13,610,1705,1681,591,0,1299,1095,1090
"45109","Ntome_NODE_13378_length_1800_cov_34","Nsylvestris_NODE_7957_length_2411_cov_190",93.103,58,1,1,1,55,2224,2167,1.67e-14,82.4,54,57
"45113","Ntome_NODE_13380_length_1800_cov_8","Nsylvestris_NODE_30389_length_495_cov_8",95.152,495,24,0,1090,1584,495,1,0,782,494,494
"45122","Ntome_NODE_13383_length_1799_cov_248","Nsylvestris_NODE_14843_length_1565_cov_186",94.834,1510,64,5,244,1746,1507,5,0,2344,1502,1502
"45148","Ntome_NODE_13392_length_1798_cov_260","Nsylvestris_NODE_5990_length_2762_cov_137",95.566,1308,56,2,62,1368,1263,2569,0,2093,1306,1306
"45161","Ntome_NODE_13395_length_1798_cov_32","Nsylvestris_NODE_26658_length_689_cov_4",89.725,691,64,4,1080,1765,1,689,0,876,685,688
"45162","Ntome_NODE_13396_length_1797_cov_266","Nsylvestris_NODE_12588_length_1806_cov_204",95.057,1740,67,12,58,1790,11,1738,0,2719,1732,1727
"45170","Ntome_NODE_13399_length_1797_cov_37","Nsylvestris_NODE_18313_length_1240_cov_76",86.475,244,17,9,832,1071,543,774,3.33e-66,254,239,231
"45171","Ntome_NODE_13400_length_1796_cov_282","Nsylvestris_NODE_12332_length_1834_cov_51",95.057,1740,77,7,1,1734,1737,1,0,2728,1733,1736
"45194","Ntome_NODE_13407_length_1796_cov_68","Nsylvestris_NODE_16427_length_1407_cov_111",95.337,1351,41,12,2,1334,13,1359,0,2126,1332,1346
"45222","Ntome_NODE_13418_length_1794_cov_174","Nsylvestris_NODE_16423_length_1400_cov_176",90.549,1111,62,26,687,1774,304,1394,0,1430,1087,1090
"45313","Ntome_NODE_13449_length_1791_cov_158","Nsylvestris_NODE_9684_length_2154_cov_107",86.517,1335,97,25,198,1505,817,2095,0,1391,1307,1278
"45331","Ntome_NODE_13456_length_1790_cov_147","Nsylvestris_NODE_20536_length_1062_cov_110",92.52,869,62,1,52,920,1,866,0,1242,868,865
"45339","Ntome_NODE_13459_length_1790_cov_28","Nsylvestris_NODE_26738_length_686_cov_9",91.023,557,38,7,977,1532,1,546,0,741,555,545
"45344","Ntome_NODE_13461_length_1790_cov_13","Nsylvestris_NODE_9591_length_2165_cov_216",95.261,1688,78,2,72,1757,2118,431,0,2673,1685,1687
"45385","Ntome_NODE_13473_length_1789_cov_79","Nsylvestris_NODE_9232_length_2218_cov_109",90.792,1781,87,22,45,1771,461,2218,0,2309,1726,1757
"45392","Ntome_NODE_13477_length_1789_cov_24","Nsylvestris_NODE_31500_length_420_cov_3",95.192,416,20,0,1070,1485,418,3,0,658,415,415
"45397","Ntome_NODE_13480_length_1788_cov_224","Nsylvestris_NODE_12561_length_1808_cov_210",95.655,1749,63,7,36,1782,1808,71,0,2796,1746,1737
"45402","Ntome_NODE_13482_length_1788_cov_140","Nsylvestris_NODE_4675_length_3051_cov_155",86.965,1473,90,33,378,1788,3042,1610,0,1563,1410,1432
"45407","Ntome_NODE_13484_length_1788_cov_114","Nsylvestris_NODE_5038_length_2963_cov_179",97.028,471,14,0,595,1065,2485,2015,0,793,470,470
"45423","Ntome_NODE_13489_length_1788_cov_23","Nsylvestris_NODE_12935_length_1771_cov_17",95.303,1767,73,7,1,1760,1769,6,0,2795,1759,1763
"45437","Ntome_NODE_13493_length_1787_cov_157","Nsylvestris_NODE_12657_length_1800_cov_43",95.221,1632,64,1,28,1645,1,1632,0,2569,1617,1631
"45466","Ntome_NODE_13503_length_1786_cov_31","Nsylvestris_NODE_11787_length_1895_cov_50",94.223,1679,80,5,114,1778,175,1850,0,2547,1664,1675
"45471","Ntome_NODE_13505_length_1785_cov_261","Nsylvestris_NODE_14591_length_1589_cov_215",93.495,1445,63,8,333,1753,1472,35,0,2119,1420,1437
"45472","Ntome_NODE_13506_length_1785_cov_223","Nsylvestris_NODE_16502_length_1399_cov_220",94.436,1312,62,5,34,1334,1361,50,0,2008,1300,1311
"45508","Ntome_NODE_13519_length_1784_cov_171","Nsylvestris_NODE_11562_length_1923_cov_157",93.786,1738,88,12,59,1784,138,1867,0,2593,1725,1729
"45517","Ntome_NODE_13523_length_1784_cov_55","Nsylvestris_NODE_4688_length_3048_cov_106",98.219,393,7,0,1,393,805,413,0,688,392,392
"45523","Ntome_NODE_13526_length_1784_cov_3","Nsylvestris_NODE_7194_length_2536_cov_40",92.999,1814,92,23,1,1784,553,2361,0,2614,1783,1808
"45547","Ntome_NODE_13535_length_1782_cov_267","Nsylvestris_NODE_13495_length_1706_cov_227",92.959,1676,93,19,21,1684,1702,40,0,2418,1663,1662
"45550","Ntome_NODE_13537_length_1782_cov_220","Nsylvestris_NODE_13613_length_1694_cov_209",92.141,1565,87,13,203,1757,1539,1,0,2176,1554,1538
"45585","Ntome_NODE_13551_length_1781_cov_136","Nsylvestris_NODE_16130_length_1437_cov_49",93.372,1388,84,6,33,1413,1,1387,0,2047,1380,1386
"45594","Ntome_NODE_13554_length_1781_cov_83","Nsylvestris_NODE_903_length_5085_cov_225",82.432,74,13,0,1355,1428,4598,4671,1.66e-09,65.8,73,73
"45597","Ntome_NODE_13556_length_1781_cov_31","Nsylvestris_NODE_12556_length_1809_cov_10",92.486,173,11,2,1234,1405,1809,1638,5.52e-64,246,171,171
"45609","Ntome_NODE_13561_length_1781_cov_17","Nsylvestris_NODE_402_length_6268_cov_86",100,29,0,0,181,209,4590,4562,3.59e-06,54.7,28,28
"45671","Ntome_NODE_13578_length_1779_cov_53","Nsylvestris_NODE_16335_length_1416_cov_30",96.229,1379,43,3,62,1440,1416,47,0,2250,1378,1369
"45688","Ntome_NODE_13587_length_1778_cov_16","Nsylvestris_NODE_2223_length_3926_cov_15",82.31,814,124,19,53,854,914,1719,0,688,801,805
"45740","Ntome_NODE_13604_length_1776_cov_225","Nsylvestris_NODE_30428_length_492_cov_10",82.927,82,11,3,254,334,3,82,3.56e-11,71.3,80,79
"45743","Ntome_NODE_13606_length_1776_cov_101","Nsylvestris_NODE_4930_length_2990_cov_162",80.095,422,60,4,1,398,1095,674,6.98e-78,292,397,421
"45747","Ntome_NODE_13608_length_1776_cov_53","Nsylvestris_NODE_13471_length_1710_cov_31",93.658,1703,89,9,20,1718,11,1698,0,2529,1698,1687
"45774","Ntome_NODE_13620_length_1774_cov_274","Nsylvestris_NODE_14107_length_1639_cov_228",93.871,1550,78,10,77,1620,101,1639,0,2320,1543,1538
"45775","Ntome_NODE_13621_length_1774_cov_261","Nsylvestris_NODE_13150_length_1744_cov_132",96.892,1673,50,2,34,1705,1719,48,0,2800,1671,1671
"45798","Ntome_NODE_13629_length_1774_cov_29","Nsylvestris_NODE_13425_length_1715_cov_56",95.263,1731,61,5,36,1761,1715,1,0,2723,1725,1714
"45833","Ntome_NODE_13641_length_1773_cov_90","Nsylvestris_NODE_12169_length_1851_cov_94",92.915,1736,74,12,80,1773,70,1798,0,2479,1693,1728
"45855","Ntome_NODE_13650_length_1772_cov_205","Nsylvestris_NODE_14848_length_1565_cov_36",70.878,1116,226,72,226,1285,1236,164,1.22e-40,169,1059,1072
"45862","Ntome_NODE_13654_length_1772_cov_58","Nsylvestris_NODE_12704_length_1795_cov_65",93.675,1676,67,17,2,1672,103,1744,0,2471,1670,1641
"45867","Ntome_NODE_13656_length_1771_cov_282","Nsylvestris_NODE_9848_length_2134_cov_175",95.054,1678,77,5,50,1722,1927,251,0,2634,1672,1676
"45873","Ntome_NODE_13659_length_1771_cov_175","Nsylvestris_NODE_16202_length_1426_cov_220",95.023,884,42,2,178,1061,37,918,0,1387,883,881
"45886","Ntome_NODE_13663_length_1771_cov_119","Nsylvestris_NODE_13260_length_1732_cov_56",93.038,1738,86,7,42,1750,1,1732,0,2507,1708,1731
"45914","Ntome_NODE_13672_length_1770_cov_103","Nsylvestris_NODE_12185_length_1849_cov_148",92.133,1627,99,14,43,1651,180,1795,0,2268,1608,1615
"45978","Ntome_NODE_13697_length_1768_cov_61","Nsylvestris_NODE_13168_length_1742_cov_81",94.043,1729,67,16,47,1767,1742,42,0,2590,1720,1700
"45979","Ntome_NODE_13698_length_1768_cov_60","Nsylvestris_NODE_8606_length_2308_cov_137",92.727,55,4,0,1714,1768,1717,1771,5.89e-14,80.5,54,54
"45980","Ntome_NODE_13700_length_1768_cov_31","Nsylvestris_NODE_11936_length_1876_cov_219",92.988,1797,81,15,3,1764,66,1852,0,2579,1761,1786
"45981","Ntome_NODE_13701_length_1768_cov_16","Nsylvestris_NODE_3478_length_3408_cov_117",96.86,1720,53,1,1,1719,70,1789,0,2876,1718,1719
"46011","Ntome_NODE_13710_length_1766_cov_288","Nsylvestris_NODE_1775_length_4193_cov_142",94.257,1567,79,5,125,1681,192,1757,0,2385,1556,1565
"46022","Ntome_NODE_13713_length_1766_cov_241","Nsylvestris_NODE_11312_length_1949_cov_222",91.243,1770,102,24,2,1721,42,1808,0,2361,1719,1766
"46023","Ntome_NODE_13714_length_1766_cov_219","Nsylvestris_NODE_13194_length_1739_cov_200",94.975,1592,50,9,45,1632,51,1616,0,2470,1587,1565
"46036","Ntome_NODE_13718_length_1766_cov_14","Nsylvestris_NODE_724_length_5405_cov_32",79.942,344,62,6,3,342,3986,3646,5.48e-64,246,339,340
"46070","Ntome_NODE_13730_length_1765_cov_8","Nsylvestris_NODE_1719_length_4236_cov_78",93.026,1778,106,8,1,1763,2877,1103,0,2580,1762,1774
"46103","Ntome_NODE_13743_length_1763_cov_124","Nsylvestris_NODE_12285_length_1839_cov_136",93.938,1765,72,16,9,1755,92,1839,0,2634,1746,1747
"46108","Ntome_NODE_13747_length_1762_cov_284","Nsylvestris_NODE_5295_length_2905_cov_239",96.453,1466,49,1,1,1463,1399,2864,0,2416,1462,1465
"46136","Ntome_NODE_13759_length_1761_cov_257","Nsylvestris_NODE_13695_length_1685_cov_201",93.709,1685,100,4,82,1761,1685,2,0,2519,1679,1683
"46177","Ntome_NODE_13772_length_1760_cov_168","Nsylvestris_NODE_14618_length_1587_cov_104",94.168,1526,44,13,37,1528,1529,15,0,2283,1491,1514
"46181","Ntome_NODE_13774_length_1760_cov_25","Nsylvestris_NODE_8443_length_2333_cov_229",96.198,1762,45,2,9,1760,2150,401,0,2863,1751,1749
"46190","Ntome_NODE_13779_length_1759_cov_281","Nsylvestris_NODE_11790_length_1894_cov_170",95.202,1459,47,4,50,1489,1634,180,0,2285,1439,1454
"46211","Ntome_NODE_13787_length_1759_cov_45","Nsylvestris_NODE_14157_length_1635_cov_6",84.459,1081,154,10,655,1730,1074,3,0,1053,1075,1071
"46215","Ntome_NODE_13790_length_1759_cov_8","Nsylvestris_NODE_20_length_11989_cov_112",81.618,408,71,4,608,1011,4337,3930,1.13e-90,335,403,407
"46238","Ntome_NODE_13799_length_1758_cov_9","Nsylvestris_NODE_7691_length_2454_cov_166",96.016,1757,70,0,2,1758,496,2252,0,2857,1756,1756
"46243","Ntome_NODE_13801_length_1757_cov_250","Nsylvestris_NODE_12553_length_1809_cov_108",95.238,1743,59,11,16,1756,1804,84,0,2737,1740,1720
"46277","Ntome_NODE_13813_length_1756_cov_161","Nsylvestris_NODE_413_length_6230_cov_183",94.776,268,13,1,860,1127,4976,4710,3.92e-115,416,267,266
"46309","Ntome_NODE_13825_length_1755_cov_175","Nsylvestris_NODE_5852_length_2791_cov_125",92.935,1642,82,13,1,1621,1161,2789,0,2359,1620,1628
"46339","Ntome_NODE_13836_length_1753_cov_279","Nsylvestris_NODE_10875_length_2003_cov_214",95.702,1559,61,4,73,1628,105,1660,0,2503,1555,1555
"46354","Ntome_NODE_13845_length_1752_cov_77","Nsylvestris_NODE_18001_length_1268_cov_191",94.434,1114,43,2,249,1344,81,1193,0,1696,1095,1112
"46377","Ntome_NODE_13852_length_1751_cov_51","Nsylvestris_NODE_13828_length_1671_cov_19",93.04,1566,87,12,62,1627,1671,128,0,2268,1565,1543
"46404","Ntome_NODE_13862_length_1750_cov_23","Nsylvestris_NODE_35894_length_275_cov_5",90.391,281,19,4,472,751,1,274,5.16e-99,363,279,273
"46444","Ntome_NODE_13877_length_1748_cov_150","Nsylvestris_NODE_1574_length_4348_cov_159",96.049,1544,49,5,13,1545,4347,2805,0,2503,1532,1542
"46487","Ntome_NODE_13895_length_1747_cov_6","Nsylvestris_NODE_4682_length_3050_cov_58",95.731,1663,71,0,1,1663,1077,2739,0,2678,1662,1662
"46491","Ntome_NODE_13897_length_1746_cov_271","Nsylvestris_NODE_13866_length_1666_cov_215",94.981,1554,62,8,32,1575,1666,119,0,2423,1543,1547
"46518","Ntome_NODE_13906_length_1746_cov_260","Nsylvestris_NODE_13288_length_1729_cov_210",95.828,1606,53,5,47,1650,1599,6,0,2582,1603,1593
"46554","Ntome_NODE_13918_length_1745_cov_18","Nsylvestris_NODE_8772_length_2284_cov_101",95.528,1744,68,4,3,1745,2166,432,0,2780,1742,1734
"46555","Ntome_NODE_13919_length_1744_cov_281","Nsylvestris_NODE_12672_length_1798_cov_224",95.033,1671,74,5,9,1678,9,1671,0,2617,1669,1662
"46584","Ntome_NODE_13928_length_1744_cov_92","Nsylvestris_NODE_4021_length_3227_cov_68",94.509,601,31,2,967,1566,2339,2938,0,926,599,599
"46594","Ntome_NODE_13931_length_1744_cov_24","Nsylvestris_NODE_13852_length_1668_cov_131",96.072,1604,62,1,105,1708,1633,31,0,2612,1603,1602
"46595","Ntome_NODE_13932_length_1744_cov_12","Nsylvestris_NODE_12728_length_1793_cov_28",94.959,1468,55,12,30,1488,1793,336,0,2283,1458,1457
"46618","Ntome_NODE_13942_length_1743_cov_64","Nsylvestris_NODE_7577_length_2473_cov_107",96.025,1283,51,0,365,1647,1835,553,0,2087,1282,1282
"46641","Ntome_NODE_13952_length_1742_cov_17","Nsylvestris_NODE_10208_length_2087_cov_164",85.714,77,11,0,349,425,1163,1239,1.61e-14,82.4,76,76
"46650","Ntome_NODE_13955_length_1741_cov_198","Nsylvestris_NODE_16454_length_1404_cov_199",95.552,1349,42,11,24,1363,59,1398,0,2143,1339,1339
"46665","Ntome_NODE_13960_length_1741_cov_86","Nsylvestris_NODE_796_length_5248_cov_145",90.191,1784,108,36,1,1732,3480,5248,0,2263,1731,1768
"46671","Ntome_NODE_13963_length_1741_cov_25","Nsylvestris_NODE_16485_length_1401_cov_58",96.53,1412,33,3,207,1618,6,1401,0,2322,1411,1395
"46713","Ntome_NODE_13979_length_1740_cov_117","Nsylvestris_NODE_2846_length_3639_cov_167",88.48,408,42,5,579,982,2572,2978,8.12e-137,488,403,406
"46723","Ntome_NODE_13984_length_1740_cov_61","Nsylvestris_NODE_13530_length_1702_cov_114",92.818,1086,51,5,117,1202,1570,512,0,1548,1085,1058
"46759","Ntome_NODE_13995_length_1738_cov_238","Nsylvestris_NODE_11175_length_1965_cov_209",96.667,1650,47,3,51,1693,1703,55,0,2736,1642,1648
"46771","Ntome_NODE_14000_length_1738_cov_28","Nsylvestris_NODE_14152_length_1635_cov_101",93.491,1521,67,14,87,1596,1546,47,0,2231,1509,1499
"46772","Ntome_NODE_14001_length_1738_cov_17","Nsylvestris_NODE_7993_length_2405_cov_45",97.296,1738,42,4,1,1735,296,2031,0,2944,1734,1735
"46792","Ntome_NODE_14008_length_1737_cov_36","Nsylvestris_NODE_13071_length_1755_cov_71",94.256,1654,86,5,21,1666,51,1703,0,2519,1645,1652
"46796","Ntome_NODE_14010_length_1737_cov_12","Nsylvestris_NODE_19906_length_1110_cov_14",89.655,290,20,5,1457,1737,985,697,1.84e-98,361,280,288
"46808","Ntome_NODE_14016_length_1736_cov_237","Nsylvestris_NODE_14080_length_1642_cov_90",94.567,1546,66,7,181,1717,1538,2,0,2374,1536,1536
"46809","Ntome_NODE_14017_length_1736_cov_126","Nsylvestris_NODE_13041_length_1759_cov_75",93.192,1601,76,17,71,1657,1759,178,0,2322,1586,1581
"46816","Ntome_NODE_14020_length_1735_cov_267","Nsylvestris_NODE_1318_length_4579_cov_220",92.303,1572,79,22,2,1560,141,1683,0,2194,1558,1542
"46835","Ntome_NODE_14029_length_1735_cov_68","Nsylvestris_NODE_3203_length_3505_cov_222",96.61,59,1,1,1677,1735,2287,2230,5.73e-19,97.1,58,57
"46836","Ntome_NODE_14030_length_1734_cov_56","Nsylvestris_NODE_1845_length_4151_cov_80",90.919,936,41,9,791,1691,4151,3225,0,1218,900,926
"46850","Ntome_NODE_14036_length_1734_cov_286","Nsylvestris_NODE_7653_length_2461_cov_225",90.451,1686,123,17,21,1680,778,2451,0,2187,1659,1673
"46863","Ntome_NODE_14041_length_1734_cov_30","Nsylvestris_NODE_12973_length_1766_cov_23",91.429,105,6,3,1628,1729,1529,1425,2.61e-32,141,101,104
"46864","Ntome_NODE_14042_length_1734_cov_9","Nsylvestris_NODE_8608_length_2308_cov_49",91.806,1672,132,3,4,1671,501,2171,0,2324,1667,1670
"46894","Ntome_NODE_14052_length_1732_cov_253","Nsylvestris_NODE_14337_length_1616_cov_205",93.408,1608,74,17,94,1679,13,1610,0,2353,1585,1597
"46895","Ntome_NODE_14054_length_1732_cov_129","Nsylvestris_NODE_22664_length_911_cov_227",87.172,343,41,1,3,342,510,852,3.03e-106,387,339,342
"46913","Ntome_NODE_14060_length_1732_cov_39","Nsylvestris_NODE_22815_length_902_cov_6",86.916,107,8,5,489,593,766,664,1.58e-24,115,104,102
"46937","Ntome_NODE_14069_length_1731_cov_27","Nsylvestris_NODE_3815_length_3296_cov_72",83.684,190,23,6,1087,1270,2136,1949,9.24e-42,172,183,187
"46952","Ntome_NODE_14074_length_1730_cov_46","Nsylvestris_NODE_9433_length_2188_cov_58",96.241,1676,63,0,1,1676,2186,511,0,2747,1675,1675
"46973","Ntome_NODE_14082_length_1729_cov_73","Nsylvestris_NODE_13824_length_1670_cov_81",94.669,1557,65,4,24,1564,1659,105,0,2399,1540,1554
"46987","Ntome_NODE_14088_length_1728_cov_264","Nsylvestris_NODE_6102_length_2736_cov_231",93.377,1510,81,9,52,1555,2736,1240,0,2217,1503,1496
"46993","Ntome_NODE_14090_length_1728_cov_252","Nsylvestris_NODE_10675_length_2029_cov_91",92.221,1247,59,13,87,1315,1874,648,0,1731,1228,1226
"47008","Ntome_NODE_14097_length_1731_cov_5","Nsylvestris_NODE_10091_length_2104_cov_71",95.168,1573,75,1,152,1724,2103,532,0,2483,1572,1571
"47015","Ntome_NODE_14100_length_1727_cov_242","Nsylvestris_NODE_15669_length_1483_cov_174",95.455,1188,54,0,237,1424,219,1406,0,1895,1187,1187
"47019","Ntome_NODE_14102_length_1727_cov_101","Nsylvestris_NODE_11671_length_1908_cov_160",93.008,1559,83,12,44,1595,324,1863,0,2252,1551,1539
"47020","Ntome_NODE_14103_length_1727_cov_59","Nsylvestris_NODE_16281_length_1421_cov_198",95.064,547,21,4,1128,1669,546,1,0,856,541,545
"47028","Ntome_NODE_14107_length_1726_cov_196","Nsylvestris_NODE_15068_length_1544_cov_223",94.367,1509,59,12,25,1519,1544,48,0,2292,1494,1496
"47031","Ntome_NODE_14109_length_1726_cov_146","Nsylvestris_NODE_6221_length_2712_cov_12",82.152,790,137,4,86,875,153,938,0,675,789,785
"47034","Ntome_NODE_14111_length_1726_cov_29","Nsylvestris_NODE_93_length_8521_cov_68",87.018,855,93,5,98,934,6933,7787,0,948,836,854
"47045","Ntome_NODE_14115_length_1725_cov_207","Nsylvestris_NODE_13473_length_1708_cov_222",95.335,1672,60,4,47,1703,1673,5,0,2639,1656,1668
"47046","Ntome_NODE_14116_length_1725_cov_179","Nsylvestris_NODE_13166_length_1742_cov_104",94.205,1691,72,8,50,1725,1692,13,0,2556,1675,1679
"47062","Ntome_NODE_14123_length_1725_cov_85","Nsylvestris_NODE_11198_length_1966_cov_101",93.621,1599,66,10,143,1725,295,1873,0,2355,1582,1578
"47067","Ntome_NODE_14128_length_1724_cov_261","Nsylvestris_NODE_15146_length_1535_cov_108",93.815,1245,65,4,129,1365,1284,44,0,1862,1236,1240
"47074","Ntome_NODE_14131_length_1724_cov_116","Nsylvestris_NODE_24167_length_823_cov_5",83.165,297,40,10,1433,1724,519,810,5.31e-69,263,291,291
"47082","Ntome_NODE_14134_length_1724_cov_46","Nsylvestris_NODE_3908_length_3265_cov_163",88,200,12,4,22,219,3238,3049,6.96e-58,226,197,189
"47119","Ntome_NODE_14145_length_1722_cov_197","Nsylvestris_NODE_15439_length_1509_cov_46",95.19,1476,45,8,149,1606,1469,2,0,2309,1457,1467
"47138","Ntome_NODE_14152_length_1721_cov_176","Nsylvestris_NODE_12821_length_1784_cov_128",93.382,1511,67,13,212,1715,1525,41,0,2206,1503,1484
"47150","Ntome_NODE_14157_length_1721_cov_81","Nsylvestris_NODE_13026_length_1760_cov_155",93.503,1693,73,12,8,1687,92,1760,0,2483,1679,1668
"47154","Ntome_NODE_14159_length_1720_cov_309","Nsylvestris_NODE_309_length_6686_cov_229",98.43,1720,27,0,1,1720,1585,3304,0,3027,1719,1719
"47179","Ntome_NODE_14166_length_1720_cov_37","Nsylvestris_NODE_35321_length_288_cov_3",83.505,97,14,2,1287,1382,103,8,9.51e-17,89.8,95,95
"47184","Ntome_NODE_14168_length_1720_cov_11","Nsylvestris_NODE_10360_length_2068_cov_73",95.644,1538,67,0,103,1640,1856,319,0,2470,1537,1537
"47187","Ntome_NODE_14170_length_1719_cov_258","Nsylvestris_NODE_14990_length_1551_cov_194",92.388,1537,58,12,53,1538,1529,1,0,2135,1485,1528
"47233","Ntome_NODE_14185_length_1716_cov_284","Nsylvestris_NODE_13878_length_1665_cov_213",93.548,1643,86,7,25,1652,28,1665,0,2429,1627,1637
"47236","Ntome_NODE_14187_length_1716_cov_262","Nsylvestris_NODE_10586_length_2039_cov_184",94.626,1284,63,1,55,1338,716,1993,0,1984,1283,1277
"47237","Ntome_NODE_14188_length_1716_cov_253","Nsylvestris_NODE_15007_length_1549_cov_157",95.521,1429,50,7,137,1564,86,1501,0,2272,1427,1415
"47246","Ntome_NODE_14192_length_1716_cov_56","Nsylvestris_NODE_10790_length_2015_cov_66",83.394,1367,214,11,38,1395,1983,621,0,1254,1357,1362
"47249","Ntome_NODE_14194_length_1716_cov_14","Nsylvestris_NODE_13412_length_1716_cov_23",94.391,1676,77,4,49,1707,8,1683,0,2558,1658,1675
"47270","Ntome_NODE_14202_length_1715_cov_94","Nsylvestris_NODE_3636_length_3354_cov_188",93.548,465,29,1,1101,1565,2554,2091,0,691,464,463
"47296","Ntome_NODE_14213_length_1714_cov_143","Nsylvestris_NODE_11270_length_1955_cov_54",94.128,1686,76,6,28,1713,89,1751,0,2543,1685,1662
"47312","Ntome_NODE_14218_length_1714_cov_24","Nsylvestris_NODE_14858_length_1564_cov_170",98.182,55,1,0,1,55,785,839,5.66e-19,97.1,54,54
"47336","Ntome_NODE_14227_length_1712_cov_267","Nsylvestris_NODE_12649_length_1800_cov_203",96.776,1706,40,9,1,1694,46,1748,0,2832,1693,1702
"47355","Ntome_NODE_14234_length_1711_cov_276","Nsylvestris_NODE_14524_length_1597_cov_224",95.551,1506,54,9,1,1494,21,1525,0,2398,1493,1504
"47376","Ntome_NODE_14240_length_1711_cov_54","Nsylvestris_NODE_11919_length_1878_cov_150",100,32,0,0,1,32,479,448,7.42e-08,60.2,31,31
"47398","Ntome_NODE_14248_length_1710_cov_235","Nsylvestris_NODE_14521_length_1598_cov_93",95.215,1442,69,0,269,1710,50,1491,0,2281,1441,1441
"47412","Ntome_NODE_14254_length_1710_cov_8","Nsylvestris_NODE_7083_length_2556_cov_56",75.458,1475,290,46,2,1464,1114,2528,0,652,1462,1414
"47430","Ntome_NODE_14260_length_1709_cov_267","Nsylvestris_NODE_10786_length_2015_cov_216",92.166,1353,80,15,88,1428,1978,640,0,1888,1340,1338
"47431","Ntome_NODE_14261_length_1709_cov_223","Nsylvestris_NODE_9015_length_2249_cov_160",92.641,1685,84,15,32,1709,125,1776,0,2388,1677,1651
"47456","Ntome_NODE_14268_length_1709_cov_15","Nsylvestris_NODE_15953_length_1454_cov_218",86.648,704,79,8,891,1584,661,1359,0,765,693,698
"47457","Ntome_NODE_14269_length_1709_cov_10","Nsylvestris_NODE_3797_length_3301_cov_51",94.952,1684,68,11,1,1682,2807,1139,0,2623,1681,1668
"47484","Ntome_NODE_14278_length_1708_cov_25","Nsylvestris_NODE_13760_length_1678_cov_48",96.344,1641,52,7,41,1679,1653,19,0,2691,1638,1634
"47505","Ntome_NODE_14285_length_1707_cov_15","Nsylvestris_NODE_12539_length_1811_cov_25",94.799,1596,57,4,102,1681,1646,61,0,2464,1579,1585
"47540","Ntome_NODE_14300_length_1705_cov_97","Nsylvestris_NODE_13625_length_1693_cov_19",96.484,1621,53,1,20,1640,1617,1,0,2675,1620,1616
"47541","Ntome_NODE_14302_length_1705_cov_37","Nsylvestris_NODE_8041_length_2396_cov_234",82.775,1492,236,8,199,1673,608,2095,0,1312,1474,1487
"47542","Ntome_NODE_14303_length_1704_cov_294","Nsylvestris_NODE_2989_length_3592_cov_160",93.777,1398,80,3,75,1471,1,1392,0,2093,1396,1391
"47575","Ntome_NODE_14316_length_1703_cov_224","Nsylvestris_NODE_144_length_7837_cov_109",97.25,1673,27,2,50,1703,7755,6083,0,2817,1653,1672
"47584","Ntome_NODE_14320_length_1703_cov_115","Nsylvestris_NODE_14286_length_1621_cov_213",94.627,1433,55,12,49,1461,1583,153,0,2200,1412,1430
"47605","Ntome_NODE_14328_length_1702_cov_34","Nsylvestris_NODE_15504_length_1502_cov_19",92.039,1231,52,12,239,1450,299,1502,0,1688,1211,1203
"47621","Ntome_NODE_14334_length_1701_cov_267","Nsylvestris_NODE_13531_length_1703_cov_88",95.674,1618,55,4,2,1604,31,1648,0,2586,1602,1617
"47656","Ntome_NODE_14347_length_1700_cov_301","Nsylvestris_NODE_11213_length_1961_cov_164",97.095,1618,32,5,42,1654,265,1872,0,2713,1612,1607
"47669","Ntome_NODE_14351_length_1700_cov_90","Nsylvestris_NODE_15042_length_1547_cov_28",95.346,1504,66,1,155,1658,1,1500,0,2386,1503,1499
"47675","Ntome_NODE_14353_length_1699_cov_306","Nsylvestris_NODE_224_length_7162_cov_204",95.652,1702,71,1,1,1699,4170,5871,0,2730,1698,1701
"47686","Ntome_NODE_14358_length_1699_cov_220","Nsylvestris_NODE_8642_length_2302_cov_199",95.805,1597,43,5,1,1576,1680,87,0,2556,1575,1593
"47718","Ntome_NODE_14371_length_1698_cov_212","Nsylvestris_NODE_13247_length_1734_cov_195",97.55,1592,38,1,2,1592,107,1698,0,2723,1590,1591
"47724","Ntome_NODE_14374_length_1698_cov_100","Nsylvestris_NODE_6761_length_2611_cov_169",94.745,1256,66,0,3,1258,2587,1332,0,1954,1255,1255
"47725","Ntome_NODE_14375_length_1678_cov_88","Nsylvestris_NODE_11835_length_1888_cov_80",95.55,1528,67,1,21,1548,313,1839,0,2444,1527,1526
"47742","Ntome_NODE_14380_length_1697_cov_285","Nsylvestris_NODE_13648_length_1690_cov_224",93.941,1502,57,22,109,1591,1531,45,0,2239,1482,1486
"47746","Ntome_NODE_14382_length_1697_cov_158","Nsylvestris_NODE_15453_length_1507_cov_80",90.082,1472,93,33,59,1498,10,1460,0,1860,1439,1450
"47747","Ntome_NODE_14383_length_1697_cov_133","Nsylvestris_NODE_13322_length_1726_cov_174",94.504,1692,62,18,1,1685,23,1690,0,2580,1684,1667
"47767","Ntome_NODE_14391_length_1696_cov_299","Nsylvestris_NODE_1419_length_4479_cov_206",96.23,1671,35,8,1,1645,1727,59,0,2712,1644,1668
"47811","Ntome_NODE_14405_length_1695_cov_27","Nsylvestris_NODE_15818_length_1467_cov_168",98.182,55,1,0,1,55,414,468,5.6e-19,97.1,54,54
"47815","Ntome_NODE_14408_length_1694_cov_250","Nsylvestris_NODE_13557_length_1700_cov_127",92.183,1663,79,27,1,1620,46,1700,0,2303,1619,1654
"47841","Ntome_NODE_14415_length_1708_cov_98","Nsylvestris_NODE_20566_length_1060_cov_18",81.301,246,42,4,892,1134,647,403,5.41e-49,196,242,244
"47864","Ntome_NODE_14423_length_1693_cov_170","Nsylvestris_NODE_15430_length_1510_cov_34",93.329,1514,85,10,183,1693,1,1501,0,2222,1510,1500
"47867","Ntome_NODE_14425_length_1693_cov_108","Nsylvestris_NODE_11472_length_1933_cov_198",88.983,236,11,1,1284,1504,1102,867,1.86e-73,278,220,235
"47879","Ntome_NODE_14431_length_1692_cov_258","Nsylvestris_NODE_15216_length_1530_cov_79",93.759,1362,68,10,71,1422,1528,174,0,2028,1351,1354
"47882","Ntome_NODE_14433_length_1692_cov_151","Nsylvestris_NODE_12274_length_1840_cov_96",79.379,354,51,15,555,905,1208,874,5.28e-59,230,350,334
"47908","Ntome_NODE_14441_length_1692_cov_33","Nsylvestris_NODE_10568_length_2041_cov_183",96.364,55,2,0,1,55,657,711,2.6e-17,91.6,54,54
"47921","Ntome_NODE_14445_length_1691_cov_213","Nsylvestris_NODE_12514_length_1813_cov_183",94.338,1678,47,20,20,1686,1730,90,0,2529,1666,1640
"47922","Ntome_NODE_14446_length_1691_cov_71","Nsylvestris_NODE_15229_length_1529_cov_47",92.199,1487,79,12,66,1542,1529,70,0,2069,1476,1459
"47928","Ntome_NODE_14449_length_1691_cov_13","Nsylvestris_NODE_12205_length_1848_cov_27",93.704,1636,75,12,61,1691,1688,76,0,2425,1630,1612
"47929","Ntome_NODE_14450_length_1691_cov_10","Nsylvestris_NODE_32293_length_382_cov_2",83.267,251,40,2,1157,1405,1,251,5.28e-59,230,248,250
"47955","Ntome_NODE_14458_length_1690_cov_41","Nsylvestris_NODE_12463_length_1820_cov_125",96.816,1476,38,1,78,1544,1668,193,0,2457,1466,1475
"47965","Ntome_NODE_14462_length_1690_cov_14","Nsylvestris_NODE_3672_length_3344_cov_83",93.878,49,2,1,824,871,1158,1110,9.41e-12,73.1,47,48
"47973","Ntome_NODE_14466_length_1689_cov_205","Nsylvestris_NODE_14328_length_1618_cov_222",90.869,1599,96,22,51,1609,1597,9,0,2098,1558,1588
"47987","Ntome_NODE_14471_length_1688_cov_142","Nsylvestris_NODE_13084_length_1752_cov_195",87.117,784,61,10,36,800,1672,910,0,852,764,762
"47996","Ntome_NODE_14475_length_1688_cov_25","Nsylvestris_NODE_10201_length_2088_cov_18",97.532,1661,41,0,1,1661,2069,409,0,2841,1660,1660
"48016","Ntome_NODE_14483_length_1687_cov_178","Nsylvestris_NODE_13725_length_1682_cov_161",95.487,1551,49,8,93,1637,1640,105,0,2457,1544,1535
"48021","Ntome_NODE_14485_length_1687_cov_112","Nsylvestris_NODE_1082_length_4837_cov_42",88.513,1715,103,37,1,1687,46,1694,0,1989,1686,1648
"48028","Ntome_NODE_14488_length_1687_cov_36","Nsylvestris_NODE_34094_length_319_cov_5",85.714,182,20,2,420,601,97,272,3.21e-46,187,181,175
"48055","Ntome_NODE_14497_length_1686_cov_52","Nsylvestris_NODE_233_length_7091_cov_109",94.071,506,17,5,52,557,7034,6542,0,756,505,492
"48063","Ntome_NODE_14501_length_1685_cov_223","Nsylvestris_NODE_14673_length_1581_cov_219",95.691,1555,47,13,92,1644,28,1564,0,2483,1552,1536
"48079","Ntome_NODE_14506_length_1685_cov_92","Nsylvestris_NODE_15257_length_1526_cov_17",93.198,1529,75,11,90,1610,1526,19,0,2220,1520,1507
"48088","Ntome_NODE_14513_length_1684_cov_165","Nsylvestris_NODE_13323_length_1726_cov_128",93.357,1656,63,7,1,1628,10,1646,0,2405,1627,1636
"48096","Ntome_NODE_14517_length_1684_cov_14","Nsylvestris_NODE_11384_length_1944_cov_37",95.29,1571,72,1,1,1569,282,1852,0,2490,1568,1570
"48097","Ntome_NODE_14518_length_1683_cov_287","Nsylvestris_NODE_9702_length_2152_cov_166",94.793,1594,71,10,10,1599,1586,1,0,2473,1589,1585
"48104","Ntome_NODE_14521_length_1683_cov_267","Nsylvestris_NODE_13600_length_1696_cov_58",91.873,1575,82,20,137,1681,1695,137,0,2158,1544,1558
"48110","Ntome_NODE_14524_length_1683_cov_101","Nsylvestris_NODE_5286_length_2908_cov_72",94.286,1330,58,11,25,1350,2832,1517,0,2019,1325,1315
"48114","Ntome_NODE_14526_length_1683_cov_35","Nsylvestris_NODE_10674_length_2029_cov_146",80.344,524,92,7,597,1113,776,1295,2.95e-106,387,516,519
"48118","Ntome_NODE_14528_length_1682_cov_261","Nsylvestris_NODE_783_length_5263_cov_121",95.957,1682,53,4,1,1682,2803,4469,0,2715,1681,1666
"48146","Ntome_NODE_14535_length_1682_cov_58","Nsylvestris_NODE_15521_length_1500_cov_42",94.481,1504,76,3,66,1567,1,1499,0,2311,1501,1498
"48150","Ntome_NODE_14537_length_1681_cov_224","Nsylvestris_NODE_14486_length_1601_cov_215",94.179,1529,68,11,156,1678,1530,17,0,2311,1522,1513
"48151","Ntome_NODE_14538_length_1681_cov_77","Nsylvestris_NODE_18013_length_1267_cov_12",95.543,1279,45,4,348,1626,1267,1,0,2036,1278,1266
"48152","Ntome_NODE_14539_length_1681_cov_67","Nsylvestris_NODE_10109_length_2102_cov_60",95.234,1301,54,6,3,1298,9,1306,0,2052,1295,1297
"48171","Ntome_NODE_14545_length_1680_cov_244","Nsylvestris_NODE_14288_length_1621_cov_200",92.984,1639,75,14,35,1667,1615,11,0,2353,1632,1604
"48172","Ntome_NODE_14546_length_1680_cov_238","Nsylvestris_NODE_13808_length_1672_cov_194",95.558,1621,56,9,22,1640,1672,66,0,2580,1618,1606
"48173","Ntome_NODE_14547_length_1680_cov_232","Nsylvestris_NODE_15309_length_1520_cov_208",96.429,1344,45,1,180,1520,147,1490,0,2213,1340,1343
"48181","Ntome_NODE_14550_length_1680_cov_168","Nsylvestris_NODE_7171_length_2539_cov_127",93.287,1579,103,1,2,1580,1626,51,0,2326,1578,1575
"48193","Ntome_NODE_14555_length_1679_cov_278","Nsylvestris_NODE_12660_length_1799_cov_217",93.684,1599,62,18,46,1633,1620,50,0,2357,1587,1570
"48196","Ntome_NODE_14557_length_1679_cov_236","Nsylvestris_NODE_13566_length_1699_cov_193",95.684,1622,58,6,48,1665,1623,10,0,2597,1617,1613
"48206","Ntome_NODE_14561_length_1679_cov_132","Nsylvestris_NODE_13078_length_1753_cov_147",96.075,1325,45,6,340,1658,390,1713,0,2152,1318,1323
"48207","Ntome_NODE_14562_length_1679_cov_131","Nsylvestris_NODE_18199_length_1250_cov_172",95.725,959,22,7,128,1078,34,981,0,1526,950,947
"48210","Ntome_NODE_14564_length_1679_cov_47","Nsylvestris_NODE_14307_length_1620_cov_92",87.296,1472,101,25,202,1640,1453,35,0,1604,1438,1418
"48213","Ntome_NODE_14566_length_1678_cov_270","Nsylvestris_NODE_7851_length_2428_cov_178",94.823,1526,68,5,46,1568,2388,871,0,2370,1522,1517
"48219","Ntome_NODE_14569_length_1678_cov_224","Nsylvestris_NODE_13683_length_1687_cov_178",92.916,1567,74,24,3,1558,144,1684,0,2244,1555,1540
"48224","Ntome_NODE_14571_length_1678_cov_221","Nsylvestris_NODE_12737_length_1792_cov_177",91.393,1615,101,20,84,1678,1714,118,0,2178,1594,1596
"48225","Ntome_NODE_14572_length_1678_cov_181","Nsylvestris_NODE_15145_length_1535_cov_165",96.638,1398,39,4,184,1580,87,1477,0,2314,1396,1390
"48226","Ntome_NODE_14573_length_1678_cov_129","Nsylvestris_NODE_14487_length_1601_cov_157",94.788,1439,44,8,52,1485,1447,35,0,2213,1433,1412
"48234","Ntome_NODE_14577_length_1678_cov_32","Nsylvestris_NODE_10564_length_2042_cov_28",93.379,1601,79,18,46,1632,390,1977,0,2344,1586,1587
"48257","Ntome_NODE_14586_length_1677_cov_114","Nsylvestris_NODE_14105_length_1640_cov_14",95.537,1053,40,3,225,1274,1147,99,0,1677,1049,1048
"48262","Ntome_NODE_14588_length_1677_cov_47","Nsylvestris_NODE_14197_length_1630_cov_30",93.719,1608,94,6,69,1675,1628,27,0,2403,1606,1601
"48267","Ntome_NODE_14590_length_1676_cov_281","Nsylvestris_NODE_6259_length_2705_cov_157",98.082,1460,25,1,1,1460,1598,142,0,2538,1459,1456
"48270","Ntome_NODE_14592_length_1676_cov_260","Nsylvestris_NODE_13738_length_1680_cov_215",94.059,1515,85,3,162,1676,85,1594,0,2294,1514,1509
"48300","Ntome_NODE_14601_length_1676_cov_74","Nsylvestris_NODE_2392_length_3845_cov_37",95.567,1173,52,0,306,1478,1331,2503,0,1879,1172,1172
"48303","Ntome_NODE_14603_length_1676_cov_71","Nsylvestris_NODE_6077_length_2742_cov_185",98.182,55,1,0,1622,1676,784,838,5.54e-19,97.1,54,54
"48306","Ntome_NODE_14605_length_1676_cov_50","Nsylvestris_NODE_12607_length_1804_cov_148",95.183,1557,64,6,11,1560,42,1594,0,2449,1549,1552
"48310","Ntome_NODE_14607_length_1675_cov_310","Nsylvestris_NODE_5387_length_2889_cov_192",100,54,0,0,1,54,1885,1832,4.28e-20,100,53,53
"48315","Ntome_NODE_14609_length_1675_cov_266","Nsylvestris_NODE_1899_length_4115_cov_189",91.048,1631,93,19,1,1598,1668,58,0,2154,1597,1610
"48353","Ntome_NODE_14621_length_1674_cov_264","Nsylvestris_NODE_6075_length_2743_cov_113",95.154,1300,55,5,272,1571,1402,2693,0,2045,1299,1291
"48360","Ntome_NODE_14624_length_1674_cov_177","Nsylvestris_NODE_2884_length_3627_cov_209",93.648,1291,70,8,190,1474,1431,147,0,1919,1284,1284
"48363","Ntome_NODE_14626_length_1674_cov_79","Nsylvestris_NODE_14814_length_1568_cov_86",93.207,1428,71,10,167,1588,1408,1,0,2076,1421,1407
"48387","Ntome_NODE_14638_length_1673_cov_197","Nsylvestris_NODE_1850_length_4149_cov_72",93.812,1616,62,11,93,1673,103,1715,0,2396,1580,1612
"48395","Ntome_NODE_14642_length_1673_cov_93","Nsylvestris_NODE_10740_length_2021_cov_87",92.502,1467,85,14,125,1579,519,1972,0,2076,1454,1453
"48396","Ntome_NODE_14644_length_1673_cov_74","Nsylvestris_NODE_24158_length_822_cov_123",89.223,399,27,7,1086,1484,742,360,1.01e-135,484,398,382
"48412","Ntome_NODE_14652_length_1672_cov_197","Nsylvestris_NODE_22479_length_923_cov_207",87.405,659,61,15,25,662,909,252,0,737,637,657
"48442","Ntome_NODE_14662_length_1671_cov_42","Nsylvestris_NODE_8688_length_2296_cov_96",80.836,574,73,14,505,1057,1017,460,3.73e-115,416,552,557
"48478","Ntome_NODE_14677_length_1668_cov_136","Nsylvestris_NODE_18143_length_1255_cov_15",86.75,400,45,4,908,1300,679,1077,7.95e-122,438,392,398
"48479","Ntome_NODE_14679_length_1668_cov_65","Nsylvestris_NODE_13769_length_1677_cov_26",93.567,1539,89,4,17,1548,1670,135,0,2285,1531,1535
"48502","Ntome_NODE_14691_length_1667_cov_67","Nsylvestris_NODE_31196_length_438_cov_19",87.118,458,38,11,1200,1657,438,2,3.59e-140,499,457,436
"48503","Ntome_NODE_14692_length_1667_cov_66","Nsylvestris_NODE_2569_length_3762_cov_29",85.897,156,20,2,1,155,495,341,1.49e-39,165,154,154
"48504","Ntome_NODE_14693_length_1667_cov_48","Nsylvestris_NODE_6934_length_2580_cov_83",96.628,682,23,0,808,1489,1899,2580,0,1133,681,681
"48505","Ntome_NODE_14694_length_1667_cov_37","Nsylvestris_NODE_18142_length_1255_cov_16",93.503,1216,45,9,138,1343,7,1198,0,1777,1205,1191
"48527","Ntome_NODE_14702_length_1665_cov_256","Nsylvestris_NODE_11933_length_1877_cov_104",86.961,1043,114,10,455,1492,786,1811,0,1153,1037,1025
"48528","Ntome_NODE_14703_length_1665_cov_249","Nsylvestris_NODE_11964_length_1874_cov_179",97.038,1553,41,3,41,1589,1552,1,0,2608,1548,1551
"48543","Ntome_NODE_14708_length_1665_cov_28","Nsylvestris_NODE_22213_length_941_cov_88",93.359,783,26,13,601,1371,769,1,0,1134,770,768
"48544","Ntome_NODE_14709_length_1665_cov_21","Nsylvestris_NODE_11551_length_1924_cov_207",96.029,1662,57,1,13,1665,1765,104,0,2695,1652,1661
"48553","Ntome_NODE_14714_length_1664_cov_257","Nsylvestris_NODE_15108_length_1540_cov_119",90.71,1550,86,27,138,1643,1,1536,0,2012,1505,1535
"48573","Ntome_NODE_14720_length_1663_cov_275","Nsylvestris_NODE_15596_length_1491_cov_170",94.088,1370,68,10,241,1606,1362,2,0,2069,1365,1360
"48582","Ntome_NODE_14725_length_1663_cov_9","Nsylvestris_NODE_9201_length_2223_cov_36",95.364,1661,76,1,1,1661,130,1789,0,2639,1660,1659
"48592","Ntome_NODE_14729_length_1662_cov_136","Nsylvestris_NODE_26488_length_695_cov_185",95.938,640,21,3,46,680,695,56,0,1033,634,639
"48601","Ntome_NODE_14732_length_1662_cov_66","Nsylvestris_NODE_9126_length_2233_cov_123",94.816,1389,67,3,144,1530,836,2221,0,2161,1386,1385
"48621","Ntome_NODE_14739_length_1661_cov_305","Nsylvestris_NODE_14087_length_1640_cov_181",96.291,1429,47,2,239,1661,1596,168,0,2340,1422,1428
"48647","Ntome_NODE_14746_length_1661_cov_53","Nsylvestris_NODE_14621_length_1587_cov_65",93.56,1615,52,16,63,1659,6,1586,0,2359,1596,1580
"48667","Ntome_NODE_14751_length_1660_cov_225","Nsylvestris_NODE_14593_length_1589_cov_200",95.925,1546,47,6,112,1653,1535,2,0,2492,1541,1533
"48705","Ntome_NODE_14765_length_1659_cov_181","Nsylvestris_NODE_14237_length_1625_cov_124",96.398,1610,54,2,1,1609,18,1624,0,2649,1608,1606
"48714","Ntome_NODE_14770_length_1659_cov_60","Nsylvestris_NODE_24310_length_812_cov_10",94.317,827,27,1,650,1476,3,809,0,1249,826,806
"48715","Ntome_NODE_14771_length_1659_cov_26","Nsylvestris_NODE_21215_length_1013_cov_138",94.488,254,6,3,1407,1659,1010,764,1.04e-105,385,252,246
"48719","Ntome_NODE_14773_length_1659_cov_10","Nsylvestris_NODE_1085_length_4831_cov_262",81.944,360,45,14,306,648,4786,4430,3.03e-76,287,342,356
"48722","Ntome_NODE_14775_length_1658_cov_150","Nsylvestris_NODE_9240_length_2216_cov_210",93.589,1591,93,6,39,1628,1632,50,0,2364,1589,1582
"48731","Ntome_NODE_14778_length_1658_cov_25","Nsylvestris_NODE_11858_length_1885_cov_53",95.221,1653,79,0,1,1653,163,1815,0,2615,1652,1652
"48732","Ntome_NODE_14779_length_1658_cov_16","Nsylvestris_NODE_13272_length_1731_cov_42",94.852,1554,73,1,103,1656,49,1595,0,2420,1553,1546
"48733","Ntome_NODE_14781_length_1657_cov_270","Nsylvestris_NODE_14055_length_1644_cov_197",96.527,1526,45,1,1,1518,1572,47,0,2518,1517,1525
"48768","Ntome_NODE_14792_length_1657_cov_26","Nsylvestris_NODE_1316_length_4581_cov_207",97.059,68,2,0,1590,1657,1751,1684,1.51e-24,115,67,67
"48769","Ntome_NODE_14793_length_1657_cov_25","Nsylvestris_NODE_9760_length_2146_cov_33",96.437,1656,56,3,3,1657,1,1654,0,2728,1654,1653
"48770","Ntome_NODE_14794_length_1656_cov_265","Nsylvestris_NODE_13967_length_1654_cov_214",96.137,1398,43,4,168,1557,1654,260,0,2272,1389,1394
"48771","Ntome_NODE_14795_length_1656_cov_191","Nsylvestris_NODE_8679_length_2297_cov_106",90.247,1620,112,25,1,1587,1762,156,0,2074,1586,1606
"48790","Ntome_NODE_14803_length_1655_cov_268","Nsylvestris_NODE_5438_length_2876_cov_210",96.749,1538,32,7,78,1603,167,1698,0,2547,1525,1531
"48791","Ntome_NODE_14804_length_1655_cov_261","Nsylvestris_NODE_4789_length_3024_cov_177",93.49,1275,58,14,239,1495,1284,17,0,1871,1256,1267
"48806","Ntome_NODE_14811_length_1655_cov_34","Nsylvestris_NODE_13681_length_1688_cov_38",94.667,1669,63,10,1,1655,1667,11,0,2566,1654,1656
"48832","Ntome_NODE_14819_length_1654_cov_67","Nsylvestris_NODE_16869_length_1367_cov_48",91.81,1392,81,17,268,1651,1367,1,0,1908,1383,1366
"48835","Ntome_NODE_14821_length_1654_cov_20","Nsylvestris_NODE_30227_length_508_cov_2",98.425,508,8,0,27,534,1,508,0,894,507,507
"48863","Ntome_NODE_14829_length_1653_cov_72","Nsylvestris_NODE_17334_length_1329_cov_13",86.992,1230,140,11,279,1494,106,1329,0,1367,1215,1223
"48883","Ntome_NODE_14834_length_1652_cov_39","Nsylvestris_NODE_7089_length_2555_cov_108",96.04,1389,54,1,221,1609,1402,15,0,2259,1388,1387
"48886","Ntome_NODE_14836_length_1652_cov_25","Nsylvestris_NODE_1386_length_4504_cov_49",83.265,245,32,9,1271,1511,3874,4113,4.01e-55,217,240,239
"48894","Ntome_NODE_14840_length_1651_cov_158","Nsylvestris_NODE_17124_length_1346_cov_219",95.68,1250,42,7,8,1248,51,1297,0,1999,1240,1246
"48900","Ntome_NODE_14843_length_1650_cov_241","Nsylvestris_NODE_14867_length_1563_cov_203",89.176,1589,80,34,66,1604,1,1547,0,1897,1538,1546
"48906","Ntome_NODE_14846_length_1651_cov_78","Nsylvestris_NODE_12228_length_1845_cov_98",88.455,1126,113,5,209,1318,1174,50,0,1343,1109,1124
"48935","Ntome_NODE_14856_length_1648_cov_257","Nsylvestris_NODE_15297_length_1521_cov_190",95.015,1304,65,0,122,1425,1474,171,0,2049,1303,1303
"48936","Ntome_NODE_14857_length_1648_cov_212","Nsylvestris_NODE_10719_length_2023_cov_178",94.779,1609,74,6,1,1605,298,1900,0,2497,1604,1602
"48963","Ntome_NODE_14866_length_1647_cov_277","Nsylvestris_NODE_8875_length_2267_cov_201",95.635,1535,53,10,97,1623,694,2222,0,2451,1526,1528
"48968","Ntome_NODE_14869_length_1647_cov_242","Nsylvestris_NODE_3428_length_3428_cov_117",92.879,1601,78,8,74,1647,3341,1750,0,2292,1573,1591
"48986","Ntome_NODE_14877_length_1646_cov_276","Nsylvestris_NODE_15017_length_1548_cov_221",93.412,1533,94,6,88,1616,1,1530,0,2265,1528,1529
"48991","Ntome_NODE_14880_length_1646_cov_39","Nsylvestris_NODE_36103_length_271_cov_4",95.911,269,9,2,140,407,268,1,1.01e-120,435,267,267
"48997","Ntome_NODE_14884_length_1646_cov_5","Nsylvestris_NODE_7648_length_2463_cov_145",92.257,1679,97,9,1,1646,2258,580,0,2350,1645,1678
"49000","Ntome_NODE_14886_length_1645_cov_231","Nsylvestris_NODE_1793_length_4183_cov_101",95.983,1145,42,3,212,1356,3043,4183,0,1857,1144,1140
"49013","Ntome_NODE_14889_length_1645_cov_92","Nsylvestris_NODE_18609_length_1217_cov_7",85.494,324,30,7,871,1178,60,382,8.23e-87,322,307,322
"49014","Ntome_NODE_14890_length_1645_cov_70","Nsylvestris_NODE_16336_length_1416_cov_24",94.126,1379,77,3,231,1608,33,1408,0,2095,1377,1375
"49015","Ntome_NODE_14891_length_1645_cov_27","Nsylvestris_NODE_12363_length_1831_cov_98",95.75,1553,66,0,93,1645,1759,207,0,2503,1552,1552
"49031","Ntome_NODE_14897_length_1644_cov_245","Nsylvestris_NODE_12687_length_1797_cov_148",94.464,1391,65,6,263,1644,382,1769,0,2132,1381,1387
"49032","Ntome_NODE_14898_length_1644_cov_240","Nsylvestris_NODE_4339_length_3142_cov_161",93.789,1272,77,2,330,1600,1773,3043,0,1910,1270,1270
"49033","Ntome_NODE_14899_length_1644_cov_223","Nsylvestris_NODE_6009_length_2758_cov_214",93.82,1068,44,5,382,1428,71,1137,0,1587,1046,1066
"49050","Ntome_NODE_14904_length_1644_cov_102","Nsylvestris_NODE_13283_length_1730_cov_63",95.258,1645,68,5,1,1640,1640,1,0,2597,1639,1639
"49062","Ntome_NODE_14909_length_1643_cov_283","Nsylvestris_NODE_14449_length_1605_cov_213",96.623,1510,46,3,1,1509,13,1518,0,2501,1508,1505
"49068","Ntome_NODE_14912_length_1643_cov_259","Nsylvestris_NODE_13605_length_1695_cov_190",96.027,1636,47,7,20,1637,1695,60,0,2645,1617,1635
"49069","Ntome_NODE_14913_length_1643_cov_218","Nsylvestris_NODE_10357_length_2068_cov_181",91.424,1236,85,10,96,1331,2065,851,0,1676,1235,1214
"49108","Ntome_NODE_14925_length_1643_cov_41","Nsylvestris_NODE_18248_length_1248_cov_6",92.693,1259,77,7,89,1344,2,1248,0,1801,1255,1246
"49109","Ntome_NODE_14927_length_1643_cov_21","Nsylvestris_NODE_19184_length_1169_cov_9",88.679,53,3,3,1081,1130,843,895,1.98e-08,62.1,49,52
"49120","Ntome_NODE_14932_length_1642_cov_260","Nsylvestris_NODE_2998_length_3588_cov_144",93.183,1511,81,8,1,1489,2019,3529,0,2200,1488,1510
"49153","Ntome_NODE_14944_length_1641_cov_278","Nsylvestris_NODE_17877_length_1278_cov_230",95.91,1198,39,5,400,1593,6,1197,0,1932,1193,1191
"49171","Ntome_NODE_14950_length_1641_cov_67","Nsylvestris_NODE_10030_length_2112_cov_212",100,55,0,0,1587,1641,502,448,1.16e-20,102,54,54
"49182","Ntome_NODE_14956_length_1640_cov_73","Nsylvestris_NODE_14823_length_1567_cov_153",93.571,1571,68,15,74,1637,1567,23,0,2311,1563,1544
"49187","Ntome_NODE_14958_length_1640_cov_11","Nsylvestris_NODE_462_length_6059_cov_186",95.161,62,2,1,1579,1640,5364,5424,5.41e-19,97.1,61,60
"49221","Ntome_NODE_14969_length_1639_cov_100","Nsylvestris_NODE_12624_length_1803_cov_74",98.387,62,1,0,1,62,1466,1527,6.95e-23,110,61,61
"49255","Ntome_NODE_14982_length_1638_cov_78","Nsylvestris_NODE_25202_length_760_cov_57",91.553,367,17,3,234,600,711,359,1.64e-138,494,366,352
"49275","Ntome_NODE_14991_length_1637_cov_10","Nsylvestris_NODE_16679_length_1383_cov_8",89.583,48,5,0,198,245,536,583,1.97e-08,62.1,47,47
"49280","Ntome_NODE_14994_length_1636_cov_294","Nsylvestris_NODE_13712_length_1683_cov_209",95.977,1392,52,3,36,1427,1672,285,0,2257,1391,1387
"49293","Ntome_NODE_14999_length_1635_cov_278","Nsylvestris_NODE_11275_length_1954_cov_161",96.194,1550,48,6,89,1635,1869,328,0,2525,1546,1541
"49307","Ntome_NODE_15006_length_1635_cov_10","Nsylvestris_NODE_12143_length_1853_cov_217",98.182,55,1,0,1,55,77,131,5.4e-19,97.1,54,54
"49341","Ntome_NODE_15018_length_1633_cov_196","Nsylvestris_NODE_17606_length_1302_cov_185",93.497,1307,49,16,316,1591,1,1302,0,1910,1275,1301
"49366","Ntome_NODE_15027_length_1632_cov_160","Nsylvestris_NODE_4120_length_3196_cov_80",95.208,1273,43,7,156,1423,217,1476,0,1997,1267,1259
"49371","Ntome_NODE_15030_length_1632_cov_13","Nsylvestris_NODE_18106_length_1259_cov_73",73.87,509,101,29,324,816,138,630,2.42e-42,174,492,492
"49383","Ntome_NODE_15035_length_1631_cov_254","Nsylvestris_NODE_1480_length_4414_cov_196",94.962,1449,54,8,134,1579,61,1493,0,2254,1445,1432
"49384","Ntome_NODE_15036_length_1631_cov_247","Nsylvestris_NODE_9308_length_2206_cov_192",95.373,1448,61,6,3,1446,1,1446,0,2298,1443,1445
"49408","Ntome_NODE_15046_length_1630_cov_240","Nsylvestris_NODE_18047_length_1264_cov_189",94.654,1085,51,4,202,1284,1209,130,0,1676,1082,1079
"49424","Ntome_NODE_15051_length_1630_cov_70","Nsylvestris_NODE_4768_length_3029_cov_205",96.17,1619,55,5,10,1626,1284,2897,0,2639,1616,1613
"49451","Ntome_NODE_15061_length_1629_cov_64","Nsylvestris_NODE_11536_length_1926_cov_123",77.731,476,101,4,856,1327,1133,1607,2.97e-76,287,471,474
"49459","Ntome_NODE_15065_length_1629_cov_10","Nsylvestris_NODE_14865_length_1563_cov_228",83.462,260,43,0,411,670,278,19,6.53e-63,243,259,259
"49465","Ntome_NODE_15068_length_1628_cov_232","Nsylvestris_NODE_16905_length_1364_cov_217",93.643,1290,44,11,300,1577,1327,64,0,1893,1277,1263
"49491","Ntome_NODE_15076_length_1627_cov_269","Nsylvestris_NODE_14889_length_1561_cov_212",96.164,1564,41,8,60,1607,1,1561,0,2538,1547,1560
"49503","Ntome_NODE_15080_length_1627_cov_24","Nsylvestris_NODE_12784_length_1788_cov_148",94.954,1625,67,2,1,1625,166,1775,0,2532,1624,1609
"49512","Ntome_NODE_15084_length_1627_cov_11","Nsylvestris_NODE_10714_length_2024_cov_32",95.127,1580,76,1,1,1580,393,1971,0,2490,1579,1578
"49517","Ntome_NODE_15086_length_1626_cov_277","Nsylvestris_NODE_88_length_8639_cov_233",96.812,1631,19,11,14,1626,5,1620,0,2693,1612,1615
"49549","Ntome_NODE_15098_length_1624_cov_37","Nsylvestris_NODE_2158_length_3960_cov_227",87.675,357,34,8,1156,1511,3377,3724,2.18e-112,407,355,347
"49554","Ntome_NODE_15100_length_1624_cov_18","Nsylvestris_NODE_14893_length_1561_cov_58",96.502,1458,48,2,143,1600,1511,57,0,2407,1457,1454
"49557","Ntome_NODE_15103_length_1623_cov_200","Nsylvestris_NODE_14422_length_1608_cov_174",95.177,1493,58,8,1,1491,1482,2,0,2346,1490,1480
"49558","Ntome_NODE_15104_length_1623_cov_176","Nsylvestris_NODE_13554_length_1700_cov_178",92.116,1522,83,18,62,1578,82,1571,0,2111,1516,1489
"49575","Ntome_NODE_15112_length_1623_cov_15","Nsylvestris_NODE_34489_length_308_cov_4",92.164,268,9,1,1322,1577,1,268,1.03e-100,368,255,267
"49624","Ntome_NODE_15128_length_1621_cov_89","Nsylvestris_NODE_1922_length_4100_cov_167",91.467,1629,84,19,20,1621,2393,3993,0,2187,1601,1600
"49640","Ntome_NODE_15135_length_1620_cov_86","Nsylvestris_NODE_15904_length_1460_cov_47",93.858,1335,73,6,157,1487,1455,126,0,2002,1330,1329
"49652","Ntome_NODE_15142_length_1619_cov_203","Nsylvestris_NODE_13974_length_1653_cov_114",93.867,1598,75,6,1,1582,1597,7,0,2386,1581,1590
"49653","Ntome_NODE_15143_length_1619_cov_105","Nsylvestris_NODE_18357_length_1236_cov_95",94.501,1182,57,5,287,1464,1228,51,0,1816,1177,1177
"49684","Ntome_NODE_15154_length_1618_cov_182","Nsylvestris_NODE_12390_length_1827_cov_213",93.274,1576,76,18,55,1618,1658,101,0,2296,1563,1557
"49685","Ntome_NODE_15155_length_1618_cov_112","Nsylvestris_NODE_26037_length_717_cov_9",83.21,542,84,7,364,902,138,675,2.1e-137,490,538,537
"49693","Ntome_NODE_15158_length_1617_cov_231","Nsylvestris_NODE_2002_length_4055_cov_210",97.018,1576,43,3,1,1575,3956,2384,0,2647,1574,1572
"49694","Ntome_NODE_15159_length_1617_cov_214","Nsylvestris_NODE_15476_length_1505_cov_147",95.792,1212,26,2,114,1303,1491,283,0,1932,1189,1208
"49700","Ntome_NODE_15162_length_1617_cov_87","Nsylvestris_NODE_3310_length_3470_cov_223",95.652,92,4,0,589,680,788,879,1.45e-34,148,91,91
"49705","Ntome_NODE_15166_length_1616_cov_259","Nsylvestris_NODE_14040_length_1645_cov_214",93.167,1244,46,11,315,1534,1284,56,0,1790,1219,1228
"49711","Ntome_NODE_15168_length_1616_cov_212","Nsylvestris_NODE_16712_length_1380_cov_180",91.47,973,52,5,227,1189,1380,429,0,1308,962,951
"49719","Ntome_NODE_15172_length_1616_cov_118","Nsylvestris_NODE_15332_length_1519_cov_116",90.007,1361,89,19,167,1480,1361,1,0,1716,1313,1360
"49737","Ntome_NODE_15178_length_1616_cov_14","Nsylvestris_NODE_4634_length_3062_cov_108",92.408,1607,69,22,48,1616,2108,517,0,2242,1568,1591
"49745","Ntome_NODE_15181_length_1615_cov_243","Nsylvestris_NODE_14725_length_1577_cov_29",92.421,1491,46,17,156,1589,97,1577,0,2065,1433,1480
"49762","Ntome_NODE_15190_length_1615_cov_22","Nsylvestris_NODE_13957_length_1656_cov_27",92.408,1528,59,20,22,1508,1545,34,0,2126,1486,1511
"49763","Ntome_NODE_15191_length_1615_cov_13","Nsylvestris_NODE_15178_length_1532_cov_226",98.182,55,1,0,1,55,692,638,5.33e-19,97.1,54,54
"49769","Ntome_NODE_15194_length_1615_cov_6","Nsylvestris_NODE_13821_length_1671_cov_182",100,32,0,0,1,32,609,640,6.99e-08,60.2,31,31
"49770","Ntome_NODE_15195_length_1614_cov_244","Nsylvestris_NODE_12918_length_1772_cov_195",90.584,1593,95,28,55,1614,82,1652,0,2060,1559,1570
"49771","Ntome_NODE_15196_length_1614_cov_233","Nsylvestris_NODE_11909_length_1879_cov_177",95.389,1518,67,3,1,1518,1575,61,0,2412,1517,1514
"49774","Ntome_NODE_15198_length_1614_cov_154","Nsylvestris_NODE_14361_length_1614_cov_68",93.871,1550,69,20,1,1536,1548,11,0,2313,1535,1537
"49786","Ntome_NODE_15202_length_1604_cov_302","Nsylvestris_NODE_13980_length_1652_cov_223",95.244,1535,64,5,35,1565,1566,37,0,2422,1530,1529
"49787","Ntome_NODE_15203_length_1608_cov_289","Nsylvestris_NODE_15060_length_1545_cov_200",95.646,1332,48,6,70,1394,177,1505,0,2130,1324,1328
"49790","Ntome_NODE_15205_length_1611_cov_250","Nsylvestris_NODE_1673_length_4271_cov_127",94.046,1562,71,11,27,1582,1594,49,0,2350,1555,1545
"49796","Ntome_NODE_15208_length_1613_cov_166","Nsylvestris_NODE_14859_length_1564_cov_139",93.153,701,37,8,18,712,1426,731,0,1018,694,695
"49800","Ntome_NODE_15210_length_1613_cov_115","Nsylvestris_NODE_13077_length_1753_cov_157",95.97,1588,60,3,1,1588,43,1626,0,2575,1587,1583
"49808","Ntome_NODE_15213_length_1612_cov_253","Nsylvestris_NODE_1954_length_4083_cov_197",97.308,1226,30,1,99,1324,2638,3860,0,2078,1225,1222
"49809","Ntome_NODE_15214_length_1612_cov_240","Nsylvestris_NODE_9006_length_2250_cov_141",95.219,1276,56,3,146,1416,2193,918,0,2013,1270,1275
"49824","Ntome_NODE_15219_length_1612_cov_97","Nsylvestris_NODE_14437_length_1606_cov_193",94.202,1604,68,9,1,1581,1603,2,0,2423,1580,1601
"49830","Ntome_NODE_15222_length_1612_cov_12","Nsylvestris_NODE_26107_length_714_cov_8",91.907,729,32,14,787,1510,714,8,0,994,723,706
"49869","Ntome_NODE_15236_length_1610_cov_203","Nsylvestris_NODE_13116_length_1749_cov_125",96.765,1484,48,0,125,1608,1720,237,0,2475,1483,1483
"49870","Ntome_NODE_15237_length_1610_cov_190","Nsylvestris_NODE_14515_length_1598_cov_193",93,1500,90,10,1,1490,1554,60,0,2174,1489,1494
"49887","Ntome_NODE_15245_length_1610_cov_14","Nsylvestris_NODE_4080_length_3210_cov_51",93.399,1621,94,1,1,1608,1863,243,0,2388,1607,1620
"49894","Ntome_NODE_15248_length_1609_cov_302","Nsylvestris_NODE_11403_length_1941_cov_205",95.956,1533,61,1,78,1609,50,1582,0,2486,1531,1532
"49916","Ntome_NODE_15255_length_1609_cov_41","Nsylvestris_NODE_12799_length_1786_cov_215",94.097,1440,59,11,4,1428,69,1497,0,2165,1424,1428
"49922","Ntome_NODE_15258_length_1608_cov_20","Nsylvestris_NODE_1287_length_4606_cov_25",81.773,203,25,10,1063,1257,2806,3004,6.67e-38,159,194,198
"49923","Ntome_NODE_15260_length_1609_cov_9","Nsylvestris_NODE_110_length_8341_cov_59",85.135,148,18,3,1465,1609,2219,2365,1.45e-34,148,144,146
"49927","Ntome_NODE_15262_length_1608_cov_274","Nsylvestris_NODE_12879_length_1776_cov_196",94.125,1515,54,21,38,1540,1540,49,0,2272,1502,1491
"49928","Ntome_NODE_15263_length_1608_cov_270","Nsylvestris_NODE_13971_length_1653_cov_235",92.934,1571,58,9,48,1582,1607,54,0,2237,1534,1553
"49948","Ntome_NODE_15269_length_1607_cov_280","Nsylvestris_NODE_15029_length_1547_cov_234",94.293,1542,65,9,3,1531,16,1547,0,2338,1528,1531
"49976","Ntome_NODE_15279_length_1607_cov_53","Nsylvestris_NODE_11560_length_1923_cov_170",94.804,1559,72,6,1,1554,222,1776,0,2422,1553,1554
"49992","Ntome_NODE_15285_length_1606_cov_87","Nsylvestris_NODE_15304_length_1521_cov_42",92.67,1296,72,5,274,1552,75,1364,0,1845,1278,1289
"49997","Ntome_NODE_15288_length_1606_cov_28","Nsylvestris_NODE_14302_length_1621_cov_35",92.613,1462,86,10,166,1605,134,1595,0,2082,1439,1461
"50005","Ntome_NODE_15291_length_1606_cov_15","Nsylvestris_NODE_9678_length_2156_cov_23",81.818,88,12,4,1187,1271,1982,1896,3.21e-11,71.3,84,86
"50012","Ntome_NODE_15294_length_1605_cov_273","Nsylvestris_NODE_14248_length_1624_cov_206",96.185,1494,32,10,130,1598,1563,70,0,2420,1468,1493
"50013","Ntome_NODE_15295_length_1605_cov_264","Nsylvestris_NODE_3554_length_3381_cov_177",96.499,1171,34,2,308,1472,3094,1925,0,1929,1164,1169
"50029","Ntome_NODE_15300_length_1605_cov_113","Nsylvestris_NODE_4473_length_3105_cov_191",93.184,1203,59,7,1,1198,20,1204,0,1746,1197,1184
"50030","Ntome_NODE_15301_length_1605_cov_26","Nsylvestris_NODE_15883_length_1461_cov_221",98.182,55,1,0,1,55,894,948,5.3e-19,97.1,54,54
"50031","Ntome_NODE_15302_length_1604_cov_289","Nsylvestris_NODE_14016_length_1647_cov_214",96.794,1591,44,6,16,1602,1645,58,0,2649,1586,1587
"50069","Ntome_NODE_15315_length_1603_cov_223","Nsylvestris_NODE_14161_length_1634_cov_201",97.039,1317,37,2,287,1603,1417,103,0,2215,1316,1314
"50075","Ntome_NODE_15318_length_1603_cov_72","Nsylvestris_NODE_18907_length_1192_cov_43",96.86,860,24,1,612,1468,964,105,0,1435,856,859
"50095","Ntome_NODE_15327_length_1602_cov_15","Nsylvestris_NODE_10456_length_2056_cov_18",97.502,1601,40,0,1,1601,1935,335,0,2736,1600,1600
"50105","Ntome_NODE_15331_length_1601_cov_274","Nsylvestris_NODE_16809_length_1371_cov_224",96.501,1372,42,4,145,1515,1,1367,0,2263,1370,1366
"50112","Ntome_NODE_15334_length_1601_cov_170","Nsylvestris_NODE_19808_length_1117_cov_33",85.266,414,55,4,351,759,747,335,7.68e-117,422,408,412
"50116","Ntome_NODE_15336_length_1601_cov_16","Nsylvestris_NODE_8672_length_2298_cov_28",94.403,1608,76,9,1,1601,1700,100,0,2459,1600,1600
"50122","Ntome_NODE_15340_length_1600_cov_226","Nsylvestris_NODE_14821_length_1567_cov_201",91.467,1547,67,23,56,1600,13,1496,0,2065,1544,1483
"50134","Ntome_NODE_15344_length_1600_cov_30","Nsylvestris_NODE_3534_length_3388_cov_103",88.777,1488,96,28,142,1598,1993,546,0,1757,1456,1447
"50135","Ntome_NODE_15345_length_1600_cov_27","Nsylvestris_NODE_14471_length_1603_cov_48",95.145,1586,71,2,16,1598,1,1583,0,2497,1582,1582
"50149","Ntome_NODE_15350_length_1599_cov_246","Nsylvestris_NODE_12835_length_1782_cov_206",94.942,1542,63,8,2,1538,1726,195,0,2401,1536,1531
"50157","Ntome_NODE_15353_length_1598_cov_242","Nsylvestris_NODE_12226_length_1845_cov_155",92.996,1599,69,26,19,1587,68,1653,0,2292,1568,1585
"50176","Ntome_NODE_15360_length_1597_cov_170","Nsylvestris_NODE_22410_length_927_cov_204",93.431,822,25,7,19,812,1,821,0,1192,793,820
"50228","Ntome_NODE_15377_length_1596_cov_93","Nsylvestris_NODE_656_length_5535_cov_213",86.567,335,9,5,1286,1594,5535,5211,2.85e-91,337,308,324
"50229","Ntome_NODE_15378_length_1596_cov_89","Nsylvestris_NODE_3136_length_3532_cov_203",95.502,1245,38,6,97,1338,1393,164,0,1973,1241,1229
"50230","Ntome_NODE_15379_length_1596_cov_77","Nsylvestris_NODE_19707_length_1127_cov_36",77.228,303,38,22,623,923,536,809,1.43e-34,148,300,273
"50239","Ntome_NODE_15383_length_1595_cov_261","Nsylvestris_NODE_15495_length_1503_cov_205",94.993,1358,59,3,47,1403,87,1436,0,2122,1356,1349
"50240","Ntome_NODE_15384_length_1595_cov_254","Nsylvestris_NODE_14078_length_1642_cov_125",93.316,1152,61,5,456,1591,1309,158,0,1687,1135,1151
"50241","Ntome_NODE_15385_length_1595_cov_244","Nsylvestris_NODE_3773_length_3311_cov_211",95.652,1104,47,1,396,1498,1222,119,0,1772,1102,1103
"50252","Ntome_NODE_15389_length_1595_cov_81","Nsylvestris_NODE_29805_length_544_cov_9",92.094,468,33,2,922,1388,77,541,0,656,466,464
"50255","Ntome_NODE_15391_length_1595_cov_28","Nsylvestris_NODE_13336_length_1725_cov_163",95.813,1600,48,11,1,1595,103,1688,0,2566,1594,1585
"50259","Ntome_NODE_15393_length_1594_cov_312","Nsylvestris_NODE_3176_length_3515_cov_216",98.444,1478,23,0,117,1594,3242,1765,0,2603,1477,1477
"50281","Ntome_NODE_15400_length_1593_cov_293","Nsylvestris_NODE_4184_length_3180_cov_217",93.367,1598,66,22,1,1586,1611,3180,0,2327,1585,1569
"50301","Ntome_NODE_15409_length_1593_cov_111","Nsylvestris_NODE_14401_length_1610_cov_113",94.862,1265,48,6,4,1264,1601,350,0,1960,1260,1251
"50313","Ntome_NODE_15414_length_1593_cov_24","Nsylvestris_NODE_1441_length_4456_cov_192",96.364,55,2,0,1,55,3300,3246,2.45e-17,91.6,54,54
"50322","Ntome_NODE_15418_length_1592_cov_278","Nsylvestris_NODE_2071_length_4010_cov_218",93.804,1501,62,14,54,1545,2172,3650,0,2228,1491,1478
"50354","Ntome_NODE_15429_length_1591_cov_230","Nsylvestris_NODE_21910_length_961_cov_80",95.118,594,17,5,844,1434,221,805,0,926,590,584
"50366","Ntome_NODE_15433_length_1591_cov_54","Nsylvestris_NODE_1565_length_4352_cov_203",93.658,1561,60,14,1,1545,4317,2780,0,2298,1544,1537
"50370","Ntome_NODE_15435_length_1591_cov_23","Nsylvestris_NODE_9448_length_2186_cov_43",95.194,1623,43,14,1,1591,203,1822,0,2532,1590,1619
"50384","Ntome_NODE_15442_length_1590_cov_88","Nsylvestris_NODE_6461_length_2668_cov_129",90.839,1419,78,7,197,1582,1230,2629,0,1853,1385,1399
"50418","Ntome_NODE_15453_length_1588_cov_217","Nsylvestris_NODE_15584_length_1492_cov_157",89.839,1427,108,17,97,1513,1481,82,0,1797,1416,1399
"50438","Ntome_NODE_15460_length_1587_cov_246","Nsylvestris_NODE_15676_length_1483_cov_224",98.05,1231,24,0,357,1587,52,1282,0,2141,1230,1230
"50441","Ntome_NODE_15462_length_1587_cov_199","Nsylvestris_NODE_15235_length_1528_cov_80",93.975,1444,84,3,49,1491,33,1474,0,2182,1442,1441
"50484","Ntome_NODE_15478_length_1586_cov_18","Nsylvestris_NODE_189_length_7438_cov_158",100,41,0,0,1,41,1743,1783,6.82e-13,76.8,40,40
"50485","Ntome_NODE_15479_length_1586_cov_17","Nsylvestris_NODE_5428_length_2878_cov_101",91.42,1352,83,10,52,1393,2828,1500,0,1823,1341,1328
"50486","Ntome_NODE_15480_length_1586_cov_14","Nsylvestris_NODE_11913_length_1879_cov_44",98.182,55,1,0,1532,1586,1367,1421,5.23e-19,97.1,54,54
"50498","Ntome_NODE_15484_length_1585_cov_197","Nsylvestris_NODE_15197_length_1531_cov_135",94.012,1503,66,10,40,1536,1530,46,0,2255,1496,1484
"50521","Ntome_NODE_15492_length_1585_cov_67","Nsylvestris_NODE_15795_length_1470_cov_116",94.18,1512,46,5,63,1574,1,1470,0,2266,1511,1469
"50527","Ntome_NODE_15495_length_1584_cov_269","Nsylvestris_NODE_16245_length_1425_cov_74",93.652,1339,64,7,37,1368,1389,65,0,1982,1331,1324
"50536","Ntome_NODE_15498_length_1584_cov_229","Nsylvestris_NODE_18512_length_1223_cov_190",94.113,1223,52,8,363,1567,1222,2,0,1842,1204,1220
"50537","Ntome_NODE_15499_length_1584_cov_164","Nsylvestris_NODE_21226_length_1012_cov_199",95.533,806,30,4,640,1445,163,962,0,1284,805,799
"50544","Ntome_NODE_15502_length_1584_cov_99","Nsylvestris_NODE_8383_length_2343_cov_102",93.611,1346,65,14,109,1449,2341,1012,0,1989,1340,1329
"50573","Ntome_NODE_15515_length_1583_cov_26","Nsylvestris_NODE_13872_length_1666_cov_141",96.091,1586,47,6,1,1582,56,1630,0,2571,1581,1574
"50574","Ntome_NODE_15516_length_1583_cov_25","Nsylvestris_NODE_13263_length_1732_cov_50",91.88,1601,88,19,1,1583,120,1696,0,2198,1582,1576
"50593","Ntome_NODE_15523_length_1582_cov_114","Nsylvestris_NODE_22152_length_945_cov_51",94.643,728,35,3,95,821,4,728,0,1125,726,724
"50613","Ntome_NODE_15532_length_1581_cov_98","Nsylvestris_NODE_16027_length_1447_cov_150",93.921,1464,51,14,1,1447,2,1444,0,2176,1446,1442
"50616","Ntome_NODE_15534_length_1581_cov_15","Nsylvestris_NODE_13351_length_1723_cov_136",73.096,1234,283,38,133,1340,247,1457,1.65e-108,394,1207,1210
"50623","Ntome_NODE_15537_length_1580_cov_282","Nsylvestris_NODE_12552_length_1809_cov_111",94.748,1447,45,10,102,1526,1799,362,0,2222,1424,1437
"50632","Ntome_NODE_15541_length_1580_cov_176","Nsylvestris_NODE_3315_length_3470_cov_171",93.59,78,4,1,121,198,2330,2406,1.44e-24,115,77,76
"50643","Ntome_NODE_15545_length_1580_cov_41","Nsylvestris_NODE_11810_length_1892_cov_113",94.769,1491,63,11,35,1517,49,1532,0,2307,1482,1483
"50644","Ntome_NODE_15547_length_1580_cov_35","Nsylvestris_NODE_17493_length_1314_cov_8",96.355,1262,34,7,268,1521,55,1312,0,2065,1253,1257
"50647","Ntome_NODE_15549_length_1580_cov_13","Nsylvestris_NODE_3511_length_3395_cov_20",94.997,1599,61,5,1,1580,3143,1545,0,2492,1579,1598
"50651","Ntome_NODE_15551_length_1579_cov_263","Nsylvestris_NODE_16123_length_1437_cov_166",95.772,1159,45,2,38,1195,7,1162,0,1866,1157,1155
"50652","Ntome_NODE_15552_length_1579_cov_249","Nsylvestris_NODE_16754_length_1376_cov_211",95.678,1342,42,6,44,1375,1336,1,0,2143,1331,1335
"50677","Ntome_NODE_15560_length_1579_cov_113","Nsylvestris_NODE_14777_length_1572_cov_56",95.493,1531,61,4,1,1530,1542,19,0,2438,1529,1523
"50686","Ntome_NODE_15564_length_1578_cov_287","Nsylvestris_NODE_12798_length_1784_cov_216",97.971,1331,25,2,248,1578,185,1513,0,2307,1330,1328
"50703","Ntome_NODE_15571_length_1578_cov_181","Nsylvestris_NODE_19018_length_1182_cov_168",94.806,1136,48,5,427,1561,1,1126,0,1760,1134,1125
"50704","Ntome_NODE_15572_length_1578_cov_120","Nsylvestris_NODE_16235_length_1426_cov_180",94.807,1425,66,7,2,1420,2,1424,0,2215,1418,1422
"50705","Ntome_NODE_15573_length_1578_cov_109","Nsylvestris_NODE_15215_length_1530_cov_101",95.442,1426,50,5,32,1451,1482,66,0,2259,1419,1416
"50722","Ntome_NODE_15580_length_1577_cov_293","Nsylvestris_NODE_9789_length_2141_cov_230",95.082,1464,59,1,1,1464,1512,62,0,2292,1463,1450
"50728","Ntome_NODE_15583_length_1577_cov_251","Nsylvestris_NODE_14027_length_1646_cov_183",94.485,1505,65,9,81,1571,88,1588,0,2303,1490,1500
"50733","Ntome_NODE_15586_length_1577_cov_245","Nsylvestris_NODE_15682_length_1481_cov_223",96.496,1427,37,6,56,1470,1,1426,0,2346,1414,1425
"50742","Ntome_NODE_15589_length_1577_cov_150","Nsylvestris_NODE_13655_length_1690_cov_84",91.543,946,56,11,191,1114,747,1690,0,1282,923,943
"50743","Ntome_NODE_15590_length_1577_cov_122","Nsylvestris_NODE_1998_length_4057_cov_168",93.866,1190,48,8,88,1258,1,1184,0,1770,1170,1183
"50764","Ntome_NODE_15600_length_1576_cov_52","Nsylvestris_NODE_5221_length_2922_cov_157",90.734,1554,107,22,1,1540,1335,2865,0,2037,1539,1530
"50778","Ntome_NODE_15607_length_1575_cov_57","Nsylvestris_NODE_25029_length_770_cov_9",91.23,764,52,7,560,1320,3,754,0,1026,760,751
"50779","Ntome_NODE_15608_length_1575_cov_56","Nsylvestris_NODE_4523_length_3094_cov_157",96.184,1415,47,3,165,1575,1668,3079,0,2307,1410,1411
"50788","Ntome_NODE_15612_length_1571_cov_32","Nsylvestris_NODE_27143_length_667_cov_57",86.402,478,62,3,104,578,189,666,2.6e-146,520,474,477
"50801","Ntome_NODE_15619_length_1574_cov_139","Nsylvestris_NODE_14699_length_1579_cov_172",90.689,1407,83,19,1,1393,1572,200,0,1829,1392,1372
"50812","Ntome_NODE_15623_length_1574_cov_39","Nsylvestris_NODE_32499_length_372_cov_5",84.173,278,34,7,499,773,1,271,1.74e-68,261,274,270
"50824","Ntome_NODE_15629_length_1573_cov_268","Nsylvestris_NODE_15449_length_1507_cov_164",94.952,1446,61,7,23,1467,1435,1,0,2255,1444,1434
"50828","Ntome_NODE_15631_length_1573_cov_204","Nsylvestris_NODE_20189_length_1087_cov_176",89.871,1086,67,22,231,1308,1,1051,0,1356,1077,1050
"50860","Ntome_NODE_15644_length_1572_cov_228","Nsylvestris_NODE_15021_length_1548_cov_131",91.194,1499,99,17,53,1532,1485,1,0,2006,1479,1484
"50877","Ntome_NODE_15650_length_1572_cov_110","Nsylvestris_NODE_26744_length_685_cov_206",94.59,536,24,3,922,1457,141,671,0,824,535,530
"50899","Ntome_NODE_15656_length_1571_cov_237","Nsylvestris_NODE_14035_length_1646_cov_46",92.73,1513,88,11,4,1510,1637,141,0,2165,1506,1496
"50923","Ntome_NODE_15664_length_1571_cov_25","Nsylvestris_NODE_14175_length_1633_cov_22",95.647,1585,49,4,2,1571,33,1612,0,2527,1569,1579
"50924","Ntome_NODE_15665_length_1571_cov_16","Nsylvestris_NODE_22_length_11544_cov_169",95.498,1577,61,5,1,1571,3656,5228,0,2510,1570,1572
"50927","Ntome_NODE_15667_length_1571_cov_11","Nsylvestris_NODE_6636_length_2636_cov_78",95.475,1569,71,0,1,1569,2320,752,0,2505,1568,1568
"50928","Ntome_NODE_15669_length_1570_cov_294","Nsylvestris_NODE_4410_length_3121_cov_163",98.698,1152,15,0,419,1570,45,1196,0,2045,1151,1151
"50929","Ntome_NODE_15670_length_1570_cov_292","Nsylvestris_NODE_14407_length_1609_cov_211",96.782,1243,28,3,47,1278,1609,368,0,2063,1231,1241
"50930","Ntome_NODE_15671_length_1570_cov_291","Nsylvestris_NODE_14025_length_1646_cov_224",95.695,1533,59,4,5,1533,1586,57,0,2459,1528,1529
"50931","Ntome_NODE_15672_length_1570_cov_289","Nsylvestris_NODE_13737_length_1680_cov_215",92.085,1554,66,13,1,1522,1654,126,0,2135,1521,1528
"50932","Ntome_NODE_15673_length_1570_cov_276","Nsylvestris_NODE_3083_length_3548_cov_228",95.412,1591,45,16,1,1570,3548,1965,0,2508,1569,1583
"50940","Ntome_NODE_15676_length_1573_cov_263","Nsylvestris_NODE_17889_length_1275_cov_226",98.129,1176,20,1,253,1426,1232,57,0,2049,1173,1175
"50941","Ntome_NODE_15677_length_1570_cov_248","Nsylvestris_NODE_14996_length_1550_cov_192",96.291,1429,31,10,72,1478,53,1481,0,2326,1406,1428
"50942","Ntome_NODE_15678_length_1570_cov_232","Nsylvestris_NODE_19874_length_1112_cov_44",96.201,1053,40,0,197,1249,52,1104,0,1724,1052,1052
"50983","Ntome_NODE_15694_length_1568_cov_249","Nsylvestris_NODE_14698_length_1579_cov_200",95.016,1565,55,6,12,1564,1,1554,0,2436,1552,1553
"50984","Ntome_NODE_15695_length_1568_cov_233","Nsylvestris_NODE_12231_length_1844_cov_182",95.245,1472,47,7,99,1568,1814,364,0,2309,1469,1450
"51002","Ntome_NODE_15705_length_1567_cov_208","Nsylvestris_NODE_13598_length_1696_cov_169",95.721,1519,63,2,1,1519,1638,122,0,2444,1518,1516
"51023","Ntome_NODE_15712_length_1567_cov_14","Nsylvestris_NODE_2908_length_3617_cov_219",96.875,160,5,0,1408,1567,610,769,1.04e-70,268,159,159
"51055","Ntome_NODE_15725_length_1566_cov_7","Nsylvestris_NODE_13311_length_1726_cov_32",93.45,1481,85,3,98,1566,61,1541,0,2187,1468,1480
"51078","Ntome_NODE_15734_length_1565_cov_128","Nsylvestris_NODE_21649_length_981_cov_141",87.452,263,19,9,126,379,26,283,2.21e-77,291,253,257
"51079","Ntome_NODE_15735_length_1565_cov_90","Nsylvestris_NODE_13182_length_1740_cov_211",95.131,1561,71,4,2,1557,101,1661,0,2457,1555,1560
"51092","Ntome_NODE_15741_length_1564_cov_18","Nsylvestris_NODE_4494_length_3101_cov_145",94.426,1525,74,5,50,1563,1617,93,0,2335,1513,1524
"51098","Ntome_NODE_15744_length_1564_cov_17","Nsylvestris_NODE_4956_length_2984_cov_62",97.313,707,19,0,8,714,2278,2984,0,1201,706,706
"51136","Ntome_NODE_15759_length_1562_cov_255","Nsylvestris_NODE_17841_length_1282_cov_220",94.269,1204,49,11,87,1289,1235,51,0,1823,1202,1184
"51145","Ntome_NODE_15764_length_1562_cov_112","Nsylvestris_NODE_34105_length_319_cov_3",98.551,276,4,0,311,586,31,306,7.28e-137,488,275,275
"51146","Ntome_NODE_15765_length_1562_cov_31","Nsylvestris_NODE_11917_length_1878_cov_211",100,55,0,0,1508,1562,743,797,1.11e-20,102,54,54
"51162","Ntome_NODE_15771_length_1561_cov_37","Nsylvestris_NODE_832_length_5189_cov_168",95.398,1521,65,3,45,1561,1619,100,0,2416,1516,1519
"51163","Ntome_NODE_15773_length_1561_cov_20","Nsylvestris_NODE_6379_length_2683_cov_93",93.43,1583,49,14,1,1561,1817,268,0,2296,1560,1549
"51209","Ntome_NODE_15795_length_1558_cov_277","Nsylvestris_NODE_17023_length_1355_cov_201",91.753,1358,62,14,157,1495,2,1328,0,1842,1338,1326
"51216","Ntome_NODE_15798_length_1558_cov_226","Nsylvestris_NODE_31088_length_446_cov_4",87.22,446,57,0,282,727,446,1,5.57e-143,508,445,445
"51217","Ntome_NODE_15799_length_1558_cov_172","Nsylvestris_NODE_29778_length_547_cov_9",90.179,560,40,7,948,1505,547,1,0,715,557,546
"51229","Ntome_NODE_15803_length_1558_cov_20","Nsylvestris_NODE_629_length_5633_cov_69",94.134,1398,78,2,161,1558,5245,3852,0,2124,1397,1393
"51246","Ntome_NODE_15809_length_1557_cov_18","Nsylvestris_NODE_2813_length_3657_cov_65",94.4,125,6,1,908,1031,997,1121,2.29e-47,191,123,124
"51271","Ntome_NODE_15819_length_1556_cov_160","Nsylvestris_NODE_5996_length_2761_cov_139",95.401,1435,56,7,78,1505,1232,2663,0,2276,1427,1431
"51331","Ntome_NODE_15841_length_1554_cov_190","Nsylvestris_NODE_17918_length_1275_cov_85",92.747,1227,54,10,59,1269,1275,68,0,1740,1210,1207
"51363","Ntome_NODE_15851_length_1553_cov_115","Nsylvestris_NODE_20770_length_1045_cov_21",76.993,439,65,16,758,1189,474,65,1.05e-55,219,431,409
"51392","Ntome_NODE_15866_length_1552_cov_10","Nsylvestris_NODE_5202_length_2925_cov_206",100,55,0,0,1,55,1041,1095,1.1e-20,102,54,54
"51428","Ntome_NODE_15881_length_1550_cov_45","Nsylvestris_NODE_13573_length_1699_cov_116",96.025,1459,34,8,105,1550,79,1526,0,2351,1445,1447
"51434","Ntome_NODE_15884_length_1549_cov_284","Nsylvestris_NODE_15501_length_1502_cov_218",94.331,1517,59,16,1,1506,2,1502,0,2300,1505,1500
"51459","Ntome_NODE_15891_length_1548_cov_297","Nsylvestris_NODE_12327_length_1834_cov_151",95.718,1051,29,5,130,1168,734,1780,0,1677,1038,1046
"51462","Ntome_NODE_15893_length_1548_cov_231","Nsylvestris_NODE_19435_length_1149_cov_192",97.196,856,24,0,293,1148,247,1102,0,1448,855,855
"51511","Ntome_NODE_15913_length_1546_cov_266","Nsylvestris_NODE_16516_length_1398_cov_201",94.565,1196,61,4,88,1281,1352,159,0,1845,1193,1193
"51526","Ntome_NODE_15918_length_1546_cov_14","Nsylvestris_NODE_1024_length_4907_cov_68",83.511,1310,187,22,164,1460,1319,26,0,1195,1296,1293
"51561","Ntome_NODE_15933_length_1544_cov_266","Nsylvestris_NODE_5712_length_2818_cov_127",97.759,1205,25,2,240,1443,1530,2733,0,2074,1203,1203
"51566","Ntome_NODE_15935_length_1544_cov_76","Nsylvestris_NODE_12362_length_1831_cov_127",97.899,238,5,0,305,542,331,568,4.45e-114,412,237,237
"51574","Ntome_NODE_15939_length_1543_cov_292","Nsylvestris_NODE_14168_length_1633_cov_226",97.197,1427,40,0,117,1543,81,1507,0,2414,1426,1426
"51582","Ntome_NODE_15943_length_1543_cov_146","Nsylvestris_NODE_13961_length_1655_cov_187",97.094,929,23,3,1,925,37,965,0,1563,924,928
"51583","Ntome_NODE_15944_length_1543_cov_136","Nsylvestris_NODE_15754_length_1474_cov_190",93.038,1422,62,11,72,1487,1474,84,0,2043,1415,1390
"51590","Ntome_NODE_15947_length_1543_cov_109","Nsylvestris_NODE_15903_length_1460_cov_59",93.675,1423,62,15,28,1439,4,1409,0,2104,1411,1405
"51593","Ntome_NODE_15949_length_1543_cov_45","Nsylvestris_NODE_6475_length_2665_cov_86",83.822,785,119,6,538,1318,1001,221,0,739,780,780
"51594","Ntome_NODE_15950_length_1543_cov_33","Nsylvestris_NODE_16484_length_1401_cov_82",94.375,1351,53,6,201,1529,1351,2,0,2052,1328,1349
"51595","Ntome_NODE_15951_length_1543_cov_33","Nsylvestris_NODE_10287_length_2077_cov_168",98.182,55,1,0,1489,1543,1348,1402,5.09e-19,97.1,54,54
"51602","Ntome_NODE_15954_length_1543_cov_9","Nsylvestris_NODE_7292_length_2520_cov_187",100,55,0,0,1489,1543,1653,1599,1.09e-20,102,54,54
"51603","Ntome_NODE_15955_length_1542_cov_264","Nsylvestris_NODE_7047_length_2562_cov_111",95.425,1552,57,6,1,1542,998,2545,0,2460,1541,1547
"51609","Ntome_NODE_15958_length_1542_cov_221","Nsylvestris_NODE_15261_length_1525_cov_167",92.333,1539,60,21,9,1523,21,1525,0,2135,1514,1504
"51625","Ntome_NODE_15966_length_1542_cov_7","Nsylvestris_NODE_18769_length_1205_cov_9",89.845,453,30,6,56,505,440,1,8.97e-161,568,449,439
"51628","Ntome_NODE_15968_length_1541_cov_240","Nsylvestris_NODE_2238_length_3919_cov_148",95.556,1215,49,3,58,1267,1301,87,0,1940,1209,1214
"51659","Ntome_NODE_15978_length_1540_cov_285","Nsylvestris_NODE_14907_length_1559_cov_196",94.609,1521,53,14,29,1540,1512,12,0,2327,1511,1500
"51684","Ntome_NODE_15988_length_1540_cov_13","Nsylvestris_NODE_29727_length_552_cov_9",86.087,230,31,1,605,834,256,28,4.77e-64,246,229,228
"51685","Ntome_NODE_15989_length_1540_cov_12","Nsylvestris_NODE_16636_length_1387_cov_230",100,55,0,0,1,55,882,936,1.09e-20,102,54,54
"51700","Ntome_NODE_15996_length_1539_cov_194","Nsylvestris_NODE_16182_length_1431_cov_173",88.603,1167,75,31,359,1490,225,1368,0,1365,1131,1143
"51715","Ntome_NODE_16003_length_1539_cov_15","Nsylvestris_NODE_6308_length_2696_cov_56",98.039,51,1,0,3,53,2207,2257,8.49e-17,89.8,50,50
"51723","Ntome_NODE_16006_length_1538_cov_250","Nsylvestris_NODE_11078_length_1979_cov_121",95.646,1401,52,6,2,1394,1979,580,0,2241,1392,1399
"51735","Ntome_NODE_16011_length_1538_cov_59","Nsylvestris_NODE_142_length_7860_cov_145",100,55,0,0,1,55,4684,4738,1.09e-20,102,54,54
"51747","Ntome_NODE_16016_length_1537_cov_308","Nsylvestris_NODE_1891_length_4124_cov_228",93.183,1555,82,14,1,1537,1299,2847,0,2263,1536,1548
"51748","Ntome_NODE_16017_length_1537_cov_281","Nsylvestris_NODE_4467_length_3106_cov_218",92.083,1440,64,20,62,1486,3,1407,0,1982,1424,1404
"51756","Ntome_NODE_16020_length_1537_cov_199","Nsylvestris_NODE_438_length_6143_cov_128",87.654,162,16,2,100,257,6143,5982,1.05e-45,185,157,161
"51775","Ntome_NODE_16027_length_1537_cov_72","Nsylvestris_NODE_17_length_12305_cov_44",83.2,1125,148,31,261,1369,5005,3906,0,992,1108,1099
"51780","Ntome_NODE_16030_length_1536_cov_288","Nsylvestris_NODE_13991_length_1650_cov_207",95.625,1440,54,5,48,1485,12,1444,0,2302,1437,1432
"51799","Ntome_NODE_16036_length_1536_cov_226","Nsylvestris_NODE_11250_length_1957_cov_20",94.304,1422,77,3,67,1487,38,1456,0,2174,1420,1418
"51803","Ntome_NODE_16038_length_1536_cov_180","Nsylvestris_NODE_4047_length_3218_cov_167",96.421,1481,52,1,57,1536,3073,1593,0,2440,1479,1480
"51804","Ntome_NODE_16039_length_1536_cov_64","Nsylvestris_NODE_15270_length_1524_cov_211",91.26,1476,84,21,98,1536,1496,29,0,1969,1438,1467
"51814","Ntome_NODE_16043_length_1536_cov_7","Nsylvestris_NODE_6657_length_2632_cov_214",83.929,56,7,2,559,613,2145,2199,1.11e-05,52.8,54,54
"51818","Ntome_NODE_16045_length_1535_cov_227","Nsylvestris_NODE_15954_length_1454_cov_179",88.973,1188,54,30,271,1420,1149,1,0,1397,1149,1148
"51824","Ntome_NODE_16048_length_1535_cov_158","Nsylvestris_NODE_15975_length_1451_cov_207",92.399,842,63,1,318,1158,358,1199,0,1199,840,841
"51849","Ntome_NODE_16055_length_1535_cov_18","Nsylvestris_NODE_6101_length_2737_cov_164",95.652,1495,62,2,1,1492,537,2031,0,2398,1491,1494
"51850","Ntome_NODE_16056_length_1536_cov_6","Nsylvestris_NODE_9605_length_2164_cov_121",78.197,1486,294,22,66,1536,1951,481,0,922,1470,1470
"51854","Ntome_NODE_16058_length_1534_cov_269","Nsylvestris_NODE_11559_length_1923_cov_179",94.049,1546,63,16,1,1534,233,1761,0,2318,1533,1528
"51863","Ntome_NODE_16062_length_1534_cov_192","Nsylvestris_NODE_18795_length_1202_cov_177",91.346,1144,47,9,165,1302,1147,50,0,1517,1137,1097
"51886","Ntome_NODE_16071_length_1533_cov_131","Nsylvestris_NODE_16509_length_1399_cov_37",93.88,1389,68,11,107,1491,1384,9,0,2078,1384,1375
"51893","Ntome_NODE_16074_length_1533_cov_50","Nsylvestris_NODE_26485_length_696_cov_229",88.333,60,7,0,1474,1533,372,431,8.52e-12,73.1,59,59
"51896","Ntome_NODE_16076_length_1532_cov_40","Nsylvestris_NODE_22446_length_925_cov_80",81.882,287,42,8,670,951,375,656,3.69e-60,233,281,281
"51897","Ntome_NODE_16077_length_1533_cov_25","Nsylvestris_NODE_14410_length_1609_cov_127",92.524,1351,82,8,148,1484,39,1384,0,1917,1336,1345
"51919","Ntome_NODE_16085_length_1532_cov_235","Nsylvestris_NODE_16594_length_1391_cov_215",95.078,1402,49,6,133,1525,1391,1,0,2189,1392,1390
"51938","Ntome_NODE_16092_length_1532_cov_24","Nsylvestris_NODE_8900_length_2263_cov_217",98.182,55,1,0,1,55,1232,1178,5.05e-19,97.1,54,54
"51939","Ntome_NODE_16093_length_1532_cov_5","Nsylvestris_NODE_12189_length_1849_cov_44",95.35,1527,66,5,9,1532,1741,217,0,2422,1523,1524
"51950","Ntome_NODE_16097_length_1531_cov_265","Nsylvestris_NODE_27699_length_642_cov_5",92.835,656,29,6,114,765,642,1,0,935,651,641
"51951","Ntome_NODE_16098_length_1531_cov_258","Nsylvestris_NODE_18035_length_1265_cov_66",95.78,1256,36,11,47,1288,1253,1,0,2010,1241,1252
"51952","Ntome_NODE_16099_length_1531_cov_154","Nsylvestris_NODE_23065_length_887_cov_30",96.519,833,29,0,251,1083,55,887,0,1378,832,832
"51956","Ntome_NODE_16101_length_1531_cov_102","Nsylvestris_NODE_24388_length_807_cov_208",95.736,469,16,4,50,516,731,265,0,752,466,466
"51968","Ntome_NODE_16104_length_1531_cov_14","Nsylvestris_NODE_1618_length_4317_cov_147",95.52,1451,52,7,6,1448,1653,208,0,2307,1442,1445
"51989","Ntome_NODE_16111_length_1530_cov_91","Nsylvestris_NODE_5537_length_2854_cov_180",87.719,57,2,5,1308,1363,2476,2528,1.84e-08,62.1,55,52
"51990","Ntome_NODE_16112_length_1530_cov_50","Nsylvestris_NODE_6370_length_2684_cov_235",98.182,55,1,0,1476,1530,2286,2340,5.05e-19,97.1,54,54
"51999","Ntome_NODE_16117_length_1529_cov_256","Nsylvestris_NODE_4406_length_3123_cov_134",96.184,1258,43,3,44,1298,45,1300,0,2052,1254,1255
"52016","Ntome_NODE_16123_length_1529_cov_149","Nsylvestris_NODE_2956_length_3601_cov_196",98.276,58,1,0,1,58,2347,2290,1.08e-20,102,57,57
"52022","Ntome_NODE_16126_length_1529_cov_49","Nsylvestris_NODE_9554_length_2169_cov_202",98.182,55,1,0,1,55,935,989,5.04e-19,97.1,54,54
"52023","Ntome_NODE_16127_length_1529_cov_25","Nsylvestris_NODE_16619_length_1390_cov_11",86.817,1373,159,13,116,1479,1360,1,0,1513,1363,1359
"52042","Ntome_NODE_16137_length_1527_cov_261","Nsylvestris_NODE_16153_length_1434_cov_220",94.788,1439,57,10,87,1513,1433,1,0,2226,1426,1432
"52072","Ntome_NODE_16150_length_1526_cov_193","Nsylvestris_NODE_14342_length_1615_cov_211",91.505,1542,97,18,1,1523,34,1560,0,2091,1522,1526
"52083","Ntome_NODE_16155_length_1526_cov_24","Nsylvestris_NODE_17844_length_1282_cov_188",100,55,0,0,1,55,640,694,1.08e-20,102,54,54
"52100","Ntome_NODE_16162_length_1525_cov_46","Nsylvestris_NODE_6780_length_2607_cov_150",91.059,425,33,4,1103,1525,1545,1966,2.47e-161,569,422,421
"52121","Ntome_NODE_16171_length_1524_cov_273","Nsylvestris_NODE_3084_length_3548_cov_216",97.001,1434,38,2,91,1524,1982,3410,0,2405,1433,1428
"52127","Ntome_NODE_16175_length_1524_cov_96","Nsylvestris_NODE_26851_length_680_cov_164",95.305,426,19,1,977,1402,249,673,0,675,425,424
"52140","Ntome_NODE_16181_length_1523_cov_65","Nsylvestris_NODE_3139_length_3531_cov_115",96.364,55,2,0,1469,1523,776,722,2.34e-17,91.6,54,54
"52159","Ntome_NODE_16186_length_1522_cov_195","Nsylvestris_NODE_8583_length_2312_cov_166",92.883,1391,56,14,150,1517,49,1419,0,1980,1367,1370
"52171","Ntome_NODE_16193_length_1521_cov_265","Nsylvestris_NODE_15786_length_1471_cov_201",93.333,1425,60,9,4,1402,56,1471,0,2073,1398,1415
"52172","Ntome_NODE_16194_length_1521_cov_238","Nsylvestris_NODE_16920_length_1363_cov_187",94.254,1340,50,13,118,1443,1327,1,0,2023,1325,1326
"52191","Ntome_NODE_16202_length_1521_cov_39","Nsylvestris_NODE_18025_length_1266_cov_21",94.239,1215,67,2,227,1438,1219,5,0,1853,1211,1214
"52214","Ntome_NODE_16211_length_1519_cov_84","Nsylvestris_NODE_26487_length_696_cov_190",92.593,459,30,3,1,457,13,469,0,656,456,456
"52222","Ntome_NODE_16214_length_1520_cov_16","Nsylvestris_NODE_18781_length_1203_cov_217",98.182,55,1,0,1,55,806,752,5.01e-19,97.1,54,54
"52250","Ntome_NODE_16223_length_1519_cov_104","Nsylvestris_NODE_1770_length_4196_cov_159",90.89,1460,64,30,96,1519,1093,2519,0,1895,1423,1426
"52251","Ntome_NODE_16224_length_1519_cov_81","Nsylvestris_NODE_16558_length_1395_cov_43",93.629,1397,67,9,106,1485,1392,1,0,2067,1379,1391
"52256","Ntome_NODE_16227_length_1518_cov_285","Nsylvestris_NODE_15377_length_1515_cov_213",93.656,1403,77,5,86,1479,78,1477,0,2087,1393,1399
"52257","Ntome_NODE_16228_length_1518_cov_243","Nsylvestris_NODE_16881_length_1366_cov_85",91.783,1363,68,22,57,1407,2,1332,0,1857,1350,1330
"52289","Ntome_NODE_16239_length_1517_cov_263","Nsylvestris_NODE_17021_length_1355_cov_219",88.889,729,77,3,545,1270,897,170,0,894,725,727
"52294","Ntome_NODE_16242_length_1517_cov_200","Nsylvestris_NODE_4885_length_2999_cov_182",97.897,523,11,0,874,1396,2323,2845,0,905,522,522
"52295","Ntome_NODE_16243_length_1517_cov_182","Nsylvestris_NODE_11673_length_1909_cov_117",90.533,676,42,17,1,665,715,51,0,874,664,664
"52302","Ntome_NODE_16248_length_1517_cov_19","Nsylvestris_NODE_631_length_5632_cov_168",100,53,0,0,1465,1517,1753,1701,1.39e-19,99,52,52
"52303","Ntome_NODE_16249_length_1517_cov_11","Nsylvestris_NODE_2920_length_3613_cov_81",96.513,1520,47,3,1,1517,1574,58,0,2508,1516,1516
"52328","Ntome_NODE_16257_length_1516_cov_98","Nsylvestris_NODE_23228_length_877_cov_26",92.281,881,44,6,233,1093,1,877,0,1229,860,876
"52336","Ntome_NODE_16261_length_1515_cov_259","Nsylvestris_NODE_3002_length_3587_cov_188",94.019,1438,59,20,34,1459,1,1423,0,2154,1425,1422
"52337","Ntome_NODE_16262_length_1515_cov_224","Nsylvestris_NODE_17272_length_1334_cov_218",91.673,1297,87,12,124,1415,54,1334,0,1777,1291,1280
"52344","Ntome_NODE_16265_length_1515_cov_80","Nsylvestris_NODE_30966_length_453_cov_117",100,47,0,0,1469,1515,216,170,3.01e-16,87.9,46,46
"52357","Ntome_NODE_16270_length_1515_cov_15","Nsylvestris_NODE_1855_length_4146_cov_224",96.61,59,1,1,1457,1515,2768,2825,5e-19,97.1,58,57
"52358","Ntome_NODE_16271_length_1515_cov_10","Nsylvestris_NODE_20555_length_1060_cov_211",96.61,59,1,1,1458,1515,504,562,5e-19,97.1,57,58
"52359","Ntome_NODE_16272_length_1515_cov_7","Nsylvestris_NODE_2854_length_3633_cov_160",91.667,96,8,0,762,857,3538,3633,3.81e-30,134,95,95
"52365","Ntome_NODE_16274_length_1514_cov_278","Nsylvestris_NODE_15541_length_1497_cov_205",92.516,1443,69,16,1,1440,1454,48,0,2030,1439,1406
"52377","Ntome_NODE_16279_length_1514_cov_120","Nsylvestris_NODE_14740_length_1575_cov_216",75.781,256,51,11,7,257,167,416,1.07e-25,119,250,249
"52378","Ntome_NODE_16280_length_1514_cov_85","Nsylvestris_NODE_14263_length_1623_cov_165",92.036,1444,87,10,71,1514,1579,164,0,2004,1443,1415
"52398","Ntome_NODE_16290_length_1513_cov_14","Nsylvestris_NODE_5801_length_2800_cov_45",94.297,1543,55,4,1,1513,1548,9,0,2331,1512,1539
"52420","Ntome_NODE_16298_length_1512_cov_130","Nsylvestris_NODE_14383_length_1612_cov_25",91.906,1495,92,13,29,1512,1612,136,0,2063,1483,1476
"52423","Ntome_NODE_16300_length_1512_cov_100","Nsylvestris_NODE_7824_length_2433_cov_104",96.685,1297,39,3,138,1432,1927,633,0,2154,1294,1294
"52432","Ntome_NODE_16303_length_1512_cov_62","Nsylvestris_NODE_16691_length_1382_cov_28",93.463,1392,66,7,46,1436,1374,7,0,2043,1390,1367
"52493","Ntome_NODE_16325_length_1510_cov_217","Nsylvestris_NODE_13372_length_1720_cov_185",97.105,1451,40,1,12,1462,112,1560,0,2446,1450,1448
"52512","Ntome_NODE_16332_length_1510_cov_81","Nsylvestris_NODE_14857_length_1564_cov_186",94.806,1444,58,9,1,1436,128,1562,0,2235,1435,1434
"52533","Ntome_NODE_16340_length_1509_cov_148","Nsylvestris_NODE_15854_length_1463_cov_196",94.354,1470,45,13,68,1506,1,1463,0,2220,1438,1462
"52543","Ntome_NODE_16344_length_1509_cov_53","Nsylvestris_NODE_19790_length_1118_cov_123",93.728,287,15,3,234,519,406,690,1.55e-118,427,285,284
"52550","Ntome_NODE_16347_length_1509_cov_33","Nsylvestris_NODE_19080_length_1177_cov_17",88.085,1175,86,19,251,1400,9,1154,0,1345,1149,1145
"52551","Ntome_NODE_16348_length_1509_cov_20","Nsylvestris_NODE_14393_length_1611_cov_35",93.305,1434,78,14,3,1428,1466,43,0,2100,1425,1423
"52570","Ntome_NODE_16355_length_1508_cov_229","Nsylvestris_NODE_18758_length_1205_cov_187",96.231,902,30,3,449,1350,266,1163,0,1474,901,897
"52622","Ntome_NODE_16372_length_1507_cov_165","Nsylvestris_NODE_33879_length_326_cov_3",88.327,257,19,6,683,930,313,59,1.27e-79,298,247,254
"52632","Ntome_NODE_16376_length_1507_cov_41","Nsylvestris_NODE_4953_length_2985_cov_127",96.364,55,2,0,1,55,2092,2038,2.31e-17,91.6,54,54
"52656","Ntome_NODE_16385_length_1506_cov_230","Nsylvestris_NODE_17339_length_1328_cov_167",93.622,1270,50,6,214,1481,88,1328,0,1868,1267,1240
"52668","Ntome_NODE_16389_length_1506_cov_49","Nsylvestris_NODE_14280_length_1622_cov_55",94.494,1453,59,8,58,1506,1599,164,0,2220,1448,1435
"52669","Ntome_NODE_16390_length_1506_cov_38","Nsylvestris_NODE_7228_length_2530_cov_59",95.42,1441,56,4,1,1432,938,2377,0,2287,1431,1439
"52676","Ntome_NODE_16392_length_1506_cov_10","Nsylvestris_NODE_7630_length_2466_cov_110",94.507,1511,66,8,9,1506,78,1584,0,2314,1497,1506
"52683","Ntome_NODE_16395_length_1503_cov_224","Nsylvestris_NODE_16843_length_1368_cov_223",94.737,1311,41,6,139,1434,1,1298,0,2013,1295,1297
"52684","Ntome_NODE_16396_length_1505_cov_180","Nsylvestris_NODE_16250_length_1420_cov_231",94.627,1005,36,6,1,1000,1076,85,0,1541,999,991
"52691","Ntome_NODE_16400_length_1505_cov_33","Nsylvestris_NODE_16030_length_1447_cov_34",91.566,1411,76,19,54,1435,20,1416,0,1906,1381,1396
"52700","Ntome_NODE_16404_length_1505_cov_10","Nsylvestris_NODE_28117_length_624_cov_6",96.491,627,19,1,454,1080,1,624,0,1033,626,623
"52701","Ntome_NODE_16405_length_1505_cov_8","Nsylvestris_NODE_851_length_5157_cov_67",85.34,648,90,3,114,761,2708,2066,0,665,647,642
"52713","Ntome_NODE_16409_length_1504_cov_267","Nsylvestris_NODE_11593_length_1920_cov_171",93.835,1330,47,13,43,1367,1877,578,0,1969,1324,1299
"52718","Ntome_NODE_16412_length_1504_cov_234","Nsylvestris_NODE_13929_length_1659_cov_140",95.218,1443,47,9,1,1439,234,1658,0,2263,1438,1424
"52743","Ntome_NODE_16422_length_1503_cov_127","Nsylvestris_NODE_16944_length_1361_cov_67",93.5,1277,69,10,188,1452,7,1281,0,1886,1264,1274
"52755","Ntome_NODE_16427_length_1503_cov_18","Nsylvestris_NODE_15700_length_1480_cov_79",94.01,1369,70,8,3,1364,68,1431,0,2063,1361,1363
"52765","Ntome_NODE_16433_length_1502_cov_257","Nsylvestris_NODE_14544_length_1595_cov_208",96.559,1395,42,4,92,1481,1545,152,0,2305,1389,1393
"52766","Ntome_NODE_16435_length_1502_cov_121","Nsylvestris_NODE_25_length_11258_cov_108",94.762,1451,50,14,1,1449,26,1452,0,2235,1448,1426
"52767","Ntome_NODE_16436_length_1502_cov_77","Nsylvestris_NODE_13436_length_1714_cov_46",94.547,1412,63,10,101,1501,1714,306,0,2169,1400,1408
"52784","Ntome_NODE_16443_length_1501_cov_238","Nsylvestris_NODE_14272_length_1622_cov_192",94.97,1491,53,15,11,1493,136,1612,0,2318,1482,1476
"52788","Ntome_NODE_16445_length_1501_cov_212","Nsylvestris_NODE_1228_length_4674_cov_126",78.182,660,86,41,855,1498,1326,1943,9.5e-101,368,643,617
"52792","Ntome_NODE_16447_length_1501_cov_154","Nsylvestris_NODE_17118_length_1347_cov_42",91.205,1319,103,7,67,1385,42,1347,0,1781,1318,1305
"52815","Ntome_NODE_16456_length_1501_cov_8","Nsylvestris_NODE_85_length_8745_cov_88",80.334,778,151,2,619,1395,2276,1500,6.7e-167,588,776,776
"52823","Ntome_NODE_16461_length_1500_cov_76","Nsylvestris_NODE_23386_length_867_cov_29",94.499,818,39,3,230,1044,5,819,0,1256,814,814
"52870","Ntome_NODE_16476_length_1498_cov_227","Nsylvestris_NODE_15420_length_1510_cov_218",93.667,1500,67,16,8,1498,1508,28,0,2218,1490,1480
"52882","Ntome_NODE_16481_length_1498_cov_98","Nsylvestris_NODE_16319_length_1417_cov_50",93.849,1203,51,7,45,1234,46,1238,0,1790,1189,1192
"52891","Ntome_NODE_16484_length_1497_cov_300","Nsylvestris_NODE_14560_length_1593_cov_198",95.917,1445,42,6,10,1446,10,1445,0,2326,1436,1435
"52892","Ntome_NODE_16485_length_1497_cov_271","Nsylvestris_NODE_13880_length_1665_cov_204",95.361,1509,44,10,1,1497,67,1561,0,2375,1496,1494
"52902","Ntome_NODE_16488_length_1497_cov_189","Nsylvestris_NODE_1868_length_4137_cov_64",93.276,1517,69,11,1,1489,34,1545,0,2206,1488,1511
"52913","Ntome_NODE_16493_length_1497_cov_68","Nsylvestris_NODE_12638_length_1801_cov_65",89.091,1320,143,1,173,1491,1656,337,0,1639,1318,1319
"52942","Ntome_NODE_16503_length_1496_cov_162","Nsylvestris_NODE_15999_length_1449_cov_144",93.191,1454,79,14,53,1491,1,1449,0,2119,1438,1448
"52963","Ntome_NODE_16512_length_1495_cov_121","Nsylvestris_NODE_151_length_7759_cov_74",89,100,9,2,1,99,2271,2369,8.13e-27,122,98,98
"52980","Ntome_NODE_16518_length_1494_cov_267","Nsylvestris_NODE_15273_length_1524_cov_173",80.342,117,17,3,477,593,573,683,3.83e-15,84.2,116,110
"53015","Ntome_NODE_16532_length_1493_cov_265","Nsylvestris_NODE_15103_length_1540_cov_198",92.55,1396,68,18,70,1451,1376,3,0,1969,1381,1373
"53016","Ntome_NODE_16533_length_1493_cov_234","Nsylvestris_NODE_18331_length_1238_cov_227",93.95,1157,48,13,21,1156,1204,49,0,1729,1135,1155
"53031","Ntome_NODE_16537_length_1493_cov_210","Nsylvestris_NODE_15952_length_1454_cov_223",90.973,1285,101,6,160,1444,1407,138,0,1716,1284,1269
"53038","Ntome_NODE_16541_length_1493_cov_99","Nsylvestris_NODE_17963_length_1271_cov_75",92.801,1014,54,5,367,1371,1081,78,0,1450,1004,1003
"53039","Ntome_NODE_16542_length_1493_cov_93","Nsylvestris_NODE_4667_length_3054_cov_49",94.785,767,35,3,212,974,1,766,0,1190,762,765
"53040","Ntome_NODE_16543_length_1493_cov_80","Nsylvestris_NODE_609_length_5688_cov_101",78.413,315,38,12,1,314,574,859,1.71e-43,178,313,285
"53053","Ntome_NODE_16548_length_1492_cov_87","Nsylvestris_NODE_3958_length_3246_cov_196",94.896,1352,40,10,98,1447,1868,3192,0,2087,1349,1324
"53057","Ntome_NODE_16551_length_1492_cov_10","Nsylvestris_NODE_14418_length_1609_cov_26",95.007,1402,56,6,1,1389,93,1493,0,2189,1388,1400
"53078","Ntome_NODE_16561_length_1490_cov_220","Nsylvestris_NODE_16673_length_1383_cov_167",93.083,1330,53,17,121,1414,54,1380,0,1910,1293,1326
"53083","Ntome_NODE_16563_length_1490_cov_122","Nsylvestris_NODE_1667_length_4274_cov_183",94.012,1286,52,5,165,1437,114,1387,0,1925,1272,1273
"53087","Ntome_NODE_16566_length_1490_cov_17","Nsylvestris_NODE_21396_length_999_cov_219",98.182,55,1,0,1436,1490,277,223,4.91e-19,97.1,54,54
"53088","Ntome_NODE_16567_length_1490_cov_15","Nsylvestris_NODE_5489_length_2864_cov_140",82.443,131,19,4,1049,1177,2131,2259,1.75e-23,111,128,128
"53094","Ntome_NODE_16571_length_1489_cov_276","Nsylvestris_NODE_11913_length_1879_cov_44",96.059,1421,48,5,77,1489,1,1421,0,2307,1412,1420
"53125","Ntome_NODE_16584_length_1488_cov_238","Nsylvestris_NODE_1864_length_4141_cov_78",96.519,1494,30,5,3,1488,1,1480,0,2451,1485,1479
"53132","Ntome_NODE_16588_length_1488_cov_13","Nsylvestris_NODE_378_length_6396_cov_152",86.801,1485,169,11,1,1483,1366,2825,0,1631,1482,1459
"53138","Ntome_NODE_16590_length_1487_cov_281","Nsylvestris_NODE_1145_length_4763_cov_178",91.515,1096,69,10,96,1167,55,1150,0,1487,1071,1095
"53150","Ntome_NODE_16594_length_1487_cov_203","Nsylvestris_NODE_16028_length_1447_cov_88",92.847,1370,74,6,1,1348,17,1384,0,1965,1347,1367
"53151","Ntome_NODE_16595_length_1487_cov_200","Nsylvestris_NODE_5552_length_2851_cov_91",95.597,1499,42,8,10,1487,1,1496,0,2381,1477,1495
"53156","Ntome_NODE_16598_length_1487_cov_129","Nsylvestris_NODE_5215_length_2923_cov_211",92,475,19,8,190,652,520,53,0,649,462,467
"53182","Ntome_NODE_16610_length_1485_cov_264","Nsylvestris_NODE_14761_length_1573_cov_214",93.542,1471,51,17,22,1459,1525,66,0,2150,1437,1459
"53190","Ntome_NODE_16613_length_1485_cov_142","Nsylvestris_NODE_15826_length_1466_cov_158",91.892,1369,73,14,114,1482,55,1385,0,1879,1368,1330
"53191","Ntome_NODE_16614_length_1485_cov_121","Nsylvestris_NODE_4116_length_3198_cov_97",97.159,1267,36,0,171,1437,1796,3062,0,2141,1266,1266
"53192","Ntome_NODE_16615_length_1485_cov_109","Nsylvestris_NODE_20484_length_1065_cov_209",88.443,424,49,0,49,472,358,781,4.1e-144,512,423,423
"53198","Ntome_NODE_16618_length_1485_cov_5","Nsylvestris_NODE_22267_length_938_cov_30",88.889,144,14,2,719,862,797,938,6.11e-43,176,143,141
"53244","Ntome_NODE_16635_length_1483_cov_146","Nsylvestris_NODE_17094_length_1349_cov_183",82.81,733,114,11,409,1136,225,950,0,645,727,725
"53245","Ntome_NODE_16637_length_1483_cov_14","Nsylvestris_NODE_7120_length_2550_cov_62",97.367,1481,39,0,3,1483,2169,689,0,2519,1480,1480
"53252","Ntome_NODE_16640_length_1483_cov_11","Nsylvestris_NODE_13633_length_1692_cov_118",98.182,55,1,0,1429,1483,981,1035,4.89e-19,97.1,54,54
"53317","Ntome_NODE_16662_length_1480_cov_150","Nsylvestris_NODE_3484_length_3406_cov_160",88.177,203,11,6,1291,1480,1,203,4.61e-59,230,189,202
"53328","Ntome_NODE_16666_length_1480_cov_71","Nsylvestris_NODE_15266_length_1525_cov_13",94.881,1387,65,3,51,1435,27,1409,0,2163,1384,1382
"53333","Ntome_NODE_16669_length_1479_cov_172","Nsylvestris_NODE_16553_length_1395_cov_151",91.753,1358,49,19,1,1311,1395,54,0,1829,1310,1341
"53351","Ntome_NODE_16678_length_1478_cov_178","Nsylvestris_NODE_12699_length_1795_cov_151",94.196,1430,52,11,73,1478,1,1423,0,2152,1405,1422
"53359","Ntome_NODE_16681_length_1478_cov_49","Nsylvestris_NODE_16115_length_1439_cov_10",90.593,489,44,1,121,607,8,496,0,647,486,488
"53360","Ntome_NODE_16682_length_1478_cov_32","Nsylvestris_NODE_13227_length_1736_cov_135",96.624,1481,45,2,2,1478,87,1566,0,2453,1476,1479
"53363","Ntome_NODE_16684_length_1477_cov_310","Nsylvestris_NODE_2459_length_3811_cov_233",95.947,1431,45,4,1,1429,2303,3722,0,2309,1428,1419
"53367","Ntome_NODE_16686_length_1477_cov_174","Nsylvestris_NODE_884_length_5107_cov_182",93.901,1410,60,11,50,1456,1417,31,0,2104,1406,1386
"53380","Ntome_NODE_16696_length_1477_cov_9","Nsylvestris_NODE_32293_length_382_cov_2",77.562,361,69,10,503,856,357,2,2.16e-52,207,353,355
"53383","Ntome_NODE_16698_length_1476_cov_299","Nsylvestris_NODE_1125_length_4786_cov_219",98.406,1380,17,4,98,1476,718,2093,0,2422,1378,1375
"53396","Ntome_NODE_16703_length_1476_cov_167","Nsylvestris_NODE_1916_length_4102_cov_137",96.583,1200,37,3,96,1295,2691,3886,0,1986,1199,1195
"53413","Ntome_NODE_16712_length_1476_cov_224","Nsylvestris_NODE_15411_length_1511_cov_215",94.626,1470,42,14,10,1473,1506,68,0,2242,1463,1438
"53425","Ntome_NODE_16718_length_1475_cov_38","Nsylvestris_NODE_19249_length_1164_cov_22",86.402,831,83,13,186,995,1122,301,0,881,809,821
"53488","Ntome_NODE_16742_length_1472_cov_20","Nsylvestris_NODE_30710_length_471_cov_2",90.726,496,16,9,860,1350,1,471,0,634,490,470
"53494","Ntome_NODE_16745_length_1471_cov_285","Nsylvestris_NODE_15887_length_1461_cov_206",97.222,1188,25,2,129,1311,1409,225,0,2004,1182,1184
"53499","Ntome_NODE_16747_length_1471_cov_104","Nsylvestris_NODE_35510_length_284_cov_3",92.281,285,20,2,639,922,284,1,2.55e-111,403,283,283
"53534","Ntome_NODE_16759_length_1470_cov_132","Nsylvestris_NODE_15466_length_1504_cov_37",94.524,694,34,4,598,1287,793,1486,0,1068,689,693
"53535","Ntome_NODE_16760_length_1470_cov_15","Nsylvestris_NODE_6329_length_2693_cov_22",96.046,1467,50,4,12,1470,2411,945,0,2381,1458,1466
"53540","Ntome_NODE_16762_length_1469_cov_238","Nsylvestris_NODE_11887_length_1881_cov_123",96.361,1319,31,3,1,1303,47,1364,0,2154,1302,1317
"53550","Ntome_NODE_16765_length_1469_cov_126","Nsylvestris_NODE_16057_length_1444_cov_96",96.157,1405,49,3,65,1466,3,1405,0,2290,1401,1402
"53569","Ntome_NODE_16772_length_1468_cov_322","Nsylvestris_NODE_99_length_8432_cov_163",98.229,1468,26,0,1,1468,5985,4518,0,2567,1467,1467
"53570","Ntome_NODE_16773_length_1468_cov_272","Nsylvestris_NODE_16119_length_1437_cov_213",95.507,1291,50,7,140,1426,140,1426,0,2056,1286,1286
"53574","Ntome_NODE_16775_length_1468_cov_221","Nsylvestris_NODE_17401_length_1322_cov_197",96.054,1267,36,7,77,1341,31,1285,0,2050,1264,1254
"53575","Ntome_NODE_16776_length_1468_cov_182","Nsylvestris_NODE_19686_length_1128_cov_119",93.607,1048,56,6,3,1046,38,1078,0,1554,1043,1040
"53578","Ntome_NODE_16778_length_1468_cov_90","Nsylvestris_NODE_27493_length_651_cov_191",96.364,55,2,0,1,55,327,273,2.25e-17,91.6,54,54
"53581","Ntome_NODE_16780_length_1468_cov_77","Nsylvestris_NODE_16091_length_1441_cov_149",95.672,1109,48,0,46,1154,1109,1,0,1783,1108,1108
"53584","Ntome_NODE_16782_length_1468_cov_32","Nsylvestris_NODE_31657_length_411_cov_3",95.62,411,18,0,80,490,411,1,0,660,410,410
"53609","Ntome_NODE_16790_length_1467_cov_184","Nsylvestris_NODE_333_length_6557_cov_206",94.093,1422,50,11,47,1464,5161,6552,0,2130,1417,1391
"53610","Ntome_NODE_16791_length_1467_cov_149","Nsylvestris_NODE_14209_length_1628_cov_143",97.825,1471,28,2,1,1467,119,1589,0,2536,1466,1470
"53641","Ntome_NODE_16803_length_1465_cov_263","Nsylvestris_NODE_17224_length_1338_cov_206",94.829,1315,38,5,152,1465,1297,12,0,2025,1313,1285
"53674","Ntome_NODE_16813_length_1465_cov_15","Nsylvestris_NODE_179_length_7502_cov_164",96.941,1471,31,5,9,1465,7344,5874,0,2455,1456,1470
"53680","Ntome_NODE_16816_length_1464_cov_189","Nsylvestris_NODE_15126_length_1537_cov_88",95.77,922,39,0,543,1464,1076,155,0,1487,921,921
"53685","Ntome_NODE_16818_length_1464_cov_77","Nsylvestris_NODE_4997_length_2973_cov_155",94.578,1457,55,8,1,1456,30,1463,0,2231,1455,1433
"53688","Ntome_NODE_16820_length_1464_cov_59","Nsylvestris_NODE_14497_length_1600_cov_208",91.565,1470,91,14,1,1450,22,1478,0,1997,1449,1456
"53697","Ntome_NODE_16823_length_1463_cov_178","Nsylvestris_NODE_15423_length_1510_cov_198",94.777,1436,58,6,1,1426,7,1435,0,2220,1425,1428
"53720","Ntome_NODE_16831_length_1462_cov_155","Nsylvestris_NODE_16265_length_1423_cov_142",95.485,1351,55,5,73,1419,1423,75,0,2152,1346,1348
"53726","Ntome_NODE_16834_length_1462_cov_50","Nsylvestris_NODE_14580_length_1591_cov_63",96.514,1463,49,2,1,1462,108,1569,0,2418,1461,1461
"53734","Ntome_NODE_16837_length_1461_cov_261","Nsylvestris_NODE_5438_length_2876_cov_210",91.289,1171,99,3,156,1324,1707,2876,0,1594,1168,1169
"53752","Ntome_NODE_16844_length_1461_cov_54","Nsylvestris_NODE_17742_length_1289_cov_186",79.059,1041,167,34,167,1188,76,1084,0,667,1021,1008
"53770","Ntome_NODE_16852_length_1460_cov_249","Nsylvestris_NODE_18030_length_1265_cov_212",96.598,1205,37,2,147,1348,50,1253,0,1995,1201,1203
"53773","Ntome_NODE_16854_length_1460_cov_187","Nsylvestris_NODE_30756_length_468_cov_6",94.977,219,11,0,323,541,394,176,1.56e-93,344,218,218
"53789","Ntome_NODE_16860_length_1460_cov_22","Nsylvestris_NODE_15591_length_1492_cov_7",94.136,1313,63,9,158,1460,15,1323,0,1986,1302,1308
"53790","Ntome_NODE_16861_length_1461_cov_12","Nsylvestris_NODE_13511_length_1705_cov_54",96.177,1465,49,6,1,1461,86,1547,0,2388,1460,1461
"53791","Ntome_NODE_16863_length_1459_cov_278","Nsylvestris_NODE_13024_length_1760_cov_200",94.231,52,3,0,1,52,581,632,4.84e-14,80.5,51,51
"53794","Ntome_NODE_16865_length_1459_cov_241","Nsylvestris_NODE_13398_length_1717_cov_148",94.721,1326,51,6,36,1351,1711,395,0,2043,1315,1316
"53805","Ntome_NODE_16869_length_1459_cov_86","Nsylvestris_NODE_14227_length_1626_cov_95",94.363,1295,72,1,125,1419,247,1540,0,1986,1294,1293
"53810","Ntome_NODE_16872_length_1459_cov_16","Nsylvestris_NODE_2081_length_4005_cov_81",92.647,68,5,0,275,342,791,724,1.34e-19,99,67,67
"53811","Ntome_NODE_16873_length_1459_cov_14","Nsylvestris_NODE_21148_length_1018_cov_209",100,55,0,0,1,55,700,646,1.03e-20,102,54,54
"53845","Ntome_NODE_16888_length_1457_cov_277","Nsylvestris_NODE_17512_length_1312_cov_136",91.692,1300,90,11,68,1357,1311,20,0,1786,1289,1291
"53846","Ntome_NODE_16889_length_1457_cov_195","Nsylvestris_NODE_17581_length_1305_cov_153",96.552,986,28,2,158,1137,986,1,0,1628,979,985
"53854","Ntome_NODE_16892_length_1457_cov_89","Nsylvestris_NODE_16521_length_1398_cov_56",94.44,1295,38,13,120,1392,66,1348,0,1962,1272,1282
"53855","Ntome_NODE_16893_length_1457_cov_73","Nsylvestris_NODE_16407_length_1409_cov_30",93.133,1296,55,11,51,1339,80,1348,0,1869,1288,1268
"53875","Ntome_NODE_16902_length_1456_cov_219","Nsylvestris_NODE_16790_length_1373_cov_182",90.523,1224,85,17,87,1300,1368,166,0,1589,1213,1202
"53905","Ntome_NODE_16908_length_1456_cov_108","Nsylvestris_NODE_8228_length_2367_cov_228",98.182,55,1,0,1,55,579,633,4.8e-19,97.1,54,54
"53926","Ntome_NODE_16916_length_1455_cov_266","Nsylvestris_NODE_14644_length_1584_cov_208",94.488,1397,54,11,62,1444,36,1423,0,2132,1382,1387
"53953","Ntome_NODE_16927_length_1454_cov_175","Nsylvestris_NODE_14831_length_1566_cov_139",94.33,1217,41,13,6,1210,366,1566,0,1840,1204,1200
"53957","Ntome_NODE_16929_length_1454_cov_69","Nsylvestris_NODE_30218_length_508_cov_6",94.892,509,20,2,815,1323,6,508,0,791,508,502
"53974","Ntome_NODE_16935_length_1453_cov_270","Nsylvestris_NODE_224_length_7162_cov_204",95.505,1357,43,10,103,1453,7161,5817,0,2152,1350,1344
"53988","Ntome_NODE_16940_length_1453_cov_134","Nsylvestris_NODE_16383_length_1411_cov_142",95.18,1307,43,11,163,1450,106,1411,0,2047,1287,1305
"53989","Ntome_NODE_16941_length_1453_cov_117","Nsylvestris_NODE_14997_length_1550_cov_184",96.835,1327,36,5,1,1325,1369,47,0,2213,1324,1322
"53990","Ntome_NODE_16942_length_1453_cov_90","Nsylvestris_NODE_10662_length_2030_cov_143",91.826,1468,81,8,25,1453,1500,33,0,2010,1428,1467
"53993","Ntome_NODE_16944_length_1453_cov_5","Nsylvestris_NODE_51_length_9473_cov_96",97.996,1447,29,0,1,1447,5078,6524,0,2512,1446,1446
"53994","Ntome_NODE_16945_length_1452_cov_290","Nsylvestris_NODE_758_length_5327_cov_190",97.508,1284,26,3,122,1401,3041,4322,0,2189,1279,1281
"54008","Ntome_NODE_16951_length_1452_cov_265","Nsylvestris_NODE_15805_length_1469_cov_169",92.515,1376,68,18,71,1421,85,1450,0,1938,1350,1365
"54011","Ntome_NODE_16953_length_1452_cov_193","Nsylvestris_NODE_3883_length_3272_cov_189",95.83,1175,46,3,213,1387,1220,49,0,1895,1174,1171
"54018","Ntome_NODE_16956_length_1452_cov_27","Nsylvestris_NODE_393_length_6311_cov_131",96.419,1452,48,3,1,1451,1449,1,0,2390,1450,1448
"54019","Ntome_NODE_16957_length_1452_cov_26","Nsylvestris_NODE_10215_length_2087_cov_15",91.837,441,24,6,1017,1452,38,471,6.43e-172,604,435,433
"54030","Ntome_NODE_16963_length_1451_cov_256","Nsylvestris_NODE_18216_length_1248_cov_208",92.314,1132,65,9,335,1444,1198,67,0,1589,1109,1131
"54036","Ntome_NODE_16966_length_1451_cov_236","Nsylvestris_NODE_17938_length_1273_cov_69",92.47,1235,68,13,184,1401,47,1273,0,1742,1217,1226
"54037","Ntome_NODE_16967_length_1451_cov_222","Nsylvestris_NODE_15855_length_1463_cov_192",94.508,1402,62,9,36,1426,1398,1,0,2148,1390,1397
"54055","Ntome_NODE_16973_length_1451_cov_105","Nsylvestris_NODE_5844_length_2793_cov_164",94.496,963,53,0,106,1068,2737,1775,0,1485,962,962
"54059","Ntome_NODE_16975_length_1451_cov_85","Nsylvestris_NODE_15630_length_1487_cov_112",89.706,1428,92,23,1,1400,73,1473,0,1772,1399,1400
"54066","Ntome_NODE_16979_length_1450_cov_275","Nsylvestris_NODE_15579_length_1492_cov_208",93.264,1440,63,6,11,1417,1,1439,0,2091,1406,1438
"54067","Ntome_NODE_16980_length_1449_cov_227","Nsylvestris_NODE_7188_length_2537_cov_91",89.583,768,45,14,109,860,2437,1689,0,942,751,748
"54068","Ntome_NODE_16981_length_1450_cov_224","Nsylvestris_NODE_8703_length_2294_cov_112",94.455,1028,35,8,386,1413,1234,2239,0,1563,1027,1005
"54090","Ntome_NODE_16990_length_1450_cov_74","Nsylvestris_NODE_16590_length_1392_cov_44",95.795,1403,36,12,1,1398,8,1392,0,2242,1397,1384
"54097","Ntome_NODE_16993_length_1449_cov_261","Nsylvestris_NODE_20934_length_1033_cov_66",95.896,999,36,2,378,1376,40,1033,0,1613,998,993
"54100","Ntome_NODE_16995_length_1449_cov_166","Nsylvestris_NODE_20539_length_1062_cov_33",92.691,944,50,5,405,1334,55,993,0,1343,929,938
"54110","Ntome_NODE_16999_length_1449_cov_9","Nsylvestris_NODE_14662_length_1583_cov_91",82.913,357,56,4,540,893,1063,709,3.37e-85,316,353,354
"54119","Ntome_NODE_17002_length_1448_cov_254","Nsylvestris_NODE_16550_length_1395_cov_186",95.399,1304,49,6,141,1441,1339,44,0,2065,1300,1295
"54126","Ntome_NODE_17005_length_1448_cov_103","Nsylvestris_NODE_10580_length_2040_cov_131",97.056,951,27,1,388,1337,580,1530,0,1600,949,950
"54162","Ntome_NODE_17017_length_1447_cov_89","Nsylvestris_NODE_25040_length_769_cov_144",96.715,274,5,3,606,875,491,218,2.46e-126,453,269,273
"54176","Ntome_NODE_17023_length_1446_cov_265","Nsylvestris_NODE_15142_length_1535_cov_214",94.078,1334,41,16,135,1446,1335,18,0,1991,1311,1317
"54179","Ntome_NODE_17025_length_1446_cov_207","Nsylvestris_NODE_18776_length_1204_cov_76",88.247,1021,84,12,249,1254,51,1050,0,1188,1005,999
"54180","Ntome_NODE_17026_length_1446_cov_186","Nsylvestris_NODE_14498_length_1600_cov_204",95.783,1399,56,2,47,1445,154,1549,0,2254,1398,1395
"54203","Ntome_NODE_17037_length_1444_cov_293","Nsylvestris_NODE_5878_length_2788_cov_216",96.5,1257,29,8,1,1244,1492,238,0,2063,1243,1254
"54219","Ntome_NODE_17043_length_1444_cov_96","Nsylvestris_NODE_10058_length_2109_cov_233",98.227,282,3,1,49,328,2109,1828,5.19e-138,492,279,281
"54222","Ntome_NODE_17046_length_1444_cov_11","Nsylvestris_NODE_12442_length_1822_cov_213",94.545,55,3,0,1,55,816,870,1.03e-15,86.1,54,54
"54223","Ntome_NODE_17047_length_1443_cov_301","Nsylvestris_NODE_2129_length_3973_cov_165",96.667,60,2,0,1,60,1939,1998,3.67e-20,100,59,59
"54249","Ntome_NODE_17056_length_1443_cov_88","Nsylvestris_NODE_15963_length_1453_cov_192",95.963,1288,39,6,147,1432,1407,131,0,2078,1285,1276
"54254","Ntome_NODE_17058_length_1443_cov_25","Nsylvestris_NODE_14870_length_1563_cov_190",80.925,173,28,5,225,393,176,347,1.3e-29,132,168,171
"54316","Ntome_NODE_17078_length_1441_cov_134","Nsylvestris_NODE_17490_length_1314_cov_144",94.118,1258,49,9,18,1264,1312,69,0,1890,1246,1243
"54319","Ntome_NODE_17080_length_1441_cov_114","Nsylvestris_NODE_17526_length_1311_cov_23",91.37,1321,73,21,102,1391,1,1311,0,1770,1289,1310
"54326","Ntome_NODE_17084_length_1441_cov_12","Nsylvestris_NODE_1098_length_4823_cov_132",88.889,81,8,1,243,323,1717,1638,1.32e-19,99,80,79
"54327","Ntome_NODE_17086_length_1441_cov_8","Nsylvestris_NODE_866_length_5142_cov_41",90.099,101,10,0,718,818,355,455,1.3e-29,132,100,100
"54328","Ntome_NODE_17087_length_1440_cov_295","Nsylvestris_NODE_13912_length_1661_cov_207",96.029,1108,38,1,339,1440,370,1477,0,1797,1101,1107
"54378","Ntome_NODE_17108_length_1438_cov_245","Nsylvestris_NODE_2388_length_3847_cov_109",95.682,1436,56,4,1,1435,1431,1,0,2303,1434,1430
"54387","Ntome_NODE_17114_length_1438_cov_87","Nsylvestris_NODE_11333_length_1948_cov_114",87.532,1171,88,23,53,1191,1193,49,0,1301,1138,1144
"54403","Ntome_NODE_17120_length_1438_cov_31","Nsylvestris_NODE_519_length_5903_cov_73",90.909,44,4,0,790,833,2075,2118,6.21e-08,60.2,43,43
"54404","Ntome_NODE_17121_length_1438_cov_26","Nsylvestris_NODE_6967_length_2574_cov_160",100,55,0,0,1384,1438,616,562,1.02e-20,102,54,54
"54432","Ntome_NODE_17134_length_1437_cov_8","Nsylvestris_NODE_14773_length_1573_cov_25",95.49,1419,59,3,16,1433,2,1416,0,2261,1417,1414
"54436","Ntome_NODE_17136_length_1437_cov_5","Nsylvestris_NODE_16157_length_1434_cov_46",96.97,33,0,1,862,894,675,706,2.89e-06,54.7,32,31
"54445","Ntome_NODE_17140_length_1436_cov_124","Nsylvestris_NODE_539_length_5843_cov_119",96.364,55,2,0,1382,1436,601,655,2.2e-17,91.6,54,54
"54521","Ntome_NODE_17165_length_1434_cov_62","Nsylvestris_NODE_1139_length_4768_cov_72",90.559,572,43,9,104,670,2456,3021,0,747,566,565
"54534","Ntome_NODE_17170_length_1433_cov_209","Nsylvestris_NODE_1740_length_4218_cov_204",95.635,1283,56,0,1,1283,2886,4168,0,2060,1282,1282
"54567","Ntome_NODE_17179_length_1432_cov_54","Nsylvestris_NODE_19497_length_1144_cov_17",78.67,797,147,17,170,949,171,961,5.11e-143,508,779,790
"54584","Ntome_NODE_17187_length_1431_cov_10","Nsylvestris_NODE_19828_length_1115_cov_42",98.182,55,1,0,1377,1431,640,694,4.71e-19,97.1,54,54
"54594","Ntome_NODE_17192_length_1430_cov_187","Nsylvestris_NODE_4791_length_3024_cov_123",93.027,1262,73,8,36,1287,2863,1607,0,1829,1251,1256
"54608","Ntome_NODE_17199_length_1430_cov_74","Nsylvestris_NODE_35054_length_294_cov_3",94.898,294,15,0,833,1126,294,1,1.45e-128,460,293,293
"54612","Ntome_NODE_17202_length_1429_cov_278","Nsylvestris_NODE_23436_length_864_cov_27",93.173,791,45,8,73,862,864,82,0,1153,789,782
"54624","Ntome_NODE_17208_length_1429_cov_224","Nsylvestris_NODE_24274_length_814_cov_24",94.286,35,2,0,195,229,769,803,2.87e-06,54.7,34,34
"54660","Ntome_NODE_17221_length_1428_cov_97","Nsylvestris_NODE_23680_length_850_cov_6",83.106,367,49,7,1035,1389,699,334,7.13e-87,322,354,365
"54677","Ntome_NODE_17229_length_1427_cov_187","Nsylvestris_NODE_13281_length_1730_cov_120",95.024,1266,62,1,124,1388,1356,91,0,1988,1264,1265
"54685","Ntome_NODE_17233_length_1427_cov_24","Nsylvestris_NODE_7419_length_2501_cov_221",81.863,1428,202,16,34,1423,1792,384,0,1149,1389,1408
"54692","Ntome_NODE_17236_length_1427_cov_14","Nsylvestris_NODE_33517_length_336_cov_4",84.132,334,50,3,298,629,335,3,2.56e-86,320,331,332
"54702","Ntome_NODE_17241_length_1426_cov_106","Nsylvestris_NODE_10182_length_2090_cov_228",94.268,314,18,0,50,363,2027,1714,1.11e-134,481,313,313
"54744","Ntome_NODE_17257_length_1424_cov_122","Nsylvestris_NODE_4332_length_3143_cov_193",87.532,385,33,10,806,1176,2322,2705,1.13e-119,431,370,383
"54745","Ntome_NODE_17258_length_1424_cov_114","Nsylvestris_NODE_16557_length_1395_cov_72",92.691,643,37,5,694,1332,674,1310,0,918,638,636
"54751","Ntome_NODE_17261_length_1424_cov_27","Nsylvestris_NODE_18106_length_1259_cov_73",92.683,41,1,2,28,67,89,128,2.21e-07,58.4,39,39
"54755","Ntome_NODE_17263_length_1424_cov_18","Nsylvestris_NODE_4403_length_3124_cov_234",93.421,76,1,3,1349,1424,646,717,6.02e-23,110,75,71
"54765","Ntome_NODE_17267_length_1423_cov_182","Nsylvestris_NODE_16189_length_1430_cov_195",94.018,1120,43,7,308,1408,133,1247,0,1676,1100,1114
"54786","Ntome_NODE_17275_length_1422_cov_253","Nsylvestris_NODE_16961_length_1360_cov_23",93.684,1045,66,0,298,1342,1095,51,0,1565,1044,1044
"54795","Ntome_NODE_17278_length_1422_cov_151","Nsylvestris_NODE_3040_length_3572_cov_53",89.587,653,59,8,1,646,2343,2993,0,821,645,650
"54801","Ntome_NODE_17281_length_1422_cov_48","Nsylvestris_NODE_25374_length_751_cov_7",89.578,758,40,11,502,1229,1,749,0,926,727,748
"54805","Ntome_NODE_17283_length_1422_cov_42","Nsylvestris_NODE_15853_length_1463_cov_209",88.988,1235,131,4,1,1234,1377,147,0,1522,1233,1230
"54809","Ntome_NODE_17286_length_1422_cov_9","Nsylvestris_NODE_7559_length_2476_cov_134",96.364,55,2,0,1368,1422,985,1039,2.18e-17,91.6,54,54
"54818","Ntome_NODE_17290_length_1421_cov_102","Nsylvestris_NODE_16568_length_1394_cov_113",95.424,1180,39,5,7,1178,1,1173,0,1866,1171,1172
"54819","Ntome_NODE_17291_length_1421_cov_91","Nsylvestris_NODE_2031_length_4032_cov_153",98.607,359,5,0,1,359,158,516,0,636,358,358
"54832","Ntome_NODE_17297_length_1420_cov_240","Nsylvestris_NODE_16302_length_1418_cov_154",90.943,1082,55,12,64,1114,9,1078,0,1415,1050,1069
"54833","Ntome_NODE_17298_length_1420_cov_228","Nsylvestris_NODE_16722_length_1379_cov_81",94.038,1258,63,10,173,1419,1337,81,0,1897,1246,1256
"54836","Ntome_NODE_17300_length_1420_cov_186","Nsylvestris_NODE_21021_length_1026_cov_208",100,55,0,0,1366,1420,378,324,1.01e-20,102,54,54
"54837","Ntome_NODE_17301_length_1420_cov_160","Nsylvestris_NODE_15322_length_1520_cov_27",93.433,670,36,3,393,1061,802,1464,0,987,668,662
"54851","Ntome_NODE_17308_length_1419_cov_271","Nsylvestris_NODE_2388_length_3847_cov_109",95.925,1276,47,3,149,1419,3841,2566,0,2063,1270,1275
"54861","Ntome_NODE_17313_length_1417_cov_91","Nsylvestris_NODE_19381_length_1153_cov_149",94.072,388,18,4,983,1370,665,283,8.17e-166,584,387,382
"54862","Ntome_NODE_17314_length_1419_cov_87","Nsylvestris_NODE_30309_length_502_cov_6",96.215,502,19,0,457,958,1,502,0,822,501,501
"54866","Ntome_NODE_17316_length_1419_cov_80","Nsylvestris_NODE_14964_length_1553_cov_192",94.077,1435,62,8,1,1419,1429,2,0,2158,1418,1427
"54895","Ntome_NODE_17330_length_1417_cov_278","Nsylvestris_NODE_17347_length_1327_cov_214",94.889,1311,45,9,35,1336,1,1298,0,2030,1301,1297
"54903","Ntome_NODE_17333_length_1417_cov_190","Nsylvestris_NODE_27569_length_648_cov_16",73.784,473,102,12,689,1152,462,3,3.51e-40,167,463,459
"54925","Ntome_NODE_17341_length_1417_cov_26","Nsylvestris_NODE_3853_length_3283_cov_147",95.161,62,2,1,1356,1417,616,676,4.67e-19,97.1,61,60
"54926","Ntome_NODE_17342_length_1417_cov_24","Nsylvestris_NODE_337_length_6530_cov_154",89.312,1469,50,21,4,1417,5726,4310,0,1744,1413,1416
"54927","Ntome_NODE_17343_length_1417_cov_20","Nsylvestris_NODE_15137_length_1536_cov_37",89.209,139,13,2,98,235,909,1046,7.54e-42,172,137,137
"54928","Ntome_NODE_17344_length_1417_cov_18","Nsylvestris_NODE_25596_length_739_cov_158",98.276,58,1,0,1,58,322,265,1e-20,102,57,57
"54929","Ntome_NODE_17345_length_1417_cov_12","Nsylvestris_NODE_630_length_5633_cov_27",92.032,1368,89,9,51,1417,4266,5614,0,1905,1366,1348
"54939","Ntome_NODE_17349_length_1416_cov_269","Nsylvestris_NODE_18474_length_1226_cov_159",93.054,1123,58,12,41,1156,1,1110,0,1624,1115,1109
"54940","Ntome_NODE_17350_length_1416_cov_265","Nsylvestris_NODE_13417_length_1715_cov_209",96.251,1387,48,2,32,1416,1,1385,0,2270,1384,1384
"54953","Ntome_NODE_17357_length_1416_cov_25","Nsylvestris_NODE_29612_length_559_cov_3",93.173,498,33,1,889,1386,62,558,0,730,497,496
"54976","Ntome_NODE_17366_length_1415_cov_146","Nsylvestris_NODE_11016_length_1986_cov_68",95.575,1017,38,5,30,1041,82,1096,0,1622,1011,1014
"54991","Ntome_NODE_17373_length_1415_cov_14","Nsylvestris_NODE_25669_length_736_cov_10",95.803,691,29,0,187,877,1,691,0,1116,690,690
"55005","Ntome_NODE_17377_length_1414_cov_118","Nsylvestris_NODE_1528_length_4374_cov_222",95.918,49,2,0,1,49,2379,2331,4.69e-14,80.5,48,48
"55012","Ntome_NODE_17380_length_1414_cov_51","Nsylvestris_NODE_12484_length_1817_cov_103",90.049,1417,79,26,23,1399,199,1593,0,1779,1376,1394
"55013","Ntome_NODE_17383_length_1414_cov_12","Nsylvestris_NODE_14606_length_1588_cov_159",95.504,1379,57,1,36,1409,1466,88,0,2198,1373,1378
"55038","Ntome_NODE_17395_length_1412_cov_122","Nsylvestris_NODE_3513_length_3394_cov_166",94.737,950,47,1,377,1323,2143,3092,0,1474,946,949
"55039","Ntome_NODE_17396_length_1412_cov_113","Nsylvestris_NODE_15677_length_1482_cov_214",96.21,1372,40,4,29,1388,1427,56,0,2235,1359,1371
"55042","Ntome_NODE_17398_length_1412_cov_63","Nsylvestris_NODE_27843_length_636_cov_12",86.19,420,45,8,68,480,24,437,5.18e-123,442,412,413
"55049","Ntome_NODE_17401_length_1412_cov_24","Nsylvestris_NODE_33311_length_342_cov_8",91.768,328,22,2,871,1194,342,16,8.61e-126,451,323,326
"55062","Ntome_NODE_17406_length_1411_cov_250","Nsylvestris_NODE_15716_length_1478_cov_182",92.044,817,47,2,264,1065,1471,658,0,1133,801,813
"55083","Ntome_NODE_17414_length_1411_cov_19","Nsylvestris_NODE_15501_length_1502_cov_218",98.077,52,1,0,1357,1408,395,446,2.16e-17,91.6,51,51
"55093","Ntome_NODE_17418_length_1410_cov_215","Nsylvestris_NODE_7297_length_2519_cov_226",98.182,55,0,1,1356,1410,349,296,1.67e-18,95.3,54,53
"55100","Ntome_NODE_17421_length_1411_cov_111","Nsylvestris_NODE_17041_length_1354_cov_24",95.174,1181,48,6,47,1221,1235,58,0,1857,1174,1177
"55110","Ntome_NODE_17425_length_1409_cov_271","Nsylvestris_NODE_3570_length_3374_cov_222",95.737,1337,45,4,1,1337,1741,3065,0,2143,1336,1324
"55124","Ntome_NODE_17431_length_1409_cov_115","Nsylvestris_NODE_14679_length_1581_cov_147",94.264,1046,57,3,1,1045,55,1098,0,1596,1044,1043
"55125","Ntome_NODE_17432_length_1409_cov_82","Nsylvestris_NODE_16595_length_1391_cov_211",96.04,1212,46,2,26,1237,1391,182,0,1971,1211,1209
"55126","Ntome_NODE_17433_length_1409_cov_74","Nsylvestris_NODE_19960_length_1106_cov_6",86.486,259,32,2,4,262,1042,787,1.19e-74,281,258,255
"55137","Ntome_NODE_17437_length_1408_cov_282","Nsylvestris_NODE_11315_length_1949_cov_188",94.366,994,53,3,291,1282,911,1903,0,1522,991,992
"55146","Ntome_NODE_17440_length_1408_cov_119","Nsylvestris_NODE_1649_length_4280_cov_111",93.168,1171,60,8,44,1199,2657,3822,0,1701,1155,1165
"55149","Ntome_NODE_17443_length_1408_cov_107","Nsylvestris_NODE_17836_length_1283_cov_62",91.713,1255,70,13,116,1357,1283,50,0,1711,1241,1233
"55160","Ntome_NODE_17453_length_1407_cov_198","Nsylvestris_NODE_15127_length_1537_cov_17",88.953,1222,73,24,1,1164,251,1468,0,1452,1163,1217
"55161","Ntome_NODE_17454_length_1407_cov_130","Nsylvestris_NODE_6848_length_2594_cov_156",98.276,58,1,0,1,58,1584,1527,9.96e-21,102,57,57
"55181","Ntome_NODE_17463_length_1406_cov_265","Nsylvestris_NODE_15212_length_1530_cov_195",93.38,1420,61,21,1,1406,52,1452,0,2071,1405,1400
"55192","Ntome_NODE_17467_length_1406_cov_172","Nsylvestris_NODE_17703_length_1294_cov_59",93.937,1270,77,0,105,1374,1,1270,0,1919,1269,1269
"55199","Ntome_NODE_17470_length_1406_cov_47","Nsylvestris_NODE_19475_length_1146_cov_9",90.614,1172,83,8,150,1321,1145,1,0,1530,1171,1144
"55203","Ntome_NODE_17472_length_1406_cov_28","Nsylvestris_NODE_14684_length_1581_cov_11",94.776,1359,66,3,51,1406,1558,202,0,2111,1355,1356
"55241","Ntome_NODE_17488_length_1404_cov_270","Nsylvestris_NODE_16630_length_1388_cov_190",94.349,1398,62,9,1,1391,1,1388,0,2128,1390,1387
"55255","Ntome_NODE_17493_length_1404_cov_141","Nsylvestris_NODE_19395_length_1152_cov_149",96.364,55,2,0,1,55,635,581,2.15e-17,91.6,54,54
"55258","Ntome_NODE_17495_length_1404_cov_45","Nsylvestris_NODE_128_length_8068_cov_85",94.286,70,0,3,1,66,6515,6446,2.76e-21,104,65,69
"55265","Ntome_NODE_17498_length_1404_cov_6","Nsylvestris_NODE_30890_length_458_cov_7",96.507,458,16,0,494,951,458,1,0,758,457,457
"55266","Ntome_NODE_17499_length_1403_cov_258","Nsylvestris_NODE_16310_length_1418_cov_187",96.814,1287,34,4,71,1356,1414,134,0,2143,1285,1280
"55278","Ntome_NODE_17503_length_1403_cov_76","Nsylvestris_NODE_20109_length_1093_cov_116",96.332,1036,34,2,1,1033,13,1047,0,1700,1032,1034
"55282","Ntome_NODE_17506_length_1403_cov_12","Nsylvestris_NODE_1559_length_4355_cov_163",91.935,62,5,0,57,118,825,764,2.78e-16,87.9,61,61
"55283","Ntome_NODE_17507_length_1403_cov_8","Nsylvestris_NODE_14662_length_1583_cov_91",91.153,373,33,0,584,956,1081,709,1.8e-142,507,372,372
"55342","Ntome_NODE_17527_length_1400_cov_15","Nsylvestris_NODE_15969_length_1452_cov_161",100,55,0,0,1,55,975,1029,9.91e-21,102,54,54
"55365","Ntome_NODE_17535_length_1399_cov_259","Nsylvestris_NODE_14423_length_1608_cov_152",95.227,1299,48,8,64,1359,1397,110,0,2043,1295,1287
"55379","Ntome_NODE_17540_length_1399_cov_143","Nsylvestris_NODE_1773_length_4192_cov_183",94.832,1103,54,1,218,1317,3043,4145,0,1718,1099,1102
"55404","Ntome_NODE_17549_length_1398_cov_110","Nsylvestris_NODE_23020_length_889_cov_48",86.722,851,44,24,82,891,877,55,0,881,809,822
"55405","Ntome_NODE_17550_length_1398_cov_46","Nsylvestris_NODE_21034_length_1026_cov_21",95.738,1009,30,3,397,1396,1005,1,0,1613,999,1004
"55423","Ntome_NODE_17556_length_1397_cov_199","Nsylvestris_NODE_7156_length_2542_cov_197",93.609,1283,58,10,119,1391,1208,2476,0,1893,1272,1268
"55426","Ntome_NODE_17558_length_1397_cov_127","Nsylvestris_NODE_14818_length_1567_cov_220",94.855,1380,67,2,4,1379,1436,57,0,2152,1375,1379
"55438","Ntome_NODE_17563_length_1396_cov_252","Nsylvestris_NODE_17496_length_1313_cov_211",91.176,1292,79,17,107,1391,1313,50,0,1722,1284,1263
"55450","Ntome_NODE_17566_length_1396_cov_196","Nsylvestris_NODE_14458_length_1604_cov_147",96.246,1039,31,5,200,1233,1507,472,0,1696,1033,1035
"55455","Ntome_NODE_17568_length_1396_cov_92","Nsylvestris_NODE_4393_length_3128_cov_96",84.483,116,14,3,1057,1170,1026,1139,1.64e-23,111,113,113
"55456","Ntome_NODE_17569_length_1396_cov_34","Nsylvestris_NODE_16370_length_1413_cov_27",95.396,1390,51,7,19,1396,1,1389,0,2200,1377,1388
"55457","Ntome_NODE_17570_length_1396_cov_33","Nsylvestris_NODE_16927_length_1363_cov_15",95.158,1363,60,3,1,1357,1363,1,0,2146,1356,1362
"55461","Ntome_NODE_17572_length_1396_cov_11","Nsylvestris_NODE_1390_length_4504_cov_41",89.042,1451,74,19,3,1396,3745,2323,0,1720,1393,1422
"55462","Ntome_NODE_17573_length_1395_cov_292","Nsylvestris_NODE_18063_length_1262_cov_227",96.67,1051,24,4,348,1395,48,1090,0,1736,1047,1042
"55466","Ntome_NODE_17575_length_1395_cov_288","Nsylvestris_NODE_15080_length_1543_cov_181",92.415,1292,61,16,2,1277,1517,247,0,1808,1275,1270
"55474","Ntome_NODE_17578_length_1395_cov_254","Nsylvestris_NODE_17452_length_1318_cov_142",94.03,67,4,0,158,224,526,592,9.87e-21,102,66,66
"55475","Ntome_NODE_17579_length_1395_cov_210","Nsylvestris_NODE_20035_length_1099_cov_151",92.115,1078,42,12,1,1069,1044,1,0,1480,1068,1043
"55488","Ntome_NODE_17583_length_1395_cov_16","Nsylvestris_NODE_3057_length_3564_cov_131",94.842,1396,70,2,1,1395,2384,990,0,2178,1394,1394
"55501","Ntome_NODE_17589_length_1394_cov_133","Nsylvestris_NODE_20260_length_1082_cov_34",95.481,1018,40,4,214,1229,1082,69,0,1620,1015,1013
"55516","Ntome_NODE_17594_length_1394_cov_47","Nsylvestris_NODE_9745_length_2147_cov_156",96.892,740,23,0,109,848,2051,1312,0,1240,739,739
"55522","Ntome_NODE_17597_length_1394_cov_18","Nsylvestris_NODE_17923_length_1275_cov_35",93.064,1211,77,5,2,1211,35,1239,0,1764,1209,1204
"55523","Ntome_NODE_17598_length_1394_cov_12","Nsylvestris_NODE_579_length_5752_cov_158",100,55,0,0,1340,1394,1347,1401,9.86e-21,102,54,54
"55526","Ntome_NODE_17600_length_1394_cov_7","Nsylvestris_NODE_23944_length_836_cov_4",96.292,836,31,0,273,1108,836,1,0,1373,835,835
"55537","Ntome_NODE_17604_length_1393_cov_221","Nsylvestris_NODE_19656_length_1130_cov_207",94.711,1021,51,2,243,1263,1068,51,0,1583,1020,1017
"55543","Ntome_NODE_17606_length_1393_cov_136","Nsylvestris_NODE_25351_length_752_cov_37",93.584,717,26,6,402,1117,752,55,0,1051,715,697
"55544","Ntome_NODE_17607_length_1393_cov_87","Nsylvestris_NODE_29553_length_561_cov_12",78.696,230,40,5,137,360,49,275,1.61e-33,145,223,226
"55551","Ntome_NODE_17610_length_1393_cov_7","Nsylvestris_NODE_1694_length_4258_cov_26",99.067,1393,13,0,1,1393,354,1746,0,2501,1392,1392
"55564","Ntome_NODE_17615_length_1392_cov_61","Nsylvestris_NODE_17591_length_1304_cov_157",94.768,1166,59,2,214,1378,96,1260,0,1814,1164,1164
"55568","Ntome_NODE_17617_length_1392_cov_36","Nsylvestris_NODE_17928_length_1274_cov_201",95.676,185,8,0,1,185,265,81,1.17e-79,298,184,184
"55569","Ntome_NODE_17618_length_1392_cov_20","Nsylvestris_NODE_4933_length_2990_cov_21",95.291,1338,52,7,54,1382,1655,2990,0,2111,1328,1335
"55572","Ntome_NODE_17620_length_1392_cov_8","Nsylvestris_NODE_7519_length_2483_cov_122",93.563,1134,65,6,260,1392,1331,2457,0,1683,1132,1126
"55573","Ntome_NODE_17621_length_1391_cov_279","Nsylvestris_NODE_13901_length_1661_cov_177",94.939,1304,31,13,90,1388,1438,165,0,2010,1298,1273
"55586","Ntome_NODE_17625_length_1391_cov_80","Nsylvestris_NODE_13578_length_1698_cov_210",88.235,595,67,1,210,801,213,807,0,708,591,594
"55590","Ntome_NODE_17627_length_1391_cov_27","Nsylvestris_NODE_25037_length_769_cov_218",100,55,0,0,1337,1391,325,379,9.84e-21,102,54,54
"55591","Ntome_NODE_17629_length_1391_cov_7","Nsylvestris_NODE_3324_length_3466_cov_219",98.182,55,1,0,1337,1391,290,344,4.58e-19,97.1,54,54
"55599","Ntome_NODE_17632_length_1390_cov_190","Nsylvestris_NODE_17198_length_1340_cov_194",92.241,1147,54,13,1,1143,1,1116,0,1592,1142,1115
"55608","Ntome_NODE_17635_length_1390_cov_53","Nsylvestris_NODE_88_length_8639_cov_233",100,55,0,0,1,55,1620,1566,9.84e-21,102,54,54
"55609","Ntome_NODE_17636_length_1390_cov_12","Nsylvestris_NODE_11700_length_1905_cov_129",94.564,1398,64,5,1,1389,1420,26,0,2150,1388,1394
"55634","Ntome_NODE_17642_length_1389_cov_147","Nsylvestris_NODE_2087_length_4002_cov_188",96.912,1263,27,5,128,1389,1637,386,0,2106,1261,1251
"55635","Ntome_NODE_17643_length_1389_cov_145","Nsylvestris_NODE_15400_length_1512_cov_184",92.006,1301,67,22,59,1346,1337,61,0,1792,1287,1276
"55639","Ntome_NODE_17645_length_1389_cov_49","Nsylvestris_NODE_37098_length_250_cov_1",97.794,136,3,0,1008,1143,20,155,9.29e-61,235,135,135
"55653","Ntome_NODE_17650_length_1388_cov_161","Nsylvestris_NODE_13301_length_1728_cov_177",92.632,1398,52,15,13,1388,5,1373,0,1964,1375,1368
"55654","Ntome_NODE_17651_length_1388_cov_142","Nsylvestris_NODE_793_length_5250_cov_202",96.127,1162,37,3,99,1260,48,1201,0,1890,1161,1153
"55695","Ntome_NODE_17664_length_1387_cov_25","Nsylvestris_NODE_16705_length_1381_cov_22",95.977,1367,51,2,1,1367,1369,7,0,2217,1366,1362
"55700","Ntome_NODE_17666_length_1387_cov_20","Nsylvestris_NODE_15166_length_1534_cov_47",94.317,1390,53,7,1,1384,1396,27,0,2106,1383,1369
"55715","Ntome_NODE_17673_length_1386_cov_240","Nsylvestris_NODE_11654_length_1913_cov_152",95.671,1132,37,7,161,1283,680,1808,0,1808,1122,1128
"55716","Ntome_NODE_17674_length_1386_cov_83","Nsylvestris_NODE_16739_length_1377_cov_208",93.285,1236,78,5,16,1249,89,1321,0,1818,1233,1232
"55728","Ntome_NODE_17678_length_1386_cov_14","Nsylvestris_NODE_36605_length_260_cov_2",89.231,260,27,1,608,867,259,1,1.92e-87,324,259,258
"55731","Ntome_NODE_17680_length_1385_cov_248","Nsylvestris_NODE_12736_length_1792_cov_181",91.13,1398,96,12,1,1380,1792,405,0,1869,1379,1387
"55754","Ntome_NODE_17688_length_1385_cov_72","Nsylvestris_NODE_30860_length_460_cov_6",96.087,460,18,0,751,1210,460,1,0,750,459,459
"55767","Ntome_NODE_17693_length_1384_cov_288","Nsylvestris_NODE_4360_length_3137_cov_137",93.074,1155,67,8,82,1232,3113,1968,0,1677,1150,1145
"55777","Ntome_NODE_17697_length_1384_cov_252","Nsylvestris_NODE_17295_length_1332_cov_186",88.898,1180,79,14,177,1334,162,1311,0,1406,1157,1149
"55784","Ntome_NODE_17699_length_1384_cov_173","Nsylvestris_NODE_5221_length_2922_cov_157",94.378,747,30,10,594,1337,567,1304,0,1136,743,737
"55797","Ntome_NODE_17706_length_1383_cov_232","Nsylvestris_NODE_6870_length_2590_cov_179",95.671,1178,43,5,59,1236,1194,25,0,1886,1177,1169
"55805","Ntome_NODE_17708_length_1383_cov_82","Nsylvestris_NODE_21609_length_984_cov_46",80.435,322,34,13,130,443,1,301,9.31e-56,219,313,300
"55818","Ntome_NODE_17714_length_1382_cov_204","Nsylvestris_NODE_20477_length_1066_cov_148",89.645,1043,72,12,282,1323,57,1064,0,1295,1041,1007
"55823","Ntome_NODE_17717_length_1382_cov_156","Nsylvestris_NODE_12426_length_1823_cov_138",93.21,1296,64,4,57,1333,195,1485,0,1884,1276,1290
"55827","Ntome_NODE_17720_length_1381_cov_275","Nsylvestris_NODE_15816_length_1467_cov_200",90.159,1382,78,21,1,1360,83,1428,0,1746,1359,1345
"55849","Ntome_NODE_17728_length_1381_cov_52","Nsylvestris_NODE_14845_length_1565_cov_99",94.137,1245,48,2,54,1298,290,1509,0,1871,1244,1219
"55853","Ntome_NODE_17730_length_1381_cov_20","Nsylvestris_NODE_4015_length_3229_cov_196",93.449,1328,59,7,1,1328,147,1446,0,1945,1327,1299
"55863","Ntome_NODE_17734_length_1381_cov_7","Nsylvestris_NODE_20015_length_1102_cov_9",94.701,736,37,2,1,734,243,978,0,1142,733,735
"55880","Ntome_NODE_17741_length_1380_cov_220","Nsylvestris_NODE_21134_length_1019_cov_152",93.242,947,42,10,380,1321,968,39,0,1375,941,929
"55894","Ntome_NODE_17746_length_1380_cov_33","Nsylvestris_NODE_15464_length_1505_cov_123",74.884,430,85,17,804,1213,808,1234,2.04e-42,174,409,426
"55922","Ntome_NODE_17754_length_1379_cov_120","Nsylvestris_NODE_15602_length_1490_cov_178",95.95,1284,34,4,53,1335,78,1344,0,2067,1282,1266
"55961","Ntome_NODE_17769_length_1377_cov_115","Nsylvestris_NODE_18129_length_1256_cov_59",89.168,1274,59,28,107,1345,4,1233,0,1515,1238,1229
"55965","Ntome_NODE_17771_length_1377_cov_74","Nsylvestris_NODE_1960_length_4077_cov_162",95.404,718,32,1,152,869,3361,4077,0,1142,717,716
"55966","Ntome_NODE_17773_length_1377_cov_51","Nsylvestris_NODE_3809_length_3297_cov_181",91.351,1318,64,17,52,1363,2024,3297,0,1757,1311,1273
"55967","Ntome_NODE_17774_length_1377_cov_49","Nsylvestris_NODE_7609_length_2469_cov_205",100,55,0,0,1323,1377,1317,1371,9.74e-21,102,54,54
"55988","Ntome_NODE_17781_length_1376_cov_231","Nsylvestris_NODE_17890_length_1277_cov_218",96.653,1255,42,0,90,1344,1,1255,0,2085,1254,1254
"55995","Ntome_NODE_17784_length_1376_cov_114","Nsylvestris_NODE_18186_length_1251_cov_205",94.477,1195,54,6,53,1241,1204,16,0,1831,1188,1188
"56002","Ntome_NODE_17789_length_1376_cov_7","Nsylvestris_NODE_8052_length_2394_cov_115",92.718,1181,65,6,217,1376,1113,2293,0,1685,1159,1180
"56013","Ntome_NODE_17793_length_1375_cov_159","Nsylvestris_NODE_11782_length_1895_cov_172",94.809,1098,54,1,9,1103,423,1520,0,1709,1094,1097
"56021","Ntome_NODE_17796_length_1375_cov_45","Nsylvestris_NODE_3410_length_3434_cov_56",98.182,55,1,0,1,55,217,163,4.53e-19,97.1,54,54
"56029","Ntome_NODE_17799_length_1375_cov_11","Nsylvestris_NODE_3122_length_3536_cov_149",98.182,55,1,0,1321,1375,190,244,4.53e-19,97.1,54,54
"56043","Ntome_NODE_17806_length_1374_cov_48","Nsylvestris_NODE_16510_length_1399_cov_27",91.089,1313,55,20,5,1274,79,1372,0,1720,1269,1293
"56044","Ntome_NODE_17809_length_1374_cov_8","Nsylvestris_NODE_3173_length_3518_cov_50",94.452,1388,52,10,1,1374,3080,1704,0,2113,1373,1376
"56045","Ntome_NODE_17810_length_1373_cov_163","Nsylvestris_NODE_21366_length_1002_cov_61",90.594,893,28,9,47,935,890,50,0,1133,888,840
"56049","Ntome_NODE_17812_length_1373_cov_133","Nsylvestris_NODE_19342_length_1156_cov_98",91.144,1005,52,19,359,1332,1140,142,0,1328,973,998
"56068","Ntome_NODE_17818_length_1373_cov_82","Nsylvestris_NODE_17353_length_1327_cov_79",91.762,1311,62,20,1,1290,1325,40,0,1781,1289,1285
"56069","Ntome_NODE_17819_length_1373_cov_48","Nsylvestris_NODE_14507_length_1599_cov_136",96.8,1375,28,5,1,1373,71,1431,0,2281,1372,1360
"56085","Ntome_NODE_17826_length_1372_cov_284","Nsylvestris_NODE_17403_length_1322_cov_162",93.82,1246,57,9,69,1309,1272,42,0,1857,1240,1230
"56131","Ntome_NODE_17842_length_1371_cov_269","Nsylvestris_NODE_17451_length_1318_cov_181",91.25,1280,53,16,78,1338,27,1266,0,1688,1260,1239
"56132","Ntome_NODE_17843_length_1371_cov_268","Nsylvestris_NODE_11899_length_1880_cov_154",92.07,1135,62,13,221,1352,771,1880,0,1572,1131,1109
"56153","Ntome_NODE_17850_length_1371_cov_23","Nsylvestris_NODE_17199_length_1340_cov_190",98.077,52,1,0,1317,1368,253,202,2.1e-17,91.6,51,51
"56157","Ntome_NODE_17852_length_1371_cov_13","Nsylvestris_NODE_1313_length_4584_cov_150",93.271,1382,82,2,1,1371,3091,4472,0,2026,1370,1381
"56166","Ntome_NODE_17856_length_1370_cov_211","Nsylvestris_NODE_16108_length_1439_cov_106",96.88,1282,33,5,1,1276,1281,1,0,2139,1275,1280
"56167","Ntome_NODE_17857_length_1370_cov_205","Nsylvestris_NODE_19436_length_1149_cov_180",95.462,1146,44,5,132,1272,1,1143,0,1821,1140,1142
"56174","Ntome_NODE_17860_length_1370_cov_114","Nsylvestris_NODE_36518_length_262_cov_3",96.109,257,10,0,646,902,6,262,2.36e-116,420,256,256
"56177","Ntome_NODE_17862_length_1370_cov_72","Nsylvestris_NODE_24034_length_830_cov_61",93.564,606,36,1,668,1270,50,655,0,900,602,605
"56183","Ntome_NODE_17865_length_1370_cov_9","Nsylvestris_NODE_35021_length_295_cov_3",93.421,304,11,2,656,959,295,1,5.03e-123,442,303,294
"56192","Ntome_NODE_17868_length_1369_cov_277","Nsylvestris_NODE_5484_length_2865_cov_133",86.028,1138,140,11,204,1339,2645,1525,0,1203,1135,1120
"56247","Ntome_NODE_17886_length_1368_cov_15","Nsylvestris_NODE_1453_length_4445_cov_232",100,55,0,0,1314,1368,998,944,9.68e-21,102,54,54
"56248","Ntome_NODE_17887_length_1368_cov_10","Nsylvestris_NODE_18932_length_1189_cov_142",98.182,55,1,0,1,55,74,128,4.5e-19,97.1,54,54
"56251","Ntome_NODE_17890_length_1367_cov_202","Nsylvestris_NODE_16367_length_1413_cov_145",91.464,1277,62,18,124,1360,1310,41,0,1711,1236,1269
"56256","Ntome_NODE_17892_length_1367_cov_141","Nsylvestris_NODE_16931_length_1362_cov_172",92.188,1216,79,10,108,1318,1208,4,0,1705,1210,1204
"56257","Ntome_NODE_17893_length_1367_cov_88","Nsylvestris_NODE_16609_length_1390_cov_209",92.53,1352,56,17,8,1318,1,1348,0,1895,1310,1347
"56265","Ntome_NODE_17897_length_1367_cov_12","Nsylvestris_NODE_6652_length_2633_cov_146",86.611,1083,139,6,54,1133,2538,1459,0,1192,1079,1079
"56271","Ntome_NODE_17899_length_1366_cov_210","Nsylvestris_NODE_1025_length_4904_cov_160",91.55,1361,81,20,1,1347,2144,3484,0,1845,1346,1340
"56275","Ntome_NODE_17902_length_1366_cov_183","Nsylvestris_NODE_8461_length_2330_cov_124",93.322,1213,45,13,2,1201,11,1200,0,1759,1199,1189
"56294","Ntome_NODE_17910_length_1365_cov_231","Nsylvestris_NODE_8123_length_2384_cov_47",96.524,633,22,0,363,995,2178,1546,0,1048,632,632
"56301","Ntome_NODE_17913_length_1365_cov_166","Nsylvestris_NODE_22485_length_923_cov_157",86.839,851,73,27,519,1347,878,45,0,915,828,833
"56315","Ntome_NODE_17919_length_1366_cov_31","Nsylvestris_NODE_11698_length_1905_cov_202",92.857,56,1,2,1202,1255,107,53,1.63e-13,78.7,53,54
"56327","Ntome_NODE_17924_length_1364_cov_265","Nsylvestris_NODE_1876_length_4133_cov_175",94.317,1355,59,6,6,1343,1356,3,0,2060,1337,1353
"56331","Ntome_NODE_17926_length_1364_cov_228","Nsylvestris_NODE_16552_length_1395_cov_172",93.765,1267,66,10,102,1364,53,1310,0,1890,1262,1257
"56343","Ntome_NODE_17930_length_1364_cov_163","Nsylvestris_NODE_3096_length_3544_cov_210",89.043,940,75,7,199,1110,962,23,0,1140,911,939
"56344","Ntome_NODE_17931_length_1364_cov_112","Nsylvestris_NODE_15097_length_1541_cov_169",93.75,768,36,4,606,1361,585,1352,0,1142,755,767
"56384","Ntome_NODE_17948_length_1363_cov_44","Nsylvestris_NODE_5211_length_2924_cov_77",98.182,55,1,0,1,55,1516,1570,4.49e-19,97.1,54,54
"56388","Ntome_NODE_17950_length_1363_cov_23","Nsylvestris_NODE_16943_length_1355_cov_115",96.755,1325,43,0,1,1325,1345,21,0,2209,1324,1324
"56399","Ntome_NODE_17956_length_1362_cov_88","Nsylvestris_NODE_19864_length_1112_cov_221",89.394,330,21,7,910,1239,368,53,2.36e-111,403,329,315
"56407","Ntome_NODE_17961_length_1361_cov_278","Nsylvestris_NODE_15376_length_1515_cov_216",96.646,1282,34,4,31,1311,42,1315,0,2121,1280,1273
"56417","Ntome_NODE_17965_length_1361_cov_84","Nsylvestris_NODE_18289_length_1242_cov_35",93.621,1160,35,11,221,1350,1152,2,0,1696,1129,1150
"56422","Ntome_NODE_17967_length_1361_cov_45","Nsylvestris_NODE_33807_length_328_cov_2",96.951,328,10,0,546,873,1,328,7.95e-156,551,327,327
"56423","Ntome_NODE_17968_length_1361_cov_30","Nsylvestris_NODE_25013_length_771_cov_8",89.535,774,46,15,81,822,1,771,0,948,741,770
"56437","Ntome_NODE_17973_length_1360_cov_203","Nsylvestris_NODE_390_length_6335_cov_171",91.21,1058,55,13,272,1306,1480,2522,0,1404,1034,1042
"56441","Ntome_NODE_17975_length_1360_cov_92","Nsylvestris_NODE_11969_length_1870_cov_24",100,37,0,0,1,37,37,1,9.76e-11,69.4,36,36
"56459","Ntome_NODE_17982_length_1360_cov_8","Nsylvestris_NODE_15078_length_1544_cov_30",92.962,952,54,7,392,1339,574,1516,0,1375,947,942
"56462","Ntome_NODE_17984_length_1359_cov_155","Nsylvestris_NODE_19504_length_1143_cov_161",94.638,1119,27,6,64,1175,1143,51,0,1703,1111,1092
"56471","Ntome_NODE_17988_length_1358_cov_246","Nsylvestris_NODE_9847_length_2134_cov_196",92.264,1047,59,13,11,1052,1045,2074,0,1465,1041,1029
"56484","Ntome_NODE_17994_length_1358_cov_22","Nsylvestris_NODE_2129_length_3973_cov_165",96.61,59,1,1,1301,1358,2466,2524,4.47e-19,97.1,57,58
"56494","Ntome_NODE_17999_length_1358_cov_9","Nsylvestris_NODE_21381_length_1001_cov_12",96.824,913,28,1,107,1019,38,949,0,1524,912,911
"56497","Ntome_NODE_18002_length_1357_cov_221","Nsylvestris_NODE_20173_length_1088_cov_194",97.695,998,17,4,310,1304,1033,39,0,1711,994,994
"56503","Ntome_NODE_18005_length_1357_cov_172","Nsylvestris_NODE_9789_length_2141_cov_230",100,55,0,0,1,55,1289,1343,9.6e-21,102,54,54
"56504","Ntome_NODE_18006_length_1357_cov_171","Nsylvestris_NODE_17264_length_1335_cov_136",92.202,1308,63,9,16,1302,46,1335,0,1814,1286,1289
"56510","Ntome_NODE_18010_length_1357_cov_40","Nsylvestris_NODE_188_length_7442_cov_173",89.306,1384,95,27,1,1357,5092,6449,0,1687,1356,1357
"56516","Ntome_NODE_18013_length_1357_cov_14","Nsylvestris_NODE_5202_length_2925_cov_206",94.444,54,3,0,1,54,1150,1097,3.48e-15,84.2,53,53
"56517","Ntome_NODE_18014_length_1357_cov_287","Nsylvestris_NODE_17981_length_1269_cov_209",95.336,1222,43,5,102,1309,1222,1,0,1929,1207,1221
"56524","Ntome_NODE_18017_length_1356_cov_128","Nsylvestris_NODE_12057_length_1863_cov_140",93.039,589,35,4,92,675,78,665,0,856,583,587
"56531","Ntome_NODE_18020_length_1356_cov_110","Nsylvestris_NODE_3659_length_3348_cov_71",93.185,719,43,5,90,806,1218,504,0,1051,716,714
"56544","Ntome_NODE_18025_length_1356_cov_5","Nsylvestris_NODE_1634_length_4306_cov_67",97.801,1364,22,1,1,1356,2313,3676,0,2346,1355,1363
"56549","Ntome_NODE_18027_length_1355_cov_290","Nsylvestris_NODE_16201_length_1429_cov_232",96.285,1319,39,5,40,1355,1391,80,0,2156,1315,1311
"56550","Ntome_NODE_18028_length_1355_cov_283","Nsylvestris_NODE_17697_length_1294_cov_213",95.772,1230,41,9,30,1250,1294,67,0,1973,1220,1227
"56570","Ntome_NODE_18034_length_1355_cov_149","Nsylvestris_NODE_18786_length_1203_cov_159",94.587,1016,52,2,9,1022,1057,43,0,1568,1013,1014
"56571","Ntome_NODE_18035_length_1355_cov_124","Nsylvestris_NODE_23558_length_856_cov_26",94.698,811,43,0,58,868,8,818,0,1260,810,810
"56581","Ntome_NODE_18039_length_1354_cov_263","Nsylvestris_NODE_7408_length_2503_cov_185",96.748,1353,43,1,2,1354,2302,951,0,2254,1352,1351
"56592","Ntome_NODE_18044_length_1354_cov_129","Nsylvestris_NODE_16756_length_1373_cov_144",95.715,1237,43,5,119,1346,38,1273,0,1982,1227,1235
"56606","Ntome_NODE_18052_length_1354_cov_19","Nsylvestris_NODE_33596_length_334_cov_4",92.72,261,19,0,50,310,261,1,1.42e-103,377,260,260
"56607","Ntome_NODE_18054_length_1354_cov_15","Nsylvestris_NODE_5133_length_2942_cov_91",94.609,1354,71,1,1,1352,1574,2927,0,2095,1351,1353
"56610","Ntome_NODE_18056_length_1354_cov_9","Nsylvestris_NODE_4941_length_2988_cov_48",85.246,61,6,3,722,780,562,621,5.85e-08,60.2,58,59
"56621","Ntome_NODE_18061_length_1353_cov_35","Nsylvestris_NODE_8757_length_2287_cov_21",94.677,1240,63,3,56,1295,2232,996,0,1921,1239,1236
"56626","Ntome_NODE_18064_length_1353_cov_25","Nsylvestris_NODE_8438_length_2334_cov_174",98.182,55,1,0,1299,1353,792,738,4.45e-19,97.1,54,54
"56634","Ntome_NODE_18067_length_1352_cov_213","Nsylvestris_NODE_16773_length_1374_cov_136",92.8,1125,52,12,114,1225,1271,163,0,1602,1111,1108
"56639","Ntome_NODE_18069_length_1352_cov_76","Nsylvestris_NODE_26851_length_680_cov_164",86.321,424,55,3,921,1342,249,671,4.92e-128,459,421,422
"56643","Ntome_NODE_18071_length_1352_cov_54","Nsylvestris_NODE_15532_length_1499_cov_17",90.317,1260,82,20,19,1242,1447,192,0,1615,1223,1255
"56652","Ntome_NODE_18074_length_1351_cov_259","Nsylvestris_NODE_15670_length_1483_cov_172",90.173,1211,67,26,96,1278,211,1397,0,1530,1182,1186
"56656","Ntome_NODE_18076_length_1351_cov_237","Nsylvestris_NODE_14980_length_1552_cov_152",95.822,1149,26,9,215,1342,351,1498,0,1836,1127,1147
"56659","Ntome_NODE_18078_length_1351_cov_233","Nsylvestris_NODE_18335_length_1238_cov_181",94.528,1133,52,6,198,1323,1185,56,0,1740,1125,1129
"56683","Ntome_NODE_18089_length_1350_cov_255","Nsylvestris_NODE_17721_length_1292_cov_206",95.628,892,35,1,86,977,1,888,0,1428,891,887
"56684","Ntome_NODE_18090_length_1350_cov_226","Nsylvestris_NODE_17094_length_1349_cov_183",95.199,1104,40,6,62,1163,1315,223,0,1733,1101,1092
"56699","Ntome_NODE_18095_length_1350_cov_155","Nsylvestris_NODE_10572_length_2041_cov_75",90.612,1225,98,8,127,1350,51,1259,0,1609,1223,1208
"56708","Ntome_NODE_18099_length_1350_cov_38","Nsylvestris_NODE_16183_length_1431_cov_134",94.543,1246,50,8,70,1299,48,1291,0,1908,1229,1243
"56715","Ntome_NODE_18103_length_1350_cov_5","Nsylvestris_NODE_7303_length_2519_cov_40",74.227,194,50,0,188,381,371,564,1.24e-14,82.4,193,193
"56718","Ntome_NODE_18106_length_1349_cov_286","Nsylvestris_NODE_17299_length_1332_cov_28",94.708,1266,56,6,46,1305,47,1307,0,1956,1259,1260
"56719","Ntome_NODE_18107_length_1349_cov_284","Nsylvestris_NODE_17125_length_1346_cov_209",94.618,1282,46,11,55,1321,1274,1,0,1964,1266,1273
"56736","Ntome_NODE_18113_length_1349_cov_149","Nsylvestris_NODE_6864_length_2592_cov_57",85.088,456,50,6,65,503,2069,1615,2.96e-125,449,438,454
"56748","Ntome_NODE_18117_length_1349_cov_76","Nsylvestris_NODE_3806_length_3298_cov_75",95.708,233,5,1,1,228,2951,2719,2.37e-101,370,227,232
"56749","Ntome_NODE_18118_length_1349_cov_76","Nsylvestris_NODE_119_length_8138_cov_130",80.617,227,33,7,502,718,2590,2365,1.2e-39,165,216,225
"56760","Ntome_NODE_18126_length_1348_cov_234","Nsylvestris_NODE_10115_length_2101_cov_135",89.992,1289,94,19,29,1292,2096,818,0,1633,1263,1278
"56786","Ntome_NODE_18138_length_1347_cov_257","Nsylvestris_NODE_16444_length_1405_cov_187",92.202,1090,60,6,45,1125,63,1136,0,1519,1080,1073
"56801","Ntome_NODE_18144_length_1347_cov_80","Nsylvestris_NODE_3389_length_3442_cov_153",94.737,1064,54,2,285,1347,1556,494,0,1653,1062,1062
"56815","Ntome_NODE_18149_length_1347_cov_27","Nsylvestris_NODE_11975_length_1873_cov_168",96.151,1273,45,1,75,1347,1326,58,0,2076,1272,1268
"56820","Ntome_NODE_18152_length_1347_cov_10","Nsylvestris_NODE_12011_length_1868_cov_211",98.182,55,1,0,1,55,1170,1116,4.43e-19,97.1,54,54
"56821","Ntome_NODE_18153_length_1347_cov_8","Nsylvestris_NODE_4046_length_3218_cov_179",94.545,55,3,0,1293,1347,1630,1576,9.59e-16,86.1,54,54
"56833","Ntome_NODE_18158_length_1346_cov_218","Nsylvestris_NODE_3040_length_3572_cov_53",96.815,1350,39,2,1,1346,1048,2397,0,2252,1345,1349
"56844","Ntome_NODE_18162_length_1346_cov_85","Nsylvestris_NODE_3354_length_3453_cov_229",92.287,363,20,8,979,1340,382,27,4.8e-143,508,361,355
"56845","Ntome_NODE_18163_length_1346_cov_59","Nsylvestris_NODE_1156_length_4749_cov_108",96.364,55,2,0,1292,1346,3920,3974,2.06e-17,91.6,54,54
"56881","Ntome_NODE_18177_length_1344_cov_226","Nsylvestris_NODE_17236_length_1337_cov_139",94.499,1327,66,5,1,1322,13,1337,0,2039,1321,1324
"56892","Ntome_NODE_18182_length_1344_cov_19","Nsylvestris_NODE_5279_length_2909_cov_201",98.182,55,1,0,1,55,1031,1085,4.42e-19,97.1,54,54
"56895","Ntome_NODE_18184_length_1344_cov_11","Nsylvestris_NODE_16080_length_1442_cov_136",94.828,58,3,0,1287,1344,289,346,2.06e-17,91.6,57,57
"56922","Ntome_NODE_18195_length_1343_cov_26","Nsylvestris_NODE_32675_length_365_cov_1",90.489,368,32,3,270,637,1,365,2.9e-135,483,367,364
"56926","Ntome_NODE_18197_length_1342_cov_286","Nsylvestris_NODE_17590_length_1304_cov_159",93.475,1318,38,7,48,1342,1,1293,0,1914,1294,1292
"56930","Ntome_NODE_18199_length_1342_cov_283","Nsylvestris_NODE_11327_length_1948_cov_224",95.309,1002,47,0,209,1210,1470,469,0,1591,1001,1001
"56937","Ntome_NODE_18202_length_1342_cov_146","Nsylvestris_NODE_19367_length_1154_cov_181",96.797,843,25,1,159,999,186,1028,0,1406,840,842
"56950","Ntome_NODE_18207_length_1342_cov_22","Nsylvestris_NODE_4933_length_2990_cov_21",96.012,1329,37,5,1,1327,1318,4,0,2146,1326,1314
"56961","Ntome_NODE_18212_length_1341_cov_268","Nsylvestris_NODE_15968_length_1452_cov_189",95.156,1218,49,3,1,1211,1215,1,0,1914,1210,1214
"56987","Ntome_NODE_18222_length_1341_cov_21","Nsylvestris_NODE_7906_length_2421_cov_25",93.383,1345,78,4,1,1341,1011,2348,0,1980,1340,1337
"56995","Ntome_NODE_18225_length_1340_cov_273","Nsylvestris_NODE_16987_length_1358_cov_189",92.62,1328,55,20,29,1327,40,1353,0,1869,1298,1313
"57007","Ntome_NODE_18229_length_1340_cov_110","Nsylvestris_NODE_15611_length_1489_cov_189",97.668,386,9,0,22,407,44,429,0,664,385,385
"57012","Ntome_NODE_18233_length_1340_cov_26","Nsylvestris_NODE_15730_length_1477_cov_142",88.401,1388,57,35,1,1340,78,1409,0,1576,1339,1331
"57026","Ntome_NODE_18238_length_1339_cov_269","Nsylvestris_NODE_15311_length_1520_cov_171",86.303,1190,73,27,160,1337,1136,25,0,1212,1177,1111
"57034","Ntome_NODE_18241_length_1339_cov_227","Nsylvestris_NODE_17315_length_1330_cov_220",94.059,1212,60,7,55,1264,80,1281,0,1829,1209,1201
"57038","Ntome_NODE_18243_length_1339_cov_117","Nsylvestris_NODE_17652_length_1298_cov_106",91.93,1264,69,21,12,1254,1292,41,0,1738,1242,1251
"57039","Ntome_NODE_18244_length_1339_cov_60","Nsylvestris_NODE_25141_length_764_cov_8",82.906,351,60,0,418,768,414,764,3.11e-85,316,350,350
"57043","Ntome_NODE_18246_length_1339_cov_20","Nsylvestris_NODE_12266_length_1841_cov_39",93.289,1356,49,7,1,1338,1731,400,0,1962,1337,1331
"57055","Ntome_NODE_18252_length_1338_cov_170","Nsylvestris_NODE_4166_length_3185_cov_154",93.078,1199,55,17,1,1180,1140,2329,0,1729,1179,1189
"57058","Ntome_NODE_18254_length_1338_cov_68","Nsylvestris_NODE_1071_length_4854_cov_182",94.066,910,45,1,310,1219,3827,2927,0,1373,909,900
"57078","Ntome_NODE_18262_length_1337_cov_68","Nsylvestris_NODE_8584_length_2312_cov_105",85.311,177,22,2,1014,1187,360,185,4.25e-44,180,173,175
"57084","Ntome_NODE_18264_length_1337_cov_24","Nsylvestris_NODE_1211_length_4694_cov_86",96.364,55,2,0,1283,1337,391,337,2.05e-17,91.6,54,54
"57088","Ntome_NODE_18266_length_1337_cov_13","Nsylvestris_NODE_1491_length_4405_cov_40",95.987,598,22,2,741,1337,3174,2578,0,970,596,596
"57102","Ntome_NODE_18271_length_1336_cov_177","Nsylvestris_NODE_17228_length_1338_cov_119",94.184,1066,58,4,231,1295,78,1140,0,1622,1064,1062
"57103","Ntome_NODE_18272_length_1336_cov_80","Nsylvestris_NODE_24071_length_827_cov_165",91.209,91,7,1,1225,1314,709,799,7.25e-27,122,89,90
"57104","Ntome_NODE_18273_length_1335_cov_49","Nsylvestris_NODE_4284_length_3155_cov_71",95.854,1182,49,0,3,1184,1681,500,0,1912,1181,1181
"57113","Ntome_NODE_18279_length_1335_cov_240","Nsylvestris_NODE_1665_length_4276_cov_126",93.42,1307,71,11,32,1335,2,1296,0,1923,1303,1294
"57149","Ntome_NODE_18292_length_1334_cov_107","Nsylvestris_NODE_408_length_6250_cov_81",93.096,956,54,4,1,955,11,955,0,1389,954,944
"57173","Ntome_NODE_18301_length_1334_cov_7","Nsylvestris_NODE_13465_length_1711_cov_22",91.994,1349,79,8,3,1333,1346,9,0,1866,1330,1337
"57211","Ntome_NODE_18312_length_1332_cov_277","Nsylvestris_NODE_18761_length_1205_cov_167",93.451,1191,66,6,153,1332,1197,8,0,1757,1179,1189
"57223","Ntome_NODE_18318_length_1332_cov_126","Nsylvestris_NODE_20500_length_1064_cov_258",86.889,450,53,6,520,965,3,450,2.86e-140,499,445,447
"57244","Ntome_NODE_18328_length_1332_cov_15","Nsylvestris_NODE_443_length_6136_cov_93",94.924,1320,67,0,13,1332,1570,251,0,2067,1319,1319
"57245","Ntome_NODE_18329_length_1332_cov_13","Nsylvestris_NODE_12946_length_1769_cov_185",96.226,53,2,0,1278,1330,1154,1102,2.64e-16,87.9,52,52
"57246","Ntome_NODE_18330_length_1331_cov_311","Nsylvestris_NODE_2045_length_4026_cov_223",97.746,1331,30,0,1,1331,1628,2958,0,2292,1330,1330
"57261","Ntome_NODE_18335_length_1331_cov_236","Nsylvestris_NODE_17235_length_1337_cov_188",94.804,1251,59,3,42,1289,1,1248,0,1945,1247,1247
"57267","Ntome_NODE_18340_length_1331_cov_12","Nsylvestris_NODE_18951_length_1187_cov_193",98.182,55,1,0,1277,1331,616,562,4.38e-19,97.1,54,54
"57278","Ntome_NODE_18345_length_1330_cov_57","Nsylvestris_NODE_12685_length_1797_cov_212",98.182,55,1,0,1276,1330,1007,1061,4.37e-19,97.1,54,54
"57283","Ntome_NODE_18348_length_1330_cov_14","Nsylvestris_NODE_1911_length_4105_cov_48",97.667,1329,31,0,2,1330,1810,482,0,2283,1328,1328
"57287","Ntome_NODE_18350_length_1330_cov_9","Nsylvestris_NODE_1912_length_4104_cov_113",95,60,3,0,1271,1330,622,563,1.57e-18,95.3,59,59
"57298","Ntome_NODE_18354_length_1329_cov_272","Nsylvestris_NODE_20196_length_1087_cov_32",91.805,903,58,12,292,1179,175,1076,0,1243,887,901
"57303","Ntome_NODE_18357_length_1329_cov_192","Nsylvestris_NODE_11230_length_1959_cov_136",95.624,777,24,1,1,777,812,46,0,1238,776,766
"57304","Ntome_NODE_18358_length_1329_cov_178","Nsylvestris_NODE_15184_length_1532_cov_170",94.902,1275,45,10,45,1302,1284,13,0,1977,1257,1271
"57313","Ntome_NODE_18362_length_1329_cov_71","Nsylvestris_NODE_17274_length_1334_cov_201",94.406,1287,64,4,1,1283,15,1297,0,1971,1282,1282
"57322","Ntome_NODE_18365_length_1329_cov_15","Nsylvestris_NODE_20935_length_1033_cov_63",95.475,906,36,3,380,1280,994,89,0,1441,900,905
"57323","Ntome_NODE_18366_length_1328_cov_314","Nsylvestris_NODE_5405_length_2884_cov_235",96.844,1331,30,3,1,1328,1116,2437,0,2215,1327,1321
"57343","Ntome_NODE_18374_length_1328_cov_28","Nsylvestris_NODE_618_length_5658_cov_166",84.529,711,72,17,77,777,2482,3164,0,669,700,682
"57344","Ntome_NODE_18375_length_1328_cov_22","Nsylvestris_NODE_9099_length_2237_cov_96",96.758,987,32,0,298,1284,1361,375,0,1646,986,986
"57347","Ntome_NODE_18378_length_1327_cov_242","Nsylvestris_NODE_8885_length_2266_cov_124",94.996,1239,51,7,73,1302,160,1396,0,1934,1229,1236
"57351","Ntome_NODE_18380_length_1327_cov_205","Nsylvestris_NODE_20806_length_1042_cov_210",92.817,891,37,6,69,942,51,931,0,1266,873,880
"57354","Ntome_NODE_18382_length_1327_cov_152","Nsylvestris_NODE_20818_length_1041_cov_17",92.512,1055,61,9,111,1161,1,1041,0,1495,1050,1040
"57355","Ntome_NODE_18383_length_1327_cov_52","Nsylvestris_NODE_1519_length_4384_cov_48",94.702,151,7,1,989,1138,197,47,3.19e-60,233,149,150
"57384","Ntome_NODE_18395_length_1326_cov_219","Nsylvestris_NODE_17723_length_1292_cov_158",94.856,1283,50,6,23,1289,1292,10,0,1989,1266,1282
"57389","Ntome_NODE_18398_length_1326_cov_21","Nsylvestris_NODE_18564_length_1219_cov_53",93.437,1219,67,4,23,1228,1,1219,0,1796,1205,1218
"57395","Ntome_NODE_18401_length_1325_cov_226","Nsylvestris_NODE_17770_length_1288_cov_176",94.051,1244,54,4,2,1227,47,1288,0,1869,1225,1241
"57403","Ntome_NODE_18404_length_1325_cov_55","Nsylvestris_NODE_12333_length_1834_cov_51",92.746,1282,69,12,13,1279,423,1695,0,1831,1266,1272
"57404","Ntome_NODE_18405_length_1325_cov_43","Nsylvestris_NODE_18659_length_1213_cov_31",92.938,1147,59,8,143,1274,1150,11,0,1650,1131,1139
"57405","Ntome_NODE_18406_length_1325_cov_42","Nsylvestris_NODE_17565_length_1307_cov_83",90.036,281,26,2,707,986,660,381,3.89e-99,363,279,279
"57411","Ntome_NODE_18410_length_1325_cov_10","Nsylvestris_NODE_11638_length_1914_cov_179",100,55,0,0,1271,1325,1109,1055,9.37e-21,102,54,54
"57425","Ntome_NODE_18417_length_1324_cov_127","Nsylvestris_NODE_11118_length_1974_cov_91",94.59,1183,53,6,141,1322,1209,37,0,1820,1181,1172
"57449","Ntome_NODE_18424_length_1323_cov_270","Nsylvestris_NODE_18074_length_1261_cov_216",93.876,1241,64,8,42,1277,27,1260,0,1860,1235,1233
"57450","Ntome_NODE_18425_length_1323_cov_234","Nsylvestris_NODE_19191_length_1168_cov_184",88.513,1123,56,33,134,1234,1151,80,0,1291,1100,1071
"57451","Ntome_NODE_18426_length_1323_cov_229","Nsylvestris_NODE_14704_length_1579_cov_41",94.205,1277,47,13,61,1323,1491,228,0,1923,1262,1263
"57454","Ntome_NODE_18428_length_1323_cov_111","Nsylvestris_NODE_16612_length_1390_cov_145",88.93,1355,71,13,1,1306,1330,6,0,1598,1305,1324
"57463","Ntome_NODE_18432_length_1323_cov_35","Nsylvestris_NODE_4852_length_3007_cov_112",89.179,268,18,9,1,263,352,613,1.83e-87,324,262,261
"57464","Ntome_NODE_18433_length_1323_cov_9","Nsylvestris_NODE_8913_length_2262_cov_51",95.238,1323,63,0,1,1323,1395,73,0,2095,1322,1322
"57465","Ntome_NODE_18434_length_1322_cov_266","Nsylvestris_NODE_18147_length_1254_cov_190",95.05,1212,45,10,105,1306,36,1242,0,1892,1201,1206
"57469","Ntome_NODE_18436_length_1322_cov_162","Nsylvestris_NODE_19050_length_1179_cov_182",88.207,1255,49,28,27,1260,1177,1,0,1406,1233,1176
"57480","Ntome_NODE_18440_length_1321_cov_40","Nsylvestris_NODE_6505_length_2660_cov_47",91.667,108,8,1,1215,1321,268,375,1.18e-34,148,106,107
"57503","Ntome_NODE_18450_length_1321_cov_128","Nsylvestris_NODE_17489_length_1314_cov_152",95.035,1269,55,6,42,1308,1312,50,0,1988,1266,1262
"57516","Ntome_NODE_18456_length_1320_cov_314","Nsylvestris_NODE_2316_length_3886_cov_225",95.406,1306,60,0,1,1306,2565,3870,0,2080,1305,1305
"57539","Ntome_NODE_18465_length_1320_cov_27","Nsylvestris_NODE_3080_length_3549_cov_224",98.182,55,1,0,1266,1320,880,826,4.34e-19,97.1,54,54
"57540","Ntome_NODE_18466_length_1320_cov_25","Nsylvestris_NODE_6632_length_2637_cov_22",98.182,55,1,0,1266,1320,637,583,4.34e-19,97.1,54,54
"57557","Ntome_NODE_18471_length_1319_cov_190","Nsylvestris_NODE_19206_length_1167_cov_195",92.268,957,74,0,237,1193,1015,59,0,1358,956,956
"57560","Ntome_NODE_18473_length_1319_cov_39","Nsylvestris_NODE_35776_length_278_cov_3",96.61,59,2,0,1,59,47,105,1.21e-19,99,58,58
"57564","Ntome_NODE_18475_length_1319_cov_12","Nsylvestris_NODE_4754_length_3032_cov_230",98.182,55,1,0,1265,1319,357,411,4.34e-19,97.1,54,54
"57593","Ntome_NODE_18487_length_1318_cov_28","Nsylvestris_NODE_503_length_5957_cov_74",94.858,739,20,2,408,1143,5234,5957,0,1138,735,723
"57603","Ntome_NODE_18491_length_1318_cov_11","Nsylvestris_NODE_22226_length_940_cov_182",98.182,55,1,0,1264,1318,727,781,4.33e-19,97.1,54,54
"57612","Ntome_NODE_18494_length_1317_cov_222","Nsylvestris_NODE_16519_length_1398_cov_122",95.37,1296,46,7,15,1298,1,1294,0,2049,1283,1293
"57625","Ntome_NODE_18499_length_1317_cov_173","Nsylvestris_NODE_8992_length_2252_cov_136",96.482,938,33,0,1,938,1066,129,0,1550,937,937
"57626","Ntome_NODE_18500_length_1317_cov_151","Nsylvestris_NODE_8044_length_2396_cov_172",83.562,292,25,10,943,1215,1990,2277,8.73e-66,252,272,287
"57627","Ntome_NODE_18501_length_1317_cov_80","Nsylvestris_NODE_11908_length_1879_cov_182",95.521,1295,53,5,1,1295,1788,499,0,2065,1294,1289
"57628","Ntome_NODE_18502_length_1317_cov_10","Nsylvestris_NODE_14520_length_1598_cov_103",96.073,1324,42,5,1,1317,1496,176,0,2148,1316,1320
"57633","Ntome_NODE_18505_length_1316_cov_259","Nsylvestris_NODE_16857_length_1367_cov_194",93.286,1266,68,9,51,1316,1,1249,0,1851,1265,1248
"57642","Ntome_NODE_18508_length_1316_cov_201","Nsylvestris_NODE_13389_length_1718_cov_135",92.786,1303,54,18,46,1316,1338,44,0,1849,1270,1294
"57655","Ntome_NODE_18513_length_1315_cov_226","Nsylvestris_NODE_7045_length_2562_cov_157",92.823,1045,60,4,86,1115,2535,1491,0,1500,1029,1044
"57658","Ntome_NODE_18515_length_1315_cov_185","Nsylvestris_NODE_16004_length_1449_cov_52",95.641,1193,47,3,5,1194,205,1395,0,1910,1189,1190
"57685","Ntome_NODE_18527_length_1314_cov_75","Nsylvestris_NODE_25570_length_740_cov_237",100,55,0,0,1,55,249,303,9.29e-21,102,54,54
"57691","Ntome_NODE_18530_length_1314_cov_18","Nsylvestris_NODE_14435_length_1607_cov_45",96.071,1120,44,0,1,1120,1346,227,0,1825,1119,1119
"57692","Ntome_NODE_18533_length_1313_cov_280","Nsylvestris_NODE_17412_length_1321_cov_211",96.134,1164,40,2,100,1263,114,1272,0,1895,1163,1158
"57699","Ntome_NODE_18536_length_1313_cov_10","Nsylvestris_NODE_8070_length_2392_cov_29",92.639,1345,67,8,1,1313,1746,402,0,1906,1312,1344
"57707","Ntome_NODE_18539_length_1312_cov_275","Nsylvestris_NODE_7329_length_2515_cov_226",93.13,1150,68,4,164,1312,2451,1312,0,1676,1148,1139
"57714","Ntome_NODE_18542_length_1312_cov_206","Nsylvestris_NODE_23901_length_837_cov_185",92.308,832,40,11,195,1010,6,829,0,1160,815,823
"57717","Ntome_NODE_18544_length_1312_cov_169","Nsylvestris_NODE_11987_length_1871_cov_154",92.175,1163,84,6,51,1208,1736,576,0,1637,1157,1160
"57739","Ntome_NODE_18554_length_1311_cov_189","Nsylvestris_NODE_23700_length_849_cov_9",93.176,850,52,6,139,983,849,1,0,1243,844,848
"57747","Ntome_NODE_18559_length_1311_cov_104","Nsylvestris_NODE_15288_length_1522_cov_118",92.268,1151,80,6,116,1264,1522,379,0,1624,1148,1143
"57753","Ntome_NODE_18561_length_1311_cov_44","Nsylvestris_NODE_31054_length_448_cov_5",87.742,465,30,11,808,1262,1,448,7.76e-146,518,454,447
"57767","Ntome_NODE_18568_length_1311_cov_19","Nsylvestris_NODE_18144_length_1255_cov_13",84.675,1292,119,28,41,1290,1,1255,0,1216,1249,1254
"57773","Ntome_NODE_18571_length_1310_cov_263","Nsylvestris_NODE_11381_length_1944_cov_138",98.007,1104,16,5,59,1156,535,1638,0,1912,1097,1103
"57774","Ntome_NODE_18572_length_1310_cov_208","Nsylvestris_NODE_2001_length_4056_cov_147",91.002,1278,79,22,53,1310,1640,379,0,1690,1257,1261
"57790","Ntome_NODE_18578_length_1310_cov_71","Nsylvestris_NODE_15984_length_1451_cov_9",96.448,366,12,1,236,600,896,531,2.08e-171,603,364,365
"57798","Ntome_NODE_18583_length_1309_cov_270","Nsylvestris_NODE_17813_length_1285_cov_171",94.01,1202,61,7,62,1257,1285,89,0,1810,1195,1196
"57799","Ntome_NODE_18584_length_1309_cov_267","Nsylvestris_NODE_15046_length_1546_cov_221",96.337,1092,37,2,214,1303,1099,9,0,1792,1089,1090
"57800","Ntome_NODE_18585_length_1307_cov_255","Nsylvestris_NODE_4126_length_3194_cov_201",96.327,1225,31,4,75,1299,1967,3177,0,2001,1224,1210
"57804","Ntome_NODE_18587_length_1309_cov_174","Nsylvestris_NODE_5948_length_2770_cov_90",95.49,643,25,3,110,749,9,650,0,1024,639,641
"57811","Ntome_NODE_18591_length_1309_cov_45","Nsylvestris_NODE_18120_length_1257_cov_35",91.849,1190,69,10,81,1257,1181,7,0,1635,1176,1174
"57827","Ntome_NODE_18598_length_1308_cov_267","Nsylvestris_NODE_2303_length_3891_cov_208",96.772,1208,39,0,101,1308,48,1255,0,2015,1207,1207
"57828","Ntome_NODE_18599_length_1308_cov_224","Nsylvestris_NODE_1659_length_4280_cov_233",89.215,853,60,20,373,1212,4131,3298,0,1037,839,833
"57829","Ntome_NODE_18600_length_1308_cov_219","Nsylvestris_NODE_17984_length_1270_cov_183",94.611,1169,51,8,101,1262,1252,89,0,1799,1161,1163
"57830","Ntome_NODE_18601_length_1308_cov_202","Nsylvestris_NODE_17175_length_1342_cov_88",92.914,1129,54,14,131,1258,1160,57,0,1618,1127,1103
"57859","Ntome_NODE_18611_length_1307_cov_265","Nsylvestris_NODE_9165_length_2228_cov_179",93.772,578,23,3,692,1259,1534,2108,0,856,567,574
"57884","Ntome_NODE_18620_length_1306_cov_251","Nsylvestris_NODE_27570_length_648_cov_10",91.887,530,31,1,49,566,584,55,0,730,517,529
"57895","Ntome_NODE_18625_length_1306_cov_55","Nsylvestris_NODE_8942_length_2258_cov_127",93.626,1161,44,13,57,1189,411,1569,0,1707,1132,1158
"57896","Ntome_NODE_18627_length_1306_cov_30","Nsylvestris_NODE_6944_length_2578_cov_146",100,33,0,0,1,33,1996,2028,1.57e-08,62.1,32,32
"57899","Ntome_NODE_18630_length_1305_cov_278","Nsylvestris_NODE_17852_length_1281_cov_218",96.822,1227,31,6,9,1234,1264,45,0,2043,1225,1219
"57903","Ntome_NODE_18632_length_1305_cov_267","Nsylvestris_NODE_15873_length_1462_cov_169",87.65,1085,98,22,88,1166,1117,63,0,1229,1078,1054
"57915","Ntome_NODE_18638_length_1305_cov_106","Nsylvestris_NODE_17824_length_1284_cov_70",95.133,1089,41,5,50,1129,1092,7,0,1707,1079,1085
"57928","Ntome_NODE_18645_length_1304_cov_265","Nsylvestris_NODE_19037_length_1180_cov_226",95.782,1138,37,3,27,1163,53,1180,0,1825,1136,1127
"57951","Ntome_NODE_18653_length_1304_cov_166","Nsylvestris_NODE_29778_length_547_cov_9",89.167,360,24,7,946,1304,547,202,8e-121,435,358,345
"57954","Ntome_NODE_18655_length_1304_cov_117","Nsylvestris_NODE_18191_length_1251_cov_105",88.489,278,24,3,787,1058,923,1198,3.88e-89,329,271,275
"57955","Ntome_NODE_18656_length_1304_cov_104","Nsylvestris_NODE_15360_length_1517_cov_41",93.394,1105,70,3,151,1254,249,1351,0,1633,1103,1102
"57963","Ntome_NODE_18659_length_1304_cov_21","Nsylvestris_NODE_17706_length_1294_cov_17",81.958,848,69,36,382,1217,778,3,0,641,835,775
"57964","Ntome_NODE_18660_length_1304_cov_14","Nsylvestris_NODE_2143_length_3968_cov_78",87.207,1321,109,30,1,1304,2379,3656,0,1448,1303,1277
"57968","Ntome_NODE_18662_length_1303_cov_265","Nsylvestris_NODE_16893_length_1365_cov_176",93.8,1242,63,6,1,1232,1339,102,0,1855,1231,1237
"57988","Ntome_NODE_18670_length_1303_cov_65","Nsylvestris_NODE_6788_length_2605_cov_182",98.182,55,1,0,1249,1303,965,911,4.28e-19,97.1,54,54
"57993","Ntome_NODE_18674_length_1302_cov_282","Nsylvestris_NODE_18787_length_1203_cov_147",90.73,1165,50,19,133,1251,51,1203,0,1500,1118,1152
"58006","Ntome_NODE_18679_length_1302_cov_124","Nsylvestris_NODE_4625_length_3066_cov_167",97.469,1225,31,0,78,1302,3016,1792,0,2091,1224,1224
"58007","Ntome_NODE_18681_length_1302_cov_76","Nsylvestris_NODE_17001_length_1357_cov_206",93.687,998,52,2,156,1153,83,1069,0,1483,997,986
"58017","Ntome_NODE_18686_length_1302_cov_33","Nsylvestris_NODE_20434_length_1069_cov_42",95.817,1028,43,0,73,1100,1,1028,0,1661,1027,1027
"58018","Ntome_NODE_18687_length_1302_cov_29","Nsylvestris_NODE_16897_length_1365_cov_87",90.625,1280,61,15,1,1252,1310,62,0,1644,1251,1248
"58022","Ntome_NODE_18689_length_1302_cov_20","Nsylvestris_NODE_23497_length_860_cov_10",96.144,804,31,0,6,809,804,1,0,1314,803,803
"58027","Ntome_NODE_18692_length_1301_cov_277","Nsylvestris_NODE_1448_length_4449_cov_196",95,1300,48,11,1,1285,1299,2,0,2025,1284,1297
"58030","Ntome_NODE_18694_length_1301_cov_208","Nsylvestris_NODE_24235_length_816_cov_221",92.308,715,33,8,501,1210,763,66,0,996,709,697
"58034","Ntome_NODE_18696_length_1301_cov_167","Nsylvestris_NODE_18358_length_1236_cov_92",94.672,807,29,6,222,1028,10,802,0,1240,806,792
"58035","Ntome_NODE_18697_length_1301_cov_118","Nsylvestris_NODE_12024_length_1867_cov_41",92.151,637,27,8,1,629,87,708,0,878,628,621
"58060","Ntome_NODE_18706_length_1300_cov_31","Nsylvestris_NODE_286_length_6785_cov_193",87.826,230,16,8,185,414,6516,6733,5.15e-68,259,229,217
"58067","Ntome_NODE_18709_length_1299_cov_267","Nsylvestris_NODE_1178_length_4723_cov_218",95.465,1279,35,7,21,1299,3,1258,0,2019,1278,1255
"58074","Ntome_NODE_18712_length_1299_cov_225","Nsylvestris_NODE_15888_length_1461_cov_196",94.65,1271,55,6,29,1299,92,1349,0,1958,1270,1257
"58075","Ntome_NODE_18713_length_1299_cov_205","Nsylvestris_NODE_3175_length_3517_cov_118",88.581,902,68,14,52,941,3421,2543,0,1062,889,878
"58105","Ntome_NODE_18723_length_1298_cov_145","Nsylvestris_NODE_17028_length_1355_cov_75",92.112,1179,81,6,79,1253,1350,180,0,1652,1174,1170
"58106","Ntome_NODE_18724_length_1298_cov_127","Nsylvestris_NODE_20749_length_1046_cov_185",93.361,964,42,11,38,987,28,983,0,1406,949,955
"58107","Ntome_NODE_18725_length_1298_cov_57","Nsylvestris_NODE_17024_length_1355_cov_198",80.342,819,134,17,266,1065,326,1136,3.45e-169,595,799,810
"58108","Ntome_NODE_18726_length_1298_cov_30","Nsylvestris_NODE_16821_length_1370_cov_189",94.444,1188,56,4,10,1187,1265,78,0,1820,1177,1187
"58112","Ntome_NODE_18729_length_1298_cov_14","Nsylvestris_NODE_13156_length_1743_cov_214",100,55,0,0,1244,1298,727,781,9.17e-21,102,54,54
"58137","Ntome_NODE_18741_length_1297_cov_46","Nsylvestris_NODE_27225_length_663_cov_60",91.084,415,23,5,524,937,49,450,2.72e-155,549,413,401
"58143","Ntome_NODE_18744_length_1296_cov_210","Nsylvestris_NODE_19495_length_1144_cov_25",94.159,1147,37,14,117,1236,1144,1,0,1720,1119,1143
"58144","Ntome_NODE_18745_length_1296_cov_139","Nsylvestris_NODE_31609_length_414_cov_3",85.39,397,49,7,387,781,390,1,2.24e-111,403,394,389
"58145","Ntome_NODE_18746_length_1296_cov_113","Nsylvestris_NODE_14745_length_1575_cov_81",95.734,1172,28,11,54,1222,423,1575,0,1868,1168,1152
"58146","Ntome_NODE_18747_length_1296_cov_40","Nsylvestris_NODE_32847_length_358_cov_10",91.808,354,14,11,62,415,358,20,3.62e-134,479,353,338
"58147","Ntome_NODE_18749_length_1296_cov_29","Nsylvestris_NODE_23827_length_842_cov_12",80.534,262,49,2,117,378,698,439,3.16e-50,200,261,259
"58159","Ntome_NODE_18755_length_1295_cov_208","Nsylvestris_NODE_10697_length_2026_cov_80",94.245,1251,44,9,15,1256,2012,781,0,1886,1241,1231
"58172","Ntome_NODE_18760_length_1295_cov_56","Nsylvestris_NODE_12008_length_1869_cov_17",84.054,1041,158,6,53,1092,255,1288,0,996,1039,1033
"58179","Ntome_NODE_18764_length_1295_cov_8","Nsylvestris_NODE_2279_length_3903_cov_56",91.465,1113,64,6,184,1295,3643,2561,0,1500,1111,1082
"58191","Ntome_NODE_18769_length_1294_cov_260","Nsylvestris_NODE_8458_length_2330_cov_168",96.136,1268,32,9,33,1294,2330,1074,0,2054,1261,1256
"58196","Ntome_NODE_18771_length_1294_cov_231","Nsylvestris_NODE_17903_length_1276_cov_186",92.054,1271,69,13,17,1261,1276,12,0,1759,1244,1264
"58199","Ntome_NODE_18773_length_1294_cov_101","Nsylvestris_NODE_18714_length_1208_cov_95",91.852,1166,70,12,70,1217,1159,1,0,1604,1147,1158
"58203","Ntome_NODE_18775_length_1294_cov_65","Nsylvestris_NODE_30336_length_499_cov_6",91.617,501,17,5,190,667,1,499,0,669,477,498
"58244","Ntome_NODE_18788_length_1293_cov_118","Nsylvestris_NODE_16725_length_1379_cov_35",93.132,1092,71,2,165,1255,1133,45,0,1598,1090,1088
"58258","Ntome_NODE_18794_length_1292_cov_48","Nsylvestris_NODE_15436_length_1509_cov_163",98.182,55,1,0,1,55,650,704,4.25e-19,97.1,54,54
"58262","Ntome_NODE_18796_length_1292_cov_33","Nsylvestris_NODE_9653_length_2158_cov_148",96.364,55,2,0,1238,1292,589,535,1.98e-17,91.6,54,54
"58263","Ntome_NODE_18797_length_1292_cov_12","Nsylvestris_NODE_20419_length_1070_cov_84",93.908,952,33,12,247,1174,71,1021,0,1413,927,950
"58282","Ntome_NODE_18804_length_1291_cov_72","Nsylvestris_NODE_18971_length_1186_cov_61",89.899,99,4,4,523,617,98,2,7e-27,122,94,96
"58290","Ntome_NODE_18808_length_1291_cov_6","Nsylvestris_NODE_5276_length_2911_cov_43",100,55,0,0,1,55,1414,1468,9.12e-21,102,54,54
"58293","Ntome_NODE_18810_length_1290_cov_213","Nsylvestris_NODE_17740_length_1290_cov_206",93.145,1167,51,6,90,1236,1210,53,0,1685,1146,1157
"58314","Ntome_NODE_18819_length_1289_cov_252","Nsylvestris_NODE_5195_length_2927_cov_206",97.198,1285,26,6,11,1289,7,1287,0,2165,1278,1280
"58323","Ntome_NODE_18824_length_1289_cov_17","Nsylvestris_NODE_26227_length_708_cov_210",88.889,279,23,8,942,1216,338,612,2.29e-91,337,274,274
"58324","Ntome_NODE_18825_length_1289_cov_14","Nsylvestris_NODE_1830_length_4159_cov_34",79.89,1089,206,11,24,1106,3859,2778,0,785,1082,1081
"58368","Ntome_NODE_18841_length_1288_cov_19","Nsylvestris_NODE_25715_length_733_cov_16",94.058,690,26,2,373,1059,678,1,0,1033,686,677
"58399","Ntome_NODE_18851_length_1287_cov_133","Nsylvestris_NODE_24321_length_811_cov_181",94.953,535,21,3,703,1237,132,660,0,833,534,528
"58402","Ntome_NODE_18853_length_1287_cov_88","Nsylvestris_NODE_16866_length_1367_cov_71",92.707,1234,66,10,63,1287,53,1271,0,1759,1224,1218
"58408","Ntome_NODE_18856_length_1287_cov_30","Nsylvestris_NODE_3801_length_3300_cov_41",85.259,251,37,0,707,957,2578,2828,5.1e-68,259,250,250
"58419","Ntome_NODE_18861_length_1287_cov_8","Nsylvestris_NODE_14565_length_1593_cov_31",86.279,1188,97,21,3,1151,328,1488,0,1230,1148,1160
"58423","Ntome_NODE_18863_length_1286_cov_269","Nsylvestris_NODE_15412_length_1511_cov_212",93.142,1254,49,13,1,1236,113,1347,0,1805,1235,1234
"58430","Ntome_NODE_18866_length_1286_cov_233","Nsylvestris_NODE_5209_length_2924_cov_120",90.338,1242,71,18,15,1225,1299,2522,0,1583,1210,1223
"58482","Ntome_NODE_18885_length_1285_cov_49","Nsylvestris_NODE_2685_length_3712_cov_170",90.937,1313,70,22,1,1285,2975,1684,0,1720,1284,1291
"58498","Ntome_NODE_18892_length_1284_cov_200","Nsylvestris_NODE_15510_length_1501_cov_48",91.076,874,66,6,246,1111,81,950,0,1171,865,869
"58525","Ntome_NODE_18903_length_1284_cov_12","Nsylvestris_NODE_11399_length_1942_cov_20",96.066,1271,41,3,1,1264,1341,73,0,2061,1263,1268
"58529","Ntome_NODE_18905_length_1283_cov_287","Nsylvestris_NODE_12764_length_1790_cov_144",93.668,1295,53,15,8,1283,8,1292,0,1910,1275,1284
"58532","Ntome_NODE_18907_length_1283_cov_175","Nsylvestris_NODE_24694_length_789_cov_173",96.041,783,28,3,60,840,1,782,0,1271,780,781
"58554","Ntome_NODE_18919_length_1282_cov_142","Nsylvestris_NODE_10568_length_2041_cov_183",94.659,880,33,3,286,1165,1978,1113,0,1352,879,865
"58555","Ntome_NODE_18920_length_1282_cov_136","Nsylvestris_NODE_16879_length_1366_cov_134",89.837,1289,69,23,1,1252,68,1331,0,1598,1251,1263
"58584","Ntome_NODE_18931_length_1282_cov_8","Nsylvestris_NODE_19078_length_1177_cov_79",93.678,949,48,2,297,1236,1051,106,0,1410,939,945
"58596","Ntome_NODE_18935_length_1281_cov_254","Nsylvestris_NODE_11107_length_1975_cov_148",93.701,1286,56,10,4,1273,1558,282,0,1903,1269,1276
"58597","Ntome_NODE_18936_length_1281_cov_251","Nsylvestris_NODE_17916_length_1275_cov_215",93.579,1246,64,10,25,1266,1,1234,0,1844,1241,1233
"58603","Ntome_NODE_18939_length_1281_cov_209","Nsylvestris_NODE_18069_length_1262_cov_103",96.548,956,29,2,192,1147,1214,263,0,1580,955,951
"58651","Ntome_NODE_18952_length_1280_cov_250","Nsylvestris_NODE_17187_length_1341_cov_215",95.185,1163,52,2,47,1209,1221,63,0,1834,1162,1158
"58655","Ntome_NODE_18954_length_1280_cov_221","Nsylvestris_NODE_19910_length_1109_cov_214",95.508,1024,38,5,223,1240,1057,36,0,1629,1017,1021
"58673","Ntome_NODE_18964_length_1279_cov_211","Nsylvestris_NODE_9037_length_2246_cov_136",95.408,871,31,6,293,1160,1382,2246,0,1378,867,864
"58680","Ntome_NODE_18967_length_1279_cov_134","Nsylvestris_NODE_18334_length_1238_cov_182",92.931,1061,48,6,219,1262,1053,3,0,1519,1043,1050
"58686","Ntome_NODE_18970_length_1279_cov_32","Nsylvestris_NODE_3360_length_3452_cov_109",90.559,805,56,11,486,1272,1618,2420,0,1048,786,802
"58687","Ntome_NODE_18971_length_1279_cov_6","Nsylvestris_NODE_17966_length_1271_cov_13",95.202,792,35,1,4,795,789,1,0,1249,791,788
"58700","Ntome_NODE_18975_length_1278_cov_245","Nsylvestris_NODE_14019_length_1647_cov_130",93.557,714,44,2,413,1125,822,1534,0,1062,712,712
"58704","Ntome_NODE_18977_length_1278_cov_200","Nsylvestris_NODE_19122_length_1174_cov_45",94.332,1182,57,1,63,1244,1172,1,0,1803,1181,1171
"58732","Ntome_NODE_18991_length_1277_cov_13","Nsylvestris_NODE_16141_length_1435_cov_235",98.182,55,1,0,1223,1277,876,822,4.2e-19,97.1,54,54
"58774","Ntome_NODE_19009_length_1275_cov_132","Nsylvestris_NODE_10574_length_2041_cov_30",100,53,0,0,1223,1275,502,450,1.17e-19,99,52,52
"58781","Ntome_NODE_19011_length_1275_cov_85","Nsylvestris_NODE_17460_length_1316_cov_130",92.58,876,36,10,208,1055,1025,151,0,1230,847,874
"58782","Ntome_NODE_19012_length_1275_cov_75","Nsylvestris_NODE_21715_length_976_cov_70",94.365,976,42,7,54,1017,2,976,0,1485,963,974
"58829","Ntome_NODE_19034_length_1273_cov_202","Nsylvestris_NODE_16436_length_1406_cov_157",95.341,1159,47,5,47,1203,233,1386,0,1834,1156,1153
"58830","Ntome_NODE_19035_length_1273_cov_194","Nsylvestris_NODE_19223_length_1166_cov_63",86.043,652,59,19,38,664,200,844,0,671,626,644
"58841","Ntome_NODE_19039_length_1273_cov_97","Nsylvestris_NODE_16676_length_1383_cov_93",94.204,1225,54,5,56,1272,1330,115,0,1853,1216,1215
"58844","Ntome_NODE_19042_length_1273_cov_42","Nsylvestris_NODE_3665_length_3345_cov_166",77.753,445,51,27,847,1273,2365,2779,3.95e-59,230,426,414
"58858","Ntome_NODE_19046_length_1272_cov_155","Nsylvestris_NODE_25305_length_754_cov_193",84.919,557,40,19,567,1103,597,65,1.62e-147,523,536,532
"58895","Ntome_NODE_19063_length_1270_cov_236","Nsylvestris_NODE_16035_length_1446_cov_165",93.585,1138,50,12,132,1265,77,1195,0,1676,1133,1118
"58907","Ntome_NODE_19070_length_1270_cov_13","Nsylvestris_NODE_391_length_6319_cov_100",100,54,0,0,1216,1269,6093,6146,3.23e-20,100,53,53
"58908","Ntome_NODE_19071_length_1270_cov_8","Nsylvestris_NODE_3356_length_3453_cov_123",76.667,210,41,4,557,760,2661,2454,5.36e-23,110,203,207
"58909","Ntome_NODE_19072_length_1269_cov_250","Nsylvestris_NODE_19422_length_1150_cov_193",95.087,977,28,3,170,1145,1107,150,0,1520,975,957
"58948","Ntome_NODE_19087_length_1268_cov_61","Nsylvestris_NODE_3735_length_3323_cov_78",92.105,114,9,0,1155,1268,2693,2580,1.46e-38,161,113,113
"58951","Ntome_NODE_19089_length_1268_cov_19","Nsylvestris_NODE_5290_length_2908_cov_25",96.913,1231,29,1,38,1268,2703,1482,0,2054,1230,1221
"58955","Ntome_NODE_19092_length_1267_cov_302","Nsylvestris_NODE_191_length_7430_cov_231",99.526,1267,6,0,1,1267,2895,1629,0,2307,1266,1266
"58958","Ntome_NODE_19094_length_1267_cov_250","Nsylvestris_NODE_6236_length_2710_cov_107",87.607,1291,88,34,2,1267,1,1244,0,1432,1265,1243
"58961","Ntome_NODE_19096_length_1267_cov_226","Nsylvestris_NODE_11253_length_1956_cov_223",92.886,745,22,5,1,717,1215,1956,0,1053,716,741
"58971","Ntome_NODE_19101_length_1267_cov_137","Nsylvestris_NODE_703_length_5422_cov_153",92.703,370,27,0,280,649,2965,2596,7.44e-151,534,369,369
"58983","Ntome_NODE_19106_length_1267_cov_29","Nsylvestris_NODE_14705_length_1579_cov_29",93.14,1239,55,12,1,1211,300,1536,0,1790,1210,1236
"59006","Ntome_NODE_19116_length_1266_cov_213","Nsylvestris_NODE_29762_length_548_cov_146",95.775,497,18,1,394,887,497,1,0,798,493,496
"59017","Ntome_NODE_19120_length_1266_cov_12","Nsylvestris_NODE_3478_length_3408_cov_117",97.551,1266,28,1,1,1266,1853,3115,0,2163,1265,1262
"59018","Ntome_NODE_19121_length_1265_cov_302","Nsylvestris_NODE_13224_length_1736_cov_241",95.817,1243,36,2,23,1265,1736,510,0,1993,1242,1226
"59019","Ntome_NODE_19122_length_1265_cov_299","Nsylvestris_NODE_10862_length_2006_cov_47",93.868,1223,60,3,52,1265,106,1322,0,1829,1213,1216
"59034","Ntome_NODE_19126_length_1265_cov_198","Nsylvestris_NODE_21008_length_1027_cov_197",94.577,461,24,1,1,461,606,147,0,712,460,459
"59044","Ntome_NODE_19131_length_1265_cov_41","Nsylvestris_NODE_720_length_5402_cov_123",95.024,1266,53,7,3,1265,1284,26,0,1980,1262,1258
"59061","Ntome_NODE_19137_length_1264_cov_215","Nsylvestris_NODE_20649_length_1054_cov_149",87.226,822,85,8,345,1146,867,46,0,918,801,821
"59062","Ntome_NODE_19138_length_1264_cov_203","Nsylvestris_NODE_19221_length_1166_cov_78",87.903,1149,63,29,93,1226,27,1114,0,1282,1133,1087
"59071","Ntome_NODE_19141_length_1264_cov_68","Nsylvestris_NODE_1415_length_4483_cov_192",97.391,1265,32,1,1,1264,38,1302,0,2152,1263,1264
"59082","Ntome_NODE_19147_length_1263_cov_280","Nsylvestris_NODE_18430_length_1229_cov_217",93.447,1053,41,6,54,1106,57,1081,0,1537,1052,1024
"59099","Ntome_NODE_19153_length_1263_cov_48","Nsylvestris_NODE_11_length_12805_cov_33",74.798,496,114,10,344,835,8919,8431,3.95e-54,213,491,488
"59110","Ntome_NODE_19158_length_1262_cov_276","Nsylvestris_NODE_18858_length_1196_cov_210",93.069,1111,57,12,11,1109,55,1157,0,1607,1098,1102
"59115","Ntome_NODE_19160_length_1262_cov_257","Nsylvestris_NODE_12245_length_1842_cov_223",95.907,1246,41,4,18,1262,4,1240,0,2010,1244,1236
"59119","Ntome_NODE_19162_length_1262_cov_235","Nsylvestris_NODE_19632_length_1132_cov_219",90.771,1116,81,10,1,1101,1109,1,0,1471,1100,1108
"59127","Ntome_NODE_19166_length_1262_cov_123","Nsylvestris_NODE_9740_length_2148_cov_178",96.226,53,2,0,1210,1262,538,590,2.5e-16,87.9,52,52
"59140","Ntome_NODE_19171_length_1262_cov_27","Nsylvestris_NODE_19983_length_1104_cov_13",95.29,1104,52,0,159,1262,1,1104,0,1751,1103,1103
"59182","Ntome_NODE_19188_length_1260_cov_270","Nsylvestris_NODE_5077_length_2954_cov_184",95.292,1147,30,5,77,1206,1174,35,0,1797,1129,1139
"59190","Ntome_NODE_19191_length_1260_cov_251","Nsylvestris_NODE_26_length_10966_cov_174",96.62,858,26,3,285,1139,44,901,0,1421,854,857
"59194","Ntome_NODE_19193_length_1260_cov_193","Nsylvestris_NODE_19731_length_1124_cov_181",91.949,1093,66,11,1,1084,1080,1,0,1511,1083,1079
"59206","Ntome_NODE_19198_length_1260_cov_41","Nsylvestris_NODE_18527_length_1222_cov_23",91.424,1201,40,14,1,1171,1168,1,0,1589,1170,1167
"59207","Ntome_NODE_19199_length_1260_cov_32","Nsylvestris_NODE_897_length_5091_cov_45",92.523,107,8,0,356,462,3728,3622,2.42e-36,154,106,106
"59230","Ntome_NODE_19209_length_1259_cov_34","Nsylvestris_NODE_15934_length_1456_cov_198",96.364,55,2,0,1,55,1064,1010,1.92e-17,91.6,54,54
"59233","Ntome_NODE_19211_length_1259_cov_24","Nsylvestris_NODE_25746_length_731_cov_22",92.075,694,43,4,10,701,730,47,0,966,691,683
"59249","Ntome_NODE_19217_length_1258_cov_258","Nsylvestris_NODE_18656_length_1213_cov_70",93.48,1043,50,8,87,1119,95,1129,0,1533,1032,1034
"59250","Ntome_NODE_19219_length_1258_cov_231","Nsylvestris_NODE_25608_length_739_cov_16",95.056,627,23,2,148,769,29,652,0,979,621,623
"59251","Ntome_NODE_19221_length_1258_cov_153","Nsylvestris_NODE_23554_length_856_cov_123",92.622,759,44,3,264,1010,808,50,0,1081,746,758
"59258","Ntome_NODE_19224_length_1258_cov_20","Nsylvestris_NODE_1505_length_4394_cov_224",98.182,55,1,0,1204,1258,1133,1187,4.13e-19,97.1,54,54
"59262","Ntome_NODE_19226_length_1258_cov_5","Nsylvestris_NODE_12718_length_1794_cov_55",96.61,59,2,0,1200,1258,1292,1350,1.15e-19,99,58,58
"59267","Ntome_NODE_19229_length_1257_cov_185","Nsylvestris_NODE_19141_length_1172_cov_164",91.976,1159,59,11,103,1240,1,1146,0,1594,1137,1145
"59283","Ntome_NODE_19236_length_1257_cov_9","Nsylvestris_NODE_26042_length_717_cov_5",92.308,39,3,0,586,624,629,667,7.01e-07,56.5,38,38
"59312","Ntome_NODE_19246_length_1256_cov_31","Nsylvestris_NODE_27016_length_673_cov_6",94.145,649,34,4,280,926,673,27,0,985,646,646
"59316","Ntome_NODE_19248_length_1256_cov_14","Nsylvestris_NODE_2600_length_3745_cov_132",98.182,55,1,0,1202,1256,3514,3460,4.13e-19,97.1,54,54
"59332","Ntome_NODE_19254_length_1255_cov_159","Nsylvestris_NODE_19623_length_1133_cov_200",94.218,1055,51,6,75,1126,1,1048,0,1602,1051,1047
"59333","Ntome_NODE_19255_length_1255_cov_23","Nsylvestris_NODE_13395_length_1717_cov_212",95.876,97,4,0,149,245,132,228,1.86e-37,158,96,96
"59372","Ntome_NODE_19271_length_1254_cov_24","Nsylvestris_NODE_3533_length_3388_cov_128",98.039,51,1,0,1204,1254,541,591,6.89e-17,89.8,50,50
"59373","Ntome_NODE_19272_length_1254_cov_22","Nsylvestris_NODE_6629_length_2637_cov_55",88.854,969,84,12,299,1254,1,958,0,1170,955,957
"59391","Ntome_NODE_19279_length_1253_cov_281","Nsylvestris_NODE_17411_length_1321_cov_223",95.983,1195,28,5,50,1243,125,1300,0,1923,1193,1175
"59411","Ntome_NODE_19285_length_1253_cov_131","Nsylvestris_NODE_18436_length_1229_cov_117",96.472,737,23,2,147,882,1191,457,0,1214,735,734
"59415","Ntome_NODE_19288_length_1253_cov_35","Nsylvestris_NODE_3649_length_3350_cov_31",87.962,1163,135,3,51,1212,1851,3009,0,1367,1161,1158
"59422","Ntome_NODE_19291_length_1253_cov_9","Nsylvestris_NODE_34562_length_306_cov_3",92.763,304,22,0,471,774,306,3,1.65e-122,440,303,303
"59423","Ntome_NODE_19292_length_1252_cov_275","Nsylvestris_NODE_18500_length_1224_cov_185",92.048,1157,65,8,111,1252,77,1221,0,1602,1141,1144
"59424","Ntome_NODE_19293_length_1252_cov_242","Nsylvestris_NODE_18611_length_1216_cov_197",95.207,1210,50,5,3,1211,11,1213,0,1906,1208,1202
"59458","Ntome_NODE_19307_length_1251_cov_51","Nsylvestris_NODE_6335_length_2692_cov_121",91.667,72,6,0,1180,1251,1938,2009,3.18e-20,100,71,71
"59459","Ntome_NODE_19308_length_1249_cov_37","Nsylvestris_NODE_1631_length_4308_cov_119",95.423,1158,51,2,69,1226,2687,3842,0,1844,1157,1155
"59474","Ntome_NODE_19316_length_1250_cov_251","Nsylvestris_NODE_19420_length_1150_cov_213",94.306,1124,53,5,82,1205,1,1113,0,1711,1123,1112
"59475","Ntome_NODE_19317_length_1250_cov_251","Nsylvestris_NODE_7333_length_2515_cov_87",94.956,1031,47,1,64,1089,116,1146,0,1611,1025,1030
"59508","Ntome_NODE_19325_length_1250_cov_23","Nsylvestris_NODE_19426_length_1150_cov_47",95.084,1017,43,2,138,1153,91,1101,0,1594,1015,1010
"59531","Ntome_NODE_19335_length_1248_cov_242","Nsylvestris_NODE_11242_length_1957_cov_194",93.159,994,61,4,143,1132,96,1086,0,1452,989,990
"59555","Ntome_NODE_19342_length_1248_cov_34","Nsylvestris_NODE_548_length_5829_cov_125",97.959,49,1,0,308,356,5773,5821,8.87e-16,86.1,48,48
"59556","Ntome_NODE_19343_length_1248_cov_30","Nsylvestris_NODE_5288_length_2908_cov_48",78.689,305,44,6,765,1069,1252,1535,3.06e-45,183,304,283
"59557","Ntome_NODE_19344_length_1248_cov_29","Nsylvestris_NODE_16002_length_1449_cov_87",95.848,1156,47,1,94,1248,1402,247,0,1868,1154,1155
"59560","Ntome_NODE_19346_length_1248_cov_20","Nsylvestris_NODE_21415_length_998_cov_22",93.918,1003,47,2,31,1033,998,10,0,1502,1002,988
"59561","Ntome_NODE_19347_length_1248_cov_11","Nsylvestris_NODE_76_length_8864_cov_174",94.406,286,14,2,393,678,6509,6226,5.91e-122,438,285,283
"59572","Ntome_NODE_19351_length_1247_cov_119","Nsylvestris_NODE_8212_length_2370_cov_209",94.229,1057,34,10,134,1189,1263,2293,0,1589,1055,1030
"59582","Ntome_NODE_19354_length_1247_cov_24","Nsylvestris_NODE_14499_length_1600_cov_200",98.182,55,1,0,1,55,383,437,4.1e-19,97.1,54,54
"59607","Ntome_NODE_19364_length_1246_cov_17","Nsylvestris_NODE_32763_length_361_cov_8",95.977,174,7,0,1048,1221,174,1,2.93e-75,283,173,173
"59640","Ntome_NODE_19377_length_1245_cov_10","Nsylvestris_NODE_15071_length_1544_cov_195",93.902,1230,44,6,1,1227,1289,88,0,1827,1226,1201
"59643","Ntome_NODE_19379_length_1244_cov_294","Nsylvestris_NODE_7258_length_2525_cov_223",96.349,1205,34,6,44,1244,2470,1272,0,1973,1200,1198
"59646","Ntome_NODE_19381_length_1244_cov_235","Nsylvestris_NODE_18653_length_1213_cov_170",93.484,1151,59,9,72,1218,1213,75,0,1696,1146,1138
"59650","Ntome_NODE_19383_length_1244_cov_102","Nsylvestris_NODE_18497_length_1224_cov_195",95.413,218,10,0,182,399,254,471,1.02e-94,348,217,217
"59660","Ntome_NODE_19387_length_1243_cov_254","Nsylvestris_NODE_17197_length_1340_cov_198",95.423,874,31,4,379,1243,994,121,0,1384,864,873
"59663","Ntome_NODE_19390_length_1243_cov_57","Nsylvestris_NODE_14430_length_1608_cov_40",85.255,373,46,8,869,1236,1193,825,4.68e-103,375,367,368
"59687","Ntome_NODE_19399_length_1242_cov_276","Nsylvestris_NODE_20043_length_1098_cov_214",92.439,1111,68,5,15,1124,1,1096,0,1572,1109,1095
"59688","Ntome_NODE_19400_length_1242_cov_244","Nsylvestris_NODE_17449_length_1318_cov_212",91.771,1118,63,15,144,1233,1146,30,0,1528,1089,1116
"59712","Ntome_NODE_19409_length_1242_cov_9","Nsylvestris_NODE_7406_length_2503_cov_213",100,55,0,0,1,55,1233,1287,8.77e-21,102,54,54
"59713","Ntome_NODE_19410_length_1241_cov_261","Nsylvestris_NODE_667_length_5511_cov_154",95.827,1246,29,9,1,1241,4267,5494,0,1991,1240,1227
"59714","Ntome_NODE_19411_length_1241_cov_242","Nsylvestris_NODE_17570_length_1306_cov_223",85.337,757,111,0,485,1241,427,1183,0,784,756,756
"59715","Ntome_NODE_19412_length_1241_cov_240","Nsylvestris_NODE_20095_length_1094_cov_185",97.132,1046,29,1,165,1210,1,1045,0,1764,1045,1044
"59735","Ntome_NODE_19421_length_1241_cov_16","Nsylvestris_NODE_23601_length_854_cov_24",95.159,785,29,4,93,868,23,807,0,1230,775,784
"59739","Ntome_NODE_19424_length_1241_cov_12","Nsylvestris_NODE_5514_length_2859_cov_147",100,55,0,0,1,55,1217,1163,8.76e-21,102,54,54
"59756","Ntome_NODE_19432_length_1239_cov_285","Nsylvestris_NODE_108_length_8357_cov_118",95.038,1169,56,2,73,1239,5093,6261,0,1836,1166,1168
"59759","Ntome_NODE_19434_length_1239_cov_163","Nsylvestris_NODE_17601_length_1303_cov_93",92.624,1193,66,15,13,1191,1300,116,0,1696,1178,1184
"59762","Ntome_NODE_19436_length_1239_cov_145","Nsylvestris_NODE_12330_length_1834_cov_88",92.444,675,29,7,105,762,1789,1120,0,944,657,669
"59769","Ntome_NODE_19440_length_1239_cov_31","Nsylvestris_NODE_10029_length_2112_cov_217",100,55,0,0,1185,1239,1708,1762,8.75e-21,102,54,54
"59773","Ntome_NODE_19443_length_1239_cov_12","Nsylvestris_NODE_32733_length_363_cov_3",90.04,251,10,3,26,276,33,268,1.33e-83,311,250,235
"59774","Ntome_NODE_19444_length_1239_cov_8","Nsylvestris_NODE_1059_length_4868_cov_65",94.323,229,8,4,1,225,4535,4308,3.66e-94,346,224,227
"59789","Ntome_NODE_19450_length_1238_cov_23","Nsylvestris_NODE_19484_length_1145_cov_11",95.494,1154,41,5,66,1217,1145,1,0,1832,1151,1144
"59832","Ntome_NODE_19466_length_1237_cov_43","Nsylvestris_NODE_19098_length_1176_cov_30",90.94,1192,74,23,52,1226,1176,2,0,1572,1174,1174
"59833","Ntome_NODE_19467_length_1237_cov_39","Nsylvestris_NODE_1767_length_4201_cov_78",98.182,55,1,0,1,55,3335,3389,4.06e-19,97.1,54,54
"59837","Ntome_NODE_19469_length_1237_cov_8","Nsylvestris_NODE_8380_length_2344_cov_16",95.796,1237,52,0,1,1237,70,1306,0,1997,1236,1236
"59850","Ntome_NODE_19474_length_1236_cov_81","Nsylvestris_NODE_7321_length_2516_cov_221",100,55,0,0,1182,1236,2177,2123,8.72e-21,102,54,54
"59854","Ntome_NODE_19476_length_1236_cov_30","Nsylvestris_NODE_18473_length_1226_cov_197",76.573,461,92,11,381,836,575,126,6.37e-62,239,455,449
"59858","Ntome_NODE_19478_length_1236_cov_25","Nsylvestris_NODE_4024_length_3226_cov_116",100,29,0,0,957,985,2260,2232,2.48e-06,54.7,28,28
"59864","Ntome_NODE_19480_length_1236_cov_17","Nsylvestris_NODE_12136_length_1854_cov_101",95.652,1196,52,0,1,1196,1241,46,0,1921,1195,1195
"59889","Ntome_NODE_19491_length_1235_cov_84","Nsylvestris_NODE_5178_length_2930_cov_183",91.894,1246,59,21,1,1235,1,1215,0,1703,1234,1214
"59890","Ntome_NODE_19492_length_1235_cov_81","Nsylvestris_NODE_21137_length_1019_cov_96",91.176,408,27,7,830,1233,441,39,3.35e-154,545,403,402
"59901","Ntome_NODE_19497_length_1234_cov_203","Nsylvestris_NODE_3039_length_3572_cov_177",92.948,1021,54,14,50,1065,2561,3568,0,1471,1015,1007
"59905","Ntome_NODE_19499_length_1234_cov_85","Nsylvestris_NODE_22471_length_924_cov_28",92.372,839,28,10,295,1106,90,919,0,1162,811,829
"59934","Ntome_NODE_19510_length_1233_cov_103","Nsylvestris_NODE_20223_length_1084_cov_105",92.661,1090,64,12,152,1233,1083,2,0,1555,1081,1081
"59939","Ntome_NODE_19513_length_1233_cov_55","Nsylvestris_NODE_14932_length_1557_cov_31",91.308,1254,70,11,10,1231,1311,65,0,1676,1221,1246
"59953","Ntome_NODE_19517_length_1233_cov_18","Nsylvestris_NODE_12627_length_1802_cov_231",94.545,55,3,0,1179,1233,1329,1383,8.76e-16,86.1,54,54
"59954","Ntome_NODE_19518_length_1233_cov_18","Nsylvestris_NODE_3223_length_3499_cov_76",96.065,1169,44,1,5,1171,2322,3490,0,1903,1166,1168
"59955","Ntome_NODE_19519_length_1233_cov_12","Nsylvestris_NODE_18821_length_1200_cov_71",94.976,1035,49,1,116,1150,169,1200,0,1620,1034,1031
"59956","Ntome_NODE_19521_length_1232_cov_295","Nsylvestris_NODE_2417_length_3832_cov_227",96.359,1181,40,1,55,1232,1704,2884,0,1940,1177,1180
"59968","Ntome_NODE_19526_length_1232_cov_167","Nsylvestris_NODE_823_length_5207_cov_120",92,75,3,3,1,74,4228,4156,8.7e-21,102,73,72
"59969","Ntome_NODE_19527_length_1232_cov_75","Nsylvestris_NODE_14824_length_1567_cov_153",95.044,1251,29,18,1,1232,1320,84,0,1936,1231,1236
"59993","Ntome_NODE_19537_length_1230_cov_82","Nsylvestris_NODE_2418_length_3832_cov_105",95.849,1084,44,1,1,1083,1156,73,0,1751,1082,1083
"59994","Ntome_NODE_19538_length_1231_cov_68","Nsylvestris_NODE_8002_length_2403_cov_161",85.408,233,22,9,21,243,104,334,1.06e-59,231,222,230
"59999","Ntome_NODE_19540_length_1231_cov_42","Nsylvestris_NODE_14868_length_1563_cov_199",92.327,1225,94,0,7,1231,1511,287,0,1742,1224,1224
"60010","Ntome_NODE_19545_length_1230_cov_31","Nsylvestris_NODE_3040_length_3572_cov_53",90.367,654,55,7,1,649,2343,2993,0,852,648,650
"60019","Ntome_NODE_19549_length_1229_cov_289","Nsylvestris_NODE_17047_length_1353_cov_182",92.07,1198,65,9,1,1179,25,1211,0,1659,1178,1186
"60023","Ntome_NODE_19551_length_1229_cov_105","Nsylvestris_NODE_16223_length_1427_cov_206",88.548,1205,95,14,12,1182,1275,80,0,1421,1170,1195
"60036","Ntome_NODE_19555_length_1229_cov_10","Nsylvestris_NODE_17227_length_1338_cov_141",93.532,1175,41,8,59,1229,1263,120,0,1716,1170,1143
"60037","Ntome_NODE_19556_length_1229_cov_9","Nsylvestris_NODE_406_length_6255_cov_89",90.143,1258,81,19,1,1224,2300,1052,0,1596,1223,1248
"60038","Ntome_NODE_19557_length_1228_cov_292","Nsylvestris_NODE_6197_length_2718_cov_187",98.046,1228,24,0,1,1228,2005,778,0,2135,1227,1227
"60039","Ntome_NODE_19558_length_1228_cov_292","Nsylvestris_NODE_19284_length_1161_cov_206",94.473,977,38,8,28,993,60,1031,0,1491,965,971
"60040","Ntome_NODE_19559_length_1227_cov_287","Nsylvestris_NODE_17982_length_1269_cov_195",94.486,1215,54,8,1,1207,60,1269,0,1860,1206,1209
"60046","Ntome_NODE_19562_length_1228_cov_207","Nsylvestris_NODE_2541_length_3773_cov_203",95.676,717,23,6,1,715,2268,2978,0,1146,714,710
"60049","Ntome_NODE_19564_length_1228_cov_156","Nsylvestris_NODE_3693_length_3337_cov_145",84.125,800,79,10,1,800,2586,3337,0,730,799,751
"60067","Ntome_NODE_19571_length_1228_cov_35","Nsylvestris_NODE_19899_length_1110_cov_71",92.204,744,41,8,283,1022,73,803,0,1037,739,730
"60068","Ntome_NODE_19572_length_1228_cov_26","Nsylvestris_NODE_2973_length_3597_cov_157",93.333,1245,58,9,1,1228,1718,2954,0,1816,1227,1236
"60125","Ntome_NODE_19596_length_1226_cov_26","Nsylvestris_NODE_2953_length_3603_cov_57",87.931,58,7,0,690,747,3531,3588,8.78e-11,69.4,57,57
"60133","Ntome_NODE_19599_length_1226_cov_12","Nsylvestris_NODE_5801_length_2800_cov_45",93.601,1219,64,13,18,1226,2798,1584,0,1807,1208,1214
"60144","Ntome_NODE_19605_length_1225_cov_231","Nsylvestris_NODE_20161_length_1089_cov_198",92.791,860,57,3,50,907,181,1037,0,1240,857,856
"60148","Ntome_NODE_19607_length_1225_cov_160","Nsylvestris_NODE_13474_length_1709_cov_211",93.913,460,18,5,766,1225,1628,1179,0,686,459,449
"60149","Ntome_NODE_19608_length_1225_cov_134","Nsylvestris_NODE_1445_length_4452_cov_150",98.182,55,1,0,1171,1225,3109,3163,4.02e-19,97.1,54,54
"60150","Ntome_NODE_19609_length_1225_cov_124","Nsylvestris_NODE_19311_length_1160_cov_82",87.915,1175,55,31,43,1183,1,1122,0,1303,1140,1121
"60155","Ntome_NODE_19611_length_1225_cov_21","Nsylvestris_NODE_11939_length_1876_cov_180",98.182,55,1,0,1,55,1258,1312,4.02e-19,97.1,54,54
"60156","Ntome_NODE_19612_length_1225_cov_8","Nsylvestris_NODE_10374_length_2065_cov_166",91.599,1226,100,2,1,1223,1892,667,0,1690,1222,1225
"60176","Ntome_NODE_19618_length_1224_cov_59","Nsylvestris_NODE_27189_length_665_cov_101",96.97,33,1,0,175,207,563,595,6.82e-07,56.5,32,32
"60181","Ntome_NODE_19620_length_1224_cov_41","Nsylvestris_NODE_5756_length_2809_cov_230",98.182,55,1,0,1170,1224,1152,1098,4.02e-19,97.1,54,54
"60185","Ntome_NODE_19622_length_1224_cov_19","Nsylvestris_NODE_134_length_7959_cov_142",88.01,1226,60,34,10,1186,3481,4668,0,1369,1176,1187
"60191","Ntome_NODE_19625_length_1223_cov_6","Nsylvestris_NODE_14093_length_1641_cov_21",77.35,1117,220,24,85,1191,1513,420,8.9e-180,630,1106,1093
"60197","Ntome_NODE_19628_length_1223_cov_291","Nsylvestris_NODE_18782_length_1203_cov_208",93.582,1044,55,3,48,1081,117,1158,0,1546,1033,1041
"60207","Ntome_NODE_19631_length_1223_cov_161","Nsylvestris_NODE_20079_length_1095_cov_203",95.794,642,27,0,582,1223,205,846,0,1037,641,641
"60224","Ntome_NODE_19638_length_1223_cov_10","Nsylvestris_NODE_17672_length_1297_cov_15",89.1,422,38,7,748,1167,1036,621,7.23e-146,518,419,415
"60245","Ntome_NODE_19647_length_1222_cov_86","Nsylvestris_NODE_6698_length_2622_cov_212",94.545,55,3,0,1,55,1358,1304,8.69e-16,86.1,54,54
"60246","Ntome_NODE_19648_length_1222_cov_61","Nsylvestris_NODE_20873_length_1037_cov_43",92.322,1042,51,11,117,1154,21,1037,0,1454,1037,1016
"60306","Ntome_NODE_19669_length_1220_cov_213","Nsylvestris_NODE_2904_length_3619_cov_174",96.252,1014,33,4,1,1010,1013,1,0,1657,1009,1012
"60307","Ntome_NODE_19670_length_1220_cov_212","Nsylvestris_NODE_4566_length_3081_cov_154",91.939,856,53,9,324,1168,275,1125,0,1184,844,850
"60312","Ntome_NODE_19672_length_1220_cov_166","Nsylvestris_NODE_177_length_7523_cov_112",92.169,1111,50,10,4,1081,7418,6312,0,1535,1077,1106
"60320","Ntome_NODE_19675_length_1220_cov_62","Nsylvestris_NODE_14853_length_1564_cov_201",93.939,66,4,0,1155,1220,1147,1082,3.1e-20,100,65,65
"60324","Ntome_NODE_19677_length_1220_cov_41","Nsylvestris_NODE_29707_length_553_cov_210",96.364,55,2,0,1166,1220,288,342,1.86e-17,91.6,54,54
"60329","Ntome_NODE_19679_length_1220_cov_34","Nsylvestris_NODE_3474_length_3409_cov_93",95.956,1088,42,1,1,1088,27,1112,0,1764,1087,1085
"60330","Ntome_NODE_19680_length_1220_cov_9","Nsylvestris_NODE_26552_length_693_cov_216",98.214,56,1,0,1165,1220,159,214,1.11e-19,99,55,55
"60338","Ntome_NODE_19683_length_1219_cov_176","Nsylvestris_NODE_23299_length_872_cov_171",93.606,782,36,8,60,835,824,51,0,1155,775,773
"60363","Ntome_NODE_19691_length_1219_cov_21","Nsylvestris_NODE_13110_length_1750_cov_32",90.127,1185,99,11,1,1170,1567,386,0,1524,1169,1181
"60378","Ntome_NODE_19698_length_1218_cov_183","Nsylvestris_NODE_25358_length_751_cov_209",94.545,55,3,0,1,55,241,187,8.66e-16,86.1,54,54
"60393","Ntome_NODE_19703_length_1218_cov_39","Nsylvestris_NODE_12423_length_1824_cov_235",98.182,55,1,0,1,55,1581,1635,4e-19,97.1,54,54
"60408","Ntome_NODE_19709_length_1217_cov_269","Nsylvestris_NODE_9885_length_2129_cov_219",97.039,1182,25,8,1,1180,952,2125,0,1980,1179,1173
"60417","Ntome_NODE_19712_length_1217_cov_234","Nsylvestris_NODE_11744_length_1900_cov_158",95.345,1117,35,5,101,1217,1157,58,0,1759,1116,1099
"60426","Ntome_NODE_19717_length_1217_cov_208","Nsylvestris_NODE_3205_length_3505_cov_204",84.243,806,114,5,117,913,2463,3264,0,773,796,801
"60476","Ntome_NODE_19736_length_1216_cov_46","Nsylvestris_NODE_30631_length_476_cov_29",87.374,198,12,2,115,311,360,175,1.06e-54,215,196,185
"60479","Ntome_NODE_19738_length_1216_cov_15","Nsylvestris_NODE_29778_length_547_cov_9",87.772,368,32,5,849,1216,547,193,7.5e-116,418,367,354
"60485","Ntome_NODE_19740_length_1215_cov_235","Nsylvestris_NODE_19752_length_1122_cov_199",94.599,1111,42,8,8,1108,1109,7,0,1703,1100,1102
"60492","Ntome_NODE_19743_length_1215_cov_83","Nsylvestris_NODE_11898_length_1880_cov_159",92.727,55,4,0,1,55,1531,1477,4.02e-14,80.5,54,54
"60499","Ntome_NODE_19746_length_1215_cov_37","Nsylvestris_NODE_4716_length_3041_cov_117",100,55,0,0,1,55,2215,2269,8.57e-21,102,54,54
"60513","Ntome_NODE_19753_length_1214_cov_243","Nsylvestris_NODE_18402_length_1232_cov_178",97.738,840,15,2,45,880,203,1042,0,1443,835,839
"60514","Ntome_NODE_19754_length_1214_cov_140","Nsylvestris_NODE_16973_length_1359_cov_134",92.51,1215,47,18,16,1197,1359,156,0,1700,1181,1203
"60515","Ntome_NODE_19755_length_1214_cov_59","Nsylvestris_NODE_35805_length_277_cov_4",93.385,257,15,2,828,1084,272,18,3.53e-104,379,256,254
"60522","Ntome_NODE_19758_length_1213_cov_242","Nsylvestris_NODE_19936_length_1107_cov_160",94.713,1116,45,8,71,1181,1,1107,0,1722,1110,1106
"60532","Ntome_NODE_19762_length_1213_cov_140","Nsylvestris_NODE_7113_length_2551_cov_98",92.964,668,37,6,446,1108,710,48,0,965,662,662
"60538","Ntome_NODE_19764_length_1213_cov_65","Nsylvestris_NODE_20258_length_1082_cov_67",94.1,1000,42,6,2,1001,1032,50,0,1504,999,982
"60541","Ntome_NODE_19769_length_1213_cov_22","Nsylvestris_NODE_4485_length_3103_cov_150",86.645,1258,104,36,1,1213,2550,1312,0,1334,1212,1238
"60563","Ntome_NODE_19778_length_1212_cov_47","Nsylvestris_NODE_16713_length_1380_cov_165",75.744,907,191,20,150,1038,313,1208,3.45e-119,429,888,895
"60567","Ntome_NODE_19780_length_1212_cov_29","Nsylvestris_NODE_6390_length_2681_cov_158",96.364,55,2,0,1,55,1158,1104,1.85e-17,91.6,54,54
"60592","Ntome_NODE_19790_length_1211_cov_156","Nsylvestris_NODE_18982_length_1185_cov_181",85.493,1034,84,20,149,1153,53,1049,0,1018,1004,996
"60596","Ntome_NODE_19792_length_1211_cov_30","Nsylvestris_NODE_10113_length_2101_cov_175",81.705,481,51,15,63,510,72,548,2.74e-100,366,447,476
"60644","Ntome_NODE_19809_length_1209_cov_141","Nsylvestris_NODE_7249_length_2527_cov_102",91.803,1159,63,14,50,1182,1367,2519,0,1585,1132,1152
"60645","Ntome_NODE_19810_length_1209_cov_116","Nsylvestris_NODE_20841_length_1039_cov_26",92.906,1029,35,14,61,1071,1,1009,0,1461,1010,1008
"60662","Ntome_NODE_19818_length_1208_cov_118","Nsylvestris_NODE_18839_length_1198_cov_116",93.656,1198,54,11,1,1190,9,1192,0,1772,1189,1183
"60663","Ntome_NODE_19819_length_1208_cov_86","Nsylvestris_NODE_12525_length_1812_cov_162",95.194,645,28,1,1,645,1002,1643,0,1016,644,641
"60685","Ntome_NODE_19828_length_1207_cov_254","Nsylvestris_NODE_18489_length_1225_cov_164",93.982,997,52,3,52,1040,190,1186,0,1502,988,996
"60686","Ntome_NODE_19829_length_1207_cov_246","Nsylvestris_NODE_119_length_8138_cov_130",88.333,360,41,1,69,428,2762,3120,9.56e-120,431,359,358
"60687","Ntome_NODE_19831_length_1207_cov_103","Nsylvestris_NODE_36502_length_262_cov_4",96.429,56,2,0,1,56,139,194,5.13e-18,93.5,55,55
"60697","Ntome_NODE_19835_length_1207_cov_15","Nsylvestris_NODE_25615_length_739_cov_7",97.429,739,19,0,425,1163,739,1,0,1260,738,738
"60701","Ntome_NODE_19837_length_1207_cov_12","Nsylvestris_NODE_18105_length_1258_cov_91",92.681,1134,69,7,62,1185,1158,29,0,1622,1123,1129
"60719","Ntome_NODE_19845_length_1205_cov_278","Nsylvestris_NODE_19892_length_1110_cov_197",92.041,1068,52,10,95,1139,1065,8,0,1471,1044,1057
"60732","Ntome_NODE_19849_length_1205_cov_240","Nsylvestris_NODE_20096_length_1094_cov_180",91.956,1007,50,5,5,986,1040,40,0,1382,981,1000
"60740","Ntome_NODE_19852_length_1205_cov_125","Nsylvestris_NODE_3087_length_3548_cov_104",92.295,1168,49,20,19,1178,49,1183,0,1620,1159,1134
"60741","Ntome_NODE_19854_length_1205_cov_70","Nsylvestris_NODE_5168_length_2933_cov_147",88.344,1141,68,24,92,1205,1105,3,0,1310,1113,1102
"60748","Ntome_NODE_19858_length_1204_cov_214","Nsylvestris_NODE_6102_length_2736_cov_231",95.537,1053,36,1,115,1156,1091,39,0,1674,1041,1052
"60762","Ntome_NODE_19865_length_1204_cov_23","Nsylvestris_NODE_2383_length_3849_cov_163",93.289,1207,60,10,1,1204,1487,2675,0,1760,1203,1188
"60765","Ntome_NODE_19868_length_1204_cov_10","Nsylvestris_NODE_16867_length_1367_cov_63",93.383,1209,54,13,4,1204,141,1331,0,1766,1200,1190
"60766","Ntome_NODE_19869_length_1204_cov_9","Nsylvestris_NODE_11855_length_1885_cov_217",96.364,55,2,0,1150,1204,499,553,1.84e-17,91.6,54,54
"60767","Ntome_NODE_19870_length_1204_cov_7","Nsylvestris_NODE_5910_length_2779_cov_217",94.545,55,3,0,1150,1204,1542,1488,8.55e-16,86.1,54,54
"60784","Ntome_NODE_19877_length_1203_cov_25","Nsylvestris_NODE_8638_length_2302_cov_230",98.276,58,1,0,1146,1203,2164,2221,8.49e-21,102,57,57
"60824","Ntome_NODE_19893_length_1202_cov_10","Nsylvestris_NODE_37086_length_250_cov_3",93.574,249,12,3,242,487,1,248,7.57e-101,368,245,247
"60837","Ntome_NODE_19898_length_1201_cov_242","Nsylvestris_NODE_18689_length_1210_cov_199",93.276,1041,52,9,53,1088,1195,168,0,1519,1035,1027
"60842","Ntome_NODE_19901_length_1201_cov_12","Nsylvestris_NODE_35557_length_283_cov_3",97.516,161,3,1,985,1145,283,124,1.7e-72,274,160,159
"60850","Ntome_NODE_19905_length_1200_cov_96","Nsylvestris_NODE_2418_length_3832_cov_105",97.417,1200,31,0,1,1200,1284,2483,0,2045,1199,1199
"60854","Ntome_NODE_19908_length_1200_cov_9","Nsylvestris_NODE_4743_length_3034_cov_192",98.182,55,1,0,1146,1200,2438,2492,3.94e-19,97.1,54,54
"60858","Ntome_NODE_19911_length_1199_cov_256","Nsylvestris_NODE_8150_length_2380_cov_202",100,55,0,0,1,55,1665,1719,8.46e-21,102,54,54
"60878","Ntome_NODE_19917_length_1199_cov_15","Nsylvestris_NODE_10206_length_2087_cov_189",98.182,55,1,0,1,55,1128,1182,3.94e-19,97.1,54,54
"60879","Ntome_NODE_19919_length_1199_cov_4","Nsylvestris_NODE_7828_length_2432_cov_163",94.662,1199,64,0,1,1199,2161,963,0,1860,1198,1198
"60880","Ntome_NODE_19920_length_1198_cov_301","Nsylvestris_NODE_2904_length_3619_cov_174",97.913,1198,25,0,1,1198,2156,959,0,2074,1197,1197
"60912","Ntome_NODE_19931_length_1197_cov_289","Nsylvestris_NODE_952_length_5018_cov_114",95.574,1107,46,2,1,1104,1155,49,0,1770,1103,1106
"60957","Ntome_NODE_19945_length_1196_cov_254","Nsylvestris_NODE_20533_length_1062_cov_195",90.909,1001,67,20,177,1164,73,1062,0,1323,987,989
"60965","Ntome_NODE_19947_length_1196_cov_237","Nsylvestris_NODE_21814_length_968_cov_117",90.987,932,37,19,232,1156,944,53,0,1212,924,891
"60969","Ntome_NODE_19949_length_1196_cov_146","Nsylvestris_NODE_11393_length_1943_cov_34",93.224,915,48,10,264,1169,1028,1937,0,1334,905,909
"60999","Ntome_NODE_19960_length_1195_cov_119","Nsylvestris_NODE_33035_length_352_cov_3",94.362,337,16,2,118,451,340,4,9.14e-145,514,333,336
"61004","Ntome_NODE_19962_length_1195_cov_106","Nsylvestris_NODE_21386_length_1000_cov_56",94.529,859,37,4,77,925,92,950,0,1317,848,858
"61007","Ntome_NODE_19964_length_1195_cov_71","Nsylvestris_NODE_423_length_6187_cov_190",92.308,52,1,3,638,688,5958,5909,2.38e-11,71.3,50,49
"61021","Ntome_NODE_19973_length_1194_cov_233","Nsylvestris_NODE_32770_length_361_cov_5",89.024,82,8,1,1114,1194,323,242,3.03e-20,100,80,81
"61030","Ntome_NODE_19976_length_1194_cov_8","Nsylvestris_NODE_13340_length_1725_cov_14",88.158,228,27,0,1,228,1539,1312,6.07e-72,272,227,227
"61034","Ntome_NODE_19978_length_1193_cov_268","Nsylvestris_NODE_19407_length_1151_cov_207",96.438,1095,29,7,46,1140,67,1151,0,1797,1094,1084
"61049","Ntome_NODE_19983_length_1193_cov_169","Nsylvestris_NODE_14791_length_1570_cov_117",91.736,1210,67,8,2,1193,233,1427,0,1650,1191,1194
"61052","Ntome_NODE_19986_length_1193_cov_74","Nsylvestris_NODE_19292_length_1161_cov_122",89.5,1019,70,14,1,1018,1141,159,0,1254,1017,982
"61053","Ntome_NODE_19988_length_1193_cov_16","Nsylvestris_NODE_11340_length_1947_cov_182",94.915,59,3,0,1,59,1061,1119,5.06e-18,93.5,58,58
"61060","Ntome_NODE_19993_length_1192_cov_179","Nsylvestris_NODE_14373_length_1612_cov_224",96.364,55,2,0,1,55,963,1017,1.82e-17,91.6,54,54
"61067","Ntome_NODE_19997_length_1192_cov_47","Nsylvestris_NODE_5219_length_2923_cov_47",88.503,374,14,10,823,1192,2923,2575,4.39e-118,425,369,348
"61092","Ntome_NODE_20008_length_1191_cov_207","Nsylvestris_NODE_26558_length_693_cov_71",95.679,648,25,2,24,671,1,645,0,1038,647,644
"61110","Ntome_NODE_20016_length_1190_cov_288","Nsylvestris_NODE_19359_length_1154_cov_233",93.488,906,39,10,175,1066,1011,112,0,1328,891,899
"61120","Ntome_NODE_20020_length_1190_cov_199","Nsylvestris_NODE_20316_length_1076_cov_201",92.523,1070,39,16,130,1189,1075,37,0,1495,1059,1038
"61127","Ntome_NODE_20024_length_1190_cov_77","Nsylvestris_NODE_16806_length_1372_cov_30",95.045,1009,50,0,180,1188,1277,269,0,1587,1008,1008
"61164","Ntome_NODE_20035_length_1189_cov_77","Nsylvestris_NODE_19053_length_1179_cov_109",92.845,1146,62,4,48,1189,1130,1,0,1644,1141,1129
"61169","Ntome_NODE_20038_length_1189_cov_38","Nsylvestris_NODE_981_length_4979_cov_83",100,55,0,0,1135,1189,3794,3740,8.39e-21,102,54,54
"61170","Ntome_NODE_20039_length_1189_cov_25","Nsylvestris_NODE_21006_length_1027_cov_200",100,55,0,0,1,55,567,513,8.39e-21,102,54,54
"61178","Ntome_NODE_20043_length_1188_cov_217","Nsylvestris_NODE_19380_length_1153_cov_174",91.503,1071,44,14,103,1164,1134,102,0,1430,1061,1032
"61195","Ntome_NODE_20049_length_1188_cov_64","Nsylvestris_NODE_15972_length_1452_cov_62",85.763,583,58,12,371,933,1220,643,1.13e-168,593,562,577
"61205","Ntome_NODE_20053_length_1188_cov_10","Nsylvestris_NODE_10538_length_2046_cov_41",75.417,480,84,28,634,1103,761,1216,8.03e-51,202,469,455
"61220","Ntome_NODE_20060_length_1187_cov_226","Nsylvestris_NODE_4486_length_3103_cov_103",96.536,1126,38,1,62,1187,202,1326,0,1862,1125,1124
"61245","Ntome_NODE_20069_length_1186_cov_262","Nsylvestris_NODE_15502_length_1502_cov_181",89.942,1213,66,16,1,1186,1187,4,0,1513,1185,1183
"61246","Ntome_NODE_20070_length_1186_cov_212","Nsylvestris_NODE_3912_length_3264_cov_174",98.364,428,7,0,1,428,1728,2155,0,752,427,427
"61250","Ntome_NODE_20072_length_1186_cov_172","Nsylvestris_NODE_16860_length_1367_cov_145",95.14,1111,51,2,1,1108,83,1193,0,1749,1107,1110
"61251","Ntome_NODE_20073_length_1186_cov_155","Nsylvestris_NODE_29261_length_572_cov_204",90.909,583,34,9,459,1033,1,572,0,765,574,571
"61268","Ntome_NODE_20081_length_1185_cov_278","Nsylvestris_NODE_19362_length_1154_cov_204",95.018,1104,41,9,93,1184,53,1154,0,1722,1091,1101
"61271","Ntome_NODE_20083_length_1185_cov_273","Nsylvestris_NODE_2891_length_3624_cov_203",94.559,1066,52,1,120,1185,3538,2479,0,1642,1065,1059
"61276","Ntome_NODE_20085_length_1185_cov_219","Nsylvestris_NODE_7495_length_2486_cov_167",92.424,924,45,14,270,1184,1579,2486,0,1295,914,907
"61286","Ntome_NODE_20089_length_1185_cov_50","Nsylvestris_NODE_18742_length_1206_cov_132",93.391,1044,49,10,140,1168,41,1079,0,1528,1028,1038
"61291","Ntome_NODE_20092_length_1185_cov_38","Nsylvestris_NODE_741_length_5363_cov_225",100,55,0,0,1131,1185,1032,1086,8.36e-21,102,54,54
"61297","Ntome_NODE_20095_length_1185_cov_17","Nsylvestris_NODE_10164_length_2093_cov_59",83.942,274,31,7,645,917,2090,1829,2.82e-65,250,272,261
"61323","Ntome_NODE_20105_length_1184_cov_79","Nsylvestris_NODE_20583_length_1058_cov_189",96.066,966,27,3,2,963,1010,52,0,1563,961,958
"61340","Ntome_NODE_20114_length_1183_cov_254","Nsylvestris_NODE_19165_length_1170_cov_179",92.445,1178,40,13,1,1174,1,1133,0,1637,1173,1132
"61363","Ntome_NODE_20123_length_1182_cov_279","Nsylvestris_NODE_20130_length_1091_cov_210",91.937,1017,75,2,42,1058,1059,50,0,1417,1016,1009
"61378","Ntome_NODE_20129_length_1182_cov_112","Nsylvestris_NODE_16124_length_1437_cov_140",87.751,449,38,7,527,958,908,460,4.2e-143,508,431,448
"61379","Ntome_NODE_20130_length_1182_cov_101","Nsylvestris_NODE_15636_length_1486_cov_91",94.737,760,38,1,274,1033,1442,685,0,1181,759,757
"61380","Ntome_NODE_20131_length_1182_cov_92","Nsylvestris_NODE_19310_length_1154_cov_135",88.96,1096,73,14,91,1175,64,1122,0,1310,1084,1058
"61388","Ntome_NODE_20134_length_1182_cov_36","Nsylvestris_NODE_18576_length_1218_cov_216",94.475,1104,55,3,52,1154,1149,51,0,1696,1102,1098
"61395","Ntome_NODE_20138_length_1182_cov_4","Nsylvestris_NODE_11636_length_1914_cov_220",100,31,0,0,1,31,799,829,1.83e-07,58.4,30,30
"61401","Ntome_NODE_20141_length_1181_cov_252","Nsylvestris_NODE_23145_length_882_cov_174",91.627,836,30,14,18,842,1,807,0,1120,824,806
"61424","Ntome_NODE_20151_length_1181_cov_10","Nsylvestris_NODE_2720_length_3696_cov_216",100,55,0,0,1,55,1701,1755,8.33e-21,102,54,54
"61473","Ntome_NODE_20168_length_1179_cov_45","Nsylvestris_NODE_22552_length_919_cov_10",82.322,758,62,27,93,831,2,706,4.05e-168,592,738,704
"61498","Ntome_NODE_20179_length_1178_cov_230","Nsylvestris_NODE_20032_length_1099_cov_195",89.572,911,46,21,236,1108,200,1099,0,1110,872,899
"61499","Ntome_NODE_20180_length_1178_cov_229","Nsylvestris_NODE_250_length_6992_cov_162",96.197,1157,37,4,1,1155,1154,3,0,1886,1154,1151
"61517","Ntome_NODE_20186_length_1178_cov_39","Nsylvestris_NODE_18257_length_1244_cov_39",87.324,71,7,2,747,816,407,338,3.89e-14,80.5,69,69
"61518","Ntome_NODE_20187_length_1178_cov_22","Nsylvestris_NODE_2162_length_3959_cov_231",98.182,55,1,0,1124,1178,1300,1246,3.86e-19,97.1,54,54
"61532","Ntome_NODE_20194_length_1177_cov_134","Nsylvestris_NODE_7669_length_2458_cov_60",94.316,1038,52,2,52,1082,52,1089,0,1583,1030,1037
"61538","Ntome_NODE_20197_length_1177_cov_107","Nsylvestris_NODE_19787_length_1118_cov_220",92.081,1086,63,8,1,1075,1118,45,0,1507,1074,1073
"61543","Ntome_NODE_20202_length_1177_cov_14","Nsylvestris_NODE_14320_length_1619_cov_121",98.182,55,1,0,1,55,255,309,3.86e-19,97.1,54,54
"61547","Ntome_NODE_20204_length_1177_cov_8","Nsylvestris_NODE_33882_length_326_cov_3",93.558,326,20,1,4,328,326,1,7.05e-136,484,324,325
"61567","Ntome_NODE_20211_length_1176_cov_140","Nsylvestris_NODE_1882_length_4131_cov_173",89.308,159,16,1,259,417,4102,3945,1.03e-49,198,158,157
"61568","Ntome_NODE_20212_length_1176_cov_92","Nsylvestris_NODE_8484_length_2327_cov_33",98.182,55,1,0,1,55,387,333,3.86e-19,97.1,54,54
"61571","Ntome_NODE_20214_length_1175_cov_33","Nsylvestris_NODE_30756_length_468_cov_6",94.86,214,11,0,301,514,391,178,7.5e-91,335,213,213
"61586","Ntome_NODE_20220_length_1176_cov_18","Nsylvestris_NODE_3206_length_3505_cov_150",93.159,1184,60,8,1,1173,401,1574,0,1718,1172,1173
"61592","Ntome_NODE_20223_length_1175_cov_261","Nsylvestris_NODE_19444_length_1148_cov_188",93.462,933,47,10,50,980,101,1021,0,1373,930,920
"61598","Ntome_NODE_20225_length_1175_cov_250","Nsylvestris_NODE_3205_length_3505_cov_204",84.513,749,108,5,1,745,2505,3249,0,734,744,744
"61599","Ntome_NODE_20226_length_1175_cov_188","Nsylvestris_NODE_23259_length_875_cov_176",94.519,821,36,5,212,1024,820,1,0,1258,812,819
"61603","Ntome_NODE_20228_length_1175_cov_103","Nsylvestris_NODE_6978_length_2572_cov_226",100,55,0,0,1,55,1001,947,8.28e-21,102,54,54
"61622","Ntome_NODE_20239_length_1174_cov_239","Nsylvestris_NODE_3544_length_3385_cov_202",98.085,940,18,0,235,1174,2174,1235,0,1637,939,939
"61623","Ntome_NODE_20240_length_1174_cov_237","Nsylvestris_NODE_17767_length_1288_cov_208",90.472,1144,87,17,19,1155,3,1131,0,1489,1136,1128
"61624","Ntome_NODE_20241_length_1174_cov_153","Nsylvestris_NODE_14616_length_1587_cov_127",96.137,673,26,0,1,673,1437,765,0,1099,672,672
"61635","Ntome_NODE_20246_length_1174_cov_49","Nsylvestris_NODE_21439_length_996_cov_149",86.173,904,41,31,230,1062,949,59,0,900,832,890
"61645","Ntome_NODE_20251_length_1173_cov_293","Nsylvestris_NODE_17035_length_1354_cov_106",92.589,958,41,14,7,964,111,1038,0,1349,957,927
"61656","Ntome_NODE_20256_length_1173_cov_177","Nsylvestris_NODE_15247_length_1526_cov_193",89.642,1033,62,16,133,1126,136,1162,0,1273,993,1026
"61668","Ntome_NODE_20261_length_1173_cov_15","Nsylvestris_NODE_2440_length_3822_cov_186",100,55,0,0,1,55,1188,1242,8.27e-21,102,54,54
"61669","Ntome_NODE_20263_length_1173_cov_6","Nsylvestris_NODE_9287_length_2209_cov_26",94.318,88,3,1,1088,1173,1920,2007,2.93e-30,134,85,87
"61672","Ntome_NODE_20265_length_1172_cov_31","Nsylvestris_NODE_15230_length_1529_cov_45",95.116,1167,53,3,1,1167,1273,111,0,1836,1166,1162
"61682","Ntome_NODE_20270_length_1172_cov_6","Nsylvestris_NODE_5548_length_2852_cov_35",78.92,778,149,13,405,1172,690,1462,8.96e-145,514,767,772
"61683","Ntome_NODE_20271_length_1171_cov_240","Nsylvestris_NODE_17278_length_1334_cov_173",96.233,1115,41,1,50,1163,1117,3,0,1825,1113,1114
"61691","Ntome_NODE_20275_length_1171_cov_20","Nsylvestris_NODE_14891_length_1561_cov_210",93.651,63,3,1,1,63,791,852,4.97e-18,93.5,62,61
"61695","Ntome_NODE_20278_length_1170_cov_288","Nsylvestris_NODE_14334_length_1617_cov_189",96.667,1170,38,1,1,1170,335,1503,0,1943,1169,1168
"61702","Ntome_NODE_20281_length_1170_cov_240","Nsylvestris_NODE_3909_length_3265_cov_105",93.258,1157,39,15,1,1147,2006,3133,0,1668,1146,1127
"61708","Ntome_NODE_20284_length_1170_cov_153","Nsylvestris_NODE_24945_length_774_cov_67",95.67,739,25,3,278,1016,3,734,0,1181,738,731
"61709","Ntome_NODE_20285_length_1170_cov_130","Nsylvestris_NODE_19801_length_1117_cov_150",89.755,898,34,18,213,1070,929,50,0,1096,857,879
"61727","Ntome_NODE_20293_length_1170_cov_9","Nsylvestris_NODE_2303_length_3891_cov_208",96.364,55,2,0,1,55,1255,1201,1.79e-17,91.6,54,54
"61731","Ntome_NODE_20297_length_1169_cov_252","Nsylvestris_NODE_20350_length_1074_cov_193",97.198,928,26,0,1,928,101,1028,0,1570,927,927
"61732","Ntome_NODE_20298_length_1169_cov_245","Nsylvestris_NODE_20556_length_1060_cov_210",92.91,1072,41,12,87,1136,1060,2,0,1526,1049,1058
"61742","Ntome_NODE_20302_length_1169_cov_40","Nsylvestris_NODE_2928_length_3610_cov_64",96.19,1076,41,0,37,1112,3599,2524,0,1760,1075,1075
"61743","Ntome_NODE_20303_length_1169_cov_33","Nsylvestris_NODE_3780_length_3307_cov_204",92.821,989,47,11,102,1089,2025,2990,0,1411,987,965
"61765","Ntome_NODE_20310_length_1168_cov_258","Nsylvestris_NODE_19443_length_1148_cov_203",92.542,1019,70,4,22,1035,1081,64,0,1456,1013,1017
"61782","Ntome_NODE_20318_length_1168_cov_26","Nsylvestris_NODE_20398_length_1071_cov_83",94.358,1028,49,5,2,1025,1,1023,0,1568,1023,1022
"61786","Ntome_NODE_20321_length_1168_cov_9","Nsylvestris_NODE_640_length_5580_cov_64",82.734,139,19,4,1026,1162,400,265,8.18e-26,119,136,135
"61793","Ntome_NODE_20324_length_1167_cov_249","Nsylvestris_NODE_6803_length_2603_cov_224",96.743,1136,31,1,1,1136,1130,1,0,1888,1135,1129
"61806","Ntome_NODE_20330_length_1167_cov_14","Nsylvestris_NODE_18510_length_1224_cov_7",97.206,1038,23,6,1,1034,1038,3,0,1751,1033,1035
"61829","Ntome_NODE_20339_length_1166_cov_121","Nsylvestris_NODE_16219_length_1428_cov_62",89.829,1052,90,11,117,1158,351,1395,0,1334,1041,1044
"61830","Ntome_NODE_20340_length_1166_cov_92","Nsylvestris_NODE_12543_length_1810_cov_164",94.388,392,14,7,261,650,1776,1391,3.09e-169,595,389,385
"61831","Ntome_NODE_20341_length_1166_cov_84","Nsylvestris_NODE_19929_length_1108_cov_63",93.569,1104,37,13,1,1089,24,1108,0,1615,1088,1084
"61843","Ntome_NODE_20346_length_1166_cov_18","Nsylvestris_NODE_12329_length_1834_cov_116",89.189,222,18,4,52,269,685,466,5.92e-72,272,217,219
"61847","Ntome_NODE_20348_length_1166_cov_11","Nsylvestris_NODE_3844_length_3287_cov_18",96.021,1156,45,1,11,1166,159,1313,0,1879,1155,1154
"61863","Ntome_NODE_20354_length_1165_cov_91","Nsylvestris_NODE_25100_length_766_cov_14",93.372,694,23,7,63,753,691,18,0,1005,690,673
"61864","Ntome_NODE_20355_length_1165_cov_76","Nsylvestris_NODE_5252_length_2915_cov_91",90.376,1143,83,12,1,1132,14,1140,0,1476,1131,1126
"61897","Ntome_NODE_20368_length_1164_cov_15","Nsylvestris_NODE_19126_length_1173_cov_206",93.75,64,4,0,1,64,321,384,3.82e-19,97.1,63,63
"61902","Ntome_NODE_20372_length_1163_cov_249","Nsylvestris_NODE_15446_length_1507_cov_214",95.19,1185,33,8,1,1163,232,1414,0,1851,1162,1182
"61917","Ntome_NODE_20379_length_1163_cov_25","Nsylvestris_NODE_14276_length_1622_cov_130",95.58,543,24,0,621,1163,42,584,0,870,542,542
"61921","Ntome_NODE_20381_length_1163_cov_14","Nsylvestris_NODE_16992_length_1358_cov_170",95.193,1165,53,2,1,1163,54,1217,0,1838,1162,1163
"61935","Ntome_NODE_20388_length_1162_cov_192","Nsylvestris_NODE_23072_length_886_cov_187",90.613,767,52,9,256,1008,780,20,0,1000,752,760
"61954","Ntome_NODE_20397_length_1161_cov_268","Nsylvestris_NODE_19606_length_1134_cov_220",92.706,1042,48,14,24,1046,1080,48,0,1478,1022,1032
"61962","Ntome_NODE_20400_length_1161_cov_193","Nsylvestris_NODE_5243_length_2917_cov_91",92.271,841,27,8,72,877,2078,2915,0,1158,805,837
"61973","Ntome_NODE_20407_length_1161_cov_6","Nsylvestris_NODE_2502_length_3793_cov_20",97.588,1161,28,0,1,1161,2244,3404,0,1989,1160,1160
"61976","Ntome_NODE_20409_length_1160_cov_310","Nsylvestris_NODE_1198_length_4706_cov_216",99.138,1160,10,0,1,1160,3268,2109,0,2087,1159,1159
"61977","Ntome_NODE_20410_length_1160_cov_231","Nsylvestris_NODE_5042_length_2962_cov_187",96.039,934,28,1,80,1004,1748,2681,0,1511,924,933
"61997","Ntome_NODE_20416_length_1160_cov_175","Nsylvestris_NODE_18539_length_1221_cov_91",94.872,1053,51,2,56,1108,172,1221,0,1642,1052,1049
"61998","Ntome_NODE_20417_length_1160_cov_164","Nsylvestris_NODE_19887_length_1111_cov_74",92.968,967,60,6,120,1084,974,14,0,1402,964,960
"61999","Ntome_NODE_20418_length_1160_cov_122","Nsylvestris_NODE_9264_length_2212_cov_142",98.182,55,1,0,1106,1160,351,297,3.8e-19,97.1,54,54
"62000","Ntome_NODE_20419_length_1160_cov_32","Nsylvestris_NODE_16735_length_1378_cov_14",77.124,306,46,10,587,886,486,773,6.19e-37,156,299,287
"62001","Ntome_NODE_20420_length_1160_cov_17","Nsylvestris_NODE_7853_length_2427_cov_143",100,55,0,0,1,55,1775,1829,8.18e-21,102,54,54
"62002","Ntome_NODE_20421_length_1160_cov_13","Nsylvestris_NODE_3128_length_3534_cov_136",93.878,49,2,1,1113,1160,686,638,6.41e-12,73.1,47,48
"62003","Ntome_NODE_20423_length_1159_cov_271","Nsylvestris_NODE_16387_length_1410_cov_212",93.224,974,37,6,2,975,992,48,0,1406,973,944
"62024","Ntome_NODE_20429_length_1159_cov_100","Nsylvestris_NODE_57_length_9298_cov_111",84.694,98,12,3,993,1087,8164,8067,1.37e-18,95.3,94,97
"62025","Ntome_NODE_20430_length_1159_cov_70","Nsylvestris_NODE_19172_length_1170_cov_31",92.818,1086,70,3,29,1107,1,1085,0,1567,1078,1084
"62032","Ntome_NODE_20433_length_1159_cov_19","Nsylvestris_NODE_5795_length_2802_cov_136",96.61,59,1,1,1,59,1208,1265,3.8e-19,97.1,58,57
"62033","Ntome_NODE_20434_length_1159_cov_19","Nsylvestris_NODE_6963_length_2574_cov_217",78.832,959,148,36,31,956,1038,1974,3.07e-169,595,925,936
"62034","Ntome_NODE_20435_length_1159_cov_13","Nsylvestris_NODE_21136_length_1019_cov_98",98.182,55,1,0,1105,1159,315,369,3.8e-19,97.1,54,54
"62075","Ntome_NODE_20451_length_1158_cov_8","Nsylvestris_NODE_7237_length_2529_cov_29",93.607,1048,54,6,122,1158,45,1090,0,1552,1036,1045
"62082","Ntome_NODE_20455_length_1157_cov_178","Nsylvestris_NODE_15026_length_1548_cov_61",95.5,1089,40,7,45,1133,302,1381,0,1731,1088,1079
"62083","Ntome_NODE_20456_length_1157_cov_166","Nsylvestris_NODE_10090_length_2104_cov_151",95.307,554,25,1,211,763,1326,1879,0,878,552,553
"62113","Ntome_NODE_20467_length_1157_cov_3","Nsylvestris_NODE_18272_length_1243_cov_214",94.545,55,3,0,1,55,501,447,8.21e-16,86.1,54,54
"62122","Ntome_NODE_20471_length_1156_cov_15","Nsylvestris_NODE_11201_length_1962_cov_220",98.182,55,1,0,1102,1156,1238,1184,3.79e-19,97.1,54,54
"62131","Ntome_NODE_20474_length_1156_cov_8","Nsylvestris_NODE_8016_length_2400_cov_209",100,55,0,0,1,55,1475,1421,8.15e-21,102,54,54
"62155","Ntome_NODE_20482_length_1155_cov_16","Nsylvestris_NODE_17216_length_1339_cov_37",92.651,1075,58,8,88,1154,1081,20,0,1528,1066,1061
"62161","Ntome_NODE_20485_length_1154_cov_287","Nsylvestris_NODE_4058_length_3215_cov_175",98.09,995,19,0,160,1154,156,1150,0,1733,994,994
"62177","Ntome_NODE_20492_length_1154_cov_202","Nsylvestris_NODE_21561_length_987_cov_183",92.984,898,41,7,88,973,938,51,0,1290,885,887
"62221","Ntome_NODE_20507_length_1153_cov_163","Nsylvestris_NODE_22254_length_939_cov_29",84.923,325,37,8,540,860,469,153,7.41e-86,318,320,316
"62225","Ntome_NODE_20509_length_1153_cov_126","Nsylvestris_NODE_5884_length_2787_cov_102",94.243,1077,53,7,12,1084,1165,94,0,1637,1072,1071
"62226","Ntome_NODE_20512_length_1153_cov_28","Nsylvestris_NODE_20685_length_1051_cov_34",89.512,1106,50,24,1,1095,1051,1,0,1339,1094,1050
"62227","Ntome_NODE_20513_length_1153_cov_25","Nsylvestris_NODE_16446_length_1405_cov_141",98.182,55,1,0,1,55,697,643,3.78e-19,97.1,54,54
"62247","Ntome_NODE_20522_length_1152_cov_115","Nsylvestris_NODE_17687_length_1295_cov_107",94.32,1074,60,1,8,1081,11,1083,0,1644,1073,1072
"62248","Ntome_NODE_20523_length_1152_cov_68","Nsylvestris_NODE_25513_length_743_cov_32",89.308,318,18,7,109,421,83,389,7.2e-106,385,312,306
"62249","Ntome_NODE_20524_length_1152_cov_61","Nsylvestris_NODE_17537_length_1309_cov_189",94.185,1135,58,6,19,1152,51,1178,0,1724,1133,1127
"62250","Ntome_NODE_20525_length_1152_cov_60","Nsylvestris_NODE_12993_length_1764_cov_185",96.035,681,27,0,426,1106,1764,1084,0,1109,680,680
"62251","Ntome_NODE_20526_length_1152_cov_51","Nsylvestris_NODE_16059_length_1444_cov_76",91.309,978,54,8,156,1133,498,1444,0,1306,977,946
"62252","Ntome_NODE_20527_length_1152_cov_12","Nsylvestris_NODE_7068_length_2559_cov_117",95.517,1160,39,6,2,1152,2421,1266,0,1842,1150,1155
"62253","Ntome_NODE_20529_length_1152_cov_9","Nsylvestris_NODE_8203_length_2371_cov_228",98.182,55,1,0,1,55,1920,1974,3.78e-19,97.1,54,54
"62289","Ntome_NODE_20544_length_1150_cov_252","Nsylvestris_NODE_15956_length_1454_cov_159",95.636,1100,37,7,60,1150,2,1099,0,1755,1090,1097
"62319","Ntome_NODE_20556_length_1149_cov_10","Nsylvestris_NODE_11758_length_1898_cov_218",100,55,0,0,1,55,1359,1413,8.1e-21,102,54,54
"62320","Ntome_NODE_20558_length_1148_cov_297","Nsylvestris_NODE_13704_length_1684_cov_220",96.445,1097,31,6,58,1148,24,1118,0,1803,1090,1094
"62324","Ntome_NODE_20561_length_1148_cov_264","Nsylvestris_NODE_19408_length_1151_cov_205",91.195,1113,41,14,52,1136,68,1151,0,1459,1084,1083
"62369","Ntome_NODE_20579_length_1147_cov_46","Nsylvestris_NODE_5614_length_2838_cov_24",96.364,55,2,0,1093,1147,2373,2427,1.75e-17,91.6,54,54
"62373","Ntome_NODE_20581_length_1147_cov_21","Nsylvestris_NODE_2187_length_3941_cov_33",91.837,98,8,0,1048,1145,1193,1290,2.22e-31,137,97,97
"62374","Ntome_NODE_20582_length_1147_cov_18","Nsylvestris_NODE_20383_length_1072_cov_191",98.182,55,1,0,1,55,408,462,3.76e-19,97.1,54,54
"62387","Ntome_NODE_20586_length_1146_cov_266","Nsylvestris_NODE_22928_length_895_cov_190",98.061,722,13,1,239,959,764,43,0,1254,720,721
"62396","Ntome_NODE_20589_length_1146_cov_102","Nsylvestris_NODE_16261_length_1423_cov_204",94.155,1095,45,10,13,1106,1365,289,0,1650,1093,1076
"62401","Ntome_NODE_20593_length_1146_cov_41","Nsylvestris_NODE_11908_length_1879_cov_182",76.493,787,133,27,177,913,396,1180,9.26e-105,381,736,784
"62402","Ntome_NODE_20594_length_1146_cov_30","Nsylvestris_NODE_2731_length_3688_cov_158",90.356,1151,63,28,1,1146,2335,3442,0,1467,1145,1107
"62403","Ntome_NODE_20595_length_1146_cov_18","Nsylvestris_NODE_3540_length_3386_cov_39",91.803,122,4,2,1031,1146,319,440,1.02e-39,165,115,121
"62434","Ntome_NODE_20606_length_1145_cov_15","Nsylvestris_NODE_16382_length_1411_cov_173",91.717,1159,38,11,36,1145,51,1200,0,1555,1109,1149
"62442","Ntome_NODE_20608_length_1145_cov_9","Nsylvestris_NODE_1481_length_4416_cov_26",94.718,1098,58,0,1,1098,1451,354,0,1707,1097,1097
"62443","Ntome_NODE_20609_length_1145_cov_7","Nsylvestris_NODE_31480_length_421_cov_4",85.714,105,13,1,233,335,131,235,4.82e-23,110,102,104
"62461","Ntome_NODE_20617_length_1144_cov_11","Nsylvestris_NODE_6454_length_2669_cov_114",78.984,709,109,21,135,829,1262,580,8.99e-125,448,694,682
"62474","Ntome_NODE_20622_length_1143_cov_234","Nsylvestris_NODE_19587_length_1135_cov_215",92.929,1089,58,8,27,1101,20,1103,0,1567,1074,1083
"62491","Ntome_NODE_20633_length_1143_cov_13","Nsylvestris_NODE_7219_length_2531_cov_58",94.545,55,3,0,1034,1088,1439,1493,8.11e-16,86.1,54,54
"62500","Ntome_NODE_20639_length_1142_cov_218","Nsylvestris_NODE_18002_length_1268_cov_108",83.099,142,21,3,425,565,619,758,4.78e-28,126,140,139
"62510","Ntome_NODE_20645_length_1142_cov_6","Nsylvestris_NODE_11524_length_1927_cov_120",97.811,1142,25,0,1,1142,177,1318,0,1971,1141,1141
"62511","Ntome_NODE_20646_length_1141_cov_278","Nsylvestris_NODE_18444_length_1228_cov_192",94.498,1036,40,5,62,1093,67,1089,0,1581,1031,1022
"62520","Ntome_NODE_20649_length_1141_cov_251","Nsylvestris_NODE_19365_length_1154_cov_190",94.703,944,47,3,23,963,1089,146,0,1463,940,943
"62523","Ntome_NODE_20651_length_1141_cov_213","Nsylvestris_NODE_5098_length_2949_cov_203",93.627,863,45,5,56,915,1927,2782,0,1280,859,855
"62527","Ntome_NODE_20653_length_1141_cov_175","Nsylvestris_NODE_19272_length_1162_cov_139",91.136,1083,63,21,9,1066,48,1122,0,1437,1057,1074
"62528","Ntome_NODE_20654_length_1141_cov_162","Nsylvestris_NODE_17483_length_1315_cov_190",92.231,1107,61,10,2,1087,120,1222,0,1544,1085,1102
"62539","Ntome_NODE_20658_length_1140_cov_49","Nsylvestris_NODE_18476_length_1226_cov_87",91.24,1153,61,23,1,1140,95,1220,0,1533,1139,1125
"62540","Ntome_NODE_20660_length_1141_cov_9","Nsylvestris_NODE_2401_length_3840_cov_194",80.069,291,31,16,658,926,2180,2465,1.67e-47,191,268,285
"62541","Ntome_NODE_20661_length_1141_cov_7","Nsylvestris_NODE_20636_length_1055_cov_211",100,55,0,0,1087,1141,771,825,8.04e-21,102,54,54
"62550","Ntome_NODE_20665_length_1140_cov_274","Nsylvestris_NODE_12969_length_1766_cov_205",94.454,1136,39,7,1,1117,636,1766,0,1727,1116,1130
"62563","Ntome_NODE_20670_length_1140_cov_41","Nsylvestris_NODE_19207_length_1167_cov_104",93.116,1104,54,17,57,1140,1132,31,0,1598,1083,1101
"62566","Ntome_NODE_20672_length_1140_cov_23","Nsylvestris_NODE_18267_length_1244_cov_128",100,55,0,0,1,55,1051,997,8.03e-21,102,54,54
"62567","Ntome_NODE_20673_length_1140_cov_18","Nsylvestris_NODE_14015_length_1647_cov_214",77.74,292,51,10,146,430,542,826,2.81e-40,167,284,284
"62595","Ntome_NODE_20683_length_1139_cov_209","Nsylvestris_NODE_17305_length_1331_cov_164",96.269,1099,38,3,43,1139,1331,234,0,1799,1096,1097
"62618","Ntome_NODE_20691_length_1139_cov_4","Nsylvestris_NODE_15395_length_1513_cov_78",95.414,1112,51,0,1,1112,363,1474,0,1772,1111,1111
"62619","Ntome_NODE_20692_length_1138_cov_316","Nsylvestris_NODE_7725_length_2448_cov_222",97.95,1073,21,1,67,1138,2406,1334,0,1858,1071,1072
"62623","Ntome_NODE_20694_length_1138_cov_258","Nsylvestris_NODE_3467_length_3413_cov_190",93.253,830,40,8,170,998,1014,200,0,1208,828,814
"62636","Ntome_NODE_20700_length_1138_cov_41","Nsylvestris_NODE_7995_length_2404_cov_217",100,54,0,0,1,54,669,616,2.88e-20,100,53,53
"62647","Ntome_NODE_20705_length_1138_cov_8","Nsylvestris_NODE_12633_length_1802_cov_129",93.942,1139,55,4,1,1138,1531,406,0,1709,1137,1125
"62658","Ntome_NODE_20709_length_1137_cov_134","Nsylvestris_NODE_25866_length_725_cov_45",91.803,610,25,6,420,1008,116,721,0,826,588,605
"62674","Ntome_NODE_20716_length_1137_cov_23","Nsylvestris_NODE_3645_length_3352_cov_218",100,55,0,0,1,55,2776,2722,8.01e-21,102,54,54
"62675","Ntome_NODE_20718_length_1137_cov_7","Nsylvestris_NODE_12707_length_1795_cov_40",98.065,1137,21,1,1,1137,1372,237,0,1977,1136,1135
"62680","Ntome_NODE_20721_length_1136_cov_276","Nsylvestris_NODE_1071_length_4854_cov_182",92.447,993,42,14,16,985,4803,3821,0,1387,969,982
"62683","Ntome_NODE_20723_length_1136_cov_213","Nsylvestris_NODE_22723_length_907_cov_46",85.859,594,36,14,497,1055,581,1,5.04e-167,588,558,580
"62692","Ntome_NODE_20728_length_1136_cov_75","Nsylvestris_NODE_18126_length_1256_cov_139",92.021,1153,51,16,1,1136,1177,49,0,1581,1135,1128
"62693","Ntome_NODE_20729_length_1136_cov_39","Nsylvestris_NODE_19481_length_1145_cov_37",95.213,1128,50,2,8,1135,22,1145,0,1781,1127,1123
"62701","Ntome_NODE_20733_length_1136_cov_18","Nsylvestris_NODE_15022_length_1548_cov_113",94.318,88,5,0,1,88,846,759,7.89e-31,135,87,87
"62702","Ntome_NODE_20734_length_1136_cov_15","Nsylvestris_NODE_11974_length_1873_cov_214",96.154,52,2,0,1085,1136,571,520,8.06e-16,86.1,51,51
"62705","Ntome_NODE_20736_length_1136_cov_6","Nsylvestris_NODE_8288_length_2356_cov_232",94.34,53,3,0,1084,1136,108,160,1.04e-14,82.4,52,52
"62706","Ntome_NODE_20737_length_1135_cov_280","Nsylvestris_NODE_19519_length_1141_cov_213",94.99,978,38,5,50,1022,1115,144,0,1524,972,971
"62711","Ntome_NODE_20740_length_1135_cov_179","Nsylvestris_NODE_18076_length_1261_cov_155",95.623,1028,39,4,62,1088,1248,226,0,1644,1026,1022
"62734","Ntome_NODE_20751_length_1135_cov_9","Nsylvestris_NODE_4591_length_3075_cov_226",95.161,62,2,1,1,61,2421,2360,3.72e-19,97.1,60,61
"62742","Ntome_NODE_20754_length_1134_cov_164","Nsylvestris_NODE_19178_length_1169_cov_88",92.074,921,46,9,237,1132,202,1120,0,1271,895,918
"62774","Ntome_NODE_20768_length_1133_cov_44","Nsylvestris_NODE_16866_length_1367_cov_71",83.196,607,95,4,150,751,1025,421,2.37e-155,549,601,604
"62792","Ntome_NODE_20774_length_1133_cov_19","Nsylvestris_NODE_1631_length_4308_cov_119",93.631,1052,64,2,37,1086,2698,1648,0,1568,1049,1050
"62798","Ntome_NODE_20778_length_1133_cov_7","Nsylvestris_NODE_15605_length_1490_cov_63",94.278,1136,62,1,1,1133,1164,29,0,1735,1132,1135
"62817","Ntome_NODE_20785_length_1132_cov_97","Nsylvestris_NODE_27366_length_657_cov_178",87.871,371,22,6,714,1084,248,595,9.02e-115,414,370,347
"62838","Ntome_NODE_20796_length_1132_cov_11","Nsylvestris_NODE_35906_length_275_cov_4",95.122,123,6,0,1,123,113,235,1.28e-48,195,122,122
"62841","Ntome_NODE_20799_length_1132_cov_8","Nsylvestris_NODE_1863_length_4141_cov_217",100,55,0,0,1078,1132,2624,2570,7.97e-21,102,54,54
"62851","Ntome_NODE_20803_length_1130_cov_271","Nsylvestris_NODE_19881_length_1111_cov_211",93.025,1061,50,14,41,1080,1087,30,0,1528,1039,1057
"62852","Ntome_NODE_20804_length_1131_cov_256","Nsylvestris_NODE_442_length_6136_cov_195",94.517,1149,32,17,1,1131,1908,773,0,1744,1130,1135
"62860","Ntome_NODE_20808_length_1131_cov_159","Nsylvestris_NODE_23226_length_877_cov_41",92.639,557,41,0,271,827,46,602,0,802,556,556
"62868","Ntome_NODE_20813_length_1131_cov_59","Nsylvestris_NODE_15262_length_1525_cov_100",95.848,1132,34,7,2,1131,44,1164,0,1818,1129,1120
"62909","Ntome_NODE_20831_length_1130_cov_10","Nsylvestris_NODE_10549_length_2044_cov_51",98.182,55,1,0,1076,1130,1311,1257,3.7e-19,97.1,54,54
"62914","Ntome_NODE_20834_length_1129_cov_268","Nsylvestris_NODE_23273_length_874_cov_219",83.902,615,71,18,512,1117,613,18,3.04e-159,562,605,595
"62920","Ntome_NODE_20838_length_1129_cov_30","Nsylvestris_NODE_15226_length_1529_cov_94",87.73,163,18,2,3,163,50,212,5.93e-47,189,160,162
"62947","Ntome_NODE_20847_length_1128_cov_212","Nsylvestris_NODE_5537_length_2854_cov_180",95.688,1090,43,4,32,1120,80,1166,0,1749,1088,1086
"62948","Ntome_NODE_20848_length_1128_cov_85","Nsylvestris_NODE_15114_length_1539_cov_151",96.715,974,32,0,16,989,1,974,0,1622,973,973
"62949","Ntome_NODE_20849_length_1128_cov_76","Nsylvestris_NODE_20662_length_1053_cov_9",91.757,922,51,15,155,1064,145,1053,0,1258,909,908
"62958","Ntome_NODE_20852_length_1128_cov_22","Nsylvestris_NODE_21514_length_991_cov_39",95.037,947,41,4,1,946,5,946,0,1483,945,941
"62965","Ntome_NODE_20856_length_1126_cov_288","Nsylvestris_NODE_18872_length_1195_cov_188",92.537,1139,48,9,6,1126,4,1123,0,1598,1120,1119
"62973","Ntome_NODE_20860_length_1127_cov_184","Nsylvestris_NODE_27468_length_652_cov_61",95.134,596,29,0,482,1077,45,640,0,941,595,595
"62981","Ntome_NODE_20864_length_1127_cov_35","Nsylvestris_NODE_18258_length_1245_cov_20",94.605,1001,47,3,87,1086,1117,123,0,1543,999,994
"62982","Ntome_NODE_20866_length_1127_cov_23","Nsylvestris_NODE_16734_length_1378_cov_26",94.844,1125,57,1,3,1127,201,1324,0,1755,1124,1123
"62986","Ntome_NODE_20868_length_1127_cov_7","Nsylvestris_NODE_14976_length_1552_cov_213",100,55,0,0,1,55,897,843,7.94e-21,102,54,54
"62999","Ntome_NODE_20873_length_1126_cov_227","Nsylvestris_NODE_20425_length_1070_cov_17",75.364,686,157,12,428,1110,715,39,2.01e-86,320,682,676
"63000","Ntome_NODE_20874_length_1126_cov_96","Nsylvestris_NODE_18347_length_1237_cov_111",89.843,1083,73,20,11,1073,65,1130,0,1356,1062,1065
"63014","Ntome_NODE_20880_length_1125_cov_232","Nsylvestris_NODE_18495_length_1224_cov_222",93.247,1007,67,1,67,1073,38,1043,0,1482,1006,1005
"63017","Ntome_NODE_20882_length_1125_cov_195","Nsylvestris_NODE_1094_length_4827_cov_227",83.721,86,14,0,878,963,4432,4517,1.03e-14,82.4,85,85
"63027","Ntome_NODE_20886_length_1124_cov_310","Nsylvestris_NODE_403_length_6262_cov_42",91.7,253,18,3,425,675,1198,947,9.21e-95,348,250,251
"63039","Ntome_NODE_20891_length_1124_cov_136","Nsylvestris_NODE_1691_length_4260_cov_176",96.007,1127,23,9,1,1124,1463,2570,0,1812,1123,1107
"63047","Ntome_NODE_20894_length_1124_cov_48","Nsylvestris_NODE_13203_length_1739_cov_16",86.667,90,7,3,725,809,551,640,1.32e-18,95.3,84,89
"63055","Ntome_NODE_20897_length_1124_cov_10","Nsylvestris_NODE_5979_length_2765_cov_79",82.764,702,113,7,258,952,2170,1470,1.77e-176,619,694,700
"63056","Ntome_NODE_20899_length_1123_cov_273","Nsylvestris_NODE_19368_length_1154_cov_177",96.429,1064,38,0,11,1074,1148,85,0,1755,1063,1063
"63067","Ntome_NODE_20904_length_1123_cov_202","Nsylvestris_NODE_24339_length_810_cov_61",91.186,624,41,11,113,726,45,664,0,835,613,619
"63096","Ntome_NODE_20915_length_1122_cov_35","Nsylvestris_NODE_4729_length_3038_cov_75",97.674,43,1,0,1,43,2559,2517,4.79e-13,76.8,42,42
"63097","Ntome_NODE_20916_length_1122_cov_25","Nsylvestris_NODE_12279_length_1839_cov_214",98.182,55,1,0,1,55,865,811,3.68e-19,97.1,54,54
"63101","Ntome_NODE_20919_length_1122_cov_14","Nsylvestris_NODE_1997_length_4062_cov_90",91.667,240,20,0,555,794,3779,4018,2.57e-90,333,239,239
"63114","Ntome_NODE_20926_length_1121_cov_183","Nsylvestris_NODE_18115_length_1257_cov_22",92.463,743,40,6,360,1088,465,1205,0,1048,728,740
"63138","Ntome_NODE_20933_length_1121_cov_46","Nsylvestris_NODE_21581_length_986_cov_78",88.66,679,74,2,282,960,948,273,0,824,678,675
"63139","Ntome_NODE_20934_length_1121_cov_46","Nsylvestris_NODE_1567_length_4351_cov_231",100,55,0,0,1,55,1187,1133,7.9e-21,102,54,54
"63157","Ntome_NODE_20943_length_1120_cov_102","Nsylvestris_NODE_19912_length_1109_cov_194",90.282,1029,70,22,100,1107,90,1109,0,1319,1007,1019
"63169","Ntome_NODE_20947_length_1120_cov_25","Nsylvestris_NODE_59_length_9263_cov_64",89.134,635,64,5,403,1032,6664,6030,0,785,629,634
"63176","Ntome_NODE_20950_length_1119_cov_224","Nsylvestris_NODE_18253_length_1245_cov_205",93.184,1027,40,10,77,1102,999,2,0,1482,1025,997
"63177","Ntome_NODE_20951_length_1119_cov_198","Nsylvestris_NODE_217_length_7234_cov_135",75.924,947,176,32,184,1117,6785,5878,5.29e-122,438,933,907
"63191","Ntome_NODE_20956_length_1119_cov_119","Nsylvestris_NODE_17638_length_1299_cov_104",94.041,772,44,2,315,1085,1253,483,0,1170,770,770
"63218","Ntome_NODE_20972_length_1118_cov_269","Nsylvestris_NODE_18706_length_1208_cov_196",94.618,1059,47,4,1,1057,95,1145,0,1631,1056,1050
"63227","Ntome_NODE_20977_length_1118_cov_6","Nsylvestris_NODE_11596_length_1920_cov_89",100,55,0,0,1064,1118,1270,1324,7.87e-21,102,54,54
"63228","Ntome_NODE_20978_length_1118_cov_6","Nsylvestris_NODE_16613_length_1390_cov_133",91.682,1118,58,15,34,1118,1172,57,0,1517,1084,1115
"63229","Ntome_NODE_20980_length_1117_cov_318","Nsylvestris_NODE_911_length_5074_cov_197",96.867,1117,35,0,1,1117,4969,3853,0,1869,1116,1116
"63240","Ntome_NODE_20984_length_1117_cov_239","Nsylvestris_NODE_19307_length_1160_cov_200",94.804,1020,46,4,80,1098,82,1095,0,1583,1018,1013
"63243","Ntome_NODE_20986_length_1117_cov_182","Nsylvestris_NODE_18420_length_1231_cov_16",89.792,480,39,5,436,907,796,319,1.37e-172,606,471,477
"63249","Ntome_NODE_20988_length_1117_cov_110","Nsylvestris_NODE_7206_length_2533_cov_144",96.364,55,2,0,1063,1117,1705,1759,1.7e-17,91.6,54,54
"63258","Ntome_NODE_20993_length_1117_cov_43","Nsylvestris_NODE_29140_length_577_cov_29",87.206,383,35,4,60,439,67,438,1.48e-117,424,379,371
"63265","Ntome_NODE_20996_length_1117_cov_9","Nsylvestris_NODE_6589_length_2645_cov_75",96.967,956,29,0,161,1116,846,1801,0,1605,955,955
"63291","Ntome_NODE_21005_length_1116_cov_11","Nsylvestris_NODE_15557_length_1494_cov_216",98.182,55,1,0,1,55,472,526,3.66e-19,97.1,54,54
"63292","Ntome_NODE_21006_length_1116_cov_10","Nsylvestris_NODE_3421_length_3429_cov_74",94.194,930,45,5,33,953,952,1881,0,1410,920,929
"63297","Ntome_NODE_21008_length_1115_cov_259","Nsylvestris_NODE_3469_length_3412_cov_96",92.391,552,34,8,91,638,3410,2863,0,780,547,547
"63311","Ntome_NODE_21014_length_1115_cov_8","Nsylvestris_NODE_4941_length_2988_cov_48",78.292,562,110,8,508,1060,1003,445,7.06e-96,351,552,558
"63325","Ntome_NODE_21021_length_1114_cov_182","Nsylvestris_NODE_20692_length_1050_cov_147",95.642,826,31,3,41,865,1,822,0,1321,824,821
"63326","Ntome_NODE_21022_length_1114_cov_86","Nsylvestris_NODE_23060_length_887_cov_121",93.333,90,6,0,771,860,787,876,2.78e-30,134,89,89
"63330","Ntome_NODE_21025_length_1114_cov_24","Nsylvestris_NODE_17653_length_1298_cov_81",90.877,1140,50,17,1,1114,1189,78,0,1480,1113,1111
"63333","Ntome_NODE_21027_length_1114_cov_10","Nsylvestris_NODE_15441_length_1509_cov_10",98.164,1035,19,0,80,1114,1485,451,0,1807,1034,1034
"63334","Ntome_NODE_21028_length_1114_cov_9","Nsylvestris_NODE_5401_length_2886_cov_38",95.902,976,37,3,1,973,1859,2834,0,1578,972,975
"63347","Ntome_NODE_21033_length_1113_cov_216","Nsylvestris_NODE_6057_length_2747_cov_110",95.385,390,18,0,418,807,1852,1463,4.87e-177,621,389,389
"63355","Ntome_NODE_21037_length_1113_cov_58","Nsylvestris_NODE_11654_length_1913_cov_152",87.943,141,17,0,973,1113,466,326,2.74e-40,167,140,140
"63360","Ntome_NODE_21039_length_1113_cov_50","Nsylvestris_NODE_18699_length_1209_cov_151",94.408,1055,41,5,1,1054,172,1209,0,1605,1053,1037
"63361","Ntome_NODE_21040_length_1113_cov_26","Nsylvestris_NODE_23660_length_851_cov_18",87.3,874,61,26,147,993,1,851,0,953,846,850
"63367","Ntome_NODE_21043_length_1112_cov_256","Nsylvestris_NODE_24114_length_824_cov_199",90.241,830,51,13,58,866,821,1,0,1057,808,820
"63370","Ntome_NODE_21046_length_1112_cov_63","Nsylvestris_NODE_1126_length_4786_cov_83",81.006,716,105,21,6,712,4006,3313,1.4e-152,540,706,693
"63385","Ntome_NODE_21051_length_1112_cov_14","Nsylvestris_NODE_4107_length_3201_cov_112",85.057,696,66,16,436,1112,1178,502,0,675,676,676
"63391","Ntome_NODE_21055_length_1111_cov_243","Nsylvestris_NODE_19657_length_1130_cov_175",90.036,1124,70,28,2,1102,25,1129,0,1417,1100,1104
"63409","Ntome_NODE_21064_length_1111_cov_16","Nsylvestris_NODE_4186_length_3179_cov_217",96.364,55,2,0,1,55,791,737,1.69e-17,91.6,54,54
"63415","Ntome_NODE_21066_length_1111_cov_11","Nsylvestris_NODE_5640_length_2830_cov_92",94.694,1112,55,4,1,1111,630,1738,0,1724,1110,1108
"63416","Ntome_NODE_21067_length_1111_cov_11","Nsylvestris_NODE_20158_length_1090_cov_9",78.659,164,30,4,271,433,113,272,2.18e-21,104,162,159
"63419","Ntome_NODE_21069_length_1111_cov_9","Nsylvestris_NODE_14751_length_1574_cov_191",95.68,1111,48,0,1,1111,1312,202,0,1786,1110,1110
"63434","Ntome_NODE_21076_length_1110_cov_112","Nsylvestris_NODE_8810_length_2277_cov_238",98.182,55,1,0,1056,1110,8,62,3.64e-19,97.1,54,54
"63435","Ntome_NODE_21077_length_1110_cov_96","Nsylvestris_NODE_20870_length_1037_cov_158",94.164,891,38,3,1,877,891,1,0,1345,876,890
"63449","Ntome_NODE_21082_length_1109_cov_290","Nsylvestris_NODE_20162_length_1089_cov_194",92.632,950,49,5,89,1021,1045,100,0,1347,932,945
"63450","Ntome_NODE_21083_length_1109_cov_238","Nsylvestris_NODE_21404_length_998_cov_197",93.564,808,43,5,195,996,104,908,0,1195,801,804
"63451","Ntome_NODE_21084_length_1109_cov_236","Nsylvestris_NODE_19974_length_1104_cov_226",92.935,1104,56,14,6,1094,8,1104,0,1587,1088,1096
"63469","Ntome_NODE_21093_length_1109_cov_29","Nsylvestris_NODE_16369_length_1413_cov_30",88.636,132,14,1,966,1096,394,263,4.57e-38,159,130,131
"63478","Ntome_NODE_21096_length_1109_cov_19","Nsylvestris_NODE_19572_length_1137_cov_47",93.939,1056,61,2,1,1053,38,1093,0,1592,1052,1055
"63479","Ntome_NODE_21097_length_1108_cov_13","Nsylvestris_NODE_1512_length_4390_cov_53",93.056,72,3,2,1,71,2909,2839,2.17e-21,104,70,70
"63480","Ntome_NODE_21098_length_1109_cov_8","Nsylvestris_NODE_15272_length_1524_cov_195",95.582,1109,45,2,1,1109,1407,303,0,1773,1108,1104
"63481","Ntome_NODE_21099_length_1109_cov_6","Nsylvestris_NODE_32293_length_382_cov_2",84.898,245,34,2,768,1009,18,262,1.23e-63,244,241,244
"63490","Ntome_NODE_21103_length_1110_cov_268","Nsylvestris_NODE_15964_length_1453_cov_175",94.511,1002,45,7,26,1023,385,1380,0,1537,997,995
"63491","Ntome_NODE_21104_length_1108_cov_247","Nsylvestris_NODE_14538_length_1596_cov_132",93.801,984,28,10,62,1014,1594,613,0,1448,952,981
"63495","Ntome_NODE_21107_length_1102_cov_60","Nsylvestris_NODE_22434_length_926_cov_39",77.446,368,70,10,637,1001,562,919,1.6e-52,207,364,357
"63496","Ntome_NODE_21108_length_1108_cov_31","Nsylvestris_NODE_23421_length_865_cov_103",90.323,62,6,0,239,300,67,128,1.02e-14,82.4,61,61
"63499","Ntome_NODE_21110_length_1108_cov_25","Nsylvestris_NODE_11134_length_1971_cov_126",98.214,56,1,0,1050,1105,1650,1705,1.01e-19,99,55,55
"63500","Ntome_NODE_21111_length_1108_cov_13","Nsylvestris_NODE_1099_length_4822_cov_161",96.61,59,2,0,1,59,389,331,1.01e-19,99,58,58
"63506","Ntome_NODE_21115_length_1107_cov_274","Nsylvestris_NODE_21889_length_960_cov_206",94.607,853,35,9,135,979,911,62,0,1310,844,849
"63532","Ntome_NODE_21122_length_1107_cov_58","Nsylvestris_NODE_12825_length_1783_cov_218",96.364,55,2,0,1,55,602,548,1.69e-17,91.6,54,54
"63533","Ntome_NODE_21123_length_1107_cov_47","Nsylvestris_NODE_18580_length_1218_cov_172",92.082,1124,53,14,1,1107,52,1156,0,1550,1106,1104
"63539","Ntome_NODE_21127_length_1107_cov_10","Nsylvestris_NODE_181_length_7492_cov_132",100,55,0,0,1053,1107,2707,2761,7.79e-21,102,54,54
"63549","Ntome_NODE_21133_length_1106_cov_251","Nsylvestris_NODE_2927_length_3611_cov_88",92.239,902,45,14,183,1081,927,48,0,1254,898,879
"63550","Ntome_NODE_21134_length_1106_cov_240","Nsylvestris_NODE_19128_length_1173_cov_191",93.275,922,57,5,177,1093,201,1122,0,1354,916,921
"63553","Ntome_NODE_21136_length_1106_cov_204","Nsylvestris_NODE_19569_length_1137_cov_149",96.108,925,35,1,142,1065,1,925,0,1507,923,924
"63554","Ntome_NODE_21137_length_1106_cov_154","Nsylvestris_NODE_1360_length_4535_cov_71",81.104,471,64,18,202,670,3754,4201,1.95e-96,353,468,447
"63555","Ntome_NODE_21138_length_1106_cov_139","Nsylvestris_NODE_18056_length_1263_cov_212",81.89,127,20,3,851,974,1066,1192,2.17e-21,104,123,126
"63559","Ntome_NODE_21140_length_1106_cov_106","Nsylvestris_NODE_21156_length_1018_cov_66",90.467,986,69,12,83,1057,41,1012,0,1277,974,971
"63566","Ntome_NODE_21143_length_1106_cov_43","Nsylvestris_NODE_34338_length_312_cov_5",88.596,114,13,0,4,117,114,1,5.94e-32,139,113,113
"63571","Ntome_NODE_21146_length_1106_cov_27","Nsylvestris_NODE_13630_length_1692_cov_195",96.875,64,2,0,1,64,1240,1177,1.67e-22,108,63,63
"63584","Ntome_NODE_21153_length_1105_cov_151","Nsylvestris_NODE_19626_length_1133_cov_164",83.481,678,104,6,220,890,886,210,3.73e-178,625,670,676
"63606","Ntome_NODE_21162_length_1104_cov_210","Nsylvestris_NODE_6901_length_2585_cov_91",93.87,1044,56,3,61,1104,2585,1550,0,1567,1043,1035
"63607","Ntome_NODE_21163_length_1104_cov_204","Nsylvestris_NODE_2375_length_3855_cov_86",95.587,1065,29,4,33,1093,45,1095,0,1690,1060,1050
"63629","Ntome_NODE_21173_length_1104_cov_33","Nsylvestris_NODE_23493_length_860_cov_54",95.167,807,25,5,9,807,12,812,0,1262,798,800
"63662","Ntome_NODE_21187_length_1103_cov_115","Nsylvestris_NODE_16354_length_1414_cov_188",95.949,1012,30,5,1,1004,356,1364,0,1631,1003,1008
"63671","Ntome_NODE_21193_length_1103_cov_8","Nsylvestris_NODE_8388_length_2343_cov_17",95.719,1098,46,1,1,1097,1188,2285,0,1766,1096,1097
"63672","Ntome_NODE_21194_length_1103_cov_5","Nsylvestris_NODE_12787_length_1788_cov_17",95.841,1106,40,4,1,1103,298,1400,0,1783,1102,1102
"63678","Ntome_NODE_21198_length_1102_cov_138","Nsylvestris_NODE_22735_length_906_cov_157",89.677,930,50,9,61,984,11,900,0,1144,923,889
"63685","Ntome_NODE_21200_length_1102_cov_94","Nsylvestris_NODE_26259_length_707_cov_206",95.563,293,11,2,233,524,38,329,6.64e-131,468,291,291
"63831","Ntome_NODE_21218_length_1101_cov_10","Nsylvestris_NODE_33823_length_327_cov_6",94.19,327,8,2,137,452,1,327,5.09e-137,488,315,326
"63834","Ntome_NODE_21220_length_1101_cov_7","Nsylvestris_NODE_5127_length_2942_cov_223",96.721,61,2,0,1041,1101,599,659,7.75e-21,102,60,60
"63835","Ntome_NODE_21221_length_1100_cov_262","Nsylvestris_NODE_14378_length_1612_cov_151",86.812,963,96,24,97,1040,1560,610,0,1046,943,950
"63839","Ntome_NODE_21223_length_1100_cov_180","Nsylvestris_NODE_6756_length_2612_cov_198",87.928,1110,50,36,1,1080,1097,42,0,1230,1079,1055
"63852","Ntome_NODE_21230_length_1100_cov_10","Nsylvestris_NODE_25649_length_737_cov_18",91.228,57,4,1,1019,1075,275,330,4.69e-13,76.8,56,55
"63855","Ntome_NODE_21233_length_1099_cov_276","Nsylvestris_NODE_21951_length_958_cov_219",96.364,55,2,0,1045,1099,322,376,1.67e-17,91.6,54,54
"63865","Ntome_NODE_21236_length_1099_cov_241","Nsylvestris_NODE_21840_length_966_cov_203",90.351,912,64,6,120,1008,41,951,0,1175,888,910
"63882","Ntome_NODE_21243_length_1099_cov_32","Nsylvestris_NODE_5062_length_2957_cov_223",98.148,54,1,0,5,58,1782,1729,1.29e-18,95.3,53,53
"63883","Ntome_NODE_21244_length_1099_cov_23","Nsylvestris_NODE_3403_length_3436_cov_119",98.182,55,1,0,1045,1099,2374,2320,3.6e-19,97.1,54,54
"63894","Ntome_NODE_21248_length_1099_cov_12","Nsylvestris_NODE_1221_length_4684_cov_217",100,53,0,0,1045,1097,4164,4112,1e-19,99,52,52
"63899","Ntome_NODE_21251_length_1098_cov_71","Nsylvestris_NODE_703_length_5422_cov_153",95.472,265,12,0,170,434,2953,3217,1.45e-117,424,264,264
"63911","Ntome_NODE_21257_length_1097_cov_257","Nsylvestris_NODE_16079_length_1442_cov_167",95.354,990,41,2,110,1097,159,1145,0,1568,987,986
"63912","Ntome_NODE_21258_length_1097_cov_237","Nsylvestris_NODE_19744_length_1123_cov_200",92.61,636,44,3,100,734,1093,460,0,911,634,633
"63917","Ntome_NODE_21260_length_1097_cov_173","Nsylvestris_NODE_20176_length_1088_cov_106",94.387,1069,43,9,25,1090,24,1078,0,1626,1065,1054
"63925","Ntome_NODE_21264_length_1097_cov_79","Nsylvestris_NODE_3644_length_3352_cov_227",98,50,1,0,1048,1097,3069,3020,2.16e-16,87.9,49,49
"63926","Ntome_NODE_21265_length_1097_cov_59","Nsylvestris_NODE_19926_length_1108_cov_173",91.648,910,59,6,69,973,1055,158,0,1243,904,897
"63937","Ntome_NODE_21269_length_1097_cov_31","Nsylvestris_NODE_4319_length_3146_cov_24",86.301,365,31,4,299,644,988,624,3.19e-104,379,345,364
"63938","Ntome_NODE_21271_length_1097_cov_26","Nsylvestris_NODE_18180_length_1252_cov_82",90.578,1072,76,11,38,1087,121,1189,0,1397,1049,1068
"63939","Ntome_NODE_21273_length_1097_cov_21","Nsylvestris_NODE_7443_length_2497_cov_100",84.319,1116,121,25,1,1097,988,2068,0,1042,1096,1080
"63951","Ntome_NODE_21280_length_1096_cov_201","Nsylvestris_NODE_21111_length_1021_cov_23",88.015,267,17,5,303,568,440,188,7.09e-81,302,265,252
"63956","Ntome_NODE_21282_length_1096_cov_15","Nsylvestris_NODE_8884_length_2266_cov_127",98.113,53,1,0,1,53,1965,1913,4.64e-18,93.5,52,52
"63966","Ntome_NODE_21287_length_1095_cov_249","Nsylvestris_NODE_20518_length_1063_cov_190",94.841,911,34,5,91,991,1028,121,0,1410,900,907
"63967","Ntome_NODE_21288_length_1095_cov_223","Nsylvestris_NODE_25533_length_742_cov_38",88.633,695,54,11,242,930,733,58,0,822,688,675
"63991","Ntome_NODE_21298_length_1095_cov_20","Nsylvestris_NODE_9581_length_2166_cov_149",92.028,715,31,14,309,1015,148,844,0,981,706,696
"64002","Ntome_NODE_21302_length_1094_cov_291","Nsylvestris_NODE_2054_length_4024_cov_174",95.31,1066,46,3,1,1064,1064,1,0,1688,1063,1063
"64031","Ntome_NODE_21312_length_1094_cov_21","Nsylvestris_NODE_18580_length_1218_cov_172",80.258,542,90,13,403,931,812,275,4.08e-108,392,528,537
"64032","Ntome_NODE_21314_length_1094_cov_19","Nsylvestris_NODE_5601_length_2840_cov_155",96.364,55,2,0,1,55,1573,1627,1.67e-17,91.6,54,54
"64037","Ntome_NODE_21317_length_1093_cov_277","Nsylvestris_NODE_20481_length_1065_cov_214",93.273,996,50,8,62,1048,10,997,0,1452,986,987
"64060","Ntome_NODE_21326_length_1093_cov_133","Nsylvestris_NODE_3120_length_3536_cov_232",90.526,95,8,1,1,95,1006,913,1.64e-27,124,94,93
"64074","Ntome_NODE_21332_length_1093_cov_15","Nsylvestris_NODE_1748_length_4216_cov_73",92.973,185,13,0,1,185,238,422,1.99e-71,270,184,184
"64075","Ntome_NODE_21333_length_1093_cov_12","Nsylvestris_NODE_3511_length_3395_cov_20",95.843,890,34,3,1,889,930,43,0,1435,888,887
"64079","Ntome_NODE_21335_length_1093_cov_8","Nsylvestris_NODE_10621_length_2035_cov_17",94.968,1093,54,1,1,1093,1879,788,0,1712,1092,1091
"64094","Ntome_NODE_21340_length_1092_cov_237","Nsylvestris_NODE_3853_length_3283_cov_147",94.662,637,27,4,459,1092,44,676,0,981,633,632
"64103","Ntome_NODE_21345_length_1092_cov_46","Nsylvestris_NODE_15809_length_1469_cov_74",89.474,1007,55,11,82,1086,471,1428,0,1225,1004,957
"64106","Ntome_NODE_21351_length_1091_cov_294","Nsylvestris_NODE_4850_length_3007_cov_154",94.944,712,28,5,108,814,2806,2098,0,1109,706,708
"64114","Ntome_NODE_21354_length_1091_cov_247","Nsylvestris_NODE_21164_length_1017_cov_192",91.744,969,57,6,48,1013,63,1011,0,1325,965,948
"64123","Ntome_NODE_21359_length_1091_cov_149","Nsylvestris_NODE_499_length_5965_cov_108",100,55,0,0,1037,1091,4981,5035,7.68e-21,102,54,54
"64129","Ntome_NODE_21363_length_1091_cov_31","Nsylvestris_NODE_17185_length_1339_cov_229",96.491,57,0,1,1035,1091,1094,1040,4.62e-18,93.5,56,54
"64130","Ntome_NODE_21364_length_1091_cov_8","Nsylvestris_NODE_3962_length_3245_cov_145",77.413,518,92,13,507,1007,2334,2843,7.1e-76,285,500,509
"64142","Ntome_NODE_21367_length_1090_cov_240","Nsylvestris_NODE_7150_length_2544_cov_80",94.016,869,39,7,81,943,1633,2494,0,1304,862,861
"64148","Ntome_NODE_21370_length_1090_cov_211","Nsylvestris_NODE_19701_length_1127_cov_141",93.927,988,41,8,84,1065,1100,126,0,1474,981,974
"64149","Ntome_NODE_21371_length_1090_cov_199","Nsylvestris_NODE_27991_length_629_cov_40",91.424,653,29,15,168,817,1,629,0,870,649,628
"64156","Ntome_NODE_21375_length_1090_cov_41","Nsylvestris_NODE_18623_length_1215_cov_118",95.281,1102,31,8,7,1088,83,1183,0,1727,1081,1100
"64177","Ntome_NODE_21383_length_1090_cov_9","Nsylvestris_NODE_7683_length_2456_cov_211",100,45,0,0,1046,1090,804,848,2.78e-15,84.2,44,44
"64181","Ntome_NODE_21386_length_1089_cov_280","Nsylvestris_NODE_11710_length_1903_cov_228",92.15,1070,47,17,1,1045,1058,1,0,1476,1044,1057
"64196","Ntome_NODE_21391_length_1089_cov_51","Nsylvestris_NODE_24873_length_779_cov_8",90.379,634,48,8,315,940,88,716,0,821,625,628
"64223","Ntome_NODE_21402_length_1088_cov_264","Nsylvestris_NODE_21163_length_1017_cov_201",98.14,968,15,2,58,1022,1009,42,0,1685,964,967
"64262","Ntome_NODE_21418_length_1087_cov_67","Nsylvestris_NODE_1375_length_4524_cov_68",76.952,538,103,17,452,981,754,230,1.97e-76,287,529,524
"64275","Ntome_NODE_21424_length_1087_cov_21","Nsylvestris_NODE_35839_length_276_cov_6",84.298,121,17,2,515,633,128,8,2.73e-25,117,118,120
"64279","Ntome_NODE_21426_length_1087_cov_5","Nsylvestris_NODE_19261_length_1163_cov_11",95.698,1046,45,0,42,1087,17,1062,0,1683,1045,1045
"64280","Ntome_NODE_21427_length_1086_cov_259","Nsylvestris_NODE_2429_length_3826_cov_206",95.704,1094,36,6,1,1086,3633,2543,0,1749,1085,1090
"64293","Ntome_NODE_21433_length_1086_cov_90","Nsylvestris_NODE_19289_length_1161_cov_182",90.167,956,61,18,106,1055,126,1054,0,1214,949,928
"64300","Ntome_NODE_21438_length_1086_cov_7","Nsylvestris_NODE_16594_length_1391_cov_215",98.182,55,1,0,1,55,807,753,3.56e-19,97.1,54,54
"64305","Ntome_NODE_21440_length_1086_cov_6","Nsylvestris_NODE_6674_length_2627_cov_24",95.136,1028,41,1,1,1028,739,1757,0,1613,1027,1018
"64314","Ntome_NODE_21444_length_1085_cov_239","Nsylvestris_NODE_3071_length_3553_cov_109",93.666,1042,62,2,1,1039,736,1776,0,1555,1038,1040
"64319","Ntome_NODE_21447_length_1085_cov_213","Nsylvestris_NODE_9634_length_2160_cov_183",95.152,990,33,7,109,1085,50,1037,0,1548,976,987
"64333","Ntome_NODE_21451_length_1091_cov_50","Nsylvestris_NODE_4153_length_3189_cov_109",92.056,214,15,2,84,295,3140,2927,2.54e-80,300,211,213
"64334","Ntome_NODE_21452_length_1085_cov_47","Nsylvestris_NODE_1883_length_4131_cov_155",93.103,58,3,1,693,750,419,363,2.77e-15,84.2,57,56
"64347","Ntome_NODE_21458_length_1084_cov_260","Nsylvestris_NODE_11322_length_1949_cov_65",93.462,1086,59,6,1,1082,151,1228,0,1602,1081,1077
"64398","Ntome_NODE_21481_length_1083_cov_45","Nsylvestris_NODE_28519_length_605_cov_33",96.652,448,13,2,323,769,64,510,0,743,446,446
"64401","Ntome_NODE_21483_length_1083_cov_25","Nsylvestris_NODE_2720_length_3696_cov_216",95.233,944,36,2,92,1027,989,47,0,1485,935,942
"64402","Ntome_NODE_21484_length_1083_cov_20","Nsylvestris_NODE_25813_length_728_cov_7",95.742,728,31,0,134,861,1,728,0,1173,727,727
"64403","Ntome_NODE_21485_length_1083_cov_9","Nsylvestris_NODE_5112_length_2946_cov_113",80.673,683,116,12,172,843,51,728,2.3e-145,516,671,677
"64404","Ntome_NODE_21486_length_1082_cov_260","Nsylvestris_NODE_22057_length_952_cov_177",96.366,963,19,3,99,1057,2,952,0,1570,958,950
"64409","Ntome_NODE_21488_length_1082_cov_163","Nsylvestris_NODE_2235_length_3921_cov_206",96.398,805,29,0,216,1020,3110,3914,0,1327,804,804
"64418","Ntome_NODE_21492_length_1082_cov_37","Nsylvestris_NODE_3633_length_3355_cov_128",96.33,1090,29,6,1,1082,1940,854,0,1781,1081,1086
"64438","Ntome_NODE_21499_length_1081_cov_245","Nsylvestris_NODE_19590_length_1135_cov_203",96.135,1035,32,5,9,1038,1066,35,0,1683,1029,1031
"64460","Ntome_NODE_21509_length_1081_cov_14","Nsylvestris_NODE_384_length_6385_cov_151",100,29,0,0,1053,1081,5503,5531,2.16e-06,54.7,28,28
"64476","Ntome_NODE_21516_length_1080_cov_190","Nsylvestris_NODE_19286_length_1161_cov_198",96.311,1030,31,2,2,1031,1161,139,0,1685,1029,1022
"64477","Ntome_NODE_21518_length_1080_cov_87","Nsylvestris_NODE_26770_length_684_cov_177",90,400,23,7,637,1036,464,82,6.41e-141,501,399,382
"64478","Ntome_NODE_21519_length_1080_cov_52","Nsylvestris_NODE_4435_length_3113_cov_51",84.112,214,20,6,861,1074,1702,1503,1.22e-48,195,213,199
"64479","Ntome_NODE_21520_length_1080_cov_29","Nsylvestris_NODE_631_length_5632_cov_168",95.517,1093,34,4,1,1080,4292,5382,0,1733,1079,1090
"64480","Ntome_NODE_21521_length_1080_cov_26","Nsylvestris_NODE_4342_length_3141_cov_167",84.82,527,71,6,1,518,942,416,4.92e-147,521,517,526
"64491","Ntome_NODE_21525_length_1080_cov_9","Nsylvestris_NODE_458_length_6074_cov_225",96.364,55,2,0,1,55,4056,4110,1.65e-17,91.6,54,54
"64492","Ntome_NODE_21526_length_1080_cov_8","Nsylvestris_NODE_7018_length_2566_cov_217",100,55,0,0,1026,1080,1318,1372,7.6e-21,102,54,54
"64497","Ntome_NODE_21529_length_1079_cov_261","Nsylvestris_NODE_12066_length_1861_cov_218",97.007,969,27,2,111,1079,1,967,0,1628,968,966
"64513","Ntome_NODE_21537_length_1079_cov_14","Nsylvestris_NODE_14771_length_1573_cov_50",86.7,609,62,8,3,593,929,1536,0,658,590,607
"64520","Ntome_NODE_21540_length_1078_cov_271","Nsylvestris_NODE_18893_length_1193_cov_198",93.303,1090,40,13,7,1076,26,1102,0,1578,1069,1076
"64521","Ntome_NODE_21541_length_1078_cov_261","Nsylvestris_NODE_21253_length_1010_cov_189",93.586,951,42,3,8,941,16,964,0,1400,933,948
"64548","Ntome_NODE_21552_length_1077_cov_270","Nsylvestris_NODE_22588_length_916_cov_159",91.977,885,46,13,55,921,1,878,0,1218,866,877
"64552","Ntome_NODE_21554_length_1077_cov_195","Nsylvestris_NODE_19710_length_1126_cov_178",92.5,880,30,12,60,922,29,889,0,1227,862,860
"64564","Ntome_NODE_21559_length_1077_cov_85","Nsylvestris_NODE_30334_length_499_cov_6",94.748,457,16,2,334,785,454,1,0,704,451,453
"64565","Ntome_NODE_21560_length_1077_cov_63","Nsylvestris_NODE_26436_length_699_cov_11",94.965,715,20,1,68,782,1,699,0,1107,714,698
"64566","Ntome_NODE_21561_length_1077_cov_63","Nsylvestris_NODE_22350_length_932_cov_44",88.999,909,55,12,80,955,926,30,0,1083,875,896
"64567","Ntome_NODE_21562_length_1077_cov_48","Nsylvestris_NODE_2361_length_3867_cov_20",76.959,434,82,17,213,637,3507,3083,9.26e-60,231,424,424
"64573","Ntome_NODE_21566_length_1077_cov_18","Nsylvestris_NODE_10855_length_2006_cov_195",100,55,0,0,1,55,1172,1118,7.58e-21,102,54,54
"64601","Ntome_NODE_21578_length_1076_cov_126","Nsylvestris_NODE_19987_length_1103_cov_198",94.489,998,44,4,84,1076,92,1083,0,1528,992,991
"64606","Ntome_NODE_21581_length_1076_cov_91","Nsylvestris_NODE_20888_length_1036_cov_86",93.825,1004,47,5,9,1004,1036,40,0,1496,995,996
"64607","Ntome_NODE_21583_length_1075_cov_31","Nsylvestris_NODE_14740_length_1575_cov_216",95,40,2,0,1022,1061,267,228,3.57e-09,63.9,39,39
"64633","Ntome_NODE_21592_length_1075_cov_68","Nsylvestris_NODE_3095_length_3545_cov_13",74.081,571,134,13,1,565,1090,528,5.56e-57,222,564,562
"64640","Ntome_NODE_21595_length_1075_cov_24","Nsylvestris_NODE_6311_length_2695_cov_237",92.727,55,4,0,1,55,1462,1408,3.54e-14,80.5,54,54
"64649","Ntome_NODE_21599_length_1074_cov_309","Nsylvestris_NODE_18772_length_1204_cov_213",92.514,1082,52,16,1,1065,1070,1,0,1522,1064,1069
"64650","Ntome_NODE_21600_length_1074_cov_236","Nsylvestris_NODE_1888_length_4127_cov_100",89.825,855,53,17,155,988,842,1,0,1066,833,841
"64659","Ntome_NODE_21604_length_1074_cov_54","Nsylvestris_NODE_2732_length_3688_cov_120",98.182,55,1,0,1,55,3380,3326,3.52e-19,97.1,54,54
"64660","Ntome_NODE_21605_length_1074_cov_33","Nsylvestris_NODE_22603_length_915_cov_208",98.182,55,1,0,1,55,699,753,3.52e-19,97.1,54,54
"64668","Ntome_NODE_21608_length_1074_cov_13","Nsylvestris_NODE_18259_length_1245_cov_14",95.946,666,24,3,373,1036,872,208,0,1077,663,664
"64669","Ntome_NODE_21609_length_1074_cov_13","Nsylvestris_NODE_23045_length_888_cov_169",95.082,61,3,0,1014,1074,340,400,3.52e-19,97.1,60,60
"64678","Ntome_NODE_21614_length_1073_cov_270","Nsylvestris_NODE_4187_length_3179_cov_211",98.633,951,13,0,123,1073,3164,2214,0,1685,950,950
"64684","Ntome_NODE_21617_length_1073_cov_237","Nsylvestris_NODE_12868_length_1778_cov_229",88.6,807,62,14,243,1030,1,796,0,953,787,795
"64692","Ntome_NODE_21621_length_1073_cov_43","Nsylvestris_NODE_20402_length_1071_cov_22",90.897,747,42,4,336,1073,253,982,0,979,737,729
"64695","Ntome_NODE_21623_length_1073_cov_26","Nsylvestris_NODE_12767_length_1790_cov_84",100,55,0,0,1,55,676,730,7.55e-21,102,54,54
"64696","Ntome_NODE_21624_length_1073_cov_18","Nsylvestris_NODE_17555_length_1308_cov_25",94.051,975,58,0,23,997,1289,315,0,1480,974,974
"64697","Ntome_NODE_21626_length_1073_cov_16","Nsylvestris_NODE_1590_length_4338_cov_12",75.798,376,78,10,8,378,3088,2721,1.22e-43,178,370,367
"64706","Ntome_NODE_21630_length_1072_cov_291","Nsylvestris_NODE_9858_length_2132_cov_104",93.525,973,43,4,82,1037,993,24,0,1430,955,969
"64718","Ntome_NODE_21635_length_1072_cov_212","Nsylvestris_NODE_2102_length_3992_cov_144",88.972,399,44,0,538,936,307,705,1.07e-138,494,398,398
"64734","Ntome_NODE_21642_length_1072_cov_14","Nsylvestris_NODE_18216_length_1248_cov_208",98.182,55,1,0,1018,1072,641,587,3.51e-19,97.1,54,54
"64737","Ntome_NODE_21644_length_1073_cov_4","Nsylvestris_NODE_15862_length_1463_cov_22",97.61,1046,25,0,25,1070,1,1046,0,1794,1045,1045
"64741","Ntome_NODE_21646_length_1071_cov_111","Nsylvestris_NODE_4559_length_3083_cov_161",100,55,0,0,1017,1071,1001,1055,7.54e-21,102,54,54
"64745","Ntome_NODE_21648_length_1071_cov_35","Nsylvestris_NODE_15043_length_1547_cov_20",95.326,1027,47,1,3,1028,1485,459,0,1629,1025,1026
"64756","Ntome_NODE_21653_length_1071_cov_9","Nsylvestris_NODE_20200_length_1087_cov_13",94.937,1027,52,0,7,1033,1027,1,0,1609,1026,1026
"64759","Ntome_NODE_21658_length_1070_cov_244","Nsylvestris_NODE_29366_length_568_cov_207",95.407,479,21,1,186,664,41,518,0,761,478,477
"64768","Ntome_NODE_21664_length_1070_cov_11","Nsylvestris_NODE_5920_length_2778_cov_98",78.017,696,134,16,383,1070,1467,2151,1.83e-116,420,687,684
"64769","Ntome_NODE_21665_length_1070_cov_8","Nsylvestris_NODE_35628_length_281_cov_6",87.302,63,7,1,361,423,174,113,2.12e-11,71.3,62,61
"64773","Ntome_NODE_21668_length_1069_cov_280","Nsylvestris_NODE_21472_length_993_cov_216",96.366,963,32,3,44,1004,1,962,0,1581,960,961
"64774","Ntome_NODE_21669_length_1069_cov_277","Nsylvestris_NODE_10049_length_2110_cov_217",96.819,943,28,2,128,1069,49,990,0,1574,941,941
"64781","Ntome_NODE_21672_length_1069_cov_235","Nsylvestris_NODE_22819_length_901_cov_172",97.535,852,17,2,12,862,1,849,0,1454,850,848
"64790","Ntome_NODE_21677_length_1069_cov_31","Nsylvestris_NODE_17004_length_1357_cov_173",98.182,55,1,0,1015,1069,251,305,3.5e-19,97.1,54,54
"64827","Ntome_NODE_21692_length_1068_cov_98","Nsylvestris_NODE_31230_length_437_cov_3",91.391,151,7,2,1,151,218,362,7.2e-51,202,150,144
"64845","Ntome_NODE_21697_length_1068_cov_23","Nsylvestris_NODE_6328_length_2693_cov_40",92.004,1013,61,7,68,1068,2629,1625,0,1404,1000,1004
"64852","Ntome_NODE_21701_length_1068_cov_14","Nsylvestris_NODE_8381_length_2343_cov_180",100,54,0,0,1014,1067,1101,1154,2.7e-20,100,53,53
"64864","Ntome_NODE_21707_length_1067_cov_214","Nsylvestris_NODE_6343_length_2691_cov_229",91.54,1052,47,14,46,1067,2069,1030,0,1411,1021,1039
"64905","Ntome_NODE_21723_length_1066_cov_260","Nsylvestris_NODE_8267_length_2360_cov_137",92.211,873,38,14,105,965,1493,2347,0,1208,860,854
"64915","Ntome_NODE_21727_length_1066_cov_163","Nsylvestris_NODE_12036_length_1865_cov_182",87.755,98,3,1,453,541,275,372,5.8e-22,106,88,97
"64916","Ntome_NODE_21728_length_1066_cov_139","Nsylvestris_NODE_952_length_5018_cov_114",100,53,0,0,3,55,467,519,9.7e-20,99,52,52
"64919","Ntome_NODE_21730_length_1066_cov_86","Nsylvestris_NODE_13583_length_1698_cov_63",93.025,1061,49,14,2,1059,660,1698,0,1526,1057,1038
"64928","Ntome_NODE_21735_length_1066_cov_35","Nsylvestris_NODE_21762_length_973_cov_10",94.444,72,4,0,202,273,276,347,1.25e-23,111,71,71
"64929","Ntome_NODE_21737_length_1066_cov_20","Nsylvestris_NODE_17027_length_1355_cov_105",96.364,55,2,0,1012,1066,550,496,1.62e-17,91.6,54,54
"64944","Ntome_NODE_21743_length_1065_cov_153","Nsylvestris_NODE_19967_length_1104_cov_130",91.658,995,59,10,25,1013,1104,128,0,1356,988,976
"64971","Ntome_NODE_21752_length_1065_cov_17","Nsylvestris_NODE_7715_length_2450_cov_203",100,55,0,0,1,55,534,588,7.49e-21,102,54,54
"64977","Ntome_NODE_21755_length_1064_cov_8","Nsylvestris_NODE_8729_length_2290_cov_123",100,55,0,0,1,55,802,748,7.48e-21,102,54,54
"64978","Ntome_NODE_21756_length_1065_cov_7","Nsylvestris_NODE_10458_length_2055_cov_206",100,55,0,0,1,55,911,857,7.49e-21,102,54,54
"64998","Ntome_NODE_21765_length_1064_cov_38","Nsylvestris_NODE_16767_length_1375_cov_88",85.526,228,27,4,202,426,53,277,2.54e-60,233,224,224
"65009","Ntome_NODE_21770_length_1063_cov_244","Nsylvestris_NODE_16814_length_1371_cov_174",92.338,1018,65,9,55,1063,332,1345,0,1435,1008,1013
"65010","Ntome_NODE_21771_length_1063_cov_175","Nsylvestris_NODE_21418_length_997_cov_206",97.314,968,23,2,1,966,983,17,0,1640,965,966
"65020","Ntome_NODE_21775_length_1063_cov_50","Nsylvestris_NODE_8921_length_2261_cov_128",100,54,0,0,1009,1062,1749,1696,2.69e-20,100,53,53
"65035","Ntome_NODE_21781_length_1063_cov_9","Nsylvestris_NODE_6735_length_2615_cov_163",96.364,55,2,0,1,55,747,693,1.62e-17,91.6,54,54
"65054","Ntome_NODE_21790_length_1062_cov_11","Nsylvestris_NODE_13193_length_1739_cov_223",95.349,989,34,1,3,979,1038,50,0,1561,976,988
"65057","Ntome_NODE_21792_length_1062_cov_277","Nsylvestris_NODE_15666_length_1483_cov_205",94.584,1034,28,8,45,1062,2,1023,0,1574,1017,1021
"65058","Ntome_NODE_21793_length_1061_cov_272","Nsylvestris_NODE_15581_length_1492_cov_191",94.48,942,36,7,129,1061,12,946,0,1437,932,934
"65066","Ntome_NODE_21797_length_1061_cov_78","Nsylvestris_NODE_15335_length_1519_cov_83",91.579,380,32,0,475,854,1450,1071,3.74e-148,525,379,379
"65069","Ntome_NODE_21800_length_1061_cov_17","Nsylvestris_NODE_4173_length_3183_cov_224",100,55,0,0,1,55,411,465,7.46e-21,102,54,54
"65072","Ntome_NODE_21802_length_1061_cov_9","Nsylvestris_NODE_8756_length_2287_cov_67",85.467,289,32,3,745,1024,1696,1983,4.13e-78,292,279,287
"65080","Ntome_NODE_21807_length_1060_cov_273","Nsylvestris_NODE_19978_length_1104_cov_209",95.726,1006,34,4,27,1023,32,1037,0,1611,996,1005
"65081","Ntome_NODE_21808_length_1060_cov_269","Nsylvestris_NODE_18422_length_1230_cov_221",87.559,426,29,13,452,856,145,567,4.93e-132,472,404,422
"65082","Ntome_NODE_21809_length_1060_cov_144","Nsylvestris_NODE_19732_length_1124_cov_142",95.393,955,36,6,54,1003,9,960,0,1513,949,951
"65099","Ntome_NODE_21818_length_1060_cov_11","Nsylvestris_NODE_2841_length_3640_cov_102",91.803,122,10,0,45,166,971,850,2.02e-41,171,121,121
"65100","Ntome_NODE_21819_length_1060_cov_10","Nsylvestris_NODE_17136_length_1345_cov_186",100,55,0,0,1006,1060,376,430,7.46e-21,102,54,54
"65110","Ntome_NODE_21824_length_1059_cov_255","Nsylvestris_NODE_25115_length_765_cov_69",97.175,708,20,0,4,711,9,716,0,1197,707,707
"65115","Ntome_NODE_21826_length_1059_cov_221","Nsylvestris_NODE_21014_length_1027_cov_123",94.985,977,42,3,68,1038,976,1,0,1526,970,975
"65129","Ntome_NODE_21832_length_1059_cov_21","Nsylvestris_NODE_17716_length_1293_cov_39",93.59,78,5,0,982,1059,680,603,2.66e-25,117,77,77
"65137","Ntome_NODE_21836_length_1059_cov_11","Nsylvestris_NODE_22850_length_900_cov_38",95.652,805,35,0,188,992,42,846,0,1293,804,804
"65140","Ntome_NODE_21838_length_1058_cov_293","Nsylvestris_NODE_19136_length_1172_cov_205",94.235,1006,43,6,1,999,58,1055,0,1522,998,997
"65146","Ntome_NODE_21842_length_1058_cov_30","Nsylvestris_NODE_7636_length_2465_cov_157",98.113,53,1,0,3,55,1544,1492,4.48e-18,93.5,52,52
"65149","Ntome_NODE_21844_length_1058_cov_20","Nsylvestris_NODE_5007_length_2971_cov_102",92.391,92,5,1,969,1058,119,28,3.41e-29,130,89,91
"65157","Ntome_NODE_21847_length_1058_cov_12","Nsylvestris_NODE_3934_length_3257_cov_165",87.008,1093,46,33,1,1057,3013,1981,0,1144,1056,1032
"65175","Ntome_NODE_21854_length_1057_cov_71","Nsylvestris_NODE_20476_length_1066_cov_184",94.223,1004,44,8,29,1020,1047,46,0,1520,991,1001
"65181","Ntome_NODE_21857_length_1057_cov_35","Nsylvestris_NODE_24225_length_817_cov_155",86.071,481,64,3,468,945,225,705,8.06e-145,514,477,480
"65186","Ntome_NODE_21861_length_1057_cov_22","Nsylvestris_NODE_18213_length_1249_cov_44",96.296,54,2,0,2,55,822,769,5.79e-17,89.8,53,53
"65187","Ntome_NODE_21862_length_1057_cov_21","Nsylvestris_NODE_4345_length_3140_cov_188",96.364,55,2,0,1003,1057,2675,2729,1.61e-17,91.6,54,54
"65191","Ntome_NODE_21864_length_1057_cov_16","Nsylvestris_NODE_211_length_7288_cov_38",93.506,77,5,0,1,77,7211,7135,9.55e-25,115,76,76
"65192","Ntome_NODE_21865_length_1057_cov_14","Nsylvestris_NODE_17553_length_1308_cov_38",95.902,1025,41,1,1,1024,270,1294,0,1659,1023,1024
"65207","Ntome_NODE_21872_length_1056_cov_204","Nsylvestris_NODE_13006_length_1763_cov_87",95.039,1028,40,5,25,1049,730,1749,0,1605,1024,1019
"65208","Ntome_NODE_21873_length_1056_cov_142","Nsylvestris_NODE_6461_length_2668_cov_129",77.778,747,102,30,171,872,998,271,6.54e-111,401,701,727
"65209","Ntome_NODE_21874_length_1045_cov_113","Nsylvestris_NODE_18212_length_1249_cov_101",94.372,995,50,6,2,994,96,1086,0,1522,992,990
"65217","Ntome_NODE_21878_length_1054_cov_63","Nsylvestris_NODE_8584_length_2312_cov_105",81.726,197,25,11,131,322,170,360,2.02e-36,154,191,190
"65218","Ntome_NODE_21880_length_1056_cov_40","Nsylvestris_NODE_24165_length_822_cov_10",95.876,582,22,2,424,1005,68,647,0,941,581,579
"65232","Ntome_NODE_21890_length_1055_cov_278","Nsylvestris_NODE_16165_length_1433_cov_171",87.216,970,78,17,60,994,1008,50,0,1062,934,958
"65262","Ntome_NODE_21901_length_1050_cov_25","Nsylvestris_NODE_17780_length_1287_cov_211",86.364,132,17,1,705,835,215,84,4.35e-33,143,130,131
"65267","Ntome_NODE_21903_length_1055_cov_17","Nsylvestris_NODE_18526_length_1222_cov_32",100,34,0,0,6,39,1027,994,3.5e-09,63.9,33,33
"65274","Ntome_NODE_21906_length_1055_cov_8","Nsylvestris_NODE_18937_length_1189_cov_22",91.969,523,40,1,1,521,594,72,0,732,520,522
"65281","Ntome_NODE_21910_length_1054_cov_247","Nsylvestris_NODE_217_length_7234_cov_135",79.386,456,75,12,4,441,5927,5473,1.89e-81,303,437,454
"65289","Ntome_NODE_21915_length_1054_cov_92","Nsylvestris_NODE_28982_length_585_cov_5",85.484,186,19,5,33,213,292,474,1.99e-46,187,180,182
"65299","Ntome_NODE_21920_length_1054_cov_10","Nsylvestris_NODE_9933_length_2123_cov_226",94.828,58,3,0,1,58,1580,1523,1.6e-17,91.6,57,57
"65315","Ntome_NODE_21927_length_1053_cov_119","Nsylvestris_NODE_23404_length_866_cov_66",91.657,875,54,9,60,929,861,1,0,1194,869,860
"65316","Ntome_NODE_21928_length_1053_cov_89","Nsylvestris_NODE_34526_length_307_cov_3",97.527,283,7,0,289,571,283,1,6.29e-136,484,282,282
"65317","Ntome_NODE_21930_length_1053_cov_86","Nsylvestris_NODE_17142_length_1344_cov_210",93.282,1042,39,10,40,1051,256,1296,0,1507,1011,1040
"65335","Ntome_NODE_21936_length_1052_cov_23","Nsylvestris_NODE_8301_length_2354_cov_232",93.878,49,2,1,1,48,1537,1489,5.8e-12,73.1,47,48
"65336","Ntome_NODE_21937_length_1053_cov_17","Nsylvestris_NODE_16495_length_1400_cov_63",94.156,1061,30,12,6,1053,1396,355,0,1587,1047,1041
"65337","Ntome_NODE_21938_length_1053_cov_17","Nsylvestris_NODE_2660_length_3719_cov_142",96.364,55,2,0,1,55,676,622,1.6e-17,91.6,54,54
"65338","Ntome_NODE_21939_length_1053_cov_16","Nsylvestris_NODE_1171_length_4729_cov_147",94.737,1026,27,12,46,1053,2875,1859,0,1570,1007,1016
"65347","Ntome_NODE_21943_length_1053_cov_8","Nsylvestris_NODE_5597_length_2841_cov_125",100,55,0,0,999,1053,2385,2331,7.41e-21,102,54,54
"65350","Ntome_NODE_21945_length_1052_cov_279","Nsylvestris_NODE_10255_length_2080_cov_220",94.283,1032,59,0,1,1032,1049,2080,0,1580,1031,1031
"65370","Ntome_NODE_21952_length_1052_cov_74","Nsylvestris_NODE_9208_length_2222_cov_133",86.66,967,64,24,35,971,1,932,0,1011,936,931
"65371","Ntome_NODE_21954_length_1052_cov_54","Nsylvestris_NODE_18600_length_1217_cov_129",90.819,708,56,3,10,708,58,765,0,939,698,707
"65372","Ntome_NODE_21955_length_1052_cov_46","Nsylvestris_NODE_33473_length_337_cov_6",91.265,332,12,3,619,934,334,4,1.79e-121,436,315,330
"65382","Ntome_NODE_21961_length_1052_cov_13","Nsylvestris_NODE_9000_length_2251_cov_113",100,55,0,0,1,55,1458,1512,7.4e-21,102,54,54
"65383","Ntome_NODE_21962_length_1052_cov_13","Nsylvestris_NODE_2636_length_3726_cov_212",98.305,59,0,1,1,59,1979,2036,7.4e-21,102,58,57
"65384","Ntome_NODE_21963_length_1052_cov_12","Nsylvestris_NODE_18059_length_1262_cov_52",100,60,0,0,1,60,103,162,1.23e-23,111,59,59
"65387","Ntome_NODE_21965_length_1052_cov_5","Nsylvestris_NODE_10026_length_2113_cov_9",92.723,907,66,0,1,907,1207,2113,0,1310,906,906
"65388","Ntome_NODE_21966_length_1051_cov_311","Nsylvestris_NODE_9952_length_2120_cov_230",97.387,995,23,2,60,1051,64,1058,0,1690,991,994
"65389","Ntome_NODE_21967_length_1051_cov_270","Nsylvestris_NODE_15918_length_1458_cov_173",92.089,986,47,7,24,981,1207,225,0,1360,957,982
"65407","Ntome_NODE_21977_length_1051_cov_22","Nsylvestris_NODE_3619_length_3359_cov_116",96.61,59,2,0,993,1051,2937,2995,9.56e-20,99,58,58
"65408","Ntome_NODE_21978_length_1051_cov_19","Nsylvestris_NODE_7613_length_2469_cov_13",94.162,1062,46,8,1,1051,2469,1413,0,1604,1050,1056
"65417","Ntome_NODE_21984_length_1051_cov_8","Nsylvestris_NODE_26558_length_693_cov_71",98.182,55,1,0,1,55,143,197,3.44e-19,97.1,54,54
"65418","Ntome_NODE_21985_length_1050_cov_285","Nsylvestris_NODE_7608_length_2469_cov_217",94.07,995,40,4,2,990,1440,2421,0,1493,988,981
"65419","Ntome_NODE_21987_length_1050_cov_217","Nsylvestris_NODE_21728_length_975_cov_151",91.014,957,41,17,1,927,959,18,0,1249,926,941
"65449","Ntome_NODE_22000_length_1049_cov_63","Nsylvestris_NODE_14060_length_1644_cov_83",82.014,695,121,4,354,1046,1,693,4.64e-167,588,692,692
"65453","Ntome_NODE_22002_length_1051_cov_37","Nsylvestris_NODE_2010_length_4046_cov_28",92.589,1012,72,3,40,1051,4017,3009,0,1450,1011,1008
"65454","Ntome_NODE_22003_length_1049_cov_20","Nsylvestris_NODE_9548_length_2170_cov_197",95.349,43,1,1,1008,1049,1827,1869,2.69e-10,67.6,41,42
"65455","Ntome_NODE_22004_length_1049_cov_9","Nsylvestris_NODE_16816_length_1371_cov_97",95.55,809,30,2,15,817,857,49,0,1290,802,808
"65472","Ntome_NODE_22012_length_1048_cov_53","Nsylvestris_NODE_8142_length_2381_cov_205",93.22,59,3,1,1,59,639,582,7.42e-16,86.1,58,57
"65481","Ntome_NODE_22016_length_1048_cov_13","Nsylvestris_NODE_13552_length_1700_cov_213",98.182,55,1,0,994,1048,980,926,3.43e-19,97.1,54,54
"65482","Ntome_NODE_22017_length_1048_cov_8","Nsylvestris_NODE_1309_length_4585_cov_174",100,55,0,0,1,55,3716,3662,7.37e-21,102,54,54
"65504","Ntome_NODE_22025_length_1047_cov_35","Nsylvestris_NODE_2129_length_3973_cov_165",98.182,55,1,0,993,1047,3085,3031,3.43e-19,97.1,54,54
"65505","Ntome_NODE_22026_length_1047_cov_29","Nsylvestris_NODE_25272_length_756_cov_28",91.218,353,22,6,478,826,1,348,4.87e-132,472,348,347
"65508","Ntome_NODE_22028_length_1047_cov_14","Nsylvestris_NODE_8486_length_2327_cov_19",82.762,934,73,37,117,1022,1010,1883,0,752,905,873
"65538","Ntome_NODE_22040_length_1046_cov_2","Nsylvestris_NODE_17603_length_1303_cov_29",95.92,1054,27,13,1,1043,52,1100,0,1694,1042,1048
"65566","Ntome_NODE_22050_length_1045_cov_45","Nsylvestris_NODE_154_length_7738_cov_75",86.154,65,9,0,21,85,5311,5247,2.07e-11,71.3,64,64
"65575","Ntome_NODE_22055_length_1045_cov_13","Nsylvestris_NODE_3645_length_3352_cov_218",100,52,0,0,991,1042,2598,2649,3.42e-19,97.1,51,51
"65593","Ntome_NODE_22062_length_1044_cov_248","Nsylvestris_NODE_19700_length_1127_cov_143",93.223,782,36,3,46,813,294,1072,0,1134,767,778
"65601","Ntome_NODE_22065_length_1044_cov_104","Nsylvestris_NODE_14090_length_1641_cov_144",96.322,734,25,1,1,732,726,1459,0,1205,731,733
"65610","Ntome_NODE_22069_length_1041_cov_253","Nsylvestris_NODE_21131_length_1019_cov_210",97.268,915,23,2,35,949,98,1010,0,1550,914,912
"65621","Ntome_NODE_22073_length_1043_cov_21","Nsylvestris_NODE_23935_length_836_cov_15",96.287,835,27,2,52,886,836,6,0,1367,834,830
"65631","Ntome_NODE_22077_length_1042_cov_271","Nsylvestris_NODE_9516_length_2174_cov_217",94.142,956,23,5,1,941,1653,716,0,1424,940,937
"65632","Ntome_NODE_22078_length_1042_cov_248","Nsylvestris_NODE_21420_length_997_cov_191",94.094,999,28,12,39,1025,997,18,0,1489,986,979
"65633","Ntome_NODE_22079_length_1042_cov_235","Nsylvestris_NODE_20233_length_1083_cov_209",92.013,914,55,7,1,905,25,929,0,1267,904,904
"65657","Ntome_NODE_22088_length_1042_cov_62","Nsylvestris_NODE_19671_length_1129_cov_68",95.938,1034,36,3,1,1034,1042,15,0,1672,1033,1027
"65658","Ntome_NODE_22089_length_1042_cov_32","Nsylvestris_NODE_12389_length_1827_cov_220",81.193,218,39,2,297,513,1496,1280,1.53e-42,174,216,216
"65661","Ntome_NODE_22092_length_1042_cov_16","Nsylvestris_NODE_17910_length_1276_cov_62",93.103,638,41,3,1,636,480,1116,0,931,635,636
"65665","Ntome_NODE_22094_length_1042_cov_9","Nsylvestris_NODE_4307_length_3148_cov_44",94.837,1046,43,7,1,1042,11,1049,0,1622,1041,1038
"65684","Ntome_NODE_22102_length_1041_cov_167","Nsylvestris_NODE_12000_length_1870_cov_132",91.083,157,13,1,104,260,1132,977,1.17e-53,211,156,155
"65711","Ntome_NODE_22116_length_1040_cov_39","Nsylvestris_NODE_30217_length_508_cov_7",94.196,448,26,0,414,861,448,1,0,684,447,447
"65761","Ntome_NODE_22133_length_1039_cov_51","Nsylvestris_NODE_23089_length_885_cov_213",96.364,55,2,0,985,1039,186,240,1.58e-17,91.6,54,54
"65768","Ntome_NODE_22137_length_1039_cov_14","Nsylvestris_NODE_9502_length_2178_cov_11",81.67,1042,180,10,3,1039,515,1550,0,856,1036,1035
"65769","Ntome_NODE_22139_length_1038_cov_204","Nsylvestris_NODE_19085_length_1176_cov_206",90.993,755,55,9,1,750,430,1176,0,1005,749,746
"65770","Ntome_NODE_22140_length_1038_cov_48","Nsylvestris_NODE_7181_length_2538_cov_217",100,55,0,0,984,1038,1261,1207,7.3e-21,102,54,54
"65771","Ntome_NODE_22141_length_1038_cov_31","Nsylvestris_NODE_11153_length_1968_cov_224",98.182,55,1,0,984,1038,1516,1570,3.4e-19,97.1,54,54
"65774","Ntome_NODE_22144_length_1038_cov_15","Nsylvestris_NODE_8922_length_2261_cov_80",93.75,1040,61,4,2,1038,133,1171,0,1557,1036,1038
"65793","Ntome_NODE_22152_length_1037_cov_215","Nsylvestris_NODE_22804_length_902_cov_173",93.552,791,32,7,90,874,833,56,0,1160,784,777
"65796","Ntome_NODE_22155_length_1037_cov_174","Nsylvestris_NODE_18900_length_1192_cov_176",94.532,951,27,11,39,983,1,932,0,1445,944,931
"65800","Ntome_NODE_22157_length_1037_cov_101","Nsylvestris_NODE_19328_length_1158_cov_219",95.45,967,39,3,18,984,1129,168,0,1537,966,961
"65801","Ntome_NODE_22158_length_1037_cov_86","Nsylvestris_NODE_8101_length_2386_cov_137",89.848,985,75,11,1,982,1169,207,0,1242,981,962
"65807","Ntome_NODE_22161_length_1039_cov_38","Nsylvestris_NODE_8049_length_2395_cov_139",93.431,411,17,7,28,436,1237,835,5.91e-171,601,408,402
"65808","Ntome_NODE_22164_length_1037_cov_21","Nsylvestris_NODE_6498_length_2660_cov_219",100,55,0,0,1,55,2249,2195,7.29e-21,102,54,54
"65816","Ntome_NODE_22168_length_1037_cov_13","Nsylvestris_NODE_5577_length_2849_cov_113",91.411,978,51,9,78,1037,1526,564,0,1310,959,962
"65827","Ntome_NODE_22172_length_1036_cov_264","Nsylvestris_NODE_21509_length_991_cov_169",92.688,930,47,11,5,926,6,922,0,1321,921,916
"65828","Ntome_NODE_22173_length_1036_cov_234","Nsylvestris_NODE_14891_length_1561_cov_210",96.005,801,32,0,236,1036,1364,564,0,1303,800,800
"65829","Ntome_NODE_22174_length_1036_cov_221","Nsylvestris_NODE_1997_length_4062_cov_90",82.68,485,49,17,531,989,20,495,8.29e-110,398,458,475
"65836","Ntome_NODE_22177_length_1036_cov_46","Nsylvestris_NODE_4953_length_2985_cov_127",98.182,55,1,0,982,1036,2041,1987,3.39e-19,97.1,54,54
"65839","Ntome_NODE_22179_length_1036_cov_39","Nsylvestris_NODE_19997_length_1103_cov_23",76.046,693,148,12,157,843,1039,359,1.1e-93,344,686,680
"65840","Ntome_NODE_22180_length_1036_cov_14","Nsylvestris_NODE_34275_length_314_cov_4",89.881,168,17,0,647,814,266,99,2.49e-55,217,167,167
"65849","Ntome_NODE_22184_length_1035_cov_228","Nsylvestris_NODE_10161_length_2093_cov_186",95.152,887,33,4,146,1025,943,60,0,1391,879,883
"65850","Ntome_NODE_22185_length_1035_cov_222","Nsylvestris_NODE_21348_length_1003_cov_117",94.905,1001,39,9,39,1034,3,996,0,1555,995,993
"65861","Ntome_NODE_22191_length_1035_cov_22","Nsylvestris_NODE_8360_length_2347_cov_67",76.986,365,60,12,650,996,409,51,1.95e-46,187,346,358
"65875","Ntome_NODE_22197_length_1034_cov_178","Nsylvestris_NODE_16955_length_1360_cov_145",95.579,769,21,6,192,955,761,1,0,1219,763,760
"65879","Ntome_NODE_22199_length_1034_cov_73","Nsylvestris_NODE_27297_length_660_cov_22",89.95,398,31,6,299,693,51,442,4.74e-142,505,394,391
"65889","Ntome_NODE_22203_length_1034_cov_18","Nsylvestris_NODE_23866_length_840_cov_13",91.965,809,47,4,195,1003,50,840,0,1118,808,790
"65890","Ntome_NODE_22204_length_1034_cov_16","Nsylvestris_NODE_13467_length_1710_cov_211",96.364,55,2,0,1,55,840,894,1.57e-17,91.6,54,54
"65891","Ntome_NODE_22205_length_1034_cov_16","Nsylvestris_NODE_18473_length_1226_cov_197",98.182,55,1,0,980,1034,215,269,3.38e-19,97.1,54,54
"65894","Ntome_NODE_22207_length_1034_cov_10","Nsylvestris_NODE_6294_length_2698_cov_179",95.567,1015,42,3,1,1015,1500,489,0,1622,1014,1011
"65895","Ntome_NODE_22208_length_1034_cov_9","Nsylvestris_NODE_10853_length_2007_cov_19",93.907,1034,63,0,1,1034,763,1796,0,1561,1033,1033
"65899","Ntome_NODE_22210_length_1034_cov_5","Nsylvestris_NODE_51_length_9473_cov_96",97.582,1034,25,0,1,1034,2909,3942,0,1772,1033,1033
"65900","Ntome_NODE_22212_length_1033_cov_259","Nsylvestris_NODE_21184_length_1016_cov_105",93.333,765,24,13,148,886,953,190,0,1105,738,763
"65934","Ntome_NODE_22224_length_1033_cov_30","Nsylvestris_NODE_1804_length_4172_cov_108",91.833,1053,51,13,3,1033,1141,2180,0,1435,1030,1039
"65935","Ntome_NODE_22225_length_1033_cov_27","Nsylvestris_NODE_29769_length_548_cov_4",94.175,103,6,0,364,466,20,122,1.53e-37,158,102,102
"65944","Ntome_NODE_22230_length_1033_cov_8","Nsylvestris_NODE_15796_length_1470_cov_109",83.871,403,65,0,331,733,1029,1431,6.44e-106,385,402,402
"65973","Ntome_NODE_22240_length_1032_cov_177","Nsylvestris_NODE_24450_length_804_cov_17",90.037,813,57,3,173,973,804,4,0,1031,800,800
"65974","Ntome_NODE_22241_length_1032_cov_85","Nsylvestris_NODE_1124_length_4787_cov_79",100,55,0,0,978,1032,3520,3574,7.25e-21,102,54,54
"65977","Ntome_NODE_22245_length_1032_cov_16","Nsylvestris_NODE_4856_length_3006_cov_107",100,51,0,0,1,51,1909,1859,1.21e-18,95.3,50,50
"66018","Ntome_NODE_22265_length_1030_cov_81","Nsylvestris_NODE_18837_length_1198_cov_224",100,55,0,0,1,55,183,237,7.24e-21,102,54,54
"66028","Ntome_NODE_22269_length_1030_cov_16","Nsylvestris_NODE_652_length_5548_cov_203",100,55,0,0,1,55,3796,3742,7.24e-21,102,54,54
"66040","Ntome_NODE_22273_length_1030_cov_13","Nsylvestris_NODE_8922_length_2261_cov_80",95.41,1024,37,7,8,1030,2185,1171,0,1622,1022,1014
"66043","Ntome_NODE_22275_length_1029_cov_251","Nsylvestris_NODE_1036_length_4892_cov_55",90.244,82,4,4,951,1029,1278,1358,2.01e-21,104,78,80
"66052","Ntome_NODE_22281_length_1029_cov_207","Nsylvestris_NODE_22326_length_933_cov_187",91.505,930,54,13,1,926,924,16,0,1256,925,908
"66065","Ntome_NODE_22286_length_1029_cov_28","Nsylvestris_NODE_6305_length_2696_cov_150",90.909,88,8,0,360,447,240,153,7.18e-26,119,87,87
"66066","Ntome_NODE_22287_length_1029_cov_24","Nsylvestris_NODE_9630_length_2161_cov_45",88.659,820,63,14,1,811,2161,1363,0,972,810,798
"66070","Ntome_NODE_22289_length_1029_cov_9","Nsylvestris_NODE_8388_length_2343_cov_17",96.723,1007,32,1,23,1029,1,1006,0,1676,1006,1005
"66085","Ntome_NODE_22298_length_1028_cov_49","Nsylvestris_NODE_17856_length_1281_cov_77",85.899,1007,84,19,1,980,1264,289,0,1020,979,975
"66089","Ntome_NODE_22300_length_1028_cov_33","Nsylvestris_NODE_23187_length_879_cov_215",98.148,54,1,0,974,1027,577,524,1.21e-18,95.3,53,53
"66094","Ntome_NODE_22303_length_1028_cov_15","Nsylvestris_NODE_7165_length_2541_cov_132",88,600,40,19,1,589,2204,1626,0,680,588,578
"66101","Ntome_NODE_22308_length_1028_cov_8","Nsylvestris_NODE_12746_length_1792_cov_11",86.26,1048,105,28,3,1028,1272,242,0,1101,1025,1030
"66121","Ntome_NODE_22314_length_1027_cov_197","Nsylvestris_NODE_23489_length_867_cov_176",95.862,435,13,4,316,745,824,390,0,699,429,434
"66125","Ntome_NODE_22316_length_1027_cov_132","Nsylvestris_NODE_19539_length_1140_cov_95",82.414,580,51,25,274,846,324,859,3.72e-128,459,572,535
"66157","Ntome_NODE_22332_length_1026_cov_268","Nsylvestris_NODE_21148_length_1018_cov_209",97,900,25,2,94,991,964,65,0,1511,897,899
"66160","Ntome_NODE_22335_length_1026_cov_176","Nsylvestris_NODE_19265_length_1162_cov_213",87.821,936,66,17,107,1009,1078,158,0,1053,902,920
"66161","Ntome_NODE_22336_length_1026_cov_151","Nsylvestris_NODE_26750_length_685_cov_74",94.629,633,30,3,131,760,1,632,0,977,629,631
"66168","Ntome_NODE_22340_length_1026_cov_65","Nsylvestris_NODE_20913_length_1034_cov_141",86.538,936,94,20,101,1023,975,59,0,1002,922,916
"66169","Ntome_NODE_22341_length_1026_cov_45","Nsylvestris_NODE_16005_length_1449_cov_48",90.26,770,42,8,57,817,795,50,0,976,760,745
"66170","Ntome_NODE_22342_length_1026_cov_45","Nsylvestris_NODE_2904_length_3619_cov_174",90.383,915,64,10,65,963,2713,3619,0,1181,898,906
"66171","Ntome_NODE_22343_length_1026_cov_29","Nsylvestris_NODE_21357_length_1003_cov_10",87.82,977,59,21,70,1026,67,1003,0,1090,956,936
"66176","Ntome_NODE_22346_length_1026_cov_13","Nsylvestris_NODE_9172_length_2227_cov_22",92.727,55,4,0,972,1026,861,915,3.38e-14,80.5,54,54
"66187","Ntome_NODE_22351_length_1026_cov_6","Nsylvestris_NODE_783_length_5263_cov_121",95.588,68,0,2,1,65,512,579,5.57e-22,106,64,67
"66216","Ntome_NODE_22363_length_1025_cov_57","Nsylvestris_NODE_22698_length_909_cov_93",96.114,772,19,4,250,1018,859,96,0,1249,768,763
"66235","Ntome_NODE_22371_length_1024_cov_247","Nsylvestris_NODE_500_length_5964_cov_187",93.573,529,23,5,502,1024,588,1111,0,778,522,523
"66236","Ntome_NODE_22373_length_1024_cov_233","Nsylvestris_NODE_1031_length_4896_cov_213",96.022,905,26,1,120,1024,3219,2325,0,1463,904,894
"66246","Ntome_NODE_22378_length_1024_cov_38","Nsylvestris_NODE_21297_length_1007_cov_12",94.863,915,40,4,6,914,1006,93,0,1423,908,913
"66259","Ntome_NODE_22383_length_1024_cov_17","Nsylvestris_NODE_18861_length_1196_cov_177",95.034,1027,35,5,1,1024,1071,58,0,1600,1023,1013
"66260","Ntome_NODE_22384_length_1024_cov_17","Nsylvestris_NODE_27302_length_660_cov_16",94.427,628,26,4,291,909,33,660,0,957,618,627
"66276","Ntome_NODE_22391_length_1023_cov_226","Nsylvestris_NODE_23948_length_835_cov_193",90.942,839,34,15,19,852,34,835,0,1090,833,801
"66285","Ntome_NODE_22395_length_1023_cov_53","Nsylvestris_NODE_22999_length_891_cov_71",90.855,678,47,5,352,1017,49,723,0,894,665,674
"66288","Ntome_NODE_22398_length_1023_cov_47","Nsylvestris_NODE_3126_length_3535_cov_124",91.909,309,9,3,1,293,3177,3485,6.28e-116,418,292,308
"66294","Ntome_NODE_22401_length_1023_cov_15","Nsylvestris_NODE_8800_length_2279_cov_128",98.182,55,1,0,1,55,1707,1653,3.34e-19,97.1,54,54
"66299","Ntome_NODE_22403_length_1023_cov_7","Nsylvestris_NODE_17624_length_1301_cov_11",95.956,989,37,2,30,1018,24,1009,0,1602,988,985
"66327","Ntome_NODE_22413_length_1022_cov_8","Nsylvestris_NODE_4879_length_3000_cov_189",98.182,55,1,0,1,55,996,942,3.34e-19,97.1,54,54
"66328","Ntome_NODE_22414_length_1022_cov_7","Nsylvestris_NODE_4351_length_3139_cov_142",87.333,150,17,1,873,1022,2369,2516,1.94e-41,171,149,147
"66337","Ntome_NODE_22417_length_1021_cov_238","Nsylvestris_NODE_293_length_6765_cov_138",98.923,1021,11,0,1,1021,1442,2462,0,1825,1020,1020
"66344","Ntome_NODE_22420_length_1021_cov_99","Nsylvestris_NODE_16114_length_1439_cov_19",91.675,1021,46,11,30,1014,1024,7,0,1378,984,1017
"66345","Ntome_NODE_22421_length_1021_cov_26","Nsylvestris_NODE_18430_length_1229_cov_217",98.182,55,1,0,1,55,297,243,3.34e-19,97.1,54,54
"66350","Ntome_NODE_22423_length_1021_cov_18","Nsylvestris_NODE_18983_length_1185_cov_163",98.182,55,1,0,967,1021,313,367,3.34e-19,97.1,54,54
"66364","Ntome_NODE_22431_length_1020_cov_248","Nsylvestris_NODE_19477_length_1145_cov_194",96.835,790,22,2,1,789,1073,286,0,1317,788,787
"66369","Ntome_NODE_22433_length_1020_cov_196","Nsylvestris_NODE_21700_length_977_cov_203",95.51,824,36,1,1,823,929,106,0,1315,822,823
"66370","Ntome_NODE_22435_length_1020_cov_173","Nsylvestris_NODE_9167_length_2228_cov_143",93.524,911,38,9,67,973,46,939,0,1336,906,893
"66371","Ntome_NODE_22436_length_1020_cov_121","Nsylvestris_NODE_20816_length_1041_cov_160",94.796,980,34,8,43,1020,45,1009,0,1511,977,964
"66374","Ntome_NODE_22439_length_1019_cov_54","Nsylvestris_NODE_22814_length_902_cov_8",80.942,913,150,14,108,1011,900,3,0,701,903,897
"66383","Ntome_NODE_22443_length_1020_cov_25","Nsylvestris_NODE_15763_length_1473_cov_247",98.182,55,1,0,966,1020,879,825,3.33e-19,97.1,54,54
"66386","Ntome_NODE_22447_length_1020_cov_13","Nsylvestris_NODE_30545_length_482_cov_215",98.182,55,1,0,966,1020,429,375,3.33e-19,97.1,54,54
"66387","Ntome_NODE_22450_length_1020_cov_3","Nsylvestris_NODE_29669_length_556_cov_4",94.776,402,14,2,617,1018,1,395,1.6e-176,619,401,394
"66396","Ntome_NODE_22454_length_1019_cov_253","Nsylvestris_NODE_19935_length_1107_cov_184",95.289,1019,38,4,3,1019,1061,51,0,1607,1016,1010
"66404","Ntome_NODE_22460_length_1019_cov_127","Nsylvestris_NODE_720_length_5402_cov_123",89.474,266,11,4,754,1019,1287,1535,1.82e-86,320,265,248
"66418","Ntome_NODE_22466_length_1019_cov_18","Nsylvestris_NODE_11676_length_1908_cov_225",96.237,372,14,0,648,1019,1853,1482,9.62e-174,610,371,371
"66419","Ntome_NODE_22467_length_1019_cov_12","Nsylvestris_NODE_6967_length_2574_cov_160",100,55,0,0,1,55,2452,2398,7.16e-21,102,54,54
"66420","Ntome_NODE_22468_length_1019_cov_9","Nsylvestris_NODE_15557_length_1494_cov_216",100,55,0,0,1,55,580,526,7.16e-21,102,54,54
"66421","Ntome_NODE_22469_length_1019_cov_9","Nsylvestris_NODE_11138_length_1971_cov_40",95.182,1017,46,1,3,1019,698,1711,0,1604,1016,1013
"66424","Ntome_NODE_22471_length_1018_cov_273","Nsylvestris_NODE_12142_length_1853_cov_218",98.414,883,13,1,137,1018,41,923,0,1552,881,882
"66446","Ntome_NODE_22478_length_1018_cov_35","Nsylvestris_NODE_4455_length_3108_cov_121",94.545,55,3,0,1,55,536,482,7.2e-16,86.1,54,54
"66451","Ntome_NODE_22482_length_1017_cov_244","Nsylvestris_NODE_22899_length_897_cov_115",84.799,921,85,20,60,971,897,23,0,874,911,874
"66452","Ntome_NODE_22483_length_1017_cov_124","Nsylvestris_NODE_3194_length_3508_cov_143",93.786,1030,39,10,1,1017,2149,1132,0,1524,1016,1017
"66470","Ntome_NODE_22495_length_1016_cov_291","Nsylvestris_NODE_1560_length_4354_cov_201",91.541,863,44,17,182,1016,207,1068,0,1162,834,861
"66488","Ntome_NODE_22503_length_1016_cov_119","Nsylvestris_NODE_21227_length_1012_cov_94",93.536,1021,51,6,1,1015,1012,1,0,1506,1014,1011
"66498","Ntome_NODE_22507_length_1016_cov_25","Nsylvestris_NODE_1957_length_4082_cov_107",89.003,291,29,3,619,906,2485,2195,1.38e-97,357,287,290
"66499","Ntome_NODE_22508_length_1016_cov_23","Nsylvestris_NODE_17863_length_1280_cov_44",95.567,767,32,2,162,927,1052,287,0,1227,765,765
"66530","Ntome_NODE_22521_length_1015_cov_16","Nsylvestris_NODE_3893_length_3271_cov_108",92.426,911,48,11,108,1015,2235,1343,0,1280,907,892
"66531","Ntome_NODE_22522_length_1015_cov_11","Nsylvestris_NODE_23167_length_881_cov_7",95.168,745,27,6,215,958,86,822,0,1168,743,736
"66532","Ntome_NODE_22523_length_1014_cov_254","Nsylvestris_NODE_15435_length_1509_cov_201",94.169,686,35,2,209,889,29,714,0,1040,680,685
"66533","Ntome_NODE_22524_length_1014_cov_141","Nsylvestris_NODE_24888_length_778_cov_15",99.743,778,2,0,137,914,778,1,0,1426,777,777
"66534","Ntome_NODE_22526_length_1014_cov_63","Nsylvestris_NODE_20177_length_1088_cov_65",92.642,965,56,9,1,954,999,39,0,1375,953,960
"66544","Ntome_NODE_22530_length_1014_cov_15","Nsylvestris_NODE_21060_length_1024_cov_125",95.804,572,24,0,251,822,406,977,0,924,571,571
"66545","Ntome_NODE_22531_length_1014_cov_11","Nsylvestris_NODE_6151_length_2725_cov_226",95.238,42,2,0,973,1014,1596,1555,2.6e-10,67.6,41,41
"66546","Ntome_NODE_22532_length_1014_cov_8","Nsylvestris_NODE_7850_length_2428_cov_33",82.265,733,98,16,1,708,1141,1866,4.45e-172,604,707,725
"66547","Ntome_NODE_22534_length_1013_cov_259","Nsylvestris_NODE_30113_length_516_cov_231",97.921,433,5,2,534,965,516,87,0,747,431,429
"66548","Ntome_NODE_22535_length_1013_cov_215","Nsylvestris_NODE_20446_length_1068_cov_195",94.211,881,41,6,134,1013,899,28,0,1336,879,871
"66549","Ntome_NODE_22536_length_1013_cov_163","Nsylvestris_NODE_9795_length_2141_cov_183",92.101,595,32,7,1,593,582,1,0,824,592,581
"66557","Ntome_NODE_22540_length_1013_cov_34","Nsylvestris_NODE_6128_length_2731_cov_123",96.499,657,21,2,355,1011,620,1274,0,1085,656,654
"66563","Ntome_NODE_22543_length_1013_cov_27","Nsylvestris_NODE_4501_length_3100_cov_54",87.565,386,43,3,57,438,2265,2649,3.69e-123,442,381,384
"66570","Ntome_NODE_22548_length_1013_cov_13","Nsylvestris_NODE_5435_length_2877_cov_39",95.558,1013,45,0,1,1013,1017,2029,0,1622,1012,1012
"66575","Ntome_NODE_22551_length_1013_cov_9","Nsylvestris_NODE_21136_length_1019_cov_98",96.364,55,2,0,1,55,266,320,1.54e-17,91.6,54,54
"66578","Ntome_NODE_22553_length_1012_cov_298","Nsylvestris_NODE_2488_length_3800_cov_191",92.89,872,36,10,73,918,2878,3749,0,1243,845,871
"66599","Ntome_NODE_22560_length_1012_cov_225","Nsylvestris_NODE_19509_length_1142_cov_202",94.515,948,49,2,1,948,136,1080,0,1459,947,944
"66600","Ntome_NODE_22561_length_1012_cov_194","Nsylvestris_NODE_6932_length_2580_cov_97",96.182,943,26,7,73,1012,2507,1572,0,1533,939,935
"66615","Ntome_NODE_22567_length_1012_cov_22","Nsylvestris_NODE_19091_length_1176_cov_167",94.244,1025,29,11,1,1012,61,1068,0,1539,1011,1007
"66616","Ntome_NODE_22568_length_1012_cov_5","Nsylvestris_NODE_3845_length_3287_cov_16",95.85,1012,42,0,1,1012,1874,863,0,1637,1011,1011
"66617","Ntome_NODE_22569_length_1012_cov_1","Nsylvestris_NODE_17922_length_1275_cov_39",86.537,1025,78,25,1,990,132,1131,0,1074,989,999
"66640","Ntome_NODE_22579_length_1011_cov_69","Nsylvestris_NODE_10429_length_2059_cov_122",84.762,840,86,17,1,811,880,54,0,804,810,826
"66644","Ntome_NODE_22581_length_1011_cov_42","Nsylvestris_NODE_21069_length_1024_cov_3",93.866,864,52,1,92,955,971,109,0,1303,863,862
"66645","Ntome_NODE_22583_length_1011_cov_16","Nsylvestris_NODE_2245_length_3915_cov_181",98.182,55,1,0,1,55,3245,3299,3.3e-19,97.1,54,54
"66668","Ntome_NODE_22591_length_1010_cov_206","Nsylvestris_NODE_23557_length_856_cov_39",87.769,883,53,24,51,913,9,856,0,981,862,847
"66669","Ntome_NODE_22592_length_1010_cov_201","Nsylvestris_NODE_24464_length_803_cov_137",86.69,849,38,23,8,841,1,789,0,872,833,788
"66670","Ntome_NODE_22593_length_1010_cov_187","Nsylvestris_NODE_23920_length_836_cov_198",95.954,791,27,3,197,982,7,797,0,1279,785,790
"66685","Ntome_NODE_22601_length_1010_cov_25","Nsylvestris_NODE_18256_length_1245_cov_130",93.794,999,50,7,15,1007,176,1168,0,1491,992,992
"66700","Ntome_NODE_22607_length_1009_cov_290","Nsylvestris_NODE_3253_length_3488_cov_174",95.36,1013,26,6,1,1004,1825,2825,0,1591,1003,1000
"66701","Ntome_NODE_22608_length_1009_cov_276","Nsylvestris_NODE_22917_length_896_cov_58",94.344,831,35,4,160,984,43,867,0,1264,824,824
"66706","Ntome_NODE_22611_length_1009_cov_182","Nsylvestris_NODE_24638_length_792_cov_171",92.33,691,25,8,237,919,727,57,0,957,682,670
"66707","Ntome_NODE_22612_length_1009_cov_175","Nsylvestris_NODE_20274_length_1080_cov_41",87.12,955,50,31,47,939,137,1080,0,1014,892,943
"66710","Ntome_NODE_22614_length_1009_cov_72","Nsylvestris_NODE_699_length_5430_cov_162",96.992,665,18,1,95,757,5392,4728,0,1116,662,664
"66736","Ntome_NODE_22629_length_1008_cov_176","Nsylvestris_NODE_3814_length_3296_cov_116",93.118,930,36,11,91,1008,3291,2378,0,1338,917,913
"66737","Ntome_NODE_22630_length_1008_cov_89","Nsylvestris_NODE_15109_length_1540_cov_101",100,39,0,0,970,1008,697,659,5.55e-12,73.1,38,38
"66760","Ntome_NODE_22641_length_1007_cov_296","Nsylvestris_NODE_2824_length_3651_cov_158",97.517,1007,25,0,1,1007,3446,2440,0,1722,1006,1006
"66764","Ntome_NODE_22643_length_1007_cov_261","Nsylvestris_NODE_13197_length_1739_cov_154",78.391,435,83,6,526,956,590,163,5.09e-72,272,430,427
"66771","Ntome_NODE_22645_length_1007_cov_164","Nsylvestris_NODE_22180_length_943_cov_39",89.738,497,26,6,228,704,935,444,2.64e-174,612,476,491
"66776","Ntome_NODE_22648_length_1007_cov_19","Nsylvestris_NODE_19482_length_1145_cov_30",96.142,1011,30,5,1,1007,14,1019,0,1642,1006,1005
"66777","Ntome_NODE_22649_length_1007_cov_19","Nsylvestris_NODE_8019_length_2400_cov_134",98.182,55,1,0,953,1007,424,370,3.29e-19,97.1,54,54
"66782","Ntome_NODE_22651_length_1007_cov_11","Nsylvestris_NODE_8186_length_2373_cov_212",100,55,0,0,953,1007,1414,1468,7.07e-21,102,54,54
"66783","Ntome_NODE_22652_length_1007_cov_9","Nsylvestris_NODE_27008_length_673_cov_22",87.234,188,18,6,13,198,653,470,4.05e-53,209,185,183
"66784","Ntome_NODE_22653_length_1007_cov_8","Nsylvestris_NODE_951_length_5018_cov_152",98.182,55,1,0,953,1007,3901,3847,3.29e-19,97.1,54,54
"66797","Ntome_NODE_22658_length_1006_cov_34","Nsylvestris_NODE_2006_length_4049_cov_184",90.947,972,51,17,1,938,3946,2978,0,1273,937,968
"66798","Ntome_NODE_22659_length_1006_cov_27","Nsylvestris_NODE_21015_length_1027_cov_73",92.807,862,54,3,137,996,872,17,0,1242,859,855
"66833","Ntome_NODE_22674_length_1005_cov_30","Nsylvestris_NODE_21929_length_960_cov_31",91.273,974,54,10,2,975,959,17,0,1299,973,942
"66834","Ntome_NODE_22676_length_1005_cov_15","Nsylvestris_NODE_17163_length_1343_cov_86",89.63,135,14,0,871,1005,1013,1147,5.3e-42,172,134,134
"66840","Ntome_NODE_22678_length_1005_cov_10","Nsylvestris_NODE_16700_length_1381_cov_131",82.398,784,114,5,111,870,181,964,0,662,759,783
"66843","Ntome_NODE_22680_length_1005_cov_9","Nsylvestris_NODE_16603_length_1391_cov_78",77.206,136,25,5,272,404,889,757,1.54e-12,75,132,132
"66846","Ntome_NODE_22684_length_1004_cov_279","Nsylvestris_NODE_9298_length_2207_cov_214",93.382,967,55,6,1,964,1045,2005,0,1423,963,960
"66874","Ntome_NODE_22694_length_1004_cov_11","Nsylvestris_NODE_6956_length_2576_cov_117",96.491,57,2,0,841,897,2052,1996,1.18e-18,95.3,56,56
"66890","Ntome_NODE_22700_length_1003_cov_263","Nsylvestris_NODE_17379_length_1324_cov_209",94.111,951,47,8,1,950,968,26,0,1437,949,942
"66898","Ntome_NODE_22704_length_1003_cov_186","Nsylvestris_NODE_24159_length_822_cov_83",92.326,821,50,7,84,891,822,2,0,1155,807,820
"66905","Ntome_NODE_22708_length_999_cov_68","Nsylvestris_NODE_23690_length_849_cov_35",89.213,788,45,20,34,809,1,760,0,948,775,759
"66917","Ntome_NODE_22712_length_1003_cov_33","Nsylvestris_NODE_2010_length_4046_cov_28",88.531,994,94,8,30,1003,4002,3009,0,1186,973,993
"66931","Ntome_NODE_22718_length_1003_cov_5","Nsylvestris_NODE_2417_length_3832_cov_227",96.364,55,2,0,1,55,1869,1815,1.52e-17,91.6,54,54
"66935","Ntome_NODE_22720_length_1002_cov_237","Nsylvestris_NODE_20945_length_1032_cov_92",94.833,929,27,6,53,970,919,1,0,1430,917,918
"66947","Ntome_NODE_22724_length_1002_cov_124","Nsylvestris_NODE_21620_length_983_cov_75",90.65,1016,46,15,1,1002,982,2,0,1304,1001,980
"66948","Ntome_NODE_22725_length_1002_cov_94","Nsylvestris_NODE_25555_length_741_cov_52",94.838,678,23,5,75,751,740,74,0,1048,676,666
"66951","Ntome_NODE_22727_length_1002_cov_64","Nsylvestris_NODE_7273_length_2522_cov_208",100,55,0,0,948,1002,129,183,7.04e-21,102,54,54
"66961","Ntome_NODE_22731_length_1002_cov_11","Nsylvestris_NODE_1229_length_4672_cov_229",96.364,55,2,0,1,55,201,255,1.52e-17,91.6,54,54
"66986","Ntome_NODE_22741_length_1001_cov_57","Nsylvestris_NODE_20753_length_1046_cov_79",94.125,851,45,4,69,916,910,62,0,1290,847,848
"67000","Ntome_NODE_22747_length_1000_cov_269","Nsylvestris_NODE_20160_length_1089_cov_200",96.674,872,29,0,77,948,924,53,0,1450,871,871
"67005","Ntome_NODE_22749_length_1000_cov_227","Nsylvestris_NODE_22554_length_918_cov_215",92.629,719,50,3,235,951,58,775,0,1031,716,717
"67006","Ntome_NODE_22750_length_1000_cov_174","Nsylvestris_NODE_23298_length_872_cov_172",96.256,828,24,4,157,980,48,872,0,1351,823,824
"67007","Ntome_NODE_22751_length_1000_cov_108","Nsylvestris_NODE_2793_length_3665_cov_122",90.476,210,17,3,372,579,2164,1956,1.41e-72,274,207,208
"67015","Ntome_NODE_22755_length_1000_cov_10","Nsylvestris_NODE_7778_length_2441_cov_192",100,55,0,0,1,55,1778,1724,7.02e-21,102,54,54
"67026","Ntome_NODE_22762_length_999_cov_16","Nsylvestris_NODE_18548_length_1220_cov_153",93.089,955,46,5,20,965,201,1144,0,1380,945,943
"67029","Ntome_NODE_22764_length_999_cov_10","Nsylvestris_NODE_5612_length_2838_cov_91",92.124,965,51,10,1,965,2089,1150,0,1338,964,939
"67030","Ntome_NODE_22765_length_999_cov_9","Nsylvestris_NODE_3356_length_3453_cov_123",75.875,257,47,13,163,405,2438,2693,2.51e-25,117,242,255
"67031","Ntome_NODE_22766_length_999_cov_7","Nsylvestris_NODE_21890_length_962_cov_200",92.424,66,5,0,3,68,582,517,1.17e-18,95.3,65,65
"67032","Ntome_NODE_22767_length_998_cov_249","Nsylvestris_NODE_21953_length_958_cov_188",92.731,963,39,11,1,955,940,1,0,1362,954,939
"67033","Ntome_NODE_22768_length_998_cov_209","Nsylvestris_NODE_25284_length_755_cov_100",90.878,581,32,6,42,602,130,709,0,760,560,579
"67041","Ntome_NODE_22771_length_998_cov_99","Nsylvestris_NODE_25418_length_747_cov_42",89.826,688,46,13,51,721,691,11,0,861,670,680
"67042","Ntome_NODE_22773_length_998_cov_60","Nsylvestris_NODE_8733_length_2290_cov_60",92.993,842,46,5,1,838,2251,1419,0,1216,837,832
"67045","Ntome_NODE_22776_length_996_cov_37","Nsylvestris_NODE_24390_length_808_cov_158",84.694,98,11,4,569,664,500,595,1.17e-18,95.3,95,95
"67048","Ntome_NODE_22778_length_998_cov_29","Nsylvestris_NODE_12715_length_1794_cov_150",96.008,501,20,0,117,617,1787,1287,0,815,500,500
"67049","Ntome_NODE_22779_length_998_cov_18","Nsylvestris_NODE_17260_length_1335_cov_216",98.182,55,1,0,944,998,764,818,3.26e-19,97.1,54,54
"67059","Ntome_NODE_22784_length_997_cov_273","Nsylvestris_NODE_2303_length_3891_cov_208",97.192,997,28,0,1,997,2197,1201,0,1687,996,996
"67082","Ntome_NODE_22795_length_997_cov_7","Nsylvestris_NODE_2538_length_3776_cov_43",95.2,1000,39,2,1,997,1319,326,0,1572,996,993
"67086","Ntome_NODE_22797_length_996_cov_253","Nsylvestris_NODE_3910_length_3265_cov_84",92.641,924,52,11,80,996,55,969,0,1315,916,914
"67087","Ntome_NODE_22798_length_996_cov_246","Nsylvestris_NODE_20691_length_1050_cov_159",91.431,992,39,15,1,984,1049,96,0,1319,983,953
"67090","Ntome_NODE_22800_length_996_cov_135","Nsylvestris_NODE_24484_length_801_cov_208",91.989,362,22,4,639,996,343,701,5.9e-141,501,357,358
"67096","Ntome_NODE_22803_length_996_cov_82","Nsylvestris_NODE_10914_length_1998_cov_116",91.815,1014,43,9,1,996,1434,443,0,1376,995,991
"67104","Ntome_NODE_22806_length_996_cov_33","Nsylvestris_NODE_5862_length_2790_cov_52",94.72,928,34,6,55,980,1876,2790,0,1428,925,914
"67138","Ntome_NODE_22819_length_995_cov_157","Nsylvestris_NODE_23641_length_852_cov_72",95.921,858,26,7,131,987,3,852,0,1382,856,849
"67139","Ntome_NODE_22820_length_995_cov_119","Nsylvestris_NODE_22165_length_944_cov_116",94.388,392,22,0,61,452,197,588,1.57e-171,603,391,391
"67150","Ntome_NODE_22824_length_995_cov_71","Nsylvestris_NODE_3744_length_3321_cov_111",82.078,770,109,20,144,897,2614,1858,7.21e-180,630,753,756
"67156","Ntome_NODE_22827_length_995_cov_43","Nsylvestris_NODE_232_length_7091_cov_100",94.18,945,47,6,52,995,6950,6013,0,1434,943,937
"67167","Ntome_NODE_22833_length_994_cov_282","Nsylvestris_NODE_6092_length_2740_cov_29",95.704,582,22,1,1,579,2105,2686,0,933,578,581
"67177","Ntome_NODE_22837_length_994_cov_43","Nsylvestris_NODE_8245_length_2365_cov_35",98.148,54,1,0,941,994,445,498,1.17e-18,95.3,53,53
"67186","Ntome_NODE_22843_length_994_cov_8","Nsylvestris_NODE_10216_length_2086_cov_224",98.148,54,1,0,941,994,1784,1731,1.17e-18,95.3,53,53
"67192","Ntome_NODE_22845_length_990_cov_249","Nsylvestris_NODE_22835_length_900_cov_185",96.837,822,20,4,63,880,858,39,0,1369,817,819
"67199","Ntome_NODE_22848_length_993_cov_123","Nsylvestris_NODE_8231_length_2367_cov_161",93.462,826,24,11,1,813,1515,2323,0,1199,812,808
"67203","Ntome_NODE_22851_length_993_cov_20","Nsylvestris_NODE_20284_length_1079_cov_42",88.732,71,2,4,250,320,434,498,9.08e-15,82.4,70,64
"67208","Ntome_NODE_22855_length_992_cov_295","Nsylvestris_NODE_15738_length_1476_cov_205",96.066,966,25,5,1,954,1018,54,0,1561,953,964
"67209","Ntome_NODE_22856_length_992_cov_266","Nsylvestris_NODE_21009_length_1027_cov_193",89.883,939,58,17,38,956,922,1,0,1173,918,921
"67210","Ntome_NODE_22857_length_992_cov_263","Nsylvestris_NODE_1248_length_4653_cov_96",93.202,912,52,6,1,908,1063,158,0,1332,907,905
"67213","Ntome_NODE_22860_length_992_cov_166","Nsylvestris_NODE_21578_length_986_cov_144",89.956,906,54,16,10,911,984,112,0,1134,901,872
"67216","Ntome_NODE_22863_length_992_cov_117","Nsylvestris_NODE_33322_length_341_cov_252",77.729,229,42,8,87,309,324,99,8.88e-30,132,222,225
"67229","Ntome_NODE_22867_length_992_cov_42","Nsylvestris_NODE_10704_length_2025_cov_127",97.347,867,23,0,8,874,1986,1120,0,1474,866,866
"67248","Ntome_NODE_22880_length_991_cov_169","Nsylvestris_NODE_14348_length_1615_cov_132",95.425,306,12,2,412,717,1566,1263,1.64e-136,486,305,303
"67249","Ntome_NODE_22881_length_991_cov_101","Nsylvestris_NODE_20730_length_1047_cov_148",91.034,948,77,6,46,989,86,1029,0,1273,943,943
"67250","Ntome_NODE_22883_length_991_cov_77","Nsylvestris_NODE_12524_length_1812_cov_178",89.542,153,9,1,846,991,416,264,1.87e-46,187,145,152
"67251","Ntome_NODE_22884_length_991_cov_54","Nsylvestris_NODE_18462_length_1227_cov_152",92.459,968,32,19,45,979,1,960,0,1345,934,959
"67256","Ntome_NODE_22886_length_991_cov_42","Nsylvestris_NODE_7806_length_2435_cov_111",89.796,245,13,6,751,990,2180,2417,1.78e-81,303,239,237
"67269","Ntome_NODE_22892_length_990_cov_270","Nsylvestris_NODE_20204_length_1086_cov_195",95.197,937,39,4,51,986,1046,115,0,1476,935,931
"67276","Ntome_NODE_22896_length_990_cov_58","Nsylvestris_NODE_12138_length_1854_cov_81",94.937,869,32,4,131,990,1821,956,0,1351,859,865
"67309","Ntome_NODE_22911_length_989_cov_11","Nsylvestris_NODE_13699_length_1685_cov_106",94.545,55,3,0,935,989,439,385,6.99e-16,86.1,54,54
"67323","Ntome_NODE_22918_length_988_cov_185","Nsylvestris_NODE_795_length_5247_cov_149",95.416,589,25,2,400,988,3023,3609,0,937,588,586
"67324","Ntome_NODE_22919_length_988_cov_161","Nsylvestris_NODE_1568_length_4350_cov_86",95.096,571,18,7,49,613,3694,4260,0,891,564,566
"67325","Ntome_NODE_22920_length_988_cov_161","Nsylvestris_NODE_21716_length_976_cov_47",94.126,698,35,4,49,743,61,755,0,1057,694,694
"67346","Ntome_NODE_22929_length_988_cov_8","Nsylvestris_NODE_29327_length_570_cov_8",90.435,575,42,5,422,988,570,1,0,745,566,569
"67358","Ntome_NODE_22934_length_987_cov_187","Nsylvestris_NODE_8475_length_2328_cov_122",92.133,750,49,4,6,755,1491,2230,0,1050,749,739
"67370","Ntome_NODE_22939_length_987_cov_13","Nsylvestris_NODE_9789_length_2141_cov_230",100,55,0,0,933,987,1271,1325,6.93e-21,102,54,54
"67391","Ntome_NODE_22945_length_986_cov_249","Nsylvestris_NODE_23668_length_850_cov_219",96.395,749,22,3,105,852,51,795,0,1229,747,744
"67395","Ntome_NODE_22947_length_986_cov_212","Nsylvestris_NODE_16281_length_1421_cov_198",93.08,896,54,2,91,986,1378,491,0,1304,895,887
"67406","Ntome_NODE_22950_length_986_cov_76","Nsylvestris_NODE_22809_length_902_cov_124",91.685,914,37,10,97,986,900,2,0,1230,889,898
"67412","Ntome_NODE_22955_length_986_cov_25","Nsylvestris_NODE_2554_length_3767_cov_143",96.825,63,2,0,924,986,525,463,5.35e-22,106,62,62
"67413","Ntome_NODE_22956_length_986_cov_21","Nsylvestris_NODE_139_length_7902_cov_57",94.915,59,2,1,1,59,6543,6486,1.5e-17,91.6,58,57
"67414","Ntome_NODE_22957_length_986_cov_15","Nsylvestris_NODE_16682_length_1382_cov_205",98.182,55,1,0,932,986,223,169,3.22e-19,97.1,54,54
"67421","Ntome_NODE_22960_length_986_cov_8","Nsylvestris_NODE_8014_length_2401_cov_134",85.535,159,22,1,821,979,1915,2072,8.7e-40,165,158,157
"67448","Ntome_NODE_22970_length_985_cov_127","Nsylvestris_NODE_17173_length_1342_cov_93",94.688,979,35,7,4,981,994,32,0,1504,977,962
"67466","Ntome_NODE_22980_length_985_cov_8","Nsylvestris_NODE_22001_length_955_cov_197",95.833,48,2,0,932,979,369,416,1.17e-13,78.7,47,47
"67490","Ntome_NODE_22991_length_984_cov_18","Nsylvestris_NODE_3085_length_3548_cov_192",100,55,0,0,1,55,3060,3006,6.91e-21,102,54,54
"67501","Ntome_NODE_22995_length_983_cov_6","Nsylvestris_NODE_8281_length_2358_cov_40",96.315,977,31,4,8,983,56,1028,0,1600,975,972
"67511","Ntome_NODE_22999_length_983_cov_233","Nsylvestris_NODE_7050_length_2562_cov_75",92.932,382,20,4,3,381,452,829,2.05e-155,549,378,377
"67515","Ntome_NODE_23001_length_983_cov_112","Nsylvestris_NODE_1291_length_4603_cov_198",93.289,894,54,5,44,937,888,1,0,1314,893,887
"67522","Ntome_NODE_23004_length_983_cov_98","Nsylvestris_NODE_16870_length_1367_cov_37",78.539,219,45,2,475,692,968,1185,4.07e-33,143,217,217
"67525","Ntome_NODE_23006_length_983_cov_87","Nsylvestris_NODE_7880_length_2424_cov_63",91.011,89,8,0,635,723,1242,1154,1.91e-26,121,88,88
"67528","Ntome_NODE_23008_length_983_cov_27","Nsylvestris_NODE_32722_length_363_cov_4",95.317,363,17,0,419,781,363,1,9.41e-164,577,362,362
"67529","Ntome_NODE_23009_length_983_cov_21","Nsylvestris_NODE_20720_length_1048_cov_118",95.043,928,39,3,6,926,1020,93,0,1452,920,927
"67530","Ntome_NODE_23011_length_983_cov_16","Nsylvestris_NODE_20138_length_1091_cov_36",95.214,982,43,3,2,983,15,992,0,1550,981,977
"67547","Ntome_NODE_23019_length_982_cov_212","Nsylvestris_NODE_22754_length_905_cov_206",95.357,883,30,5,1,879,876,1,0,1393,878,875
"67554","Ntome_NODE_23024_length_982_cov_33","Nsylvestris_NODE_17714_length_1293_cov_49",94.758,973,46,2,14,982,50,1021,0,1509,968,971
"67560","Ntome_NODE_23028_length_981_cov_7","Nsylvestris_NODE_1011_length_4932_cov_20",85.063,790,111,7,187,972,4233,3447,0,798,785,786
"67575","Ntome_NODE_23035_length_981_cov_20","Nsylvestris_NODE_21893_length_959_cov_38",95.758,778,32,1,23,799,913,136,0,1253,776,777
"67582","Ntome_NODE_23041_length_981_cov_5","Nsylvestris_NODE_12074_length_1860_cov_224",96.364,55,2,0,927,981,683,629,1.49e-17,91.6,54,54
"67592","Ntome_NODE_23046_length_980_cov_93","Nsylvestris_NODE_7543_length_2478_cov_192",92.199,423,16,7,532,948,444,33,2.02e-165,582,416,411
"67597","Ntome_NODE_23051_length_980_cov_21","Nsylvestris_NODE_3040_length_3572_cov_53",96.122,980,38,0,1,980,1102,123,0,1600,979,979
"67603","Ntome_NODE_23054_length_980_cov_8","Nsylvestris_NODE_12069_length_1861_cov_195",96.61,59,1,1,1,59,459,402,3.2e-19,97.1,58,57
"67613","Ntome_NODE_23058_length_979_cov_259","Nsylvestris_NODE_19305_length_1160_cov_202",96.145,856,33,0,75,930,125,980,0,1399,855,855
"67618","Ntome_NODE_23060_length_979_cov_228","Nsylvestris_NODE_27185_length_665_cov_217",90.651,599,38,10,180,777,75,656,0,780,597,581
"67623","Ntome_NODE_23063_length_977_cov_116","Nsylvestris_NODE_9404_length_2193_cov_24",85.463,681,62,21,5,660,1449,2117,0,675,655,668
"67626","Ntome_NODE_23065_length_979_cov_88","Nsylvestris_NODE_27266_length_661_cov_249",94.248,226,12,1,743,968,298,74,1.03e-93,344,225,224
"67631","Ntome_NODE_23067_length_979_cov_52","Nsylvestris_NODE_10437_length_2057_cov_151",87.861,173,18,2,109,278,747,575,2.37e-50,200,169,172
"67638","Ntome_NODE_23071_length_979_cov_11","Nsylvestris_NODE_1772_length_4194_cov_99",90.654,107,9,1,404,510,1654,1759,1.46e-32,141,106,105
"67639","Ntome_NODE_23073_length_979_cov_8","Nsylvestris_NODE_12505_length_1812_cov_218",98.182,55,1,0,925,979,991,937,3.2e-19,97.1,54,54
"67640","Ntome_NODE_23075_length_978_cov_281","Nsylvestris_NODE_14535_length_1596_cov_204",97.068,921,25,2,59,978,1,920,0,1550,919,919
"67655","Ntome_NODE_23081_length_948_cov_71","Nsylvestris_NODE_20942_length_1033_cov_8",93.528,618,27,2,1,618,306,910,0,907,617,604
"67656","Ntome_NODE_23082_length_978_cov_65","Nsylvestris_NODE_16376_length_1412_cov_16",91.589,963,59,10,1,961,2,944,0,1310,960,942
"67657","Ntome_NODE_23083_length_978_cov_48","Nsylvestris_NODE_13453_length_1712_cov_4",83.636,165,20,3,98,257,1299,1461,8.69e-35,148,159,162
"67658","Ntome_NODE_23085_length_978_cov_38","Nsylvestris_NODE_10907_length_1999_cov_160",91.549,284,24,0,695,978,1407,1690,3.64e-108,392,283,283
"67663","Ntome_NODE_23088_length_978_cov_31","Nsylvestris_NODE_4720_length_3040_cov_107",98.182,55,1,0,1,55,2274,2328,3.19e-19,97.1,54,54
"67699","Ntome_NODE_23105_length_977_cov_28","Nsylvestris_NODE_24309_length_812_cov_10",81.527,406,72,2,379,784,324,726,8.03e-90,331,405,402
"67722","Ntome_NODE_23114_length_976_cov_60","Nsylvestris_NODE_21647_length_981_cov_168",87.056,958,64,27,47,975,981,55,0,1027,928,926
"67723","Ntome_NODE_23115_length_976_cov_38","Nsylvestris_NODE_21653_length_981_cov_17",93.629,926,32,11,51,969,906,1,0,1358,918,905
"67730","Ntome_NODE_23118_length_976_cov_25","Nsylvestris_NODE_18717_length_1208_cov_45",87.277,393,18,7,591,976,682,1049,1.67e-116,420,385,367
"67734","Ntome_NODE_23120_length_976_cov_20","Nsylvestris_NODE_21914_length_961_cov_25",89.801,804,64,7,182,976,806,12,0,1014,794,794
"67763","Ntome_NODE_23132_length_975_cov_64","Nsylvestris_NODE_21922_length_960_cov_175",85.294,408,30,15,5,394,1,396,1.01e-108,394,389,395
"67764","Ntome_NODE_23133_length_975_cov_47","Nsylvestris_NODE_13946_length_1657_cov_200",92.857,56,2,2,921,975,1031,1085,3.21e-14,80.5,54,54
"67770","Ntome_NODE_23136_length_975_cov_14","Nsylvestris_NODE_18974_length_1186_cov_25",91.038,848,57,15,132,975,286,1118,0,1127,843,832
"67790","Ntome_NODE_23146_length_974_cov_260","Nsylvestris_NODE_17055_length_1352_cov_209",94.168,926,51,2,1,926,923,1,0,1408,925,922
"67795","Ntome_NODE_23148_length_974_cov_197","Nsylvestris_NODE_22954_length_894_cov_143",94.993,699,32,1,218,913,47,745,0,1094,695,698
"67796","Ntome_NODE_23149_length_974_cov_191","Nsylvestris_NODE_7808_length_2435_cov_76",92.948,865,55,4,1,865,1444,2302,0,1254,864,858
"67807","Ntome_NODE_23153_length_974_cov_69","Nsylvestris_NODE_5046_length_2961_cov_127",90.728,151,11,1,700,850,1991,2138,8.47e-50,198,150,147
"67812","Ntome_NODE_23156_length_974_cov_40","Nsylvestris_NODE_1760_length_4208_cov_67",92.48,758,45,8,70,822,4208,3458,0,1074,752,750
"67828","Ntome_NODE_23164_length_973_cov_250","Nsylvestris_NODE_14470_length_1603_cov_66",93.272,654,32,3,57,710,27,668,0,953,653,641
"67839","Ntome_NODE_23169_length_973_cov_58","Nsylvestris_NODE_24448_length_804_cov_128",92.257,762,38,5,227,973,757,2,0,1061,746,755
"67844","Ntome_NODE_23171_length_973_cov_36","Nsylvestris_NODE_4455_length_3108_cov_121",100,55,0,0,1,55,1906,1852,6.83e-21,102,54,54
"67845","Ntome_NODE_23172_length_973_cov_29","Nsylvestris_NODE_4280_length_3156_cov_132",100,55,0,0,919,973,1606,1552,6.83e-21,102,54,54
"67851","Ntome_NODE_23177_length_973_cov_17","Nsylvestris_NODE_9071_length_2242_cov_220",96.667,60,2,0,1,60,1342,1283,2.46e-20,100,59,59
"67877","Ntome_NODE_23189_length_972_cov_195","Nsylvestris_NODE_17531_length_1310_cov_121",92.857,588,41,1,383,969,588,1,0,852,586,587
"67878","Ntome_NODE_23190_length_972_cov_167","Nsylvestris_NODE_29561_length_561_cov_5",95.088,570,15,5,91,660,558,2,0,885,569,556
"67887","Ntome_NODE_23193_length_972_cov_89","Nsylvestris_NODE_20420_length_1070_cov_61",92.145,802,38,10,1,794,13,797,0,1109,793,784
"67888","Ntome_NODE_23194_length_972_cov_63","Nsylvestris_NODE_23722_length_847_cov_49",93.814,679,33,4,140,816,29,700,0,1013,676,671
"67917","Ntome_NODE_23208_length_971_cov_22","Nsylvestris_NODE_21012_length_1027_cov_145",93.482,537,34,1,436,971,553,17,0,797,535,536
"67918","Ntome_NODE_23209_length_971_cov_16","Nsylvestris_NODE_4879_length_3000_cov_189",98.182,55,1,0,1,55,1732,1678,3.17e-19,97.1,54,54
"67934","Ntome_NODE_23215_length_970_cov_256","Nsylvestris_NODE_9284_length_2209_cov_95",94.944,890,35,8,1,885,39,923,0,1386,884,884
"67955","Ntome_NODE_23225_length_970_cov_14","Nsylvestris_NODE_4357_length_3137_cov_226",94.444,54,3,0,1,54,62,115,2.47e-15,84.2,53,53
"67963","Ntome_NODE_23229_length_970_cov_7","Nsylvestris_NODE_36274_length_267_cov_4",96.255,267,9,1,493,758,1,267,1.64e-121,436,265,266
"67968","Ntome_NODE_23232_length_969_cov_222","Nsylvestris_NODE_15340_length_1518_cov_202",97.5,640,13,3,1,638,1053,415,0,1090,637,638
"67971","Ntome_NODE_23234_length_969_cov_97","Nsylvestris_NODE_920_length_5060_cov_183",100,54,0,0,1,54,4219,4272,2.45e-20,100,53,53
"68007","Ntome_NODE_23247_length_968_cov_211","Nsylvestris_NODE_3630_length_3355_cov_190",94.839,930,44,2,39,968,3255,2330,0,1448,929,925
"68027","Ntome_NODE_23256_length_968_cov_13","Nsylvestris_NODE_5651_length_2827_cov_231",100,55,0,0,914,968,1839,1785,6.79e-21,102,54,54
"68028","Ntome_NODE_23257_length_968_cov_6","Nsylvestris_NODE_16820_length_1355_cov_197",98.182,55,1,0,914,968,536,482,3.16e-19,97.1,54,54
"68029","Ntome_NODE_23258_length_968_cov_4","Nsylvestris_NODE_470_length_6031_cov_12",74.048,867,190,17,63,922,1050,1888,4.79e-87,322,859,838
"68051","Ntome_NODE_23267_length_967_cov_13","Nsylvestris_NODE_18107_length_1259_cov_62",91.162,826,38,13,153,967,458,1259,0,1088,814,801
"68068","Ntome_NODE_23273_length_966_cov_267","Nsylvestris_NODE_30980_length_453_cov_3",85.934,455,43,13,105,547,453,8,2.09e-130,466,442,445
"68072","Ntome_NODE_23275_length_966_cov_258","Nsylvestris_NODE_19331_length_1158_cov_193",91.995,862,44,10,60,916,981,140,0,1186,856,841
"68081","Ntome_NODE_23279_length_966_cov_95","Nsylvestris_NODE_3213_length_3502_cov_192",98.182,55,1,0,912,966,1838,1892,3.15e-19,97.1,54,54
"68096","Ntome_NODE_23285_length_966_cov_20","Nsylvestris_NODE_7734_length_2447_cov_117",91.935,62,4,1,1,61,546,485,6.83e-16,86.1,60,61
"68121","Ntome_NODE_23296_length_966_cov_6","Nsylvestris_NODE_26922_length_677_cov_10",91.266,687,27,8,284,966,677,20,0,905,682,657
"68122","Ntome_NODE_23297_length_966_cov_6","Nsylvestris_NODE_32431_length_375_cov_7",95.817,263,11,0,704,966,375,113,3.54e-118,425,262,262
"68123","Ntome_NODE_23298_length_966_cov_4","Nsylvestris_NODE_9277_length_2210_cov_111",98.182,55,1,0,912,966,1110,1164,3.15e-19,97.1,54,54
"68138","Ntome_NODE_23304_length_965_cov_71","Nsylvestris_NODE_10761_length_2018_cov_99",92.808,584,18,3,406,965,1015,432,0,824,559,583
"68139","Ntome_NODE_23305_length_965_cov_44","Nsylvestris_NODE_3347_length_3457_cov_20",92.233,206,15,1,49,254,593,797,1.35e-77,291,205,204
"68142","Ntome_NODE_23307_length_965_cov_19","Nsylvestris_NODE_10348_length_2069_cov_220",100,55,0,0,1,55,1686,1740,6.77e-21,102,54,54
"68143","Ntome_NODE_23308_length_965_cov_12","Nsylvestris_NODE_4535_length_3090_cov_113",100,55,0,0,911,965,314,260,6.77e-21,102,54,54
"68156","Ntome_NODE_23313_length_964_cov_226","Nsylvestris_NODE_21891_length_962_cov_170",94.203,897,36,7,73,964,892,7,0,1354,891,885
"68157","Ntome_NODE_23314_length_964_cov_191","Nsylvestris_NODE_2079_length_4005_cov_161",90.604,149,14,0,181,329,1498,1646,8.39e-50,198,148,148
"68158","Ntome_NODE_23315_length_964_cov_109","Nsylvestris_NODE_11694_length_1905_cov_226",98.039,51,1,0,3,53,1200,1250,5.27e-17,89.8,50,50
"68162","Ntome_NODE_23317_length_964_cov_45","Nsylvestris_NODE_16883_length_1365_cov_56",88.86,386,24,6,243,609,185,570,1.25e-127,457,366,385
"68163","Ntome_NODE_23318_length_964_cov_40","Nsylvestris_NODE_296_length_6757_cov_95",84.556,259,35,4,367,621,4724,4467,6.35e-66,252,254,257
"68164","Ntome_NODE_23319_length_964_cov_40","Nsylvestris_NODE_20997_length_1028_cov_32",93.895,950,34,5,8,934,80,1028,0,1411,926,948
"68179","Ntome_NODE_23325_length_964_cov_20","Nsylvestris_NODE_4767_length_3029_cov_209",100,58,0,0,1,58,1367,1310,1.45e-22,108,57,57
"68180","Ntome_NODE_23326_length_964_cov_19","Nsylvestris_NODE_19702_length_1127_cov_119",88.599,921,59,23,20,904,44,954,0,1077,884,910
"68181","Ntome_NODE_23329_length_964_cov_8","Nsylvestris_NODE_9643_length_2159_cov_151",100,55,0,0,1,55,1973,1919,6.76e-21,102,54,54
"68182","Ntome_NODE_23331_length_964_cov_7","Nsylvestris_NODE_856_length_5155_cov_44",81.733,427,67,7,410,834,523,940,2.83e-94,346,424,417
"68189","Ntome_NODE_23336_length_963_cov_262","Nsylvestris_NODE_22288_length_936_cov_213",95.197,937,25,11,19,952,13,932,0,1463,933,919
"68193","Ntome_NODE_23338_length_963_cov_163","Nsylvestris_NODE_16669_length_1384_cov_71",96.18,890,25,5,83,963,1315,426,0,1447,880,889
"68194","Ntome_NODE_23339_length_963_cov_148","Nsylvestris_NODE_21615_length_983_cov_206",94.656,393,19,2,572,963,937,546,3.27e-173,608,391,391
"68198","Ntome_NODE_23341_length_963_cov_117","Nsylvestris_NODE_26501_length_696_cov_9",89.349,169,17,1,751,918,527,695,1.08e-53,211,167,168
"68199","Ntome_NODE_23342_length_963_cov_95","Nsylvestris_NODE_3399_length_3438_cov_103",77.542,236,37,9,51,285,1475,1255,1.11e-28,128,234,220
"68202","Ntome_NODE_23345_length_963_cov_17","Nsylvestris_NODE_3962_length_3245_cov_145",98.182,55,1,0,1,55,1302,1248,3.14e-19,97.1,54,54
"68207","Ntome_NODE_23347_length_963_cov_16","Nsylvestris_NODE_13069_length_1755_cov_127",91.87,369,15,3,267,628,1655,1295,5.7e-141,501,361,360
"68214","Ntome_NODE_23350_length_963_cov_13","Nsylvestris_NODE_23787_length_843_cov_201",100,55,0,0,1,55,542,488,6.76e-21,102,54,54
"68220","Ntome_NODE_23353_length_963_cov_4","Nsylvestris_NODE_10464_length_2055_cov_38",96.823,724,23,0,240,963,53,776,0,1210,723,723
"68235","Ntome_NODE_23360_length_962_cov_65","Nsylvestris_NODE_22547_length_919_cov_42",94.521,730,40,0,121,850,778,49,0,1127,729,729
"68240","Ntome_NODE_23363_length_962_cov_31","Nsylvestris_NODE_11726_length_1902_cov_23",100,55,0,0,1,55,493,439,6.75e-21,102,54,54
"68258","Ntome_NODE_23374_length_961_cov_261","Nsylvestris_NODE_22302_length_935_cov_210",91.746,630,14,12,1,592,125,754,0,841,591,629
"68264","Ntome_NODE_23377_length_961_cov_139","Nsylvestris_NODE_23905_length_837_cov_60",90.876,822,49,11,53,866,807,4,0,1079,813,803
"68265","Ntome_NODE_23378_length_961_cov_102","Nsylvestris_NODE_12427_length_1824_cov_109",94.366,781,30,3,192,961,1550,773,0,1186,769,777
"68266","Ntome_NODE_23380_length_961_cov_56","Nsylvestris_NODE_8077_length_2391_cov_16",87.245,196,21,4,675,869,1590,1398,1.78e-56,220,194,192
"68267","Ntome_NODE_23382_length_961_cov_32","Nsylvestris_NODE_493_length_5980_cov_105",98.182,55,1,0,1,55,1415,1361,3.14e-19,97.1,54,54
"68275","Ntome_NODE_23387_length_961_cov_16","Nsylvestris_NODE_2602_length_3744_cov_230",98.182,55,1,0,1,55,1054,1108,3.14e-19,97.1,54,54
"68276","Ntome_NODE_23388_length_961_cov_11","Nsylvestris_NODE_11686_length_1907_cov_133",98.039,51,1,0,542,592,755,805,5.25e-17,89.8,50,50
"68277","Ntome_NODE_23389_length_961_cov_10","Nsylvestris_NODE_16298_length_1420_cov_22",92.029,966,60,4,2,961,232,1186,0,1341,959,954
"68278","Ntome_NODE_23390_length_961_cov_9","Nsylvestris_NODE_34106_length_319_cov_3",94.688,320,14,3,534,851,319,1,9.52e-139,494,317,318
"68281","Ntome_NODE_23392_length_961_cov_3","Nsylvestris_NODE_10267_length_2079_cov_143",91.099,955,57,8,7,960,992,65,0,1267,953,927
"68311","Ntome_NODE_23403_length_960_cov_56","Nsylvestris_NODE_22218_length_941_cov_24",92.841,866,49,11,73,933,52,909,0,1243,860,857
"68318","Ntome_NODE_23407_length_960_cov_18","Nsylvestris_NODE_29868_length_539_cov_6",94.991,539,27,0,324,862,1,539,0,846,538,538
"68319","Ntome_NODE_23408_length_960_cov_16","Nsylvestris_NODE_2753_length_3681_cov_147",90.724,981,58,18,1,960,470,1438,0,1277,959,968
"68320","Ntome_NODE_23409_length_960_cov_9","Nsylvestris_NODE_13181_length_1740_cov_221",86.218,965,123,10,1,960,1258,299,0,1037,959,959
"68342","Ntome_NODE_23420_length_959_cov_30","Nsylvestris_NODE_1255_length_4636_cov_133",100,55,0,0,905,959,1415,1361,6.73e-21,102,54,54
"68351","Ntome_NODE_23424_length_959_cov_15","Nsylvestris_NODE_2559_length_3769_cov_117",90.476,126,10,2,736,860,2275,2151,8.46e-40,165,124,124
"68366","Ntome_NODE_23430_length_958_cov_261","Nsylvestris_NODE_22878_length_898_cov_184",92.279,816,39,14,95,905,60,856,0,1136,810,796
"68372","Ntome_NODE_23433_length_958_cov_204","Nsylvestris_NODE_3894_length_3270_cov_145",90.051,784,40,12,141,896,1514,2287,0,981,755,773
"68375","Ntome_NODE_23435_length_958_cov_196","Nsylvestris_NODE_30244_length_506_cov_217",93.541,449,26,3,125,573,61,506,0,665,448,445
"68384","Ntome_NODE_23438_length_958_cov_128","Nsylvestris_NODE_24325_length_811_cov_64",92.809,598,28,5,25,616,19,607,0,852,591,588
"68385","Ntome_NODE_23439_length_958_cov_125","Nsylvestris_NODE_2382_length_3850_cov_154",98.182,55,1,0,904,958,728,674,3.13e-19,97.1,54,54
"68388","Ntome_NODE_23442_length_958_cov_49","Nsylvestris_NODE_27238_length_663_cov_5",93.949,661,25,6,204,849,3,663,0,985,645,660
"68392","Ntome_NODE_23444_length_958_cov_37","Nsylvestris_NODE_5047_length_2961_cov_101",88.197,915,92,7,1,903,2894,1984,0,1077,902,910
"68393","Ntome_NODE_23445_length_958_cov_30","Nsylvestris_NODE_3829_length_3292_cov_117",95.385,65,2,1,1,64,2282,2218,6.72e-21,102,63,64
"68417","Ntome_NODE_23456_length_957_cov_217","Nsylvestris_NODE_24742_length_786_cov_131",94.382,623,30,5,197,817,739,120,0,952,620,619
"68423","Ntome_NODE_23458_length_957_cov_148","Nsylvestris_NODE_22464_length_924_cov_188",94.645,859,31,8,99,949,1,852,0,1317,850,851
"68434","Ntome_NODE_23462_length_957_cov_88","Nsylvestris_NODE_23212_length_878_cov_11",88.466,867,53,22,39,890,878,44,0,1003,851,834
"68435","Ntome_NODE_23463_length_957_cov_48","Nsylvestris_NODE_24445_length_804_cov_185",91.867,750,46,10,213,957,6,745,0,1033,744,739
"68481","Ntome_NODE_23485_length_956_cov_6","Nsylvestris_NODE_19004_length_1183_cov_111",95.329,942,42,2,16,956,1073,133,0,1495,940,940
"68487","Ntome_NODE_23487_length_955_cov_261","Nsylvestris_NODE_15507_length_1501_cov_211",96.214,898,30,4,1,895,91,987,0,1467,894,896
"68488","Ntome_NODE_23488_length_955_cov_175","Nsylvestris_NODE_23805_length_843_cov_14",92.475,598,33,7,320,913,254,843,0,845,593,589
"68491","Ntome_NODE_23490_length_955_cov_152","Nsylvestris_NODE_2840_length_3641_cov_93",92.299,922,54,11,5,924,529,1435,0,1293,919,906
"68494","Ntome_NODE_23492_length_955_cov_68","Nsylvestris_NODE_11197_length_1963_cov_118",100,55,0,0,901,955,1045,1099,6.7e-21,102,54,54
"68501","Ntome_NODE_23495_length_955_cov_48","Nsylvestris_NODE_7351_length_2512_cov_228",95.122,41,2,0,1,41,255,215,8.79e-10,65.8,40,40
"68518","Ntome_NODE_23504_length_954_cov_291","Nsylvestris_NODE_833_length_5187_cov_157",96.133,931,34,2,26,954,2088,1158,0,1519,928,930
"68519","Ntome_NODE_23505_length_954_cov_278","Nsylvestris_NODE_224_length_7162_cov_204",94.49,853,40,3,106,954,1249,2098,0,1308,848,849
"68520","Ntome_NODE_23506_length_954_cov_271","Nsylvestris_NODE_12141_length_1853_cov_219",95.828,815,30,3,1,813,987,1799,0,1314,812,812
"68545","Ntome_NODE_23515_length_954_cov_114","Nsylvestris_NODE_16066_length_1443_cov_121",95.013,742,29,2,50,791,744,11,0,1158,741,733
"68555","Ntome_NODE_23518_length_954_cov_44","Nsylvestris_NODE_35483_length_284_cov_5",95.07,284,14,0,283,566,1,284,7.46e-125,448,283,283
"68559","Ntome_NODE_23521_length_954_cov_8","Nsylvestris_NODE_1560_length_4354_cov_201",96.429,56,2,0,1,56,2499,2444,4.03e-18,93.5,55,55
"68560","Ntome_NODE_23522_length_954_cov_6","Nsylvestris_NODE_4094_length_3204_cov_133",92.228,965,51,12,1,954,1338,387,0,1345,953,951
"68569","Ntome_NODE_23526_length_953_cov_225","Nsylvestris_NODE_17870_length_1279_cov_125",88.948,941,74,17,32,952,45,975,0,1134,920,930
"68570","Ntome_NODE_23528_length_953_cov_76","Nsylvestris_NODE_21599_length_985_cov_79",91.689,758,59,4,104,857,758,1,0,1048,753,757
"68577","Ntome_NODE_23531_length_953_cov_21","Nsylvestris_NODE_14192_length_1631_cov_33",94.671,957,35,3,3,947,679,1631,0,1471,944,952
"68581","Ntome_NODE_23533_length_953_cov_14","Nsylvestris_NODE_12244_length_1842_cov_233",100,55,0,0,899,953,526,472,6.68e-21,102,54,54
"68582","Ntome_NODE_23534_length_953_cov_13","Nsylvestris_NODE_21017_length_1027_cov_17",89.497,914,25,20,1,900,34,890,0,1090,899,856
"68583","Ntome_NODE_23535_length_953_cov_7","Nsylvestris_NODE_6521_length_2657_cov_80",77.852,298,56,6,648,943,1953,2242,3.88e-43,176,295,289
"68616","Ntome_NODE_23549_length_951_cov_231","Nsylvestris_NODE_8910_length_2262_cov_182",96.594,734,21,3,168,900,1448,2178,0,1214,732,730
"68634","Ntome_NODE_23559_length_951_cov_17","Nsylvestris_NODE_18581_length_1218_cov_170",92.782,859,43,8,100,951,241,1087,0,1225,851,846
"68635","Ntome_NODE_23560_length_951_cov_16","Nsylvestris_NODE_25163_length_762_cov_188",98.113,53,1,0,897,949,249,301,4.01e-18,93.5,52,52
"68636","Ntome_NODE_23561_length_951_cov_15","Nsylvestris_NODE_18696_length_1209_cov_190",100,55,0,0,897,951,274,328,6.67e-21,102,54,54
"68646","Ntome_NODE_23565_length_951_cov_9","Nsylvestris_NODE_10215_length_2087_cov_15",86.424,302,26,8,1,297,1757,1466,2.19e-85,316,296,291
"68657","Ntome_NODE_23573_length_950_cov_227","Nsylvestris_NODE_24270_length_814_cov_37",93.343,691,41,3,155,840,58,748,0,1016,685,690
"68658","Ntome_NODE_23574_length_950_cov_224","Nsylvestris_NODE_2550_length_3770_cov_62",94.231,52,2,1,900,950,3282,3333,1.12e-13,78.7,50,51
"68665","Ntome_NODE_23577_length_950_cov_68","Nsylvestris_NODE_11_length_12805_cov_33",77.91,756,161,6,173,925,4820,5572,2.05e-130,466,752,752
"68670","Ntome_NODE_23579_length_950_cov_32","Nsylvestris_NODE_15872_length_1462_cov_188",83.993,556,80,6,260,809,867,1419,3.34e-148,525,549,552
"68674","Ntome_NODE_23581_length_950_cov_21","Nsylvestris_NODE_16280_length_1421_cov_203",98.182,55,1,0,1,55,547,493,3.1e-19,97.1,54,54
"68684","Ntome_NODE_23586_length_950_cov_11","Nsylvestris_NODE_20942_length_1033_cov_8",81.647,425,74,4,98,520,202,624,2.16e-95,350,422,422
"68685","Ntome_NODE_23587_length_950_cov_6","Nsylvestris_NODE_10386_length_2064_cov_104",94.444,90,5,0,1,90,837,926,5.08e-32,139,89,89
"68686","Ntome_NODE_23588_length_949_cov_292","Nsylvestris_NODE_3581_length_3371_cov_225",97.771,942,19,1,10,949,3371,2430,0,1622,939,941
"68687","Ntome_NODE_23589_length_949_cov_287","Nsylvestris_NODE_21826_length_967_cov_217",90.226,931,54,15,21,922,930,8,0,1181,901,922
"68688","Ntome_NODE_23590_length_949_cov_229","Nsylvestris_NODE_16252_length_1424_cov_118",87.205,891,72,13,53,942,97,946,0,976,889,849
"68710","Ntome_NODE_23599_length_949_cov_12","Nsylvestris_NODE_5390_length_2889_cov_65",94.24,625,32,2,1,621,428,1052,0,952,620,624
"68714","Ntome_NODE_23601_length_948_cov_249","Nsylvestris_NODE_22542_length_919_cov_190",95.838,913,36,2,1,912,8,919,0,1474,911,911
"68721","Ntome_NODE_23604_length_948_cov_154","Nsylvestris_NODE_24582_length_796_cov_181",94.11,781,32,4,37,814,27,796,0,1175,777,769
"68722","Ntome_NODE_23605_length_948_cov_146","Nsylvestris_NODE_26695_length_687_cov_139",93.548,372,22,2,11,381,429,59,1.53e-156,553,370,370
"68737","Ntome_NODE_23610_length_948_cov_37","Nsylvestris_NODE_16631_length_1388_cov_174",98.182,55,1,0,894,948,872,926,3.09e-19,97.1,54,54
"68752","Ntome_NODE_23617_length_947_cov_283","Nsylvestris_NODE_1088_length_4831_cov_175",91.448,877,50,12,33,906,44,898,0,1181,873,854
"68758","Ntome_NODE_23620_length_947_cov_222","Nsylvestris_NODE_5826_length_2796_cov_168",94.573,866,40,4,89,947,1205,2070,0,1332,858,865
"68759","Ntome_NODE_23621_length_947_cov_191","Nsylvestris_NODE_16384_length_1411_cov_93",88.165,752,51,20,75,791,45,793,0,861,716,748
"68774","Ntome_NODE_23629_length_947_cov_55","Nsylvestris_NODE_19245_length_1164_cov_71",94.813,347,13,2,564,907,372,28,1.54e-151,536,343,344
"68780","Ntome_NODE_23634_length_947_cov_19","Nsylvestris_NODE_4589_length_3076_cov_73",90.359,529,42,6,72,592,71,598,0,686,520,527
"68781","Ntome_NODE_23635_length_947_cov_19","Nsylvestris_NODE_8709_length_2292_cov_184",100,55,0,0,893,947,1095,1041,6.64e-21,102,54,54
"68785","Ntome_NODE_23637_length_947_cov_15","Nsylvestris_NODE_19137_length_1172_cov_200",98.182,55,1,0,1,55,935,881,3.09e-19,97.1,54,54
"68786","Ntome_NODE_23638_length_947_cov_15","Nsylvestris_NODE_6294_length_2698_cov_179",95.396,847,38,1,1,847,1787,2632,0,1347,846,845
"68787","Ntome_NODE_23640_length_947_cov_10","Nsylvestris_NODE_5659_length_2825_cov_158",85.472,826,55,30,146,945,2137,1351,0,800,799,786
"68790","Ntome_NODE_23642_length_947_cov_9","Nsylvestris_NODE_12442_length_1822_cov_213",98.182,55,1,0,893,947,869,923,3.09e-19,97.1,54,54
"68805","Ntome_NODE_23649_length_946_cov_89","Nsylvestris_NODE_14364_length_1615_cov_25",93.885,278,10,6,581,852,1615,1339,2.7e-114,412,271,276
"68813","Ntome_NODE_23654_length_946_cov_15","Nsylvestris_NODE_18602_length_1217_cov_81",92.209,783,33,11,1,765,1095,323,0,1083,764,772
"68818","Ntome_NODE_23656_length_946_cov_10","Nsylvestris_NODE_19087_length_1176_cov_200",100,33,0,0,1,33,547,579,1.13e-08,62.1,32,32
"68827","Ntome_NODE_23661_length_945_cov_239","Nsylvestris_NODE_24318_length_811_cov_217",95.412,741,27,6,127,863,27,764,0,1173,736,737
"68830","Ntome_NODE_23663_length_945_cov_62","Nsylvestris_NODE_11772_length_1897_cov_67",89.685,349,35,1,382,730,1302,1649,9.56e-124,444,348,347
"68831","Ntome_NODE_23665_length_945_cov_34","Nsylvestris_NODE_7216_length_2531_cov_186",98.182,55,1,0,1,55,655,601,3.08e-19,97.1,54,54
"68834","Ntome_NODE_23667_length_945_cov_25","Nsylvestris_NODE_22739_length_906_cov_99",86.614,381,49,2,183,562,689,310,1.61e-116,420,379,379
"68864","Ntome_NODE_23679_length_944_cov_225","Nsylvestris_NODE_22055_length_952_cov_190",93.985,798,32,4,25,821,911,129,0,1194,796,782
"68904","Ntome_NODE_23695_length_943_cov_228","Nsylvestris_NODE_12028_length_1866_cov_79",94.707,888,37,7,1,887,138,1016,0,1371,886,878
"68920","Ntome_NODE_23701_length_943_cov_44","Nsylvestris_NODE_800_length_5246_cov_116",92.632,570,30,6,1,558,2956,2387,0,809,557,569
"68929","Ntome_NODE_23706_length_943_cov_9","Nsylvestris_NODE_6881_length_2588_cov_73",88.13,893,64,26,67,943,11,877,0,1024,876,866
"68936","Ntome_NODE_23709_length_943_cov_6","Nsylvestris_NODE_9248_length_2216_cov_30",94.247,817,44,2,2,818,1024,1837,0,1245,816,813
"68937","Ntome_NODE_23710_length_943_cov_6","Nsylvestris_NODE_228_length_7144_cov_176",93.1,884,50,5,3,875,972,89,0,1284,872,883
"68944","Ntome_NODE_23713_length_942_cov_252","Nsylvestris_NODE_2771_length_3676_cov_207",93.083,853,33,4,1,853,1554,728,0,1225,852,826
"68945","Ntome_NODE_23714_length_942_cov_235","Nsylvestris_NODE_20607_length_1057_cov_142",90.176,682,56,9,139,814,783,107,0,878,675,676
"68957","Ntome_NODE_23719_length_942_cov_66","Nsylvestris_NODE_30937_length_455_cov_28",77.22,259,38,6,557,795,194,451,8.42e-30,132,238,257
"68966","Ntome_NODE_23724_length_942_cov_19","Nsylvestris_NODE_21675_length_979_cov_71",77.296,577,104,17,290,854,713,152,7.79e-85,315,564,561
"68972","Ntome_NODE_23728_length_942_cov_7","Nsylvestris_NODE_25471_length_745_cov_189",100,32,0,0,910,941,519,488,4.03e-08,60.2,31,31
"68973","Ntome_NODE_23729_length_941_cov_301","Nsylvestris_NODE_3109_length_3540_cov_201",97.343,941,25,0,1,941,1351,411,0,1600,940,940
"68978","Ntome_NODE_23732_length_940_cov_177","Nsylvestris_NODE_19048_length_1179_cov_194",90.795,880,60,6,55,913,880,1,0,1157,858,879
"68983","Ntome_NODE_23734_length_934_cov_106","Nsylvestris_NODE_15185_length_1532_cov_97",96.429,812,27,2,79,890,48,857,0,1338,811,809
"69003","Ntome_NODE_23744_length_941_cov_9","Nsylvestris_NODE_27335_length_659_cov_7",91.438,292,22,3,1,291,515,226,7.51e-110,398,290,289
"69004","Ntome_NODE_23745_length_941_cov_8","Nsylvestris_NODE_6573_length_2648_cov_57",95.396,934,37,4,1,933,1054,126,0,1482,932,928
"69008","Ntome_NODE_23747_length_940_cov_279","Nsylvestris_NODE_1127_length_4785_cov_183",89.861,937,80,12,7,939,1659,734,0,1190,932,925
"69009","Ntome_NODE_23748_length_940_cov_222","Nsylvestris_NODE_8154_length_2379_cov_230",96.51,659,19,3,1,655,1593,2251,0,1086,654,658
"69034","Ntome_NODE_23757_length_939_cov_222","Nsylvestris_NODE_3219_length_3500_cov_131",95.592,862,23,6,1,856,2568,3420,0,1367,855,852
"69035","Ntome_NODE_23758_length_939_cov_220","Nsylvestris_NODE_17759_length_1289_cov_127",94.86,681,32,1,103,783,57,734,0,1061,680,677
"69036","Ntome_NODE_23759_length_939_cov_146","Nsylvestris_NODE_22666_length_911_cov_158",94.248,904,37,4,20,920,907,16,0,1367,900,891
"69037","Ntome_NODE_23760_length_939_cov_141","Nsylvestris_NODE_4093_length_3204_cov_152",97.959,49,1,0,891,939,865,913,6.63e-16,86.1,48,48
"69042","Ntome_NODE_23763_length_939_cov_61","Nsylvestris_NODE_12030_length_1866_cov_45",95.22,795,32,1,1,789,973,1767,0,1253,788,794
"69043","Ntome_NODE_23764_length_939_cov_44","Nsylvestris_NODE_25506_length_744_cov_6",94.519,748,27,10,1,738,1,744,0,1142,737,743
"69044","Ntome_NODE_23765_length_939_cov_38","Nsylvestris_NODE_3270_length_3483_cov_153",98.214,56,0,1,1,55,2393,2448,3.06e-19,97.1,54,55
"69045","Ntome_NODE_23766_length_939_cov_36","Nsylvestris_NODE_25424_length_748_cov_12",82.823,751,77,29,1,724,748,23,3.16e-178,625,723,725
"69061","Ntome_NODE_23773_length_937_cov_34","Nsylvestris_NODE_35428_length_285_cov_256",96.552,58,1,1,3,59,204,261,1.1e-18,95.3,56,57
"69076","Ntome_NODE_23779_length_937_cov_134","Nsylvestris_NODE_23208_length_878_cov_20",92.781,748,39,4,142,877,7,751,0,1068,735,744
"69087","Ntome_NODE_23785_length_937_cov_66","Nsylvestris_NODE_806_length_5237_cov_108",96.137,233,9,0,630,862,402,170,7.53e-105,381,232,232
"69088","Ntome_NODE_23786_length_937_cov_59","Nsylvestris_NODE_14740_length_1575_cov_216",95,40,2,0,885,924,267,228,3.1e-09,63.9,39,39
"69106","Ntome_NODE_23795_length_937_cov_10","Nsylvestris_NODE_9019_length_2249_cov_43",97.115,936,27,0,1,936,1238,2173,0,1580,935,935
"69107","Ntome_NODE_23796_length_937_cov_9","Nsylvestris_NODE_6177_length_2721_cov_92",95.819,885,28,1,62,937,902,1786,0,1421,875,884
"69154","Ntome_NODE_23814_length_936_cov_39","Nsylvestris_NODE_1109_length_4815_cov_151",95.745,329,14,0,608,936,1043,715,7.06e-150,531,328,328
"69155","Ntome_NODE_23815_length_936_cov_32","Nsylvestris_NODE_1370_length_4526_cov_234",100,55,0,0,882,936,2487,2541,6.56e-21,102,54,54
"69158","Ntome_NODE_23817_length_936_cov_21","Nsylvestris_NODE_3301_length_3472_cov_226",98.182,55,1,0,882,936,1246,1192,3.05e-19,97.1,54,54
"69159","Ntome_NODE_23818_length_936_cov_19","Nsylvestris_NODE_7811_length_2435_cov_31",94.451,811,45,0,1,811,1964,1154,0,1249,810,810
"69166","Ntome_NODE_23821_length_936_cov_11","Nsylvestris_NODE_2131_length_3973_cov_157",98.182,55,1,0,1,55,3643,3589,3.05e-19,97.1,54,54
"69167","Ntome_NODE_23823_length_936_cov_7","Nsylvestris_NODE_3615_length_3360_cov_181",85.593,118,15,2,520,636,256,372,5.04e-27,122,116,116
"69175","Ntome_NODE_23827_length_935_cov_238","Nsylvestris_NODE_15477_length_1505_cov_86",88.338,686,48,8,195,880,1352,699,0,795,685,653
"69189","Ntome_NODE_23832_length_935_cov_50","Nsylvestris_NODE_9446_length_2186_cov_122",91.278,665,39,8,43,704,1,649,0,889,661,648
"69192","Ntome_NODE_23838_length_935_cov_11","Nsylvestris_NODE_5865_length_2789_cov_229",96.364,55,2,0,1,55,1127,1181,1.42e-17,91.6,54,54
"69193","Ntome_NODE_23839_length_935_cov_11","Nsylvestris_NODE_8350_length_2348_cov_212",96.774,31,1,0,579,609,494,464,6.7e-06,52.8,30,30
"69197","Ntome_NODE_23842_length_934_cov_241","Nsylvestris_NODE_19625_length_1133_cov_164",93.14,933,44,9,18,933,1030,101,0,1351,915,929
"69201","Ntome_NODE_23844_length_934_cov_196","Nsylvestris_NODE_10730_length_2022_cov_168",91.212,899,46,15,56,934,918,33,0,1192,878,885
"69202","Ntome_NODE_23845_length_934_cov_138","Nsylvestris_NODE_550_length_5825_cov_190",96.296,54,2,0,2,55,5415,5468,5.1e-17,89.8,53,53
"69203","Ntome_NODE_23846_length_934_cov_31","Nsylvestris_NODE_22314_length_935_cov_11",89.546,947,74,16,1,934,1,935,0,1177,933,934
"69208","Ntome_NODE_23848_length_934_cov_13","Nsylvestris_NODE_14310_length_1620_cov_15",86.303,679,41,15,283,930,1076,419,0,691,647,657
"69209","Ntome_NODE_23849_length_934_cov_13","Nsylvestris_NODE_28762_length_594_cov_202",98.182,55,1,0,1,55,277,331,3.05e-19,97.1,54,54
"69217","Ntome_NODE_23853_length_933_cov_298","Nsylvestris_NODE_13941_length_1657_cov_227",95.05,808,20,11,137,933,1401,603,0,1253,796,798
"69218","Ntome_NODE_23854_length_933_cov_201","Nsylvestris_NODE_25884_length_721_cov_105",83.673,392,48,9,50,433,715,332,4.55e-97,355,383,383
"69229","Ntome_NODE_23857_length_933_cov_143","Nsylvestris_NODE_18059_length_1262_cov_52",83.784,74,10,2,613,686,266,337,6.63e-11,69.4,73,71
"69230","Ntome_NODE_23859_length_933_cov_68","Nsylvestris_NODE_26275_length_707_cov_15",93.656,662,38,4,74,735,658,1,0,987,661,657
"69251","Ntome_NODE_23867_length_933_cov_2","Nsylvestris_NODE_2199_length_3937_cov_191",94.85,932,41,6,4,933,1380,454,0,1450,929,926
"69289","Ntome_NODE_23880_length_932_cov_30","Nsylvestris_NODE_29231_length_574_cov_5",95.333,450,21,0,53,502,450,1,0,715,449,449
"69296","Ntome_NODE_23883_length_932_cov_14","Nsylvestris_NODE_1767_length_4201_cov_78",96.907,485,13,1,1,483,709,1193,0,811,482,484
"69337","Ntome_NODE_23899_length_931_cov_22","Nsylvestris_NODE_25486_length_744_cov_201",98.551,69,1,0,1,69,488,556,5.01e-27,122,68,68
"69338","Ntome_NODE_23901_length_931_cov_7","Nsylvestris_NODE_388_length_6343_cov_161",98.182,55,1,0,1,55,4958,5012,3.04e-19,97.1,54,54
"69344","Ntome_NODE_23904_length_930_cov_205","Nsylvestris_NODE_22678_length_910_cov_174",94.032,687,27,7,171,845,685,1,0,1029,674,684
"69360","Ntome_NODE_23912_length_930_cov_36","Nsylvestris_NODE_8136_length_2382_cov_147",96.237,930,24,2,1,930,869,1787,0,1513,929,918
"69371","Ntome_NODE_23918_length_929_cov_292","Nsylvestris_NODE_24649_length_791_cov_208",93.304,687,32,6,4,676,54,740,0,1002,672,686
"69391","Ntome_NODE_23926_length_929_cov_123","Nsylvestris_NODE_22589_length_916_cov_134",93.074,693,36,7,219,910,688,7,0,1003,691,681
"69402","Ntome_NODE_23930_length_929_cov_44","Nsylvestris_NODE_14632_length_1585_cov_224",100,55,0,0,1,55,1032,978,6.51e-21,102,54,54
"69411","Ntome_NODE_23934_length_929_cov_24","Nsylvestris_NODE_9331_length_2203_cov_170",100,57,0,0,1,57,791,847,5.03e-22,106,56,56
"69412","Ntome_NODE_23935_length_929_cov_18","Nsylvestris_NODE_4860_length_3005_cov_205",98.182,55,1,0,875,929,1239,1185,3.03e-19,97.1,54,54
"69413","Ntome_NODE_23938_length_929_cov_12","Nsylvestris_NODE_21100_length_1022_cov_19",85.069,864,88,27,49,887,1009,162,0,843,838,847
"69449","Ntome_NODE_23951_length_928_cov_48","Nsylvestris_NODE_14246_length_1624_cov_217",98.148,54,1,0,874,927,667,614,1.09e-18,95.3,53,53
"69455","Ntome_NODE_23954_length_928_cov_15","Nsylvestris_NODE_2989_length_3592_cov_160",90.759,909,84,0,20,928,3343,2435,0,1214,908,908
"69456","Ntome_NODE_23955_length_928_cov_12","Nsylvestris_NODE_4682_length_3050_cov_58",97.263,877,24,0,52,928,139,1015,0,1487,876,876
"69457","Ntome_NODE_23957_length_928_cov_7","Nsylvestris_NODE_4630_length_3064_cov_112",85.699,916,122,6,10,922,1265,2174,0,957,912,909
"69463","Ntome_NODE_23959_length_927_cov_265","Nsylvestris_NODE_5658_length_2825_cov_179",93.087,622,39,3,1,620,199,818,0,907,619,619
"69477","Ntome_NODE_23964_length_927_cov_215","Nsylvestris_NODE_24864_length_779_cov_189",90.116,688,34,13,100,771,779,110,0,863,671,669
"69478","Ntome_NODE_23965_length_927_cov_140","Nsylvestris_NODE_5888_length_2786_cov_221",91.615,322,22,4,46,363,2701,2381,1.21e-122,440,317,320
"69482","Ntome_NODE_23969_length_927_cov_22","Nsylvestris_NODE_1589_length_4337_cov_125",91.747,933,66,9,1,927,2053,2980,0,1286,926,927
"69501","Ntome_NODE_23980_length_926_cov_30","Nsylvestris_NODE_36223_length_268_cov_4",93.657,268,15,1,41,306,268,1,2.05e-110,399,265,267
"69502","Ntome_NODE_23981_length_926_cov_29","Nsylvestris_NODE_17642_length_1299_cov_17",89.787,235,19,3,622,851,1043,1277,2.77e-79,296,229,234
"69505","Ntome_NODE_23983_length_926_cov_24","Nsylvestris_NODE_5188_length_2929_cov_100",96.364,55,2,0,872,926,1473,1419,1.4e-17,91.6,54,54
"69506","Ntome_NODE_23984_length_926_cov_13","Nsylvestris_NODE_12404_length_1825_cov_61",95.606,842,34,3,1,842,671,1509,0,1347,841,838
"69507","Ntome_NODE_23985_length_926_cov_8","Nsylvestris_NODE_34129_length_318_cov_4",95.016,321,13,2,508,828,318,1,5.48e-141,501,320,317
"69510","Ntome_NODE_23987_length_925_cov_261","Nsylvestris_NODE_11332_length_1948_cov_141",94.545,55,2,1,1,55,1231,1284,2.35e-15,84.2,54,53
"69513","Ntome_NODE_23989_length_925_cov_224","Nsylvestris_NODE_13902_length_1662_cov_168",98.1,421,8,0,505,925,533,953,0,734,420,420
"69517","Ntome_NODE_23991_length_925_cov_123","Nsylvestris_NODE_26561_length_693_cov_53",84.496,129,17,3,49,175,682,555,1.38e-27,124,126,127
"69523","Ntome_NODE_23996_length_925_cov_21","Nsylvestris_NODE_2077_length_4007_cov_172",90.861,941,57,14,1,925,2127,1200,0,1234,924,927
"69531","Ntome_NODE_24001_length_925_cov_7","Nsylvestris_NODE_16457_length_1404_cov_29",95.264,929,40,2,1,925,1001,73,0,1469,924,928
"69534","Ntome_NODE_24004_length_924_cov_230","Nsylvestris_NODE_30165_length_512_cov_5",82.938,211,36,0,647,857,227,17,1.34e-47,191,210,210
"69537","Ntome_NODE_24006_length_924_cov_127","Nsylvestris_NODE_7486_length_2489_cov_195",93.614,830,36,13,85,901,826,1,0,1223,816,825
"69544","Ntome_NODE_24010_length_924_cov_46","Nsylvestris_NODE_35161_length_291_cov_9",88.552,297,14,7,420,702,1,291,3.5e-93,342,282,290
"69563","Ntome_NODE_24020_length_923_cov_139","Nsylvestris_NODE_21566_length_987_cov_72",86.761,846,42,20,1,810,33,844,0,878,809,811
"69564","Ntome_NODE_24023_length_923_cov_38","Nsylvestris_NODE_20190_length_1087_cov_169",91.441,888,42,11,53,923,1013,143,0,1188,870,870
"69565","Ntome_NODE_24024_length_923_cov_27","Nsylvestris_NODE_22330_length_933_cov_36",95.599,818,35,1,107,923,883,66,0,1310,816,817
"69579","Ntome_NODE_24029_length_923_cov_8","Nsylvestris_NODE_16717_length_1379_cov_189",100,55,0,0,1,55,1082,1136,6.47e-21,102,54,54
"69580","Ntome_NODE_24031_length_923_cov_8","Nsylvestris_NODE_4249_length_3163_cov_67",92.404,882,22,15,1,874,1686,842,0,1216,873,844
"69592","Ntome_NODE_24038_length_922_cov_120","Nsylvestris_NODE_22370_length_931_cov_72",87.691,853,36,30,34,834,931,96,0,929,800,835
"69598","Ntome_NODE_24041_length_922_cov_54","Nsylvestris_NODE_35650_length_281_cov_2",92.446,278,21,0,608,885,1,278,7.36e-110,398,277,277
"69622","Ntome_NODE_24047_length_922_cov_10","Nsylvestris_NODE_6449_length_2670_cov_131",96.364,55,2,0,868,922,34,88,3.89e-18,93.5,54,54
"69623","Ntome_NODE_24049_length_922_cov_7","Nsylvestris_NODE_28667_length_599_cov_4",92.766,235,17,0,433,667,311,545,1.26e-92,340,234,234
"69626","Ntome_NODE_24051_length_921_cov_255","Nsylvestris_NODE_23335_length_870_cov_215",92.407,777,37,15,149,921,759,1,0,1088,772,758
"69627","Ntome_NODE_24052_length_921_cov_241","Nsylvestris_NODE_23017_length_890_cov_75",91.862,897,54,14,6,890,890,1,0,1234,884,889
"69633","Ntome_NODE_24055_length_921_cov_175","Nsylvestris_NODE_3150_length_3527_cov_173",100,55,0,0,867,921,2829,2775,6.45e-21,102,54,54
"69634","Ntome_NODE_24056_length_921_cov_114","Nsylvestris_NODE_24069_length_827_cov_187",91.795,780,41,14,83,841,821,44,0,1064,758,777
"69635","Ntome_NODE_24057_length_921_cov_85","Nsylvestris_NODE_3687_length_3339_cov_189",98.182,55,1,0,867,921,1175,1121,3e-19,97.1,54,54
"69655","Ntome_NODE_24066_length_921_cov_9","Nsylvestris_NODE_10817_length_2012_cov_11",94.463,903,50,0,19,921,1975,1073,0,1391,902,902
"69673","Ntome_NODE_24074_length_920_cov_43","Nsylvestris_NODE_3295_length_3476_cov_65",93.701,127,8,0,191,317,2733,2607,1.34e-47,191,126,126
"69676","Ntome_NODE_24078_length_920_cov_8","Nsylvestris_NODE_6418_length_2676_cov_116",88.246,536,47,14,1,534,1941,2462,8.6e-179,627,533,521
"69680","Ntome_NODE_24080_length_919_cov_263","Nsylvestris_NODE_17262_length_1335_cov_172",95.517,870,23,3,18,872,922,54,0,1376,854,868
"69692","Ntome_NODE_24085_length_919_cov_210","Nsylvestris_NODE_13337_length_1725_cov_135",94.779,881,46,0,1,881,763,1643,0,1373,880,880
"69700","Ntome_NODE_24088_length_919_cov_78","Nsylvestris_NODE_17265_length_1335_cov_104",90.642,919,47,16,10,919,416,1304,0,1184,909,888
"69703","Ntome_NODE_24091_length_919_cov_40","Nsylvestris_NODE_6539_length_2654_cov_136",98.305,59,0,1,861,919,892,835,6.44e-21,102,58,57
"69715","Ntome_NODE_24098_length_919_cov_8","Nsylvestris_NODE_14078_length_1642_cov_125",83.951,324,47,5,449,768,1642,1320,4.57e-82,305,319,322
"69735","Ntome_NODE_24107_length_918_cov_19","Nsylvestris_NODE_21541_length_989_cov_16",95.448,725,18,5,186,904,274,989,0,1142,718,715
"69738","Ntome_NODE_24110_length_918_cov_7","Nsylvestris_NODE_8841_length_2273_cov_230",98.182,55,1,0,864,918,1536,1590,2.99e-19,97.1,54,54
"69742","Ntome_NODE_24112_length_918_cov_4","Nsylvestris_NODE_17486_length_1314_cov_227",100,53,0,0,3,55,771,719,8.32e-20,99,52,52
"69746","Ntome_NODE_24114_length_917_cov_262","Nsylvestris_NODE_23445_length_863_cov_205",91.117,788,33,10,47,802,791,9,0,1033,755,782
"69747","Ntome_NODE_24115_length_917_cov_221","Nsylvestris_NODE_26552_length_693_cov_216",91.171,555,29,11,298,849,588,51,0,736,551,537
"69748","Ntome_NODE_24117_length_917_cov_214","Nsylvestris_NODE_29594_length_559_cov_202",95.043,464,20,1,46,509,508,48,0,726,463,460
"69759","Ntome_NODE_24123_length_917_cov_24","Nsylvestris_NODE_10368_length_2066_cov_219",100,55,0,0,1,55,474,420,6.42e-21,102,54,54
"69765","Ntome_NODE_24126_length_917_cov_18","Nsylvestris_NODE_23522_length_858_cov_43",90.909,110,10,0,753,862,4,113,8.14e-35,148,109,109
"69768","Ntome_NODE_24128_length_917_cov_15","Nsylvestris_NODE_19845_length_1114_cov_99",96.14,855,33,0,63,917,1069,215,0,1397,854,854
"69771","Ntome_NODE_24130_length_917_cov_11","Nsylvestris_NODE_32688_length_364_cov_4",94.231,364,20,1,66,428,1,364,4.1e-157,555,362,363
"69806","Ntome_NODE_24149_length_916_cov_8","Nsylvestris_NODE_15864_length_1463_cov_10",96.07,916,36,0,1,916,1002,87,0,1493,915,915
"69819","Ntome_NODE_24155_length_915_cov_169","Nsylvestris_NODE_10795_length_2014_cov_175",87.174,499,41,5,440,915,200,698,2.46e-154,545,475,498
"69822","Ntome_NODE_24157_length_915_cov_159","Nsylvestris_NODE_31235_length_436_cov_160",91.317,334,16,7,1,324,17,347,9.25e-124,444,323,330
"69823","Ntome_NODE_24158_length_915_cov_127","Nsylvestris_NODE_1631_length_4308_cov_119",91.373,255,21,1,347,601,712,965,7.46e-95,348,254,253
"69829","Ntome_NODE_24161_length_915_cov_22","Nsylvestris_NODE_31406_length_425_cov_5",93.882,425,26,0,363,787,1,425,0,641,424,424
"69839","Ntome_NODE_24165_length_915_cov_9","Nsylvestris_NODE_23086_length_886_cov_13",97.579,826,20,0,1,826,826,1,0,1415,825,825
"69858","Ntome_NODE_24173_length_914_cov_141","Nsylvestris_NODE_24800_length_783_cov_109",93.951,777,45,2,11,785,783,7,0,1173,774,776
"69859","Ntome_NODE_24174_length_914_cov_110","Nsylvestris_NODE_22885_length_898_cov_41",84.012,688,70,24,169,824,696,17,3.07e-178,625,655,679
"69871","Ntome_NODE_24179_length_914_cov_20","Nsylvestris_NODE_8570_length_2314_cov_42",100,55,0,0,860,914,670,616,6.4e-21,102,54,54
"69911","Ntome_NODE_24200_length_913_cov_7","Nsylvestris_NODE_9003_length_2250_cov_200",100,55,0,0,1,55,1499,1445,6.4e-21,102,54,54
"69934","Ntome_NODE_24212_length_912_cov_7","Nsylvestris_NODE_2479_length_3806_cov_22",95.362,884,41,0,29,912,1,884,0,1406,883,883
"69951","Ntome_NODE_24220_length_911_cov_223","Nsylvestris_NODE_25595_length_739_cov_161",90.449,691,42,8,4,691,28,697,0,889,687,669
"69965","Ntome_NODE_24227_length_911_cov_22","Nsylvestris_NODE_15982_length_1451_cov_15",90.811,838,33,10,1,830,650,1451,0,1081,829,801
"69970","Ntome_NODE_24231_length_910_cov_258","Nsylvestris_NODE_9114_length_2234_cov_211",94.425,861,45,2,1,860,1372,2230,0,1321,859,858
"69976","Ntome_NODE_24234_length_910_cov_239","Nsylvestris_NODE_335_length_6535_cov_63",80.162,247,46,3,535,780,640,396,7.96e-45,182,245,244
"69995","Ntome_NODE_24242_length_910_cov_33","Nsylvestris_NODE_6360_length_2686_cov_119",98.182,55,1,0,856,910,1552,1498,2.97e-19,97.1,54,54
"70002","Ntome_NODE_24246_length_910_cov_5","Nsylvestris_NODE_19038_length_1180_cov_215",94.545,55,3,0,1,55,851,797,6.42e-16,86.1,54,54
"70003","Ntome_NODE_24248_length_909_cov_287","Nsylvestris_NODE_8836_length_2274_cov_161",95,560,16,3,132,691,77,624,0,869,559,547
"70004","Ntome_NODE_24249_length_909_cov_264","Nsylvestris_NODE_12815_length_1785_cov_51",95.214,794,38,0,116,909,28,821,0,1256,793,793
"70005","Ntome_NODE_24250_length_909_cov_256","Nsylvestris_NODE_23257_length_875_cov_200",92.857,700,35,8,87,781,139,828,0,1002,694,689
"70011","Ntome_NODE_24253_length_909_cov_143","Nsylvestris_NODE_11011_length_1986_cov_187",90.976,410,28,7,313,720,1,403,8.8e-154,544,407,402
"70019","Ntome_NODE_24256_length_909_cov_41","Nsylvestris_NODE_19599_length_1135_cov_44",93.766,786,34,9,53,823,299,1084,0,1166,770,785
"70034","Ntome_NODE_24263_length_909_cov_5","Nsylvestris_NODE_10044_length_2111_cov_8",92.967,910,63,1,1,909,854,1763,0,1325,908,909
"70038","Ntome_NODE_24265_length_908_cov_296","Nsylvestris_NODE_23378_length_867_cov_209",92.058,831,35,10,84,900,818,5,0,1140,816,813
"70043","Ntome_NODE_24268_length_908_cov_171","Nsylvestris_NODE_24793_length_784_cov_4",91.338,785,46,12,60,824,783,1,0,1053,764,782
"70044","Ntome_NODE_24269_length_908_cov_157","Nsylvestris_NODE_8359_length_2347_cov_112",85.68,419,51,7,1,415,1476,1889,1.99e-120,433,414,413
"70045","Ntome_NODE_24270_length_908_cov_147","Nsylvestris_NODE_1031_length_4896_cov_213",100,55,0,0,854,908,3715,3769,6.36e-21,102,54,54
"70055","Ntome_NODE_24275_length_908_cov_15","Nsylvestris_NODE_6292_length_2698_cov_12",93.619,909,31,10,1,908,1154,2036,0,1332,907,882
"70086","Ntome_NODE_24286_length_907_cov_57","Nsylvestris_NODE_25258_length_757_cov_37",91.806,720,41,12,129,837,713,1,0,987,708,712
"70087","Ntome_NODE_24287_length_907_cov_49","Nsylvestris_NODE_14475_length_1603_cov_14",84.349,607,87,8,191,793,102,704,4e-167,588,602,602
"70095","Ntome_NODE_24291_length_907_cov_23","Nsylvestris_NODE_16812_length_1371_cov_204",98.182,55,1,0,853,907,630,576,2.96e-19,97.1,54,54
"70104","Ntome_NODE_24297_length_907_cov_7","Nsylvestris_NODE_15392_length_1514_cov_10",92.849,909,61,3,1,907,1514,608,0,1315,906,906
"70119","Ntome_NODE_24304_length_906_cov_13","Nsylvestris_NODE_8537_length_2320_cov_53",91.125,800,60,4,1,800,1478,2266,0,1074,799,788
"70131","Ntome_NODE_24308_length_905_cov_71","Nsylvestris_NODE_22258_length_938_cov_206",82.173,589,98,5,100,685,174,758,1.93e-140,499,585,584
"70135","Ntome_NODE_24310_length_905_cov_30","Nsylvestris_NODE_28000_length_629_cov_10",89.418,567,31,7,257,821,629,90,0,688,564,539
"70141","Ntome_NODE_24314_length_905_cov_11","Nsylvestris_NODE_1894_length_4121_cov_138",100,55,0,0,851,905,831,777,6.35e-21,102,54,54
"70142","Ntome_NODE_24315_length_905_cov_8","Nsylvestris_NODE_1919_length_4101_cov_107",98.182,55,1,0,1,55,3365,3419,2.95e-19,97.1,54,54
"70143","Ntome_NODE_24316_length_905_cov_5","Nsylvestris_NODE_2714_length_3698_cov_83",94.545,55,3,0,1,55,2954,2900,6.39e-16,86.1,54,54
"70152","Ntome_NODE_24320_length_904_cov_271","Nsylvestris_NODE_891_length_5098_cov_157",94.267,907,49,1,1,904,2912,3818,0,1384,903,906
"70156","Ntome_NODE_24322_length_904_cov_207","Nsylvestris_NODE_24375_length_808_cov_176",94.351,655,28,4,203,849,737,84,0,996,646,653
"70169","Ntome_NODE_24330_length_904_cov_25","Nsylvestris_NODE_430_length_6172_cov_226",98.182,55,1,0,850,904,4330,4384,2.95e-19,97.1,54,54
"70172","Ntome_NODE_24332_length_904_cov_16","Nsylvestris_NODE_2444_length_3820_cov_223",98.182,55,1,0,850,904,2680,2734,2.95e-19,97.1,54,54
"70173","Ntome_NODE_24333_length_904_cov_15","Nsylvestris_NODE_3349_length_3456_cov_52",100,31,0,0,789,819,1435,1405,1.39e-07,58.4,30,30
"70174","Ntome_NODE_24336_length_904_cov_12","Nsylvestris_NODE_1990_length_4062_cov_125",90.968,919,65,4,1,904,1268,2183,0,1221,903,915
"70180","Ntome_NODE_24339_length_904_cov_9","Nsylvestris_NODE_3052_length_3567_cov_156",100,55,0,0,1,55,3210,3156,6.34e-21,102,54,54
"70183","Ntome_NODE_24341_length_904_cov_7","Nsylvestris_NODE_11262_length_1955_cov_223",98.182,55,1,0,1,55,599,545,2.95e-19,97.1,54,54
"70184","Ntome_NODE_24342_length_904_cov_6","Nsylvestris_NODE_586_length_5739_cov_225",100,55,0,0,850,904,4905,4959,6.34e-21,102,54,54
"70192","Ntome_NODE_24345_length_903_cov_226","Nsylvestris_NODE_23323_length_871_cov_190",93.814,776,33,10,83,847,822,51,0,1153,764,771
"70199","Ntome_NODE_24348_length_903_cov_97","Nsylvestris_NODE_6935_length_2579_cov_223",95.161,62,2,1,842,903,798,858,2.95e-19,97.1,61,60
"70204","Ntome_NODE_24352_length_903_cov_10","Nsylvestris_NODE_18516_length_1223_cov_35",89.369,903,57,8,1,900,94,960,0,1099,899,866
"70207","Ntome_NODE_24354_length_903_cov_10","Nsylvestris_NODE_574_length_5764_cov_237",100,55,0,0,1,55,950,896,6.33e-21,102,54,54
"70211","Ntome_NODE_24360_length_902_cov_263","Nsylvestris_NODE_18183_length_1251_cov_221",94.495,763,29,5,1,758,814,60,0,1164,757,754
"70255","Ntome_NODE_24379_length_901_cov_17","Nsylvestris_NODE_3162_length_3522_cov_228",96.364,55,2,0,1,55,3092,3146,1.37e-17,91.6,54,54
"70256","Ntome_NODE_24380_length_900_cov_316","Nsylvestris_NODE_3556_length_3380_cov_195",97,900,27,0,1,900,3036,2137,0,1513,899,899
"70257","Ntome_NODE_24381_length_900_cov_158","Nsylvestris_NODE_10220_length_2086_cov_122",89.932,884,45,20,1,848,1663,788,0,1099,847,875
"70258","Ntome_NODE_24382_length_900_cov_116","Nsylvestris_NODE_11465_length_1934_cov_188",93.601,672,20,6,1,662,974,316,0,981,661,658
"70267","Ntome_NODE_24388_length_900_cov_25","Nsylvestris_NODE_21634_length_982_cov_47",92.68,888,57,4,20,900,939,53,0,1273,880,886
"70268","Ntome_NODE_24389_length_900_cov_11","Nsylvestris_NODE_7967_length_2410_cov_235",98.182,55,1,0,1,55,886,832,2.94e-19,97.1,54,54
"70271","Ntome_NODE_24391_length_900_cov_7","Nsylvestris_NODE_13193_length_1739_cov_223",92.308,143,8,1,1,140,986,844,2.18e-50,200,139,142
"70276","Ntome_NODE_24393_length_899_cov_269","Nsylvestris_NODE_5684_length_2822_cov_82",96.009,852,19,5,1,839,59,908,0,1371,838,849
"70283","Ntome_NODE_24396_length_899_cov_99","Nsylvestris_NODE_23819_length_842_cov_65",90.943,806,34,19,1,782,791,1,0,1048,781,790
"70297","Ntome_NODE_24408_length_898_cov_319","Nsylvestris_NODE_4596_length_3075_cov_216",92.094,898,71,0,1,898,1571,2468,0,1266,897,897
"70309","Ntome_NODE_24415_length_898_cov_12","Nsylvestris_NODE_8065_length_2392_cov_147",95.57,903,29,5,1,898,627,1523,0,1435,897,896
"70325","Ntome_NODE_24421_length_897_cov_244","Nsylvestris_NODE_4720_length_3040_cov_107",93.402,773,28,11,96,862,3,758,0,1123,766,755
"70326","Ntome_NODE_24422_length_897_cov_218","Nsylvestris_NODE_28860_length_589_cov_179",92.115,520,27,3,348,853,589,70,0,721,505,519
"70330","Ntome_NODE_24424_length_897_cov_197","Nsylvestris_NODE_27556_length_648_cov_212",86.774,620,42,19,288,869,644,27,0,654,581,617
"70336","Ntome_NODE_24427_length_897_cov_78","Nsylvestris_NODE_4580_length_3078_cov_215",98.182,55,1,0,843,897,563,617,2.93e-19,97.1,54,54
"70354","Ntome_NODE_24438_length_896_cov_287","Nsylvestris_NODE_15030_length_1547_cov_228",91.531,862,31,10,68,896,7,859,0,1149,828,852
"70361","Ntome_NODE_24441_length_896_cov_212","Nsylvestris_NODE_17604_length_1302_cov_206",95.764,897,32,4,1,896,103,994,0,1441,895,891
"70364","Ntome_NODE_24443_length_896_cov_147","Nsylvestris_NODE_23464_length_862_cov_107",88.876,845,42,20,10,840,13,819,0,992,830,806
"70365","Ntome_NODE_24444_length_896_cov_132","Nsylvestris_NODE_3473_length_3409_cov_212",92.403,566,42,1,306,871,3358,2794,0,806,565,564
"70383","Ntome_NODE_24451_length_896_cov_14","Nsylvestris_NODE_4184_length_3180_cov_217",92.857,70,3,2,829,896,1596,1665,2.26e-20,100,67,69
"70387","Ntome_NODE_24453_length_896_cov_5","Nsylvestris_NODE_13941_length_1657_cov_227",100,53,0,0,3,55,655,603,8.13e-20,99,52,52
"70388","Ntome_NODE_24454_length_895_cov_273","Nsylvestris_NODE_15123_length_1537_cov_182",95.367,626,29,0,1,626,674,49,0,996,625,625
"70389","Ntome_NODE_24456_length_895_cov_261","Nsylvestris_NODE_12992_length_1764_cov_198",93.308,792,35,5,1,774,861,70,0,1153,773,791
"70390","Ntome_NODE_24457_length_895_cov_231","Nsylvestris_NODE_7063_length_2560_cov_127",88.415,751,57,15,12,753,1683,954,0,878,741,729
"70391","Ntome_NODE_24458_length_895_cov_199","Nsylvestris_NODE_8556_length_2316_cov_73",94.507,892,20,8,1,892,1412,2274,0,1349,891,862
"70392","Ntome_NODE_24459_length_895_cov_166","Nsylvestris_NODE_24168_length_821_cov_224",88.957,815,54,22,64,867,790,1,0,974,803,789
"70393","Ntome_NODE_24460_length_895_cov_124","Nsylvestris_NODE_20114_length_1093_cov_31",94.013,618,21,8,33,635,1,617,0,922,602,616
"70397","Ntome_NODE_24462_length_895_cov_7","Nsylvestris_NODE_13992_length_1650_cov_174",81.707,82,13,2,307,388,610,531,2.29e-10,67.6,81,79
"70413","Ntome_NODE_24469_length_894_cov_21","Nsylvestris_NODE_822_length_5208_cov_194",98.182,55,1,0,840,894,464,518,2.92e-19,97.1,54,54
"70422","Ntome_NODE_24473_length_894_cov_12","Nsylvestris_NODE_13772_length_1676_cov_212",98.182,55,1,0,1,55,943,997,2.92e-19,97.1,54,54
"70425","Ntome_NODE_24476_length_894_cov_6","Nsylvestris_NODE_14907_length_1559_cov_196",100,51,0,0,1,51,851,801,1.05e-18,95.3,50,50
"70426","Ntome_NODE_24477_length_893_cov_323","Nsylvestris_NODE_461_length_6060_cov_199",96.004,901,26,5,1,893,2734,3632,0,1456,892,898
"70427","Ntome_NODE_24478_length_893_cov_318","Nsylvestris_NODE_8405_length_2339_cov_199",93.82,890,55,0,4,893,1855,966,0,1339,889,889
"70431","Ntome_NODE_24480_length_893_cov_260","Nsylvestris_NODE_12906_length_1774_cov_144",93.279,491,24,7,381,870,1292,1774,0,715,489,482
"70461","Ntome_NODE_24490_length_893_cov_84","Nsylvestris_NODE_129_length_8056_cov_38",86.598,194,23,3,687,879,827,1018,9.97e-54,211,192,191
"70473","Ntome_NODE_24497_length_893_cov_8","Nsylvestris_NODE_31289_length_433_cov_4",84.365,307,37,7,579,883,134,431,1.25e-77,291,304,297
"70481","Ntome_NODE_24501_length_892_cov_256","Nsylvestris_NODE_6426_length_2673_cov_208",95.878,655,27,0,1,655,1736,1082,0,1061,654,654
"70499","Ntome_NODE_24511_length_891_cov_284","Nsylvestris_NODE_23947_length_835_cov_201",94.381,783,27,9,8,780,20,795,0,1186,772,775
"70500","Ntome_NODE_24512_length_891_cov_269","Nsylvestris_NODE_17414_length_1321_cov_210",90.221,859,35,20,59,891,39,874,0,1075,832,835
"70501","Ntome_NODE_24513_length_891_cov_194","Nsylvestris_NODE_20279_length_1079_cov_187",96.203,790,26,2,50,839,820,35,0,1290,789,785
"70513","Ntome_NODE_24518_length_891_cov_33","Nsylvestris_NODE_1579_length_4344_cov_226",98.276,58,1,0,834,891,3046,3103,6.25e-21,102,57,57
"70514","Ntome_NODE_24519_length_891_cov_29","Nsylvestris_NODE_12067_length_1861_cov_209",100,55,0,0,837,891,969,1023,6.25e-21,102,54,54
"70523","Ntome_NODE_24524_length_890_cov_272","Nsylvestris_NODE_15445_length_1507_cov_218",96.644,864,23,2,33,890,1,864,0,1430,857,863
"70534","Ntome_NODE_24528_length_890_cov_206","Nsylvestris_NODE_21332_length_1004_cov_124",96.099,769,24,3,124,890,90,854,0,1249,766,764
"70552","Ntome_NODE_24536_length_890_cov_8","Nsylvestris_NODE_21625_length_983_cov_28",94.111,849,49,1,36,883,849,1,0,1290,847,848
"70553","Ntome_NODE_24537_length_890_cov_8","Nsylvestris_NODE_21022_length_1026_cov_206",98.039,51,1,0,5,55,427,377,4.86e-17,89.8,50,50
"70560","Ntome_NODE_24540_length_889_cov_161","Nsylvestris_NODE_26818_length_682_cov_42",90.625,448,30,8,422,865,636,197,5.08e-166,584,443,439
"70569","Ntome_NODE_24544_length_889_cov_79","Nsylvestris_NODE_3894_length_3270_cov_145",79.335,571,78,16,284,850,2357,2891,7.2e-100,364,566,534
"70586","Ntome_NODE_24552_length_889_cov_13","Nsylvestris_NODE_3155_length_3525_cov_59",90.123,891,78,10,1,889,886,4,0,1149,888,882
"70593","Ntome_NODE_24555_length_889_cov_9","Nsylvestris_NODE_441_length_6140_cov_71",86.181,919,96,15,1,888,1514,2432,0,965,887,918
"70605","Ntome_NODE_24561_length_888_cov_163","Nsylvestris_NODE_29393_length_567_cov_159",96.226,53,2,0,836,888,426,374,1.74e-16,87.9,52,52
"70606","Ntome_NODE_24562_length_888_cov_85","Nsylvestris_NODE_724_length_5405_cov_32",77.02,557,115,13,54,604,2129,2678,1.23e-82,307,550,549
"70613","Ntome_NODE_24565_length_888_cov_25","Nsylvestris_NODE_5667_length_2824_cov_46",94.737,76,4,0,527,602,2607,2532,6.18e-26,119,75,75
"70629","Ntome_NODE_24575_length_887_cov_280","Nsylvestris_NODE_24854_length_780_cov_159",92.478,678,33,10,156,830,695,33,0,953,674,662
"70630","Ntome_NODE_24576_length_887_cov_256","Nsylvestris_NODE_21879_length_963_cov_199",91.892,888,39,21,1,860,945,63,0,1210,859,882
"70634","Ntome_NODE_24578_length_887_cov_204","Nsylvestris_NODE_33741_length_329_cov_51",97.403,231,6,0,76,306,274,44,9.16e-109,394,230,230
"70662","Ntome_NODE_24591_length_887_cov_5","Nsylvestris_NODE_31132_length_443_cov_4",95.937,443,18,0,97,539,443,1,0,719,442,442
"70674","Ntome_NODE_24595_length_886_cov_67","Nsylvestris_NODE_4417_length_3118_cov_194",97.5,40,1,0,1,40,1721,1760,6.3e-11,69.4,39,39
"70678","Ntome_NODE_24599_length_886_cov_11","Nsylvestris_NODE_2245_length_3915_cov_181",100,55,0,0,1,55,3350,3296,6.21e-21,102,54,54
"70681","Ntome_NODE_24601_length_886_cov_8","Nsylvestris_NODE_1897_length_4117_cov_95",83.741,695,78,22,1,670,3023,2339,2.98e-178,625,669,684
"70685","Ntome_NODE_24603_length_885_cov_262","Nsylvestris_NODE_1193_length_4708_cov_104",95.833,720,21,6,46,761,3851,4565,0,1155,715,714
"70691","Ntome_NODE_24606_length_885_cov_220","Nsylvestris_NODE_89_length_8609_cov_78",91.403,442,20,7,1,427,5284,5722,1.09e-167,590,426,438
"70695","Ntome_NODE_24608_length_885_cov_158","Nsylvestris_NODE_713_length_5408_cov_40",94.095,525,13,3,330,836,4748,5272,0,782,506,524
"70696","Ntome_NODE_24609_length_885_cov_113","Nsylvestris_NODE_19603_length_1135_cov_14",81.27,315,45,3,225,527,791,479,3.5e-63,243,302,312
"70711","Ntome_NODE_24619_length_885_cov_8","Nsylvestris_NODE_31052_length_448_cov_5",92.692,260,16,3,573,830,37,295,4.28e-102,372,257,258
"70718","Ntome_NODE_24623_length_884_cov_310","Nsylvestris_NODE_1560_length_4354_cov_201",95.773,899,23,1,1,884,2620,3518,0,1435,883,898
"70730","Ntome_NODE_24628_length_884_cov_136","Nsylvestris_NODE_30508_length_485_cov_78",91.753,485,23,4,411,878,485,1,0,658,467,484
"70738","Ntome_NODE_24637_length_884_cov_29","Nsylvestris_NODE_16683_length_1382_cov_202",80.837,908,110,27,1,883,356,1224,0,654,882,868
"70739","Ntome_NODE_24638_length_885_cov_11","Nsylvestris_NODE_32750_length_362_cov_2",92.077,366,24,4,139,503,1,362,8.7e-144,510,364,361
"70745","Ntome_NODE_24642_length_884_cov_7","Nsylvestris_NODE_22198_length_942_cov_54",95.597,863,34,4,25,884,903,42,0,1380,859,861
"70757","Ntome_NODE_24647_length_883_cov_167","Nsylvestris_NODE_4686_length_3045_cov_159",95.257,506,24,0,378,883,2372,2877,0,802,505,505
"70768","Ntome_NODE_24651_length_883_cov_97","Nsylvestris_NODE_18430_length_1229_cov_217",100,55,0,0,829,883,853,907,6.19e-21,102,54,54
"70769","Ntome_NODE_24652_length_883_cov_70","Nsylvestris_NODE_17008_length_1357_cov_55",93.383,801,51,2,53,852,800,1,0,1184,799,799
"70780","Ntome_NODE_24656_length_883_cov_19","Nsylvestris_NODE_10356_length_2068_cov_190",100,55,0,0,1,55,946,892,6.19e-21,102,54,54
"70785","Ntome_NODE_24661_length_882_cov_294","Nsylvestris_NODE_13926_length_1659_cov_197",93.026,717,39,6,171,882,1336,626,0,1037,711,710
"70796","Ntome_NODE_24665_length_882_cov_249","Nsylvestris_NODE_25255_length_757_cov_80",89.143,350,22,9,541,877,320,666,4.18e-117,422,336,346
"70802","Ntome_NODE_24669_length_882_cov_153","Nsylvestris_NODE_25474_length_745_cov_133",92.047,679,30,13,159,825,12,678,0,933,666,666
"70815","Ntome_NODE_24675_length_882_cov_14","Nsylvestris_NODE_5873_length_2789_cov_39",93.408,895,39,9,3,881,36,926,0,1308,878,890
"70819","Ntome_NODE_24677_length_882_cov_9","Nsylvestris_NODE_2538_length_3776_cov_43",97.902,858,18,0,25,882,2728,1871,0,1485,857,857
"70820","Ntome_NODE_24678_length_882_cov_5","Nsylvestris_NODE_11516_length_1928_cov_224",96.825,63,1,1,820,882,832,893,1.72e-21,104,62,61
"70821","Ntome_NODE_24679_length_881_cov_294","Nsylvestris_NODE_15398_length_1512_cov_214",97.506,882,21,1,1,881,882,1,0,1506,880,881
"70835","Ntome_NODE_24685_length_881_cov_222","Nsylvestris_NODE_22164_length_944_cov_179",95.626,823,21,6,4,825,851,43,0,1306,821,808
"70860","Ntome_NODE_24697_length_881_cov_6","Nsylvestris_NODE_1452_length_4447_cov_220",98.077,52,1,0,4,55,1679,1628,1.34e-17,91.6,51,51
"70868","Ntome_NODE_24702_length_880_cov_163","Nsylvestris_NODE_27139_length_667_cov_171",94.676,601,24,6,281,880,617,24,0,926,599,593
"70874","Ntome_NODE_24705_length_880_cov_37","Nsylvestris_NODE_2084_length_4003_cov_207",86.882,930,60,15,1,880,2591,1674,0,985,879,917
"70884","Ntome_NODE_24709_length_880_cov_13","Nsylvestris_NODE_16175_length_1432_cov_73",93.548,62,3,1,1,61,505,566,1.34e-17,91.6,60,61
"70885","Ntome_NODE_24710_length_880_cov_10","Nsylvestris_NODE_14343_length_1615_cov_201",100,55,0,0,826,880,455,401,6.17e-21,102,54,54
"70886","Ntome_NODE_24711_length_880_cov_9","Nsylvestris_NODE_677_length_5498_cov_139",93.774,787,34,6,1,772,3728,2942,0,1168,771,786
"70887","Ntome_NODE_24712_length_880_cov_8","Nsylvestris_NODE_67_length_9106_cov_194",84.004,894,122,13,1,880,3589,2703,0,839,879,886
"70894","Ntome_NODE_24716_length_879_cov_176","Nsylvestris_NODE_24404_length_806_cov_179",93.602,719,24,11,27,736,56,761,0,1053,709,705
"70895","Ntome_NODE_24717_length_879_cov_171","Nsylvestris_NODE_5753_length_2810_cov_78",95.402,87,3,1,487,572,235,321,1.69e-31,137,85,86
"70913","Ntome_NODE_24726_length_878_cov_107","Nsylvestris_NODE_18560_length_1219_cov_173",94.759,725,38,0,113,837,240,964,0,1129,724,724
"70918","Ntome_NODE_24729_length_878_cov_83","Nsylvestris_NODE_20264_length_1081_cov_193",91.319,887,41,13,2,878,1001,141,0,1179,876,860
"70937","Ntome_NODE_24736_length_878_cov_15","Nsylvestris_NODE_213_length_7267_cov_92",92.727,55,4,0,824,878,6400,6454,2.88e-14,80.5,54,54
"70938","Ntome_NODE_24737_length_878_cov_10","Nsylvestris_NODE_7574_length_2473_cov_152",94.144,905,22,11,1,878,431,1331,0,1349,877,900
"70942","Ntome_NODE_24740_length_877_cov_219","Nsylvestris_NODE_21474_length_993_cov_174",90.995,744,54,8,49,784,778,40,0,990,735,738
"70953","Ntome_NODE_24745_length_877_cov_42","Nsylvestris_NODE_9976_length_2119_cov_16",87.557,876,71,8,1,875,368,1206,0,979,874,838
"70986","Ntome_NODE_24760_length_876_cov_252","Nsylvestris_NODE_16894_length_1365_cov_176",95.802,667,19,1,1,667,771,114,0,1068,666,657
"70997","Ntome_NODE_24764_length_876_cov_222","Nsylvestris_NODE_27320_length_660_cov_189",94.921,630,18,3,223,849,619,1,0,974,626,618
"70998","Ntome_NODE_24765_length_876_cov_193","Nsylvestris_NODE_19406_length_1151_cov_221",96.364,55,2,0,1,55,789,735,1.33e-17,91.6,54,54
"70999","Ntome_NODE_24767_length_876_cov_152","Nsylvestris_NODE_8117_length_2385_cov_86",96.257,668,24,1,1,667,2300,1633,0,1094,666,667
"71043","Ntome_NODE_24786_length_875_cov_44","Nsylvestris_NODE_6333_length_2692_cov_161",88.571,70,4,1,1,66,788,857,7.99e-15,82.4,65,69
"71050","Ntome_NODE_24790_length_874_cov_28","Nsylvestris_NODE_17716_length_1293_cov_39",94.286,70,4,0,698,767,680,611,1.32e-22,108,69,69
"71062","Ntome_NODE_24795_length_875_cov_10","Nsylvestris_NODE_9247_length_2216_cov_39",94.976,836,30,7,1,831,1,829,0,1301,830,828
"71065","Ntome_NODE_24797_length_875_cov_8","Nsylvestris_NODE_275_length_6832_cov_69",86.889,900,80,19,1,875,5654,4768,0,974,874,886
"71075","Ntome_NODE_24802_length_874_cov_89","Nsylvestris_NODE_16426_length_1406_cov_148",87.108,892,69,16,1,874,286,1149,0,968,873,863
"71078","Ntome_NODE_24804_length_874_cov_70","Nsylvestris_NODE_304_length_6709_cov_224",96.494,770,23,2,1,766,106,875,0,1269,765,769
"71079","Ntome_NODE_24805_length_874_cov_68","Nsylvestris_NODE_30261_length_505_cov_11",90.303,165,16,0,168,332,505,341,2.1e-55,217,164,164
"71088","Ntome_NODE_24810_length_874_cov_23","Nsylvestris_NODE_783_length_5263_cov_121",98.182,55,1,0,1,55,745,799,2.85e-19,97.1,54,54
"71108","Ntome_NODE_24818_length_873_cov_212","Nsylvestris_NODE_23672_length_850_cov_69",91.888,715,31,14,129,839,694,3,0,974,710,691
"71109","Ntome_NODE_24819_length_873_cov_201","Nsylvestris_NODE_3933_length_3257_cov_191",98.182,55,1,0,819,873,608,554,2.85e-19,97.1,54,54
"71110","Ntome_NODE_24820_length_873_cov_121","Nsylvestris_NODE_21735_length_975_cov_51",78.289,152,25,5,491,635,36,186,1.32e-17,91.6,144,150
"71117","Ntome_NODE_24823_length_873_cov_67","Nsylvestris_NODE_12453_length_1821_cov_157",100,55,0,0,819,873,1372,1318,6.12e-21,102,54,54
"71120","Ntome_NODE_24826_length_873_cov_25","Nsylvestris_NODE_3909_length_3265_cov_105",100,55,0,0,819,873,2058,2112,6.12e-21,102,54,54
"71123","Ntome_NODE_24828_length_873_cov_15","Nsylvestris_NODE_20494_length_1065_cov_22",71.821,582,147,15,199,770,972,398,2.15e-35,150,571,574
"71124","Ntome_NODE_24829_length_873_cov_14","Nsylvestris_NODE_4409_length_3122_cov_20",96.998,866,26,0,4,869,2022,1157,0,1456,865,865
"71125","Ntome_NODE_24830_length_873_cov_11","Nsylvestris_NODE_2967_length_3599_cov_46",86.059,373,37,5,516,873,3380,3008,1.51e-106,387,357,372
"71130","Ntome_NODE_24832_length_873_cov_8","Nsylvestris_NODE_23176_length_880_cov_46",93.443,854,42,5,1,854,41,880,0,1254,853,839
"71150","Ntome_NODE_24844_length_872_cov_24","Nsylvestris_NODE_12855_length_1780_cov_222",98.182,55,1,0,818,872,502,448,2.84e-19,97.1,54,54
"71159","Ntome_NODE_24849_length_871_cov_8","Nsylvestris_NODE_4377_length_3132_cov_114",98.182,55,1,0,817,871,844,790,2.84e-19,97.1,54,54
"71160","Ntome_NODE_24851_length_872_cov_6","Nsylvestris_NODE_10215_length_2087_cov_15",89.041,146,13,2,206,351,1877,1735,9.87e-44,178,145,142
"71164","Ntome_NODE_24853_length_871_cov_224","Nsylvestris_NODE_23817_length_842_cov_91",87.427,684,36,17,162,841,168,805,0,741,679,637
"71165","Ntome_NODE_24854_length_871_cov_188","Nsylvestris_NODE_26123_length_713_cov_28",94.052,538,30,2,130,666,13,549,0,815,536,536
"71170","Ntome_NODE_24856_length_871_cov_87","Nsylvestris_NODE_4008_length_3231_cov_164",100,55,0,0,1,55,726,780,6.1e-21,102,54,54
"71178","Ntome_NODE_24860_length_871_cov_41","Nsylvestris_NODE_14315_length_1619_cov_170",96.364,55,2,0,1,55,1049,995,1.32e-17,91.6,54,54
"71179","Ntome_NODE_24861_length_871_cov_22","Nsylvestris_NODE_923_length_5059_cov_127",84.071,226,32,4,649,871,3417,3193,7.51e-55,215,222,224
"71198","Ntome_NODE_24869_length_871_cov_7","Nsylvestris_NODE_2976_length_3596_cov_216",98.182,55,1,0,817,871,2712,2766,2.84e-19,97.1,54,54
"71199","Ntome_NODE_24870_length_871_cov_5","Nsylvestris_NODE_18179_length_1252_cov_102",95.519,848,31,4,4,846,950,105,0,1349,842,845
"71200","Ntome_NODE_24872_length_870_cov_305","Nsylvestris_NODE_3337_length_3460_cov_237",97.586,870,21,0,1,870,1835,2704,0,1491,869,869
"71212","Ntome_NODE_24876_length_870_cov_232","Nsylvestris_NODE_2002_length_4055_cov_210",98.182,55,1,0,816,870,992,938,2.84e-19,97.1,54,54
"71215","Ntome_NODE_24878_length_870_cov_209","Nsylvestris_NODE_18859_length_1196_cov_186",92.747,648,37,5,1,647,826,188,0,928,646,638
"71216","Ntome_NODE_24879_length_870_cov_208","Nsylvestris_NODE_30984_length_452_cov_184",92.641,462,20,6,186,646,1,449,0,652,460,448
"71217","Ntome_NODE_24880_length_870_cov_207","Nsylvestris_NODE_22956_length_894_cov_119",91.436,794,47,15,26,810,828,47,0,1070,784,781
"71220","Ntome_NODE_24882_length_870_cov_61","Nsylvestris_NODE_10770_length_2017_cov_99",94.526,749,41,0,122,870,1798,1050,0,1157,748,748
"71232","Ntome_NODE_24888_length_870_cov_14","Nsylvestris_NODE_21646_length_981_cov_206",94.153,838,46,2,31,868,930,96,0,1273,837,834
"71236","Ntome_NODE_24891_length_870_cov_9","Nsylvestris_NODE_28495_length_606_cov_19",95.39,282,12,1,1,282,375,95,6.8e-125,448,281,280
"71237","Ntome_NODE_24892_length_870_cov_6","Nsylvestris_NODE_13536_length_1702_cov_212",94.545,55,3,0,816,870,148,202,6.14e-16,86.1,54,54
"71238","Ntome_NODE_24893_length_870_cov_4","Nsylvestris_NODE_5290_length_2908_cov_25",96.895,773,21,2,100,870,661,1432,0,1291,770,771
"71253","Ntome_NODE_24899_length_869_cov_227","Nsylvestris_NODE_26533_length_694_cov_196",93.086,593,26,5,188,779,678,100,0,854,591,578
"71285","Ntome_NODE_24912_length_868_cov_242","Nsylvestris_NODE_25057_length_768_cov_167",95.261,612,23,5,78,686,77,685,0,965,608,608
"71290","Ntome_NODE_24914_length_868_cov_235","Nsylvestris_NODE_23346_length_868_cov_208",95.735,680,27,2,1,680,122,799,0,1094,679,677
"71295","Ntome_NODE_24917_length_868_cov_179","Nsylvestris_NODE_26227_length_708_cov_210",83.91,491,50,11,307,783,131,606,3.16e-123,442,476,475
"71308","Ntome_NODE_24923_length_868_cov_10","Nsylvestris_NODE_14824_length_1567_cov_153",83.333,480,72,5,110,585,1046,571,1.47e-121,436,475,475
"71328","Ntome_NODE_24929_length_867_cov_157","Nsylvestris_NODE_22869_length_899_cov_29",83.2,500,67,3,102,585,174,672,3.15e-123,442,483,498
"71329","Ntome_NODE_24930_length_867_cov_102","Nsylvestris_NODE_3636_length_3354_cov_188",93.993,283,17,0,585,867,2782,2500,2.45e-119,429,282,282
"71339","Ntome_NODE_24938_length_867_cov_16","Nsylvestris_NODE_34683_length_303_cov_4",88.235,102,7,3,501,601,288,191,2.17e-25,117,100,97
"71343","Ntome_NODE_24940_length_867_cov_13","Nsylvestris_NODE_22318_length_934_cov_49",91.482,857,61,8,2,854,881,33,0,1168,852,848
"71352","Ntome_NODE_24944_length_866_cov_287","Nsylvestris_NODE_23717_length_847_cov_221",96.885,642,18,2,180,821,797,158,0,1074,641,639
"71353","Ntome_NODE_24945_length_866_cov_282","Nsylvestris_NODE_24041_length_829_cov_218",89.596,817,63,10,57,865,822,20,0,1018,808,802
"71357","Ntome_NODE_24947_length_866_cov_187","Nsylvestris_NODE_31112_length_444_cov_34",89.109,404,37,2,11,408,443,41,2.38e-139,496,397,402
"71360","Ntome_NODE_24949_length_866_cov_81","Nsylvestris_NODE_31395_length_426_cov_2",92,350,15,5,55,400,341,1,2.4e-134,479,345,340
"71361","Ntome_NODE_24950_length_866_cov_47","Nsylvestris_NODE_23999_length_832_cov_38",86.02,794,52,22,18,786,761,2,0,797,768,759
"71377","Ntome_NODE_24958_length_866_cov_9","Nsylvestris_NODE_3721_length_3328_cov_201",100,55,0,0,812,866,2027,1973,6.07e-21,102,54,54
"71378","Ntome_NODE_24959_length_866_cov_6","Nsylvestris_NODE_21023_length_1026_cov_203",95.161,62,1,1,1,62,225,166,2.82e-19,97.1,61,59
"71383","Ntome_NODE_24962_length_865_cov_258","Nsylvestris_NODE_6721_length_2618_cov_119",91.164,713,45,7,83,782,1864,2571,0,952,699,707
"71394","Ntome_NODE_24967_length_865_cov_170","Nsylvestris_NODE_23736_length_846_cov_178",93.162,819,40,12,15,821,32,846,0,1188,806,814
"71413","Ntome_NODE_24975_length_866_cov_13","Nsylvestris_NODE_113_length_8253_cov_73",85.294,170,24,1,113,281,7189,7358,1.27e-42,174,168,169
"71414","Ntome_NODE_24977_length_865_cov_9","Nsylvestris_NODE_6450_length_2670_cov_102",88.542,96,4,3,1,90,1392,1486,3.62e-23,110,89,94
"71415","Ntome_NODE_24979_length_864_cov_310","Nsylvestris_NODE_18143_length_1255_cov_15",80.645,434,61,13,81,501,665,242,7.14e-85,315,420,423
"71423","Ntome_NODE_24982_length_864_cov_231","Nsylvestris_NODE_1515_length_4387_cov_151",92.319,690,18,12,1,672,22,694,0,948,671,672
"71424","Ntome_NODE_24983_length_864_cov_200","Nsylvestris_NODE_22821_length_901_cov_116",91.218,706,28,9,171,864,46,729,0,929,693,683
"71425","Ntome_NODE_24984_length_864_cov_131","Nsylvestris_NODE_32595_length_368_cov_3",89.773,176,11,3,620,795,198,366,5.76e-56,219,175,168
"71449","Ntome_NODE_24996_length_863_cov_400","Nsylvestris_NODE_116_length_8164_cov_94",94.792,864,44,1,1,863,4587,3724,0,1345,862,863
"71457","Ntome_NODE_25000_length_863_cov_97","Nsylvestris_NODE_23477_length_861_cov_138",90.986,832,39,14,53,855,7,831,0,1088,802,824
"71461","Ntome_NODE_25002_length_863_cov_70","Nsylvestris_NODE_20034_length_1099_cov_171",91.87,738,44,10,1,724,216,951,0,1016,723,735
"71470","Ntome_NODE_25006_length_863_cov_17","Nsylvestris_NODE_17656_length_1298_cov_12",97.581,124,3,0,350,473,1296,1173,2.68e-54,213,123,123
"71474","Ntome_NODE_25008_length_863_cov_13","Nsylvestris_NODE_12639_length_1801_cov_165",79.424,243,37,12,458,692,823,586,3.54e-38,159,234,237
"71480","Ntome_NODE_25011_length_863_cov_8","Nsylvestris_NODE_13369_length_1721_cov_9",85.686,503,71,1,357,859,642,1143,2.34e-149,529,502,501
"71499","Ntome_NODE_25020_length_862_cov_118","Nsylvestris_NODE_23516_length_858_cov_131",91.147,689,43,11,8,689,845,168,0,918,681,677
"71503","Ntome_NODE_25023_length_862_cov_32","Nsylvestris_NODE_17131_length_1346_cov_105",94.016,869,27,8,1,862,476,1326,0,1293,861,850
"71512","Ntome_NODE_25028_length_862_cov_11","Nsylvestris_NODE_3425_length_3428_cov_220",100,55,0,0,1,55,1920,1974,6.04e-21,102,54,54
"71516","Ntome_NODE_25031_length_862_cov_7","Nsylvestris_NODE_8078_length_2390_cov_217",98.276,58,1,0,1,58,1707,1650,6.04e-21,102,57,57
"71523","Ntome_NODE_25035_length_861_cov_91","Nsylvestris_NODE_25377_length_750_cov_189",97.596,208,5,0,548,755,253,46,1.17e-97,357,207,207
"71524","Ntome_NODE_25038_length_861_cov_24","Nsylvestris_NODE_7281_length_2521_cov_235",100,55,0,0,1,55,1425,1479,6.03e-21,102,54,54
"71525","Ntome_NODE_25039_length_861_cov_19","Nsylvestris_NODE_6045_length_2751_cov_61",100,55,0,0,807,861,1893,1947,6.03e-21,102,54,54
"71526","Ntome_NODE_25040_length_862_cov_15","Nsylvestris_NODE_5055_length_2959_cov_103",98.182,55,1,0,808,862,536,482,2.81e-19,97.1,54,54
"71527","Ntome_NODE_25041_length_861_cov_15","Nsylvestris_NODE_5312_length_2903_cov_111",94.545,55,3,0,807,861,2121,2175,6.07e-16,86.1,54,54
"71528","Ntome_NODE_25042_length_861_cov_11","Nsylvestris_NODE_2763_length_3679_cov_216",100,54,0,0,807,860,2068,2121,2.17e-20,100,53,53
"71547","Ntome_NODE_25052_length_860_cov_206","Nsylvestris_NODE_6244_length_2708_cov_212",96.364,55,2,0,1,55,2135,2081,1.3e-17,91.6,54,54
"71555","Ntome_NODE_25055_length_860_cov_122","Nsylvestris_NODE_8005_length_2403_cov_15",88.931,533,56,3,202,733,124,654,0,654,531,530
"71558","Ntome_NODE_25057_length_860_cov_101","Nsylvestris_NODE_873_length_5122_cov_131",92.085,657,26,8,1,656,992,1623,0,902,655,631
"71564","Ntome_NODE_25059_length_860_cov_39","Nsylvestris_NODE_3309_length_3471_cov_83",90.026,762,52,12,101,854,3453,2708,0,965,753,745
"71568","Ntome_NODE_25061_length_860_cov_17","Nsylvestris_NODE_25636_length_738_cov_8",94.03,737,44,0,79,815,2,738,0,1118,736,736
"71580","Ntome_NODE_25067_length_860_cov_7","Nsylvestris_NODE_15307_length_1521_cov_10",90.82,305,15,6,2,294,1320,1017,2.47e-109,396,292,303
"71583","Ntome_NODE_25069_length_860_cov_6","Nsylvestris_NODE_20899_length_1035_cov_72",98.039,51,1,0,791,841,533,583,4.69e-17,89.8,50,50
"71586","Ntome_NODE_25072_length_859_cov_241","Nsylvestris_NODE_16125_length_1436_cov_116",94.943,870,30,6,1,859,867,1,0,1351,858,866
"71587","Ntome_NODE_25073_length_859_cov_117","Nsylvestris_NODE_3352_length_3455_cov_142",92.465,783,28,11,78,859,36,788,0,1090,781,752
"71592","Ntome_NODE_25076_length_859_cov_39","Nsylvestris_NODE_6402_length_2679_cov_231",100,55,0,0,805,859,2377,2431,6.02e-21,102,54,54
"71620","Ntome_NODE_25089_length_858_cov_42","Nsylvestris_NODE_6917_length_2582_cov_216",94.828,58,3,0,801,858,1935,1992,1.3e-17,91.6,57,57
"71621","Ntome_NODE_25090_length_858_cov_35","Nsylvestris_NODE_16366_length_1413_cov_153",96.364,55,2,0,1,55,483,429,1.3e-17,91.6,54,54
"71622","Ntome_NODE_25091_length_858_cov_32","Nsylvestris_NODE_22900_length_897_cov_105",91.043,681,49,6,43,720,855,184,0,909,677,671
"71633","Ntome_NODE_25096_length_858_cov_10","Nsylvestris_NODE_12166_length_1851_cov_184",100,55,0,0,804,858,1275,1221,6.01e-21,102,54,54
"71639","Ntome_NODE_25099_length_857_cov_311","Nsylvestris_NODE_7721_length_2449_cov_218",99.3,857,6,0,1,857,1467,611,0,1550,856,856
"71640","Ntome_NODE_25100_length_857_cov_283","Nsylvestris_NODE_17324_length_1330_cov_44",93.866,864,41,9,1,857,1,859,0,1291,856,858
"71643","Ntome_NODE_25102_length_857_cov_243","Nsylvestris_NODE_1062_length_4866_cov_138",90.957,564,41,6,65,623,1939,1381,0,750,558,558
"71661","Ntome_NODE_25110_length_857_cov_15","Nsylvestris_NODE_32405_length_376_cov_7",90.283,247,16,4,220,462,126,368,1.97e-85,316,242,242
"71664","Ntome_NODE_25115_length_856_cov_270","Nsylvestris_NODE_9373_length_2197_cov_221",96.748,861,21,3,1,854,895,35,0,1428,853,860
"71665","Ntome_NODE_25116_length_856_cov_268","Nsylvestris_NODE_22521_length_920_cov_205",93.717,764,31,4,51,801,111,870,0,1129,750,759
"71670","Ntome_NODE_25119_length_856_cov_259","Nsylvestris_NODE_15421_length_1510_cov_217",96.463,735,23,1,1,735,617,1348,0,1210,734,731
"71671","Ntome_NODE_25120_length_856_cov_229","Nsylvestris_NODE_23540_length_857_cov_102",92.426,713,42,10,60,762,798,88,0,1007,702,710
"71674","Ntome_NODE_25122_length_856_cov_116","Nsylvestris_NODE_2160_length_3960_cov_187",85.698,881,54,31,1,856,2208,1375,0,863,855,833
"71709","Ntome_NODE_25134_length_855_cov_120","Nsylvestris_NODE_8714_length_2293_cov_97",93.953,430,15,8,3,429,33,454,0,640,426,421
"71710","Ntome_NODE_25135_length_855_cov_57","Nsylvestris_NODE_8785_length_2282_cov_10",95.911,856,34,1,1,855,1240,2095,0,1386,854,855
"71711","Ntome_NODE_25136_length_855_cov_27","Nsylvestris_NODE_4674_length_3051_cov_189",98.182,55,1,0,801,855,1164,1110,2.79e-19,97.1,54,54
"71715","Ntome_NODE_25138_length_855_cov_16","Nsylvestris_NODE_13427_length_1714_cov_30",87.514,873,84,10,2,853,1021,153,0,985,851,868
"71722","Ntome_NODE_25142_length_855_cov_6","Nsylvestris_NODE_10576_length_2040_cov_227",96.552,58,2,0,3,60,598,541,2.79e-19,97.1,57,57
"71723","Ntome_NODE_25143_length_855_cov_5","Nsylvestris_NODE_3587_length_3369_cov_128",98.182,55,1,0,801,855,1450,1504,2.79e-19,97.1,54,54
"71734","Ntome_NODE_25147_length_854_cov_234","Nsylvestris_NODE_498_length_5966_cov_219",94.72,625,30,1,173,797,674,53,0,968,624,621
"71742","Ntome_NODE_25150_length_854_cov_188","Nsylvestris_NODE_23367_length_868_cov_126",94.536,787,41,2,47,832,796,11,0,1214,785,785
"71759","Ntome_NODE_25159_length_854_cov_23","Nsylvestris_NODE_14420_length_1608_cov_229",98.182,55,1,0,1,55,964,910,2.78e-19,97.1,54,54
"71764","Ntome_NODE_25162_length_854_cov_7","Nsylvestris_NODE_22638_length_914_cov_5",78.167,600,58,22,216,747,597,3,7.06e-85,315,531,594
"71775","Ntome_NODE_25168_length_853_cov_65","Nsylvestris_NODE_27216_length_664_cov_14",92.765,622,21,8,189,804,1,604,0,878,615,603
"71778","Ntome_NODE_25170_length_853_cov_36","Nsylvestris_NODE_5640_length_2830_cov_92",85.301,415,25,14,292,682,61,463,2.45e-109,396,390,402
"71796","Ntome_NODE_25181_length_853_cov_9","Nsylvestris_NODE_381_length_6388_cov_93",89.34,197,19,2,1,196,3582,3777,2.61e-64,246,195,195
"71799","Ntome_NODE_25183_length_853_cov_7","Nsylvestris_NODE_13453_length_1712_cov_4",86.842,836,87,11,30,852,874,49,0,913,822,825
"71802","Ntome_NODE_25185_length_852_cov_193","Nsylvestris_NODE_31845_length_401_cov_15",91.206,398,22,4,217,608,401,11,2.31e-149,529,391,390
"71810","Ntome_NODE_25188_length_852_cov_12","Nsylvestris_NODE_5576_length_2848_cov_125",100,55,0,0,798,852,1445,1391,5.97e-21,102,54,54
"71823","Ntome_NODE_25194_length_851_cov_268","Nsylvestris_NODE_21798_length_969_cov_211",90.738,799,57,8,1,793,149,936,0,1050,792,787
"71824","Ntome_NODE_25195_length_851_cov_264","Nsylvestris_NODE_27867_length_634_cov_203",88.889,522,37,9,1,505,30,547,1.03e-177,623,504,517
"71837","Ntome_NODE_25200_length_851_cov_48","Nsylvestris_NODE_19755_length_1122_cov_58",97.503,801,20,0,49,849,231,1031,0,1369,800,800
"71841","Ntome_NODE_25202_length_851_cov_40","Nsylvestris_NODE_9404_length_2193_cov_24",90.141,71,7,0,1,71,1411,1481,3.59e-18,93.5,70,70
"71842","Ntome_NODE_25204_length_851_cov_33","Nsylvestris_NODE_14740_length_1575_cov_216",84.211,76,9,2,624,698,268,195,1.68e-11,71.3,74,73
"71843","Ntome_NODE_25205_length_851_cov_25","Nsylvestris_NODE_25093_length_766_cov_207",96.364,55,2,0,797,851,195,249,1.29e-17,91.6,54,54
"71854","Ntome_NODE_25212_length_850_cov_248","Nsylvestris_NODE_22555_length_918_cov_200",92.946,808,35,7,46,850,60,848,0,1157,804,788
"71861","Ntome_NODE_25215_length_850_cov_115","Nsylvestris_NODE_1100_length_4821_cov_197",100,55,0,0,1,55,896,950,5.95e-21,102,54,54
"71868","Ntome_NODE_25218_length_850_cov_80","Nsylvestris_NODE_8837_length_2274_cov_151",98.182,55,1,0,1,55,688,634,2.77e-19,97.1,54,54
"71873","Ntome_NODE_25222_length_850_cov_19","Nsylvestris_NODE_9124_length_2233_cov_153",92.258,620,21,9,232,850,2187,1594,0,854,618,593
"71896","Ntome_NODE_25233_length_849_cov_47","Nsylvestris_NODE_6024_length_2755_cov_189",92.506,854,47,10,1,849,1354,513,0,1206,848,841
"71897","Ntome_NODE_25234_length_849_cov_32","Nsylvestris_NODE_1528_length_4374_cov_222",94.545,55,3,0,1,55,1735,1681,5.99e-16,86.1,54,54
"71901","Ntome_NODE_25236_length_849_cov_6","Nsylvestris_NODE_14876_length_1563_cov_7",79.049,568,105,14,43,603,620,1180,8.82e-104,377,560,560
"71902","Ntome_NODE_25237_length_849_cov_5","Nsylvestris_NODE_1276_length_4616_cov_130",92.733,688,47,2,162,849,3287,3971,0,990,687,684
"71906","Ntome_NODE_25239_length_848_cov_98","Nsylvestris_NODE_23116_length_883_cov_47",89.61,154,15,1,15,167,174,327,9.52e-49,195,152,153
"71911","Ntome_NODE_25243_length_848_cov_27","Nsylvestris_NODE_6210_length_2714_cov_223",98.182,55,1,0,794,848,1080,1134,2.76e-19,97.1,54,54
"71914","Ntome_NODE_25245_length_848_cov_12","Nsylvestris_NODE_10394_length_2063_cov_82",98.182,55,1,0,1,55,1334,1280,2.76e-19,97.1,54,54
"71918","Ntome_NODE_25247_length_848_cov_8","Nsylvestris_NODE_34614_length_305_cov_3",94.059,303,18,0,94,396,303,1,8.5e-129,460,302,302
"71919","Ntome_NODE_25248_length_848_cov_6","Nsylvestris_NODE_18730_length_1207_cov_101",79.01,505,75,18,350,848,822,343,1.95e-85,316,498,479
"71920","Ntome_NODE_25251_length_848_cov_3","Nsylvestris_NODE_12867_length_1779_cov_22",93.341,856,44,2,1,843,745,1600,0,1271,842,855
"71921","Ntome_NODE_25252_length_847_cov_271","Nsylvestris_NODE_2505_length_3789_cov_233",94.971,855,33,5,2,847,74,927,0,1332,845,853
"71922","Ntome_NODE_25253_length_847_cov_235","Nsylvestris_NODE_27445_length_653_cov_211",90.206,582,25,16,216,796,51,601,0,730,580,550
"71928","Ntome_NODE_25256_length_847_cov_62","Nsylvestris_NODE_15913_length_1459_cov_43",88.602,851,55,16,1,847,647,1459,0,996,846,812
"71929","Ntome_NODE_25257_length_847_cov_57","Nsylvestris_NODE_98_length_8447_cov_211",98.182,55,1,0,793,847,7119,7065,2.76e-19,97.1,54,54
"71936","Ntome_NODE_25261_length_847_cov_24","Nsylvestris_NODE_7426_length_2500_cov_91",90.264,719,41,8,151,847,2500,1789,0,913,696,711
"71937","Ntome_NODE_25262_length_847_cov_17","Nsylvestris_NODE_14297_length_1621_cov_81",86.076,395,47,8,455,847,576,964,5.18e-116,418,392,388
"71941","Ntome_NODE_25264_length_847_cov_10","Nsylvestris_NODE_2000_length_4056_cov_197",100,37,0,0,793,829,3508,3472,6.02e-11,69.4,36,36
"71950","Ntome_NODE_25268_length_847_cov_4","Nsylvestris_NODE_1064_length_4863_cov_92",98.659,820,11,0,5,824,1078,1897,0,1454,819,819
"71953","Ntome_NODE_25270_length_846_cov_287","Nsylvestris_NODE_18174_length_1252_cov_208",95.676,370,16,0,1,370,658,1027,2.23e-169,595,369,369
"71968","Ntome_NODE_25276_length_845_cov_140","Nsylvestris_NODE_23160_length_881_cov_170",90.499,821,38,10,1,808,880,87,0,1048,807,793
"71984","Ntome_NODE_25284_length_846_cov_9","Nsylvestris_NODE_2428_length_3828_cov_130",97.406,848,16,4,3,846,2905,3750,0,1439,843,845
"71985","Ntome_NODE_25286_length_846_cov_7","Nsylvestris_NODE_6639_length_2635_cov_121",86.861,137,18,0,79,215,318,454,1.61e-36,154,136,136
"71986","Ntome_NODE_25287_length_846_cov_6","Nsylvestris_NODE_17086_length_1350_cov_24",100,55,0,0,792,846,1144,1090,5.92e-21,102,54,54
"71987","Ntome_NODE_25289_length_846_cov_5","Nsylvestris_NODE_3821_length_3293_cov_230",92.727,55,4,0,1,55,2609,2663,2.78e-14,80.5,54,54
"71988","Ntome_NODE_25290_length_845_cov_301","Nsylvestris_NODE_13772_length_1676_cov_212",94.424,807,40,3,41,845,1638,835,0,1236,804,803
"71994","Ntome_NODE_25292_length_845_cov_252","Nsylvestris_NODE_23765_length_844_cov_195",94.141,751,28,9,26,770,42,782,0,1129,744,740
"72001","Ntome_NODE_25295_length_845_cov_237","Nsylvestris_NODE_1105_length_4819_cov_49",97.213,287,8,0,415,701,4387,4673,1.4e-136,486,286,286
"72008","Ntome_NODE_25299_length_845_cov_73","Nsylvestris_NODE_19022_length_1182_cov_63",94.037,805,30,3,1,805,1176,390,0,1205,804,786
"72026","Ntome_NODE_25307_length_844_cov_52","Nsylvestris_NODE_21990_length_956_cov_200",91.561,865,42,11,1,839,896,37,0,1164,838,859
"72036","Ntome_NODE_25312_length_844_cov_17","Nsylvestris_NODE_5433_length_2877_cov_202",95.313,64,3,0,1,64,1740,1677,5.91e-21,102,63,63
"72045","Ntome_NODE_25316_length_844_cov_6","Nsylvestris_NODE_1613_length_4320_cov_178",97.275,844,23,0,1,844,3111,3954,0,1432,843,843
"72051","Ntome_NODE_25319_length_844_cov_5","Nsylvestris_NODE_19063_length_1178_cov_103",94.176,704,34,3,58,761,737,41,0,1066,703,696
"72052","Ntome_NODE_25320_length_844_cov_5","Nsylvestris_NODE_26832_length_682_cov_4",94.595,74,4,0,768,841,676,603,7.59e-25,115,73,73
"72061","Ntome_NODE_25324_length_843_cov_91","Nsylvestris_NODE_26036_length_717_cov_10",88.04,602,57,11,136,728,633,38,0,699,592,595
"72064","Ntome_NODE_25327_length_843_cov_20","Nsylvestris_NODE_34793_length_300_cov_4",79.167,288,49,8,442,719,12,298,4.4e-47,189,277,286
"72075","Ntome_NODE_25335_length_842_cov_274","Nsylvestris_NODE_20761_length_1045_cov_213",98.207,725,12,1,63,786,19,743,0,1266,723,724
"72079","Ntome_NODE_25337_length_842_cov_266","Nsylvestris_NODE_5036_length_2963_cov_185",97.87,845,11,6,1,842,1583,2423,0,1454,841,840
"72084","Ntome_NODE_25340_length_841_cov_67","Nsylvestris_NODE_19372_length_1154_cov_92",95.504,734,30,3,56,789,210,940,0,1170,733,730
"72085","Ntome_NODE_25341_length_842_cov_59","Nsylvestris_NODE_3218_length_3500_cov_148",94.41,161,9,0,129,289,1355,1515,7.15e-65,248,160,160
"72086","Ntome_NODE_25342_length_842_cov_52","Nsylvestris_NODE_34625_length_304_cov_7",94.079,304,18,0,238,541,1,304,2.35e-129,462,303,303
"72101","Ntome_NODE_25348_length_841_cov_95","Nsylvestris_NODE_1963_length_4076_cov_68",93.872,359,21,1,483,841,4076,3719,1.05e-152,540,358,357
"72102","Ntome_NODE_25349_length_841_cov_54","Nsylvestris_NODE_7978_length_2407_cov_204",96.97,132,4,0,601,732,985,854,4.33e-57,222,131,131
"72103","Ntome_NODE_25350_length_841_cov_37","Nsylvestris_NODE_22398_length_927_cov_143",89.985,679,67,1,53,730,57,735,0,876,677,678
"72113","Ntome_NODE_25354_length_841_cov_21","Nsylvestris_NODE_34556_length_306_cov_5",91.954,87,7,0,752,838,3,89,4.52e-27,122,86,86
"72122","Ntome_NODE_25358_length_841_cov_15","Nsylvestris_NODE_20449_length_1068_cov_164",98.182,55,1,0,787,841,178,124,2.74e-19,97.1,54,54
"72123","Ntome_NODE_25359_length_841_cov_13","Nsylvestris_NODE_771_length_5294_cov_175",95.862,290,8,2,54,342,583,297,1.81e-130,466,288,286
"72127","Ntome_NODE_25362_length_840_cov_259","Nsylvestris_NODE_23900_length_837_cov_190",91.716,845,46,12,8,840,833,1,0,1151,832,832
"72135","Ntome_NODE_25366_length_840_cov_210","Nsylvestris_NODE_6739_length_2615_cov_226",98.182,55,1,0,786,840,1647,1593,2.74e-19,97.1,54,54
"72138","Ntome_NODE_25369_length_840_cov_118","Nsylvestris_NODE_33861_length_326_cov_5",88.854,323,23,7,174,484,2,323,5.21e-106,385,310,321
"72139","Ntome_NODE_25370_length_840_cov_45","Nsylvestris_NODE_5143_length_2939_cov_129",98.182,55,1,0,786,840,727,781,2.74e-19,97.1,54,54
"72144","Ntome_NODE_25374_length_840_cov_17","Nsylvestris_NODE_744_length_5355_cov_157",98.182,55,1,0,1,55,428,374,2.74e-19,97.1,54,54
"72150","Ntome_NODE_25379_length_840_cov_5","Nsylvestris_NODE_13463_length_1711_cov_53",94.7,849,33,1,4,840,1548,700,0,1308,836,848
"72158","Ntome_NODE_25382_length_839_cov_245","Nsylvestris_NODE_15300_length_1521_cov_129",94.922,709,35,1,75,783,83,790,0,1109,708,707
"72166","Ntome_NODE_25385_length_839_cov_75","Nsylvestris_NODE_30369_length_496_cov_194",86.23,305,37,3,426,726,107,410,3.2e-88,326,300,303
"72167","Ntome_NODE_25386_length_839_cov_42","Nsylvestris_NODE_2348_length_3871_cov_222",100,55,0,0,785,839,1464,1410,5.87e-21,102,54,54
"72171","Ntome_NODE_25388_length_839_cov_40","Nsylvestris_NODE_7853_length_2427_cov_143",98.113,53,1,0,785,837,1473,1421,3.53e-18,93.5,52,52
"72177","Ntome_NODE_25394_length_839_cov_16","Nsylvestris_NODE_4529_length_3092_cov_128",96.364,55,2,0,1,55,731,677,1.27e-17,91.6,54,54
"72178","Ntome_NODE_25395_length_839_cov_15","Nsylvestris_NODE_1185_length_4715_cov_120",96.364,55,2,0,785,839,3419,3365,1.27e-17,91.6,54,54
"72182","Ntome_NODE_25397_length_839_cov_5","Nsylvestris_NODE_30222_length_508_cov_5",93.306,493,20,3,354,839,5,491,0,715,485,486
"72183","Ntome_NODE_25398_length_839_cov_5","Nsylvestris_NODE_250_length_6992_cov_162",98.182,55,1,0,1,55,827,773,2.73e-19,97.1,54,54
"72191","Ntome_NODE_25401_length_838_cov_253","Nsylvestris_NODE_21081_length_1023_cov_16",90.139,649,44,8,204,838,181,823,0,826,634,642
"72198","Ntome_NODE_25404_length_838_cov_220","Nsylvestris_NODE_32082_length_390_cov_53",84.881,377,22,14,428,769,1,377,6.82e-95,348,341,376
"72207","Ntome_NODE_25408_length_838_cov_23","Nsylvestris_NODE_7557_length_2476_cov_156",100,55,0,0,784,838,1151,1097,5.87e-21,102,54,54
"72213","Ntome_NODE_25412_length_837_cov_9","Nsylvestris_NODE_8132_length_2383_cov_14",88.032,493,34,8,347,837,2277,1808,8.04e-159,560,490,469
"72221","Ntome_NODE_25416_length_837_cov_273","Nsylvestris_NODE_19563_length_1138_cov_163",88.621,747,46,12,36,744,310,1055,0,872,708,745
"72235","Ntome_NODE_25421_length_837_cov_18","Nsylvestris_NODE_10585_length_2039_cov_187",98.077,52,1,0,4,55,567,516,1.27e-17,91.6,51,51
"72241","Ntome_NODE_25423_length_837_cov_12","Nsylvestris_NODE_6384_length_2682_cov_42",91.083,628,42,14,21,638,1193,1816,0,837,617,623
"72242","Ntome_NODE_25424_length_837_cov_11","Nsylvestris_NODE_21651_length_981_cov_75",96.941,752,23,0,86,837,932,181,0,1262,751,751
"72246","Ntome_NODE_25428_length_837_cov_8","Nsylvestris_NODE_12886_length_1776_cov_212",100,55,0,0,783,837,551,497,5.86e-21,102,54,54
"72247","Ntome_NODE_25429_length_837_cov_8","Nsylvestris_NODE_33766_length_329_cov_3",88.35,309,24,5,182,489,8,305,8.75e-99,361,307,297
"72254","Ntome_NODE_25432_length_837_cov_6","Nsylvestris_NODE_18066_length_1262_cov_202",98.182,55,1,0,1,55,660,714,2.73e-19,97.1,54,54
"72270","Ntome_NODE_25438_length_836_cov_41","Nsylvestris_NODE_6480_length_2664_cov_196",100,55,0,0,1,55,1677,1623,5.85e-21,102,54,54
"72271","Ntome_NODE_25441_length_836_cov_26","Nsylvestris_NODE_795_length_5247_cov_149",98.182,55,1,0,1,55,3555,3609,2.72e-19,97.1,54,54
"72272","Ntome_NODE_25442_length_836_cov_22","Nsylvestris_NODE_15376_length_1515_cov_216",100,55,0,0,782,836,495,441,5.85e-21,102,54,54
"72282","Ntome_NODE_25448_length_836_cov_5","Nsylvestris_NODE_13990_length_1651_cov_15",73.963,434,86,23,7,431,1328,913,2.06e-35,150,424,415
"72290","Ntome_NODE_25453_length_835_cov_274","Nsylvestris_NODE_3922_length_3262_cov_175",96.598,823,22,3,16,835,1560,741,0,1360,819,819
"72295","Ntome_NODE_25455_length_835_cov_235","Nsylvestris_NODE_6029_length_2754_cov_222",90.271,812,43,20,2,794,803,9,0,1029,792,794
"72299","Ntome_NODE_25457_length_835_cov_178","Nsylvestris_NODE_23978_length_833_cov_88",92.975,726,38,12,52,771,1,719,0,1046,719,718
"72302","Ntome_NODE_25459_length_835_cov_84","Nsylvestris_NODE_26887_length_678_cov_148",90.653,567,33,15,234,786,632,72,0,736,552,560
"72311","Ntome_NODE_25462_length_835_cov_64","Nsylvestris_NODE_20309_length_1077_cov_21",83.913,230,35,2,33,261,829,601,5.56e-56,219,228,228
"72315","Ntome_NODE_25465_length_835_cov_15","Nsylvestris_NODE_26673_length_688_cov_19",93.849,634,37,1,202,833,55,688,0,953,631,633
"72316","Ntome_NODE_25466_length_835_cov_13","Nsylvestris_NODE_6932_length_2580_cov_97",100,55,0,0,781,835,1626,1572,5.84e-21,102,54,54
"72319","Ntome_NODE_25469_length_835_cov_8","Nsylvestris_NODE_22409_length_927_cov_209",98.182,55,1,0,1,55,315,261,2.72e-19,97.1,54,54
"72322","Ntome_NODE_25472_length_835_cov_6","Nsylvestris_NODE_441_length_6140_cov_71",77.061,837,173,8,1,835,4224,5043,6.47e-130,464,834,819
"72328","Ntome_NODE_25475_length_834_cov_263","Nsylvestris_NODE_24672_length_790_cov_220",93.974,780,35,8,5,777,777,3,0,1170,772,774
"72332","Ntome_NODE_25477_length_834_cov_259","Nsylvestris_NODE_7732_length_2447_cov_143",98.864,352,4,0,483,834,591,942,2.17e-179,628,351,351
"72339","Ntome_NODE_25481_length_834_cov_87","Nsylvestris_NODE_29045_length_582_cov_3",91.039,558,39,3,231,777,582,25,0,743,546,557
"72345","Ntome_NODE_25484_length_834_cov_44","Nsylvestris_NODE_1610_length_4323_cov_173",92.766,788,34,9,50,834,1932,2699,0,1118,784,767
"72356","Ntome_NODE_25489_length_834_cov_14","Nsylvestris_NODE_36047_length_272_cov_4",91.078,269,18,6,1,266,7,272,3.14e-98,359,265,265
"72359","Ntome_NODE_25491_length_834_cov_11","Nsylvestris_NODE_12467_length_1819_cov_183",100,55,0,0,780,834,1310,1256,5.84e-21,102,54,54
"72360","Ntome_NODE_25492_length_834_cov_10","Nsylvestris_NODE_17508_length_1313_cov_13",85.317,252,23,2,589,831,1,247,7.08e-65,248,242,246
"72361","Ntome_NODE_25493_length_834_cov_9","Nsylvestris_NODE_26102_length_714_cov_10",85.953,299,39,2,491,788,708,412,1.91e-85,316,297,296
"72364","Ntome_NODE_25496_length_833_cov_233","Nsylvestris_NODE_9369_length_2198_cov_38",87.227,321,35,6,300,618,748,1064,8.71e-99,361,318,316
"72365","Ntome_NODE_25497_length_833_cov_144","Nsylvestris_NODE_2176_length_3951_cov_137",85.52,442,53,5,77,507,3162,3603,5.02e-126,451,430,441
"72369","Ntome_NODE_25499_length_833_cov_64","Nsylvestris_NODE_29752_length_549_cov_44",89.091,330,28,3,5,326,522,193,1.43e-111,403,321,329
"72394","Ntome_NODE_25511_length_832_cov_306","Nsylvestris_NODE_10648_length_2031_cov_229",97.01,836,19,4,1,831,853,1687,0,1400,830,834
"72402","Ntome_NODE_25517_length_832_cov_88","Nsylvestris_NODE_19895_length_1110_cov_133",89.682,785,52,8,50,823,188,954,0,974,773,766
"72415","Ntome_NODE_25523_length_832_cov_24","Nsylvestris_NODE_9000_length_2251_cov_113",100,52,0,0,4,55,1855,1804,2.71e-19,97.1,51,51
"72453","Ntome_NODE_25540_length_832_cov_8","Nsylvestris_NODE_25898_length_724_cov_4",86.885,61,5,3,772,831,543,601,7.64e-10,65.8,59,58
"72456","Ntome_NODE_25542_length_831_cov_6","Nsylvestris_NODE_7281_length_2521_cov_235",100,55,0,0,1,55,968,1022,5.82e-21,102,54,54
"72459","Ntome_NODE_25544_length_830_cov_295","Nsylvestris_NODE_11101_length_1976_cov_64",97.829,783,17,0,48,830,95,877,0,1352,782,782
"72467","Ntome_NODE_25548_length_830_cov_210","Nsylvestris_NODE_28838_length_590_cov_56",90.26,462,27,7,48,500,39,491,3.66e-167,588,452,452
"72480","Ntome_NODE_25553_length_830_cov_79","Nsylvestris_NODE_25725_length_732_cov_87",88.538,253,26,3,471,721,270,521,1.48e-81,303,250,251
"72484","Ntome_NODE_25555_length_830_cov_52","Nsylvestris_NODE_32669_length_365_cov_3",85.323,402,22,9,175,576,1,365,6.66e-105,381,401,364
"72513","Ntome_NODE_25569_length_829_cov_233","Nsylvestris_NODE_29544_length_561_cov_189",86.933,551,54,15,196,735,17,560,1.3e-171,603,539,543
"72522","Ntome_NODE_25572_length_829_cov_126","Nsylvestris_NODE_11230_length_1959_cov_136",91.152,486,22,8,1,468,1376,1858,0,640,467,482
"72528","Ntome_NODE_25575_length_829_cov_77","Nsylvestris_NODE_13970_length_1654_cov_25",95.652,69,3,0,1,69,1266,1198,9.64e-24,111,68,68
"72537","Ntome_NODE_25579_length_829_cov_57","Nsylvestris_NODE_7118_length_2550_cov_86",90.09,111,11,0,7,117,2550,2440,9.5e-34,145,110,110
"72540","Ntome_NODE_25581_length_829_cov_24","Nsylvestris_NODE_7790_length_2438_cov_217",98.182,55,1,0,1,55,582,528,2.7e-19,97.1,54,54
"72554","Ntome_NODE_25589_length_828_cov_40","Nsylvestris_NODE_10008_length_2114_cov_101",94.545,55,3,0,1,55,1300,1354,5.83e-16,86.1,54,54
"72555","Ntome_NODE_25591_length_828_cov_23","Nsylvestris_NODE_22824_length_901_cov_64",92.019,827,48,10,14,828,74,894,0,1146,814,820
"72556","Ntome_NODE_25592_length_828_cov_18","Nsylvestris_NODE_32294_length_382_cov_1",83.577,274,38,4,522,794,103,370,1.96e-65,250,272,267
"72557","Ntome_NODE_25593_length_828_cov_15","Nsylvestris_NODE_29822_length_543_cov_6",93.04,273,19,0,264,536,271,543,1.83e-110,399,272,272
"72563","Ntome_NODE_25597_length_828_cov_8","Nsylvestris_NODE_17411_length_1321_cov_223",94.545,55,3,0,1,55,225,171,5.83e-16,86.1,54,54
"72564","Ntome_NODE_25599_length_827_cov_279","Nsylvestris_NODE_24621_length_793_cov_200",88.86,781,53,9,46,821,36,787,0,929,775,751
"72574","Ntome_NODE_25603_length_827_cov_86","Nsylvestris_NODE_18627_length_1215_cov_40",94.625,707,31,6,1,701,510,1215,0,1088,700,705
"72581","Ntome_NODE_25606_length_827_cov_46","Nsylvestris_NODE_13448_length_1712_cov_184",94.293,368,18,1,49,416,49,413,7.94e-159,560,367,364
"72582","Ntome_NODE_25607_length_827_cov_34","Nsylvestris_NODE_24061_length_828_cov_24",92.09,708,38,12,98,795,762,63,0,981,697,699
"72585","Ntome_NODE_25610_length_827_cov_12","Nsylvestris_NODE_6884_length_2588_cov_225",98.182,55,1,0,1,55,1160,1106,2.69e-19,97.1,54,54
"72586","Ntome_NODE_25611_length_827_cov_8","Nsylvestris_NODE_12566_length_1808_cov_174",83.14,172,19,5,400,569,496,659,7.33e-35,148,169,163
"72587","Ntome_NODE_25613_length_826_cov_256","Nsylvestris_NODE_24248_length_815_cov_196",91.905,803,51,4,1,797,800,6,0,1110,796,794
"72591","Ntome_NODE_25615_length_826_cov_131","Nsylvestris_NODE_26974_length_674_cov_79",89.267,587,36,12,74,633,28,614,0,710,559,586
"72594","Ntome_NODE_25617_length_826_cov_79","Nsylvestris_NODE_3053_length_3565_cov_153",95.773,686,20,5,146,826,1663,982,0,1098,680,681
"72602","Ntome_NODE_25621_length_826_cov_26","Nsylvestris_NODE_1103_length_4819_cov_230",100,55,0,0,1,55,4370,4316,5.78e-21,102,54,54
"72613","Ntome_NODE_25628_length_826_cov_9","Nsylvestris_NODE_18_length_12244_cov_232",97.727,44,1,0,1,44,4264,4221,3.5e-13,76.8,43,43
"72619","Ntome_NODE_25631_length_826_cov_7","Nsylvestris_NODE_2666_length_3717_cov_54",97.307,817,10,1,1,817,893,89,0,1376,816,804
"72620","Ntome_NODE_25632_length_825_cov_260","Nsylvestris_NODE_11442_length_1936_cov_224",91.142,779,36,12,1,774,789,39,0,1026,773,750
"72626","Ntome_NODE_25638_length_825_cov_39","Nsylvestris_NODE_24284_length_813_cov_36",93.75,720,37,4,69,781,767,49,0,1074,712,718
"72635","Ntome_NODE_25642_length_825_cov_24","Nsylvestris_NODE_21313_length_1005_cov_56",90.655,824,60,6,5,817,107,924,0,1079,812,817
"72644","Ntome_NODE_25648_length_825_cov_5","Nsylvestris_NODE_33524_length_336_cov_3",91.875,320,24,2,504,823,19,336,2.31e-124,446,319,317
"72657","Ntome_NODE_25653_length_824_cov_226","Nsylvestris_NODE_16333_length_1416_cov_59",92.154,599,42,5,1,599,637,1230,0,841,598,593
"72671","Ntome_NODE_25661_length_824_cov_13","Nsylvestris_NODE_3791_length_3302_cov_194",98.182,55,1,0,1,55,2507,2561,2.68e-19,97.1,54,54
"72672","Ntome_NODE_25662_length_824_cov_7","Nsylvestris_NODE_11059_length_1981_cov_16",97.694,824,19,0,1,824,1079,256,0,1417,823,823
"72673","Ntome_NODE_25663_length_823_cov_254","Nsylvestris_NODE_24924_length_775_cov_85",92.5,640,19,11,136,758,35,662,0,889,622,627
"72676","Ntome_NODE_25665_length_823_cov_147","Nsylvestris_NODE_1828_length_4159_cov_136",98.182,55,1,0,1,55,525,471,2.68e-19,97.1,54,54
"72679","Ntome_NODE_25667_length_823_cov_64","Nsylvestris_NODE_10972_length_1991_cov_195",100,55,0,0,1,55,817,763,5.76e-21,102,54,54
"72680","Ntome_NODE_25668_length_823_cov_62","Nsylvestris_NODE_15075_length_1544_cov_95",87.94,796,53,18,1,767,648,1429,0,898,766,781
"72700","Ntome_NODE_25677_length_823_cov_3","Nsylvestris_NODE_12399_length_1826_cov_186",98.182,55,1,0,1,55,1313,1367,2.68e-19,97.1,54,54
"72701","Ntome_NODE_25678_length_822_cov_283","Nsylvestris_NODE_3292_length_3478_cov_160",83.455,683,95,9,142,821,3277,2610,1.28e-176,619,679,667
"72709","Ntome_NODE_25682_length_822_cov_224","Nsylvestris_NODE_16791_length_1373_cov_159",92.278,259,19,1,512,770,413,670,1.85e-100,366,258,257
"72715","Ntome_NODE_25684_length_822_cov_182","Nsylvestris_NODE_7584_length_2472_cov_188",93.099,797,50,3,28,822,1,794,0,1162,794,793
"72723","Ntome_NODE_25691_length_822_cov_9","Nsylvestris_NODE_25218_length_759_cov_43",89.706,68,5,2,139,204,171,238,5.79e-16,86.1,65,67
"72724","Ntome_NODE_25692_length_822_cov_5","Nsylvestris_NODE_35270_length_289_cov_3",97.436,39,1,0,6,44,78,40,2.1e-10,67.6,38,38
"72730","Ntome_NODE_25697_length_821_cov_68","Nsylvestris_NODE_6987_length_2571_cov_96",96.914,810,24,1,13,821,74,883,0,1356,808,809
"72743","Ntome_NODE_25703_length_821_cov_8","Nsylvestris_NODE_33453_length_338_cov_2",89.489,333,17,9,288,606,333,5,3.91e-112,405,318,328
"72760","Ntome_NODE_25708_length_820_cov_244","Nsylvestris_NODE_9979_length_2118_cov_200",96.33,436,16,0,385,820,1286,1721,0,717,435,435
"72761","Ntome_NODE_25709_length_820_cov_226","Nsylvestris_NODE_25903_length_723_cov_187",96.41,585,20,1,183,766,91,675,0,963,583,584
"72769","Ntome_NODE_25715_length_820_cov_79","Nsylvestris_NODE_15513_length_1502_cov_3",100,55,0,0,1,55,114,168,5.74e-21,102,54,54
"72773","Ntome_NODE_25717_length_820_cov_43","Nsylvestris_NODE_940_length_5034_cov_104",94.321,722,35,4,1,717,225,945,0,1101,716,720
"72774","Ntome_NODE_25718_length_820_cov_28","Nsylvestris_NODE_132_length_7968_cov_104",85.789,190,20,5,513,700,2831,3015,9.2e-49,195,187,184
"72782","Ntome_NODE_25724_length_820_cov_8","Nsylvestris_NODE_13469_length_1710_cov_60",87.249,847,53,20,2,820,1658,839,0,915,818,819
"72783","Ntome_NODE_25725_length_820_cov_8","Nsylvestris_NODE_6577_length_2647_cov_86",93.009,658,29,5,1,648,1085,435,0,944,647,650
"72787","Ntome_NODE_25727_length_819_cov_6","Nsylvestris_NODE_899_length_5087_cov_92",81.132,212,38,2,409,620,3432,3641,5.57e-41,169,211,209
"72798","Ntome_NODE_25731_length_819_cov_247","Nsylvestris_NODE_30022_length_525_cov_247",89.668,542,30,9,282,815,525,2,0,667,533,523
"72803","Ntome_NODE_25736_length_819_cov_31","Nsylvestris_NODE_1772_length_4194_cov_99",98.182,55,1,0,765,819,3199,3253,2.67e-19,97.1,54,54
"72804","Ntome_NODE_25739_length_819_cov_15","Nsylvestris_NODE_29515_length_562_cov_301",84.81,553,80,4,184,734,562,12,1.32e-156,553,550,550
"72807","Ntome_NODE_25741_length_819_cov_10","Nsylvestris_NODE_7848_length_2423_cov_130",98.182,55,1,0,765,819,1515,1461,2.67e-19,97.1,54,54
"72808","Ntome_NODE_25742_length_819_cov_9","Nsylvestris_NODE_2831_length_3646_cov_84",81.614,223,28,7,459,677,823,610,4.31e-42,172,218,213
"72809","Ntome_NODE_25743_length_819_cov_8","Nsylvestris_NODE_20204_length_1086_cov_195",100,55,0,0,765,819,622,568,5.73e-21,102,54,54
"72815","Ntome_NODE_25747_length_819_cov_3","Nsylvestris_NODE_1031_length_4896_cov_213",94.545,55,3,0,1,55,2325,2379,5.77e-16,86.1,54,54
"72818","Ntome_NODE_25749_length_818_cov_258","Nsylvestris_NODE_13693_length_1685_cov_221",95.965,793,20,4,27,818,1681,900,0,1277,791,781
"72825","Ntome_NODE_25753_length_818_cov_86","Nsylvestris_NODE_6719_length_2617_cov_148",87.281,228,29,0,165,392,2314,2087,8.92e-69,261,227,227
"72837","Ntome_NODE_25760_length_818_cov_15","Nsylvestris_NODE_6259_length_2705_cov_157",98.182,55,1,0,1,55,523,577,2.66e-19,97.1,54,54
"72840","Ntome_NODE_25762_length_818_cov_10","Nsylvestris_NODE_27722_length_641_cov_10",90.465,430,35,5,30,457,6,431,2.18e-159,562,427,425
"72841","Ntome_NODE_25763_length_818_cov_10","Nsylvestris_NODE_4365_length_3135_cov_215",100,55,0,0,764,818,2266,2212,5.72e-21,102,54,54
"72842","Ntome_NODE_25766_length_818_cov_7","Nsylvestris_NODE_31949_length_396_cov_6",91.571,261,20,2,113,372,136,395,3.07e-98,359,259,259
"72853","Ntome_NODE_25772_length_817_cov_240","Nsylvestris_NODE_2751_length_3681_cov_224",90.518,791,48,14,47,817,17,800,0,1020,770,783
"72872","Ntome_NODE_25780_length_817_cov_21","Nsylvestris_NODE_19775_length_1120_cov_28",90.305,361,25,4,50,407,598,951,6.33e-130,464,357,353
"72880","Ntome_NODE_25785_length_816_cov_272","Nsylvestris_NODE_16224_length_1427_cov_204",87.831,567,51,7,1,564,756,205,0,649,563,551
"72892","Ntome_NODE_25790_length_816_cov_137","Nsylvestris_NODE_1021_length_4922_cov_89",85,60,9,0,208,267,2327,2268,9.69e-09,62.1,59,59
"72913","Ntome_NODE_25799_length_816_cov_21","Nsylvestris_NODE_35719_length_279_cov_4",89.753,283,16,3,292,565,1,279,1.85e-95,350,273,278
"72921","Ntome_NODE_25803_length_816_cov_7","Nsylvestris_NODE_3845_length_3287_cov_16",96.539,549,19,0,268,816,3255,2707,0,909,548,548
"72924","Ntome_NODE_25807_length_815_cov_358","Nsylvestris_NODE_19867_length_1112_cov_200",96.893,515,15,1,302,815,445,959,0,861,513,514
"72925","Ntome_NODE_25808_length_815_cov_314","Nsylvestris_NODE_13197_length_1739_cov_154",92.005,813,45,5,8,802,864,54,0,1123,794,810
"72933","Ntome_NODE_25815_length_815_cov_24","Nsylvestris_NODE_15707_length_1479_cov_187",98.182,55,1,0,1,55,258,204,2.65e-19,97.1,54,54
"72941","Ntome_NODE_25818_length_815_cov_11","Nsylvestris_NODE_553_length_5813_cov_96",100,55,0,0,761,815,4173,4227,5.7e-21,102,54,54
"72950","Ntome_NODE_25824_length_814_cov_146","Nsylvestris_NODE_24636_length_792_cov_218",94.965,576,27,2,49,623,125,699,0,902,574,574
"72951","Ntome_NODE_25825_length_814_cov_87","Nsylvestris_NODE_3757_length_3316_cov_135",97.895,285,6,0,1,285,946,662,8.04e-139,494,284,284
"72981","Ntome_NODE_25839_length_813_cov_204","Nsylvestris_NODE_25549_length_741_cov_105",95,740,30,4,10,744,741,4,0,1155,734,737
"72995","Ntome_NODE_25847_length_813_cov_31","Nsylvestris_NODE_5233_length_2919_cov_146",90.389,822,45,12,1,813,2072,1276,0,1050,812,796
"72996","Ntome_NODE_25848_length_813_cov_24","Nsylvestris_NODE_620_length_5655_cov_206",98.113,53,1,0,758,810,4472,4524,3.42e-18,93.5,52,52
"72997","Ntome_NODE_25850_length_813_cov_20","Nsylvestris_NODE_15937_length_1456_cov_103",83.141,866,83,30,3,813,858,1,0,732,810,857
"72998","Ntome_NODE_25851_length_813_cov_19","Nsylvestris_NODE_1105_length_4819_cov_49",78.523,149,32,0,34,182,1694,1842,7.35e-20,99,148,148
"73005","Ntome_NODE_25855_length_813_cov_6","Nsylvestris_NODE_4652_length_3057_cov_101",95.663,784,29,2,1,782,2674,1894,0,1254,781,780
"73006","Ntome_NODE_25856_length_812_cov_299","Nsylvestris_NODE_1445_length_4452_cov_150",96.675,812,27,0,1,812,2297,3108,0,1351,811,811
"73013","Ntome_NODE_25860_length_812_cov_129","Nsylvestris_NODE_18613_length_1216_cov_165",94.903,412,21,0,401,812,412,1,0,645,411,411
"73021","Ntome_NODE_25864_length_812_cov_22","Nsylvestris_NODE_2752_length_3681_cov_200",100,55,0,0,758,812,2591,2537,5.68e-21,102,54,54
"73038","Ntome_NODE_25873_length_811_cov_139","Nsylvestris_NODE_13500_length_1704_cov_142",96.735,735,24,0,2,736,74,808,0,1225,734,734
"73039","Ntome_NODE_25874_length_811_cov_120","Nsylvestris_NODE_23754_length_845_cov_58",93.944,677,39,1,137,811,102,778,0,1022,674,676
"73045","Ntome_NODE_25878_length_811_cov_53","Nsylvestris_NODE_24425_length_805_cov_183",89.429,700,47,14,136,811,52,748,0,857,675,696
"73084","Ntome_NODE_25889_length_811_cov_9","Nsylvestris_NODE_9873_length_2131_cov_17",96.301,811,30,0,1,811,1240,2050,0,1332,810,810
"73085","Ntome_NODE_25890_length_811_cov_7","Nsylvestris_NODE_18063_length_1262_cov_227",100,55,0,0,1,55,471,525,5.67e-21,102,54,54
"73098","Ntome_NODE_25896_length_810_cov_177","Nsylvestris_NODE_24775_length_784_cov_136",91.379,290,13,5,511,789,389,677,1.4e-106,387,278,288
"73101","Ntome_NODE_25898_length_810_cov_134","Nsylvestris_NODE_18957_length_1187_cov_108",89.467,788,39,21,1,775,1183,427,0,955,774,756
"73129","Ntome_NODE_25910_length_810_cov_18","Nsylvestris_NODE_31892_length_398_cov_173",87.895,190,9,2,351,540,1,176,9.02e-54,211,189,175
"73136","Ntome_NODE_25913_length_810_cov_11","Nsylvestris_NODE_16314_length_1417_cov_211",98.182,55,1,0,1,55,660,714,2.64e-19,97.1,54,54
"73139","Ntome_NODE_25915_length_810_cov_9","Nsylvestris_NODE_14659_length_1583_cov_158",100,55,0,0,1,55,868,922,5.66e-21,102,54,54
"73143","Ntome_NODE_25918_length_810_cov_4","Nsylvestris_NODE_5363_length_2895_cov_27",94.859,817,35,1,1,810,1681,2497,0,1269,809,816
"73144","Ntome_NODE_25919_length_809_cov_319","Nsylvestris_NODE_1567_length_4351_cov_231",99.011,809,8,0,1,809,1133,1941,0,1450,808,808
"73149","Ntome_NODE_25921_length_809_cov_269","Nsylvestris_NODE_18065_length_1262_cov_202",93.838,779,27,5,36,809,1262,500,0,1153,773,762
"73166","Ntome_NODE_25927_length_809_cov_31","Nsylvestris_NODE_19743_length_1123_cov_208",98.182,55,1,0,755,809,247,193,2.63e-19,97.1,54,54
"73174","Ntome_NODE_25931_length_809_cov_16","Nsylvestris_NODE_1198_length_4706_cov_216",91.803,61,5,0,1,61,279,219,5.7e-16,86.1,60,60
"73175","Ntome_NODE_25932_length_809_cov_13","Nsylvestris_NODE_6571_length_2648_cov_175",100,55,0,0,1,55,943,889,5.66e-21,102,54,54
"73176","Ntome_NODE_25933_length_809_cov_10","Nsylvestris_NODE_4_length_15019_cov_122",89.7,233,22,2,322,554,9935,10165,2.42e-79,296,232,230
"73184","Ntome_NODE_25937_length_808_cov_268","Nsylvestris_NODE_23416_length_865_cov_197",94.313,721,32,4,37,753,101,816,0,1096,716,715
"73192","Ntome_NODE_25942_length_808_cov_63","Nsylvestris_NODE_988_length_4971_cov_222",94.326,423,24,0,1,423,4845,4423,0,649,422,422
"73208","Ntome_NODE_25948_length_808_cov_18","Nsylvestris_NODE_2699_length_3705_cov_186",100,55,0,0,754,808,638,584,5.65e-21,102,54,54
"73213","Ntome_NODE_25952_length_808_cov_16","Nsylvestris_NODE_14160_length_1634_cov_214",98.182,55,1,0,754,808,1220,1166,2.63e-19,97.1,54,54
"73220","Ntome_NODE_25958_length_808_cov_8","Nsylvestris_NODE_769_length_5299_cov_80",88.315,445,39,9,37,475,2623,2186,3.66e-147,521,438,437
"73223","Ntome_NODE_25961_length_807_cov_260","Nsylvestris_NODE_6370_length_2684_cov_235",100,55,0,0,1,55,2233,2287,5.64e-21,102,54,54
"73228","Ntome_NODE_25964_length_807_cov_205","Nsylvestris_NODE_5367_length_2893_cov_70",87.034,725,39,20,51,759,2831,2146,0,767,708,685
"73229","Ntome_NODE_25965_length_807_cov_195","Nsylvestris_NODE_20637_length_1055_cov_179",93.3,791,40,6,25,807,212,997,0,1155,782,785
"73250","Ntome_NODE_25976_length_807_cov_21","Nsylvestris_NODE_17403_length_1322_cov_162",87.941,680,66,5,1,675,774,106,0,787,674,668
"73259","Ntome_NODE_25981_length_807_cov_13","Nsylvestris_NODE_20681_length_1051_cov_176",93.269,104,2,1,709,807,363,466,7.15e-35,148,98,103
"73272","Ntome_NODE_25990_length_807_cov_6","Nsylvestris_NODE_1901_length_4114_cov_198",98.182,55,1,0,753,807,951,897,2.63e-19,97.1,54,54
"73275","Ntome_NODE_25992_length_806_cov_177","Nsylvestris_NODE_1101_length_4821_cov_40",90.726,248,21,2,1,247,1165,919,2.37e-89,329,246,246
"73276","Ntome_NODE_25993_length_806_cov_90","Nsylvestris_NODE_22386_length_930_cov_137",92.724,646,33,5,97,732,834,193,0,920,635,641
"73277","Ntome_NODE_25995_length_806_cov_59","Nsylvestris_NODE_19589_length_1135_cov_203",94.34,53,3,0,754,806,300,352,7.34e-15,82.4,52,52
"73283","Ntome_NODE_25998_length_806_cov_40","Nsylvestris_NODE_2541_length_3773_cov_203",100,55,0,0,752,806,3317,3371,5.64e-21,102,54,54
"73287","Ntome_NODE_26001_length_806_cov_25","Nsylvestris_NODE_13028_length_1760_cov_140",93.921,658,27,4,69,723,864,1511,0,981,654,647
"73290","Ntome_NODE_26003_length_806_cov_13","Nsylvestris_NODE_3528_length_3390_cov_199",100,55,0,0,1,55,1970,1916,5.64e-21,102,54,54
"73291","Ntome_NODE_26006_length_806_cov_8","Nsylvestris_NODE_1996_length_4059_cov_106",89.988,819,57,7,1,803,1179,1988,0,1035,802,809
"73294","Ntome_NODE_26011_length_805_cov_278","Nsylvestris_NODE_1316_length_4581_cov_207",99.004,803,8,0,3,805,1736,934,0,1439,802,802
"73303","Ntome_NODE_26014_length_805_cov_255","Nsylvestris_NODE_24739_length_786_cov_194",88.828,367,40,1,305,671,467,102,1.74e-125,449,366,365
"73304","Ntome_NODE_26015_length_805_cov_247","Nsylvestris_NODE_9615_length_2162_cov_237",95.52,759,30,3,49,805,2111,1355,0,1210,756,756
"73305","Ntome_NODE_26016_length_805_cov_240","Nsylvestris_NODE_14262_length_1623_cov_175",94.407,733,32,7,1,726,770,40,0,1118,725,730
"73316","Ntome_NODE_26025_length_805_cov_27","Nsylvestris_NODE_25991_length_718_cov_44",87.353,340,34,3,475,805,1,340,6.46e-105,381,330,339
"73321","Ntome_NODE_26029_length_805_cov_17","Nsylvestris_NODE_16145_length_1435_cov_198",100,55,0,0,1,55,813,867,5.63e-21,102,54,54
"73322","Ntome_NODE_26030_length_805_cov_8","Nsylvestris_NODE_12955_length_1768_cov_69",96.364,55,2,0,751,805,677,731,1.22e-17,91.6,54,54
"73323","Ntome_NODE_26031_length_805_cov_8","Nsylvestris_NODE_5874_length_2789_cov_23",81.481,216,28,7,541,747,1507,1295,1.97e-40,167,206,212
"73324","Ntome_NODE_26032_length_805_cov_8","Nsylvestris_NODE_35640_length_281_cov_3",93.594,281,18,0,208,488,281,1,1.37e-116,420,280,280
"73325","Ntome_NODE_26034_length_805_cov_6","Nsylvestris_NODE_1453_length_4445_cov_232",100,55,0,0,1,55,1105,1159,5.63e-21,102,54,54
"73326","Ntome_NODE_26035_length_805_cov_5","Nsylvestris_NODE_212_length_7274_cov_199",100,55,0,0,1,55,4290,4344,5.63e-21,102,54,54
"73327","Ntome_NODE_26036_length_804_cov_321","Nsylvestris_NODE_1033_length_4895_cov_231",98.259,804,14,0,1,804,858,55,0,1408,803,803
"73331","Ntome_NODE_26038_length_804_cov_249","Nsylvestris_NODE_17468_length_1316_cov_220",92.556,712,29,10,115,804,1316,607,0,1000,689,709
"73344","Ntome_NODE_26045_length_804_cov_106","Nsylvestris_NODE_22216_length_939_cov_46",93.026,717,33,6,2,707,8,718,0,1031,705,710
"73353","Ntome_NODE_26048_length_804_cov_47","Nsylvestris_NODE_5949_length_2768_cov_63",94.349,814,33,7,1,804,1366,556,0,1236,803,810
"73357","Ntome_NODE_26050_length_804_cov_39","Nsylvestris_NODE_4105_length_3201_cov_223",94.545,55,3,0,1,55,73,127,5.66e-16,86.1,54,54
"73364","Ntome_NODE_26054_length_804_cov_20","Nsylvestris_NODE_4804_length_3021_cov_114",94.545,55,3,0,1,55,2644,2698,5.66e-16,86.1,54,54
"73378","Ntome_NODE_26059_length_804_cov_13","Nsylvestris_NODE_2558_length_3766_cov_21",83.218,435,52,15,189,616,3228,3648,2.32e-104,379,427,420
"73382","Ntome_NODE_26062_length_804_cov_7","Nsylvestris_NODE_25963_length_720_cov_174",98.182,55,1,0,750,804,346,400,2.62e-19,97.1,54,54
"73389","Ntome_NODE_26067_length_804_cov_4","Nsylvestris_NODE_272_length_6842_cov_189",100,55,0,0,750,804,1143,1089,5.62e-21,102,54,54
"73390","Ntome_NODE_26068_length_803_cov_291","Nsylvestris_NODE_11565_length_1922_cov_228",96.319,489,17,1,1,489,1231,1718,0,802,488,487
"73391","Ntome_NODE_26069_length_803_cov_281","Nsylvestris_NODE_2388_length_3847_cov_109",97.883,803,17,0,1,803,2620,1818,0,1389,802,802
"73398","Ntome_NODE_26072_length_803_cov_238","Nsylvestris_NODE_22834_length_900_cov_189",95.856,748,20,3,7,752,57,795,0,1199,745,738
"73402","Ntome_NODE_26074_length_803_cov_115","Nsylvestris_NODE_12693_length_1796_cov_170",94.03,804,47,1,1,803,1358,555,0,1218,802,803
"73418","Ntome_NODE_26083_length_803_cov_10","Nsylvestris_NODE_17161_length_1343_cov_144",98.182,55,1,0,1,55,261,315,2.61e-19,97.1,54,54
"73419","Ntome_NODE_26084_length_803_cov_7","Nsylvestris_NODE_1452_length_4447_cov_220",98.182,55,1,0,1,55,1575,1629,2.61e-19,97.1,54,54
"73422","Ntome_NODE_26086_length_803_cov_7","Nsylvestris_NODE_2172_length_3952_cov_96",96.512,516,17,1,20,534,3385,3900,0,852,514,515
"73426","Ntome_NODE_26088_length_802_cov_253","Nsylvestris_NODE_22803_length_902_cov_193",88.075,696,53,12,48,735,849,176,0,798,687,673
"73435","Ntome_NODE_26092_length_802_cov_205","Nsylvestris_NODE_11260_length_1956_cov_33",88.21,704,75,7,102,800,1724,1024,0,833,698,700
"73444","Ntome_NODE_26096_length_802_cov_86","Nsylvestris_NODE_13390_length_1718_cov_124",90.418,814,49,6,1,802,457,1253,0,1044,801,796
"73445","Ntome_NODE_26097_length_802_cov_71","Nsylvestris_NODE_25255_length_757_cov_80",86.857,175,8,7,546,706,320,493,7e-45,182,160,173
"73451","Ntome_NODE_26100_length_802_cov_18","Nsylvestris_NODE_35570_length_283_cov_1",94.7,283,15,0,468,750,1,283,1.05e-122,440,282,282
"73452","Ntome_NODE_26101_length_802_cov_12","Nsylvestris_NODE_30367_length_497_cov_2",83.812,383,59,3,342,723,1,381,8.38e-99,361,381,380
"73456","Ntome_NODE_26103_length_802_cov_8","Nsylvestris_NODE_18368_length_1235_cov_100",96.275,510,19,0,1,510,1104,595,0,837,509,509
"73459","Ntome_NODE_26105_length_802_cov_6","Nsylvestris_NODE_18477_length_1226_cov_73",90.105,475,37,6,95,563,832,362,2.71e-173,608,468,470
"73473","Ntome_NODE_26111_length_801_cov_254","Nsylvestris_NODE_8449_length_2333_cov_141",92.507,734,34,13,69,801,2268,1555,0,1031,732,713
"73477","Ntome_NODE_26114_length_801_cov_82","Nsylvestris_NODE_644_length_5573_cov_192",93.532,804,45,7,1,801,3482,2683,0,1190,800,799
"73487","Ntome_NODE_26117_length_801_cov_35","Nsylvestris_NODE_2214_length_3931_cov_223",100,55,0,0,747,801,3137,3083,5.6e-21,102,54,54
"73504","Ntome_NODE_26123_length_801_cov_12","Nsylvestris_NODE_11187_length_1964_cov_139",98.182,55,1,0,747,801,448,502,2.6e-19,97.1,54,54
"73507","Ntome_NODE_26125_length_801_cov_3","Nsylvestris_NODE_18287_length_1242_cov_57",91.971,822,40,15,1,801,76,892,0,1129,800,816
"73521","Ntome_NODE_26131_length_800_cov_196","Nsylvestris_NODE_8741_length_2289_cov_67",93.228,443,29,1,208,649,175,617,0,651,441,442
"73532","Ntome_NODE_26137_length_800_cov_59","Nsylvestris_NODE_25660_length_735_cov_34",90.093,646,47,10,1,646,723,95,0,822,645,628
"73536","Ntome_NODE_26139_length_800_cov_30","Nsylvestris_NODE_677_length_5498_cov_139",98.182,55,1,0,1,55,2739,2685,2.6e-19,97.1,54,54
"73552","Ntome_NODE_26148_length_800_cov_9","Nsylvestris_NODE_1417_length_4483_cov_166",92.565,807,39,10,1,800,1837,2629,0,1138,799,792
"73555","Ntome_NODE_26151_length_799_cov_254","Nsylvestris_NODE_18148_length_1254_cov_188",97.782,586,12,1,1,585,621,1206,0,1009,584,585
"73556","Ntome_NODE_26152_length_799_cov_206","Nsylvestris_NODE_29544_length_561_cov_189",87.317,205,26,0,249,453,437,233,5.28e-61,235,204,204
"73557","Ntome_NODE_26153_length_799_cov_189","Nsylvestris_NODE_15303_length_1521_cov_62",89.458,683,44,7,46,727,326,981,0,837,681,655
"73558","Ntome_NODE_26154_length_798_cov_174","Nsylvestris_NODE_21812_length_968_cov_145",88.933,750,55,11,23,762,775,44,0,900,739,731
"73573","Ntome_NODE_26162_length_799_cov_18","Nsylvestris_NODE_16840_length_1369_cov_18",88.462,130,11,2,674,799,1082,1211,1.52e-36,154,125,129
"73574","Ntome_NODE_26163_length_799_cov_17","Nsylvestris_NODE_34266_length_314_cov_5",94.983,299,14,1,19,317,13,310,4.78e-131,468,298,297
"73575","Ntome_NODE_26164_length_799_cov_16","Nsylvestris_NODE_4741_length_3035_cov_95",98.182,55,1,0,745,799,384,330,2.6e-19,97.1,54,54
"73626","Ntome_NODE_26188_length_798_cov_14","Nsylvestris_NODE_1894_length_4121_cov_138",93.734,798,31,8,8,798,2122,1337,0,1179,790,785
"73630","Ntome_NODE_26191_length_798_cov_9","Nsylvestris_NODE_8085_length_2389_cov_235",100,55,0,0,744,798,2145,2091,5.58e-21,102,54,54
"73637","Ntome_NODE_26194_length_797_cov_299","Nsylvestris_NODE_168_length_7585_cov_185",95.511,802,20,7,1,792,796,1,0,1267,791,795
"73646","Ntome_NODE_26198_length_797_cov_116","Nsylvestris_NODE_1185_length_4715_cov_120",89.312,683,63,6,95,775,586,1260,0,848,680,674
"73662","Ntome_NODE_26205_length_797_cov_9","Nsylvestris_NODE_10272_length_2079_cov_61",96.496,799,20,2,1,797,804,1596,0,1314,796,792
"73663","Ntome_NODE_26206_length_797_cov_9","Nsylvestris_NODE_9626_length_2161_cov_217",96.364,55,2,0,743,797,992,938,1.21e-17,91.6,54,54
"73671","Ntome_NODE_26210_length_796_cov_276","Nsylvestris_NODE_23536_length_857_cov_208",94.645,691,34,3,53,742,114,802,0,1068,689,688
"73680","Ntome_NODE_26213_length_796_cov_211","Nsylvestris_NODE_27611_length_646_cov_124",92.243,593,31,3,40,619,4,594,0,826,579,590
"73690","Ntome_NODE_26217_length_796_cov_97","Nsylvestris_NODE_11142_length_1970_cov_78",87.312,465,49,6,1,463,771,315,1e-147,523,462,456
"73703","Ntome_NODE_26223_length_796_cov_13","Nsylvestris_NODE_7680_length_2457_cov_82",96.364,55,2,0,1,55,716,662,1.2e-17,91.6,54,54
"73715","Ntome_NODE_26230_length_796_cov_4","Nsylvestris_NODE_19199_length_1168_cov_12",95.801,762,31,1,1,762,252,1012,0,1229,761,760
"73718","Ntome_NODE_26232_length_796_cov_3","Nsylvestris_NODE_61_length_9229_cov_221",95.181,83,4,0,1,83,3340,3258,7.09e-30,132,82,82
"73724","Ntome_NODE_26235_length_795_cov_164","Nsylvestris_NODE_6579_length_2644_cov_175",88.018,676,49,19,137,795,39,699,0,771,658,660
"73727","Ntome_NODE_26237_length_795_cov_89","Nsylvestris_NODE_15998_length_1449_cov_170",81.504,492,80,7,257,744,1154,670,8.18e-109,394,487,484
"73728","Ntome_NODE_26238_length_795_cov_50","Nsylvestris_NODE_2384_length_3848_cov_178",91.521,802,60,7,1,795,3506,2706,0,1098,794,800
"73732","Ntome_NODE_26241_length_795_cov_9","Nsylvestris_NODE_15130_length_1536_cov_213",96.364,55,2,0,741,795,767,713,1.2e-17,91.6,54,54
"73735","Ntome_NODE_26244_length_795_cov_5","Nsylvestris_NODE_9902_length_2128_cov_40",91.687,806,38,12,1,795,2089,1302,0,1090,794,787
"73736","Ntome_NODE_26245_length_795_cov_5","Nsylvestris_NODE_19501_length_1143_cov_205",94.545,55,3,0,1,55,706,760,5.6e-16,86.1,54,54
"73737","Ntome_NODE_26246_length_795_cov_4","Nsylvestris_NODE_4499_length_3100_cov_203",98.182,55,1,0,741,795,879,825,2.58e-19,97.1,54,54
"73741","Ntome_NODE_26248_length_794_cov_287","Nsylvestris_NODE_8238_length_2366_cov_228",92.181,729,31,8,83,793,2315,1595,0,1007,710,720
"73754","Ntome_NODE_26253_length_794_cov_115","Nsylvestris_NODE_2827_length_3648_cov_156",97.567,781,19,0,14,794,3594,2814,0,1338,780,780
"73755","Ntome_NODE_26254_length_794_cov_107","Nsylvestris_NODE_15459_length_1506_cov_225",98.701,77,1,0,718,794,723,647,1.52e-31,137,76,76
"73756","Ntome_NODE_26255_length_794_cov_44","Nsylvestris_NODE_2805_length_3660_cov_185",93.476,797,43,7,1,794,3492,2702,0,1175,793,790
"73770","Ntome_NODE_26262_length_794_cov_12","Nsylvestris_NODE_15329_length_1519_cov_156",94.022,803,38,8,1,794,858,57,0,1208,793,801
"73777","Ntome_NODE_26267_length_794_cov_7","Nsylvestris_NODE_6771_length_2609_cov_200",98.182,55,1,0,1,55,1944,1998,2.58e-19,97.1,54,54
"73780","Ntome_NODE_26269_length_794_cov_6","Nsylvestris_NODE_10381_length_2064_cov_179",100,55,0,0,1,55,980,926,5.55e-21,102,54,54
"73783","Ntome_NODE_26271_length_794_cov_6","Nsylvestris_NODE_1189_length_4711_cov_120",90.339,797,30,15,1,794,2020,2772,0,1002,793,752
"73788","Ntome_NODE_26274_length_793_cov_224","Nsylvestris_NODE_24070_length_827_cov_183",93.234,739,37,6,52,786,748,19,0,1075,734,729
"73794","Ntome_NODE_26276_length_793_cov_155","Nsylvestris_NODE_2653_length_3722_cov_28",90.141,71,5,2,720,789,1931,2000,1.2e-17,91.6,69,69
"73795","Ntome_NODE_26277_length_793_cov_118","Nsylvestris_NODE_3705_length_3333_cov_15",85.938,64,9,0,303,366,1402,1339,5.62e-11,69.4,63,63
"73796","Ntome_NODE_26278_length_793_cov_117","Nsylvestris_NODE_21081_length_1023_cov_16",79.492,551,97,12,190,738,863,327,8.22e-104,377,548,536
"73808","Ntome_NODE_26284_length_793_cov_14","Nsylvestris_NODE_352_length_6468_cov_187",78.426,394,53,19,9,399,4912,4548,8.76e-59,228,390,364
"73813","Ntome_NODE_26288_length_793_cov_11","Nsylvestris_NODE_21982_length_957_cov_31",93.503,708,28,8,3,707,157,849,0,1037,704,692
"73819","Ntome_NODE_26292_length_793_cov_6","Nsylvestris_NODE_19363_length_1154_cov_204",89.024,82,7,2,712,793,423,502,1.99e-20,100,81,79
"73843","Ntome_NODE_26303_length_792_cov_68","Nsylvestris_NODE_4510_length_3096_cov_152",90.873,756,42,15,3,739,809,62,0,989,736,747
"73849","Ntome_NODE_26308_length_792_cov_39","Nsylvestris_NODE_441_length_6140_cov_71",91.071,784,70,0,1,784,2987,3770,0,1061,783,783
"73850","Ntome_NODE_26310_length_792_cov_34","Nsylvestris_NODE_20483_length_1065_cov_211",98.065,672,13,0,1,672,354,1025,0,1170,671,671
"73851","Ntome_NODE_26312_length_792_cov_15","Nsylvestris_NODE_6731_length_2616_cov_84",82.555,321,41,14,466,777,1320,1634,5.16e-71,268,311,314
"73872","Ntome_NODE_26322_length_791_cov_30","Nsylvestris_NODE_23365_length_868_cov_148",90.254,749,41,9,2,750,111,827,0,950,748,716
"73876","Ntome_NODE_26326_length_791_cov_15","Nsylvestris_NODE_19103_length_1175_cov_214",95.918,49,2,0,273,321,426,378,2.59e-14,80.5,48,48
"73877","Ntome_NODE_26327_length_791_cov_12","Nsylvestris_NODE_14538_length_1596_cov_132",84.428,411,45,8,60,459,560,158,1.36e-106,387,399,402
"73878","Ntome_NODE_26329_length_791_cov_8","Nsylvestris_NODE_2750_length_3682_cov_133",90.186,805,59,15,1,791,1470,672,0,1031,790,798
"73888","Ntome_NODE_26336_length_790_cov_224","Nsylvestris_NODE_1724_length_4233_cov_217",96.588,762,17,7,31,790,4226,3472,0,1254,759,754
"73892","Ntome_NODE_26339_length_790_cov_134","Nsylvestris_NODE_22497_length_922_cov_163",94.865,779,31,6,1,778,93,863,0,1208,777,770
"73893","Ntome_NODE_26340_length_790_cov_116","Nsylvestris_NODE_8317_length_2353_cov_168",100,55,0,0,1,55,1204,1258,5.52e-21,102,54,54
"73899","Ntome_NODE_26343_length_790_cov_20","Nsylvestris_NODE_18687_length_1210_cov_210",96.61,59,1,1,1,59,424,481,2.57e-19,97.1,58,57
"73900","Ntome_NODE_26344_length_790_cov_17","Nsylvestris_NODE_2079_length_4005_cov_161",100,55,0,0,1,55,1838,1784,5.52e-21,102,54,54
"73901","Ntome_NODE_26345_length_790_cov_11","Nsylvestris_NODE_32202_length_385_cov_5",88.974,390,24,10,26,402,384,1,6.11e-130,464,376,383
"73902","Ntome_NODE_26348_length_790_cov_8","Nsylvestris_NODE_34231_length_315_cov_5",93.514,185,12,0,1,185,94,278,3.07e-73,276,184,184
"73903","Ntome_NODE_26349_length_790_cov_6","Nsylvestris_NODE_3798_length_3300_cov_236",98.077,52,1,0,1,52,2751,2802,1.19e-17,91.6,51,51
"73907","Ntome_NODE_26351_length_789_cov_261","Nsylvestris_NODE_17452_length_1318_cov_142",92.222,90,6,1,328,416,715,804,3.27e-28,126,88,89
"73917","Ntome_NODE_26356_length_789_cov_138","Nsylvestris_NODE_6502_length_2660_cov_161",84.758,807,59,29,1,781,807,39,0,750,780,768
"73918","Ntome_NODE_26357_length_789_cov_90","Nsylvestris_NODE_19039_length_1180_cov_156",88.688,221,19,5,489,707,607,823,6.64e-70,265,218,216
"73919","Ntome_NODE_26358_length_789_cov_60","Nsylvestris_NODE_28720_length_596_cov_221",86.149,592,27,16,203,784,50,596,3.47e-167,588,581,546
"73920","Ntome_NODE_26359_length_789_cov_50","Nsylvestris_NODE_3295_length_3476_cov_65",89.175,194,12,3,192,378,2349,2540,1.87e-60,233,186,191
"73937","Ntome_NODE_26365_length_789_cov_11","Nsylvestris_NODE_6787_length_2602_cov_219",100,55,0,0,1,55,603,657,5.51e-21,102,54,54
"73944","Ntome_NODE_26370_length_789_cov_6","Nsylvestris_NODE_10464_length_2055_cov_38",91.805,781,56,3,1,781,1939,1167,0,1081,780,772
"73945","Ntome_NODE_26371_length_789_cov_6","Nsylvestris_NODE_1417_length_4483_cov_166",100,55,0,0,735,789,3027,3081,5.51e-21,102,54,54
"73946","Ntome_NODE_26372_length_788_cov_253","Nsylvestris_NODE_24881_length_778_cov_188",91.599,738,49,7,54,784,47,778,0,1007,730,731
"73947","Ntome_NODE_26373_length_788_cov_235","Nsylvestris_NODE_5923_length_2776_cov_136",95.779,616,23,3,3,618,1,613,0,990,615,612
"73948","Ntome_NODE_26374_length_788_cov_200","Nsylvestris_NODE_16085_length_1441_cov_205",94.5,600,20,6,194,788,1392,801,0,913,594,591
"73951","Ntome_NODE_26377_length_788_cov_96","Nsylvestris_NODE_28516_length_605_cov_73",92.322,547,41,1,99,645,55,600,0,776,546,545
"73952","Ntome_NODE_26378_length_788_cov_86","Nsylvestris_NODE_34491_length_308_cov_4",96.753,308,10,0,226,533,308,1,5.97e-145,514,307,307
"73959","Ntome_NODE_26382_length_788_cov_32","Nsylvestris_NODE_1230_length_4672_cov_112",100,55,0,0,1,55,4010,4064,5.51e-21,102,54,54
"73971","Ntome_NODE_26386_length_788_cov_16","Nsylvestris_NODE_14151_length_1635_cov_124",100,55,0,0,734,788,774,720,5.51e-21,102,54,54
"73972","Ntome_NODE_26387_length_788_cov_11","Nsylvestris_NODE_31556_length_416_cov_10",79.397,199,35,6,177,372,205,10,5.43e-31,135,195,195
"73975","Ntome_NODE_26390_length_788_cov_3","Nsylvestris_NODE_5793_length_2801_cov_213",98.182,55,1,0,734,788,1566,1512,2.56e-19,97.1,54,54
"73976","Ntome_NODE_26391_length_780_cov_292","Nsylvestris_NODE_18497_length_1224_cov_195",94.189,740,31,5,1,739,417,1145,0,1118,738,728
"73980","Ntome_NODE_26393_length_787_cov_231","Nsylvestris_NODE_7764_length_2443_cov_94",97.834,785,17,0,3,787,1145,1929,0,1356,784,784
"73997","Ntome_NODE_26401_length_787_cov_27","Nsylvestris_NODE_176_length_7526_cov_167",98.182,55,1,0,1,55,5111,5165,2.56e-19,97.1,54,54
"73998","Ntome_NODE_26402_length_787_cov_26","Nsylvestris_NODE_2829_length_3648_cov_97",96.696,787,24,2,1,787,2997,2213,0,1308,786,784
"73999","Ntome_NODE_26404_length_787_cov_18","Nsylvestris_NODE_12776_length_1789_cov_110",84.606,799,101,8,1,787,1550,762,0,774,786,788
"74008","Ntome_NODE_26410_length_785_cov_3","Nsylvestris_NODE_60_length_9257_cov_109",97.727,44,1,0,1,44,6884,6927,3.32e-13,76.8,43,43
"74009","Ntome_NODE_26411_length_786_cov_267","Nsylvestris_NODE_2541_length_3773_cov_203",98.219,786,14,0,1,786,1128,343,0,1375,785,785
"74019","Ntome_NODE_26417_length_786_cov_36","Nsylvestris_NODE_26030_length_717_cov_33",93.494,707,43,3,1,706,1,705,0,1048,705,704
"74024","Ntome_NODE_26421_length_786_cov_12","Nsylvestris_NODE_810_length_5230_cov_73",98.182,55,1,0,732,786,669,723,2.55e-19,97.1,54,54
"74025","Ntome_NODE_26422_length_786_cov_9","Nsylvestris_NODE_32602_length_367_cov_201",98.182,55,1,0,1,55,161,107,2.55e-19,97.1,54,54
"74026","Ntome_NODE_26423_length_786_cov_8","Nsylvestris_NODE_1473_length_4423_cov_120",91.831,759,51,9,1,753,1894,2647,0,1048,752,753
"74033","Ntome_NODE_26427_length_786_cov_7","Nsylvestris_NODE_5707_length_2819_cov_116",96.835,790,18,4,1,786,1165,1951,0,1314,785,786
"74048","Ntome_NODE_26432_length_785_cov_229","Nsylvestris_NODE_11878_length_1882_cov_189",91.495,776,37,9,1,776,1134,1880,0,1040,775,746
"74049","Ntome_NODE_26433_length_785_cov_229","Nsylvestris_NODE_8689_length_2296_cov_66",95.866,629,26,0,1,629,1468,840,0,1018,628,628
"74050","Ntome_NODE_26434_length_785_cov_228","Nsylvestris_NODE_17352_length_1327_cov_101",93.32,494,25,7,150,637,598,107,0,723,487,491
"74051","Ntome_NODE_26435_length_785_cov_185","Nsylvestris_NODE_7745_length_2445_cov_170",92.923,650,26,7,150,785,1,644,0,928,635,643
"74052","Ntome_NODE_26436_length_785_cov_185","Nsylvestris_NODE_27617_length_646_cov_17",96.604,589,20,0,60,648,3,591,0,977,588,588
"74070","Ntome_NODE_26448_length_785_cov_6","Nsylvestris_NODE_1996_length_4059_cov_106",90.446,785,35,9,4,785,2903,2156,0,998,781,747
"74081","Ntome_NODE_26453_length_784_cov_221","Nsylvestris_NODE_27363_length_657_cov_233",90.858,536,20,6,60,567,636,102,0,691,507,534
"74086","Ntome_NODE_26457_length_784_cov_106","Nsylvestris_NODE_3839_length_3289_cov_119",89.871,464,23,12,16,475,2798,3241,2.68e-163,575,459,443
"74093","Ntome_NODE_26462_length_784_cov_36","Nsylvestris_NODE_23131_length_883_cov_56",93.182,440,25,5,204,643,328,762,0,641,439,434
"74096","Ntome_NODE_26464_length_784_cov_33","Nsylvestris_NODE_9004_length_2250_cov_161",84.733,131,12,2,83,213,123,1,1.17e-27,124,130,122
"74099","Ntome_NODE_26466_length_784_cov_20","Nsylvestris_NODE_13147_length_1744_cov_189",97.959,49,1,0,736,784,1199,1151,5.52e-16,86.1,48,48
"74114","Ntome_NODE_26476_length_784_cov_7","Nsylvestris_NODE_2893_length_3623_cov_227",98.182,55,1,0,1,55,712,766,2.55e-19,97.1,54,54
"74120","Ntome_NODE_26480_length_784_cov_3","Nsylvestris_NODE_11_length_12805_cov_33",80.518,657,124,4,123,777,5512,6166,4.62e-141,501,654,654
"74127","Ntome_NODE_26483_length_783_cov_271","Nsylvestris_NODE_6882_length_2587_cov_230",95.873,727,28,1,59,783,1,727,0,1175,724,726
"74128","Ntome_NODE_26484_length_783_cov_252","Nsylvestris_NODE_2791_length_3666_cov_87",93.207,736,20,9,1,729,2954,3666,0,1055,728,712
"74147","Ntome_NODE_26493_length_783_cov_6","Nsylvestris_NODE_34674_length_303_cov_5",92.739,303,21,1,309,610,1,303,1.32e-121,436,301,302
"74148","Ntome_NODE_26494_length_783_cov_5","Nsylvestris_NODE_24316_length_812_cov_5",96.028,705,21,2,1,705,115,812,0,1140,704,697
"74160","Ntome_NODE_26499_length_782_cov_89","Nsylvestris_NODE_12497_length_1815_cov_218",98.182,55,1,0,1,55,254,308,2.54e-19,97.1,54,54
"74163","Ntome_NODE_26502_length_782_cov_39","Nsylvestris_NODE_31182_length_439_cov_10",88.889,468,18,8,167,632,4,439,2.1e-154,545,465,435
"74179","Ntome_NODE_26508_length_782_cov_20","Nsylvestris_NODE_14100_length_1640_cov_134",98.039,51,1,0,729,779,668,718,4.25e-17,89.8,50,50
"74183","Ntome_NODE_26510_length_782_cov_5","Nsylvestris_NODE_24373_length_808_cov_185",100,53,0,0,728,780,140,88,7.07e-20,99,52,52
"74184","Ntome_NODE_26511_length_782_cov_4","Nsylvestris_NODE_6768_length_2609_cov_100",95.182,768,37,0,1,768,1601,2368,0,1214,767,767
"74208","Ntome_NODE_26522_length_781_cov_48","Nsylvestris_NODE_29394_length_567_cov_112",92.339,496,21,7,286,781,504,26,0,689,495,478
"74217","Ntome_NODE_26526_length_781_cov_18","Nsylvestris_NODE_25312_length_754_cov_26",89.03,237,24,1,405,639,570,334,3.02e-78,292,234,236
"74218","Ntome_NODE_26527_length_781_cov_13","Nsylvestris_NODE_20391_length_1072_cov_9",91.667,120,10,0,20,139,73,192,1.91e-40,167,119,119
"74226","Ntome_NODE_26531_length_781_cov_10","Nsylvestris_NODE_24850_length_781_cov_4",74.302,179,44,2,73,250,351,528,1.19e-12,75,177,177
"74231","Ntome_NODE_26534_length_780_cov_248","Nsylvestris_NODE_20354_length_1073_cov_157",96.532,692,23,1,35,725,335,1026,0,1144,690,691
"74234","Ntome_NODE_26536_length_780_cov_188","Nsylvestris_NODE_11654_length_1913_cov_152",84.127,252,16,12,416,664,42,272,4.01e-57,222,248,230
"74239","Ntome_NODE_26539_length_780_cov_57","Nsylvestris_NODE_93_length_8521_cov_68",95.128,780,38,0,1,780,5582,6361,0,1230,779,779
"74240","Ntome_NODE_26540_length_780_cov_25","Nsylvestris_NODE_4391_length_3128_cov_211",92.754,69,3,2,713,780,2608,2541,7.05e-20,99,67,67
"74241","Ntome_NODE_26541_length_780_cov_20","Nsylvestris_NODE_11031_length_1983_cov_219",98.182,55,1,0,726,780,1119,1065,2.53e-19,97.1,54,54
"74244","Ntome_NODE_26543_length_780_cov_15","Nsylvestris_NODE_2297_length_3894_cov_189",100,55,0,0,1,55,1126,1180,5.45e-21,102,54,54
"74245","Ntome_NODE_26544_length_780_cov_13","Nsylvestris_NODE_1674_length_4270_cov_208",94.545,55,3,0,1,55,2401,2347,5.49e-16,86.1,54,54
"74246","Ntome_NODE_26545_length_780_cov_13","Nsylvestris_NODE_23782_length_844_cov_13",95.367,777,27,1,4,780,844,77,0,1227,776,767
"74253","Ntome_NODE_26548_length_780_cov_12","Nsylvestris_NODE_35919_length_275_cov_3",87.008,254,31,1,193,444,2,255,5.04e-76,285,251,253
"74254","Ntome_NODE_26550_length_780_cov_10","Nsylvestris_NODE_33750_length_329_cov_7",84.277,159,19,5,323,478,2,157,1.92e-35,150,155,155
"74255","Ntome_NODE_26551_length_780_cov_10","Nsylvestris_NODE_10870_length_2004_cov_228",100,29,0,0,725,753,351,379,1.55e-06,54.7,28,28
"74259","Ntome_NODE_26554_length_779_cov_314","Nsylvestris_NODE_3075_length_3551_cov_119",96.164,782,27,1,1,779,2847,2066,0,1275,778,781
"74268","Ntome_NODE_26558_length_779_cov_69","Nsylvestris_NODE_5710_length_2818_cov_166",86.806,811,58,26,1,779,1569,2362,0,859,778,793
"74269","Ntome_NODE_26559_length_779_cov_49","Nsylvestris_NODE_22739_length_906_cov_99",85.553,443,22,15,292,729,129,534,2.84e-118,425,437,405
"74270","Ntome_NODE_26560_length_779_cov_33","Nsylvestris_NODE_24016_length_831_cov_45",76.111,720,104,37,76,768,102,780,6.42e-85,315,692,678
"74275","Ntome_NODE_26563_length_779_cov_13","Nsylvestris_NODE_729_length_5389_cov_212",100,55,0,0,1,55,179,233,5.44e-21,102,54,54
"74280","Ntome_NODE_26571_length_778_cov_257","Nsylvestris_NODE_30632_length_476_cov_19",89.955,448,38,6,153,596,476,32,3.45e-162,571,443,444
"74281","Ntome_NODE_26573_length_778_cov_236","Nsylvestris_NODE_25573_length_740_cov_198",93.235,680,29,6,4,683,724,62,0,985,679,662
"74288","Ntome_NODE_26578_length_778_cov_22","Nsylvestris_NODE_29146_length_577_cov_11",96.007,576,22,1,98,672,2,577,0,935,574,575
"74295","Ntome_NODE_26585_length_778_cov_9","Nsylvestris_NODE_14740_length_1575_cov_216",77.056,231,40,11,453,677,389,166,1.5e-26,121,224,223
"74302","Ntome_NODE_26592_length_778_cov_4","Nsylvestris_NODE_25806_length_728_cov_12",88.01,417,29,9,370,765,525,109,9.99e-133,473,395,416
"74310","Ntome_NODE_26595_length_777_cov_220","Nsylvestris_NODE_4035_length_3222_cov_193",96.364,55,2,0,723,777,808,862,1.17e-17,91.6,54,54
"74311","Ntome_NODE_26596_length_777_cov_208","Nsylvestris_NODE_23430_length_864_cov_162",91.395,674,27,6,83,746,56,708,0,894,663,652
"74323","Ntome_NODE_26605_length_777_cov_27","Nsylvestris_NODE_9298_length_2207_cov_214",96.364,55,2,0,1,55,1278,1224,1.17e-17,91.6,54,54
"74324","Ntome_NODE_26606_length_777_cov_21","Nsylvestris_NODE_93_length_8521_cov_68",88.846,780,84,1,1,777,5582,6361,0,955,776,779
"74325","Ntome_NODE_26608_length_777_cov_19","Nsylvestris_NODE_9375_length_2197_cov_176",100,54,0,0,1,54,1029,1082,1.95e-20,100,53,53
"74332","Ntome_NODE_26612_length_777_cov_15","Nsylvestris_NODE_14407_length_1609_cov_211",98.182,55,1,0,723,777,857,803,2.52e-19,97.1,54,54
"74333","Ntome_NODE_26613_length_777_cov_15","Nsylvestris_NODE_14939_length_1556_cov_107",92.636,679,48,1,71,749,273,949,0,976,678,676
"74334","Ntome_NODE_26614_length_777_cov_13","Nsylvestris_NODE_61_length_9229_cov_221",92.553,188,12,2,1,187,5933,5747,5.06e-71,268,186,186
"74341","Ntome_NODE_26619_length_777_cov_7","Nsylvestris_NODE_8327_length_2351_cov_151",85.106,517,44,10,271,770,1765,2265,5.92e-140,497,499,500
"74342","Ntome_NODE_26621_length_777_cov_5","Nsylvestris_NODE_33259_length_344_cov_4",94.783,345,17,1,270,614,344,1,1.26e-151,536,344,343
"74346","Ntome_NODE_26623_length_776_cov_247","Nsylvestris_NODE_20289_length_1078_cov_101",94.993,679,28,2,48,723,113,788,0,1061,675,675
"74347","Ntome_NODE_26624_length_776_cov_206","Nsylvestris_NODE_9752_length_2146_cov_225",93.472,720,31,5,51,763,2071,1361,0,1055,712,710
"74348","Ntome_NODE_26625_length_776_cov_141","Nsylvestris_NODE_15012_length_1549_cov_80",91.304,713,34,7,1,708,837,1526,0,948,707,689
"74349","Ntome_NODE_26626_length_776_cov_90","Nsylvestris_NODE_25862_length_725_cov_125",90.698,645,16,14,110,736,104,722,0,819,626,618
"74355","Ntome_NODE_26631_length_776_cov_32","Nsylvestris_NODE_2117_length_3980_cov_224",98.182,55,1,0,722,776,735,789,2.52e-19,97.1,54,54
"74358","Ntome_NODE_26633_length_776_cov_27","Nsylvestris_NODE_6754_length_2611_cov_227",96.364,55,2,0,1,55,591,645,1.17e-17,91.6,54,54
"74362","Ntome_NODE_26635_length_776_cov_24","Nsylvestris_NODE_6926_length_2581_cov_89",93.79,789,32,8,1,776,1710,926,0,1170,775,784
"74369","Ntome_NODE_26638_length_776_cov_17","Nsylvestris_NODE_903_length_5085_cov_225",93.22,59,4,0,1,59,4719,4661,1.52e-16,87.9,58,58
"74372","Ntome_NODE_26640_length_775_cov_9","Nsylvestris_NODE_6853_length_2594_cov_14",93.256,771,49,3,3,771,1385,616,0,1133,768,769
"74375","Ntome_NODE_26642_length_776_cov_7","Nsylvestris_NODE_17607_length_1294_cov_175",100,55,0,0,722,776,1023,969,5.42e-21,102,54,54
"74378","Ntome_NODE_26645_length_776_cov_2","Nsylvestris_NODE_13958_length_1656_cov_14",91.478,575,24,18,225,776,945,1517,0,767,551,572
"74383","Ntome_NODE_26647_length_775_cov_227","Nsylvestris_NODE_23616_length_853_cov_159",94.35,761,22,10,31,775,28,783,0,1147,744,755
"74384","Ntome_NODE_26648_length_775_cov_184","Nsylvestris_NODE_22560_length_918_cov_111",95.751,659,24,3,54,710,800,144,0,1059,656,656
"74391","Ntome_NODE_26652_length_775_cov_74","Nsylvestris_NODE_13792_length_1672_cov_45",89.833,777,73,5,1,775,626,1398,0,992,774,772
"74410","Ntome_NODE_26660_length_775_cov_12","Nsylvestris_NODE_14147_length_1635_cov_199",96.364,55,2,0,1,55,1297,1351,1.17e-17,91.6,54,54
"74411","Ntome_NODE_26661_length_775_cov_10","Nsylvestris_NODE_26633_length_690_cov_11",87.243,243,17,6,539,775,235,1,6.52e-70,265,236,234
"74412","Ntome_NODE_26662_length_775_cov_8","Nsylvestris_NODE_5643_length_2829_cov_237",100,55,0,0,721,775,2030,2084,5.41e-21,102,54,54
"74425","Ntome_NODE_26668_length_774_cov_132","Nsylvestris_NODE_24855_length_780_cov_137",89.077,531,36,10,136,659,70,585,0,640,523,515
"74435","Ntome_NODE_26675_length_774_cov_22","Nsylvestris_NODE_19360_length_1154_cov_220",98.182,55,1,0,720,774,806,752,2.51e-19,97.1,54,54
"74436","Ntome_NODE_26676_length_774_cov_17","Nsylvestris_NODE_14087_length_1640_cov_181",94.545,55,3,0,1,55,1419,1365,5.44e-16,86.1,54,54
"74442","Ntome_NODE_26681_length_774_cov_6","Nsylvestris_NODE_14398_length_1610_cov_201",96.364,55,2,0,720,774,407,461,1.17e-17,91.6,54,54
"74443","Ntome_NODE_26682_length_774_cov_5","Nsylvestris_NODE_4113_length_3198_cov_172",98.182,55,1,0,720,774,471,417,2.51e-19,97.1,54,54
"74444","Ntome_NODE_26683_length_774_cov_3","Nsylvestris_NODE_3200_length_3506_cov_27",97.419,775,18,2,1,774,2336,1563,0,1319,773,773
"74458","Ntome_NODE_26690_length_773_cov_214","Nsylvestris_NODE_27882_length_633_cov_212",95.495,444,15,2,99,541,54,493,0,704,442,439
"74463","Ntome_NODE_26692_length_773_cov_100","Nsylvestris_NODE_23685_length_849_cov_190",97.426,544,14,0,51,594,306,849,0,928,543,543
"74474","Ntome_NODE_26697_length_773_cov_34","Nsylvestris_NODE_36283_length_267_cov_2",95.506,267,12,0,289,555,267,1,7.84e-119,427,266,266
"74485","Ntome_NODE_26702_length_773_cov_14","Nsylvestris_NODE_12559_length_1808_cov_218",98.182,55,1,0,1,55,1190,1136,2.51e-19,97.1,54,54
"74486","Ntome_NODE_26703_length_773_cov_13","Nsylvestris_NODE_22664_length_911_cov_227",98.039,51,1,0,723,773,667,717,4.2e-17,89.8,50,50
"74491","Ntome_NODE_26709_length_773_cov_6","Nsylvestris_NODE_765_length_5309_cov_228",100,55,0,0,719,773,4310,4364,5.4e-21,102,54,54
"74492","Ntome_NODE_26711_length_772_cov_292","Nsylvestris_NODE_7777_length_2440_cov_193",91.576,736,38,10,1,731,1648,932,0,994,730,716
"74517","Ntome_NODE_26724_length_772_cov_9","Nsylvestris_NODE_789_length_5255_cov_204",94.828,58,3,0,1,58,1767,1710,1.17e-17,91.6,57,57
"74518","Ntome_NODE_26725_length_772_cov_8","Nsylvestris_NODE_2559_length_3769_cov_117",98.333,60,1,0,257,316,2521,2462,4.17e-22,106,59,59
"74522","Ntome_NODE_26727_length_772_cov_5","Nsylvestris_NODE_32352_length_379_cov_2",93.298,373,19,1,194,560,377,5,2.07e-154,545,366,372
"74523","Ntome_NODE_26728_length_772_cov_4","Nsylvestris_NODE_10122_length_2100_cov_199",98.182,55,1,0,718,772,1440,1494,2.51e-19,97.1,54,54
"74524","Ntome_NODE_26729_length_771_cov_155","Nsylvestris_NODE_18000_length_1268_cov_207",85.251,617,30,14,184,771,630,46,2.04e-164,579,587,584
"74542","Ntome_NODE_26736_length_771_cov_25","Nsylvestris_NODE_5198_length_2926_cov_170",96.368,771,14,5,1,771,1733,977,0,1256,770,756
"74551","Ntome_NODE_26740_length_771_cov_4","Nsylvestris_NODE_4970_length_2981_cov_8",97.147,771,22,0,1,771,2600,1830,0,1303,770,770
"74552","Ntome_NODE_26741_length_771_cov_4","Nsylvestris_NODE_8600_length_2309_cov_166",100,55,0,0,1,55,1703,1649,5.38e-21,102,54,54
"74553","Ntome_NODE_26742_length_770_cov_315","Nsylvestris_NODE_2240_length_3918_cov_233",97.662,770,18,0,1,770,2318,3087,0,1323,769,769
"74561","Ntome_NODE_26745_length_770_cov_239","Nsylvestris_NODE_13271_length_1731_cov_115",87.459,606,29,15,200,766,1638,1041,0,654,566,597
"74582","Ntome_NODE_26752_length_770_cov_51","Nsylvestris_NODE_23672_length_850_cov_69",86.839,775,43,20,3,770,796,74,0,811,767,722
"74601","Ntome_NODE_26760_length_770_cov_13","Nsylvestris_NODE_11535_length_1926_cov_123",96.143,726,23,3,47,770,1160,1882,0,1181,723,722
"74602","Ntome_NODE_26761_length_770_cov_12","Nsylvestris_NODE_7795_length_2437_cov_161",96.61,59,1,1,1,58,1576,1634,2.5e-19,97.1,57,58
"74603","Ntome_NODE_26762_length_770_cov_12","Nsylvestris_NODE_1440_length_4458_cov_209",100,55,0,0,1,55,2173,2227,5.38e-21,102,54,54
"74612","Ntome_NODE_26767_length_769_cov_263","Nsylvestris_NODE_5298_length_2906_cov_162",88.517,688,24,15,1,651,676,7,0,782,650,669
"74622","Ntome_NODE_26770_length_769_cov_52","Nsylvestris_NODE_7604_length_2470_cov_104",98.077,104,1,1,53,156,2161,2059,2.41e-44,180,103,102
"74623","Ntome_NODE_26771_length_769_cov_33","Nsylvestris_NODE_10523_length_2048_cov_52",100,29,0,0,51,79,310,338,1.52e-06,54.7,28,28
"74624","Ntome_NODE_26772_length_769_cov_27","Nsylvestris_NODE_14190_length_1631_cov_85",79.016,386,55,12,299,681,860,1222,1.09e-62,241,382,362
"74636","Ntome_NODE_26779_length_769_cov_9","Nsylvestris_NODE_259_length_6942_cov_110",98.113,53,1,0,717,769,677,625,3.23e-18,93.5,52,52
"74639","Ntome_NODE_26781_length_769_cov_8","Nsylvestris_NODE_4409_length_3122_cov_20",97.659,769,18,0,1,769,405,1173,0,1321,768,768
"74648","Ntome_NODE_26786_length_768_cov_169","Nsylvestris_NODE_23192_length_879_cov_133",92.056,642,17,5,1,626,198,821,0,872,625,623
"74651","Ntome_NODE_26788_length_768_cov_104","Nsylvestris_NODE_26426_length_699_cov_102",92.521,361,27,0,128,488,290,650,4.49e-146,518,360,360
"74652","Ntome_NODE_26789_length_768_cov_56","Nsylvestris_NODE_35162_length_291_cov_8",82.237,152,23,4,93,242,218,69,8.84e-29,128,149,149
"74653","Ntome_NODE_26790_length_768_cov_49","Nsylvestris_NODE_555_length_5813_cov_95",96.667,60,1,1,1,60,5206,5264,6.93e-20,99,59,58
"74654","Ntome_NODE_26791_length_768_cov_49","Nsylvestris_NODE_953_length_5012_cov_141",96.364,55,2,0,714,768,1175,1229,1.16e-17,91.6,54,54
"74655","Ntome_NODE_26792_length_768_cov_47","Nsylvestris_NODE_8002_length_2403_cov_161",97.135,768,19,1,1,768,2101,1337,0,1293,767,764
"74661","Ntome_NODE_26795_length_768_cov_8","Nsylvestris_NODE_27807_length_638_cov_3",87.2,250,28,4,444,691,280,527,6.42e-75,281,247,247
"74662","Ntome_NODE_26796_length_768_cov_6","Nsylvestris_NODE_22327_length_933_cov_59",93.447,763,41,1,1,763,172,925,0,1123,762,753
"74679","Ntome_NODE_26804_length_766_cov_101","Nsylvestris_NODE_2775_length_3673_cov_218",92.308,598,26,8,26,620,3673,3093,0,832,594,580
"74689","Ntome_NODE_26809_length_767_cov_39","Nsylvestris_NODE_5521_length_2858_cov_79",85.271,129,18,1,640,767,2035,2163,6.83e-30,132,127,128
"74690","Ntome_NODE_26810_length_767_cov_37","Nsylvestris_NODE_6087_length_2740_cov_231",93.443,61,3,1,708,767,2157,2097,4.17e-17,89.8,59,60
"74691","Ntome_NODE_26811_length_767_cov_35","Nsylvestris_NODE_5771_length_2806_cov_126",89.809,785,61,7,1,767,1175,1958,0,989,766,783
"74692","Ntome_NODE_26813_length_767_cov_30","Nsylvestris_NODE_27839_length_636_cov_15",92.763,152,11,0,616,767,477,326,1.42e-56,220,151,151
"74696","Ntome_NODE_26819_length_767_cov_11","Nsylvestris_NODE_1266_length_4625_cov_73",96.296,54,2,0,2,55,1625,1678,4.17e-17,89.8,53,53
"74697","Ntome_NODE_26820_length_767_cov_9","Nsylvestris_NODE_2920_length_3613_cov_81",92.774,775,45,4,1,765,3242,2469,0,1110,764,773
"74698","Ntome_NODE_26822_length_767_cov_6","Nsylvestris_NODE_22288_length_936_cov_213",100,55,0,0,1,55,274,220,5.35e-21,102,54,54
"74710","Ntome_NODE_26829_length_766_cov_257","Nsylvestris_NODE_1924_length_4097_cov_211",90.526,570,42,7,1,566,2133,2694,0,743,565,561
"74730","Ntome_NODE_26838_length_766_cov_58","Nsylvestris_NODE_11328_length_1948_cov_214",98.182,55,1,0,712,766,1768,1714,2.49e-19,97.1,54,54
"74734","Ntome_NODE_26840_length_766_cov_23","Nsylvestris_NODE_2844_length_3639_cov_215",100,55,0,0,712,766,1104,1050,5.35e-21,102,54,54
"74744","Ntome_NODE_26846_length_766_cov_7","Nsylvestris_NODE_22970_length_893_cov_87",92.598,689,47,4,30,716,802,116,0,987,686,686
"74745","Ntome_NODE_26847_length_766_cov_6","Nsylvestris_NODE_7337_length_2514_cov_162",98.182,55,1,0,1,55,2042,2096,2.49e-19,97.1,54,54
"74746","Ntome_NODE_26848_length_766_cov_3","Nsylvestris_NODE_14287_length_1621_cov_204",96.364,55,2,0,1,55,941,995,1.16e-17,91.6,54,54
"74747","Ntome_NODE_26849_length_765_cov_283","Nsylvestris_NODE_19745_length_1123_cov_189",94.538,714,29,5,52,765,978,275,0,1094,713,703
"74762","Ntome_NODE_26856_length_765_cov_202","Nsylvestris_NODE_8942_length_2258_cov_127",95.482,664,28,2,55,718,2211,1550,0,1059,663,661
"74781","Ntome_NODE_26866_length_765_cov_21","Nsylvestris_NODE_15116_length_1539_cov_57",94.118,68,4,0,526,593,1407,1340,1.48e-21,104,67,67
"74786","Ntome_NODE_26870_length_765_cov_11","Nsylvestris_NODE_493_length_5980_cov_105",94.545,55,3,0,711,765,4035,3981,5.38e-16,86.1,54,54
"74792","Ntome_NODE_26873_length_765_cov_5","Nsylvestris_NODE_7267_length_2524_cov_145",86.425,663,81,9,87,747,1673,2328,0,717,660,655
"74793","Ntome_NODE_26874_length_765_cov_4","Nsylvestris_NODE_28092_length_625_cov_3",90.02,491,24,5,1,485,148,619,1.99e-174,612,484,471
"74794","Ntome_NODE_26875_length_765_cov_3","Nsylvestris_NODE_6044_length_2751_cov_112",80.233,86,12,3,667,751,511,592,3.26e-08,60.2,84,81
"74809","Ntome_NODE_26881_length_764_cov_67","Nsylvestris_NODE_11960_length_1874_cov_191",98.182,55,1,0,710,764,1288,1342,2.48e-19,97.1,54,54
"74821","Ntome_NODE_26887_length_764_cov_20","Nsylvestris_NODE_5038_length_2963_cov_179",88.832,788,42,11,1,764,1025,260,0,926,763,765
"74827","Ntome_NODE_26892_length_764_cov_11","Nsylvestris_NODE_13122_length_1748_cov_119",98.182,55,1,0,1,55,788,842,2.48e-19,97.1,54,54
"74828","Ntome_NODE_26893_length_764_cov_10","Nsylvestris_NODE_15329_length_1519_cov_156",93.266,594,26,5,175,764,1463,880,0,863,589,583
"74837","Ntome_NODE_26901_length_763_cov_263","Nsylvestris_NODE_21119_length_1020_cov_167",92.105,760,23,10,25,763,2,745,0,1037,738,743
"74844","Ntome_NODE_26905_length_763_cov_167","Nsylvestris_NODE_23880_length_839_cov_173",96.828,725,22,1,29,753,795,72,0,1210,724,723
"74849","Ntome_NODE_26908_length_763_cov_81","Nsylvestris_NODE_6366_length_2685_cov_94",89.651,773,58,15,1,763,1349,2109,0,965,762,760
"74857","Ntome_NODE_26911_length_763_cov_39","Nsylvestris_NODE_15239_length_1528_cov_19",92.05,239,11,3,78,308,4,242,2.24e-89,329,230,238
"74861","Ntome_NODE_26913_length_763_cov_17","Nsylvestris_NODE_6999_length_2569_cov_214",100,55,0,0,709,763,2067,2013,5.32e-21,102,54,54
"74870","Ntome_NODE_26919_length_762_cov_239","Nsylvestris_NODE_28674_length_598_cov_223",92.308,598,25,9,9,597,7,592,0,830,588,585
"74884","Ntome_NODE_26925_length_764_cov_69","Nsylvestris_NODE_18511_length_1223_cov_236",95.513,156,7,0,1,156,342,497,1.8e-65,250,155,155
"74887","Ntome_NODE_26928_length_762_cov_31","Nsylvestris_NODE_25538_length_742_cov_15",89.909,773,36,15,1,762,742,1,0,957,761,741
"74888","Ntome_NODE_26929_length_762_cov_27","Nsylvestris_NODE_6022_length_2756_cov_185",83.117,231,26,8,10,231,263,37,6.59e-50,198,221,226
"74889","Ntome_NODE_26930_length_762_cov_22","Nsylvestris_NODE_7624_length_2467_cov_89",81.992,261,32,9,217,465,397,140,1.1e-52,207,248,257
"74900","Ntome_NODE_26935_length_762_cov_13","Nsylvestris_NODE_18781_length_1203_cov_217",100,55,0,0,708,762,465,411,5.32e-21,102,54,54
"74904","Ntome_NODE_26937_length_762_cov_13","Nsylvestris_NODE_9561_length_2168_cov_212",98.182,55,1,0,1,55,1273,1327,2.47e-19,97.1,54,54
"74905","Ntome_NODE_26938_length_762_cov_13","Nsylvestris_NODE_2081_length_4005_cov_81",75.419,537,106,16,38,568,2743,3259,1.4e-61,237,530,516
"74913","Ntome_NODE_26941_length_762_cov_7","Nsylvestris_NODE_2303_length_3891_cov_208",100,55,0,0,708,762,1203,1149,5.32e-21,102,54,54
"74920","Ntome_NODE_26948_length_761_cov_189","Nsylvestris_NODE_8894_length_2264_cov_154",93.523,772,30,10,1,761,890,1652,0,1131,760,762
"74921","Ntome_NODE_26949_length_761_cov_185","Nsylvestris_NODE_21881_length_963_cov_50",100,45,0,0,5,49,834,790,1.92e-15,84.2,44,44
"74954","Ntome_NODE_26963_length_760_cov_234","Nsylvestris_NODE_561_length_5798_cov_199",93.098,652,29,3,26,661,733,82,0,941,635,651
"74955","Ntome_NODE_26964_length_760_cov_226","Nsylvestris_NODE_11065_length_1980_cov_194",91.828,722,38,11,49,760,1977,1267,0,987,711,710
"74963","Ntome_NODE_26968_length_760_cov_53","Nsylvestris_NODE_4439_length_3112_cov_79",100,55,0,0,706,760,2298,2244,5.3e-21,102,54,54
"74964","Ntome_NODE_26969_length_760_cov_49","Nsylvestris_NODE_25206_length_760_cov_19",94.362,745,36,3,19,760,1,742,0,1138,741,741
"74973","Ntome_NODE_26975_length_760_cov_15","Nsylvestris_NODE_1560_length_4354_cov_201",96.364,55,2,0,1,55,1332,1386,1.15e-17,91.6,54,54
"74982","Ntome_NODE_26981_length_759_cov_237","Nsylvestris_NODE_21876_length_963_cov_224",96.244,639,18,2,127,759,49,687,0,1042,632,638
"74997","Ntome_NODE_26986_length_759_cov_48","Nsylvestris_NODE_24674_length_790_cov_71",91.304,759,30,6,1,759,745,23,0,1003,758,722
"74998","Ntome_NODE_26987_length_759_cov_45","Nsylvestris_NODE_483_length_6004_cov_227",96.721,61,2,0,699,759,5909,5969,5.3e-21,102,60,60
"74999","Ntome_NODE_26988_length_759_cov_34","Nsylvestris_NODE_7289_length_2521_cov_78",93.721,653,32,5,18,663,720,1370,0,970,645,650
"75000","Ntome_NODE_26989_length_759_cov_33","Nsylvestris_NODE_13346_length_1724_cov_159",98.182,55,1,0,705,759,727,781,2.46e-19,97.1,54,54
"75001","Ntome_NODE_26992_length_759_cov_10","Nsylvestris_NODE_4103_length_3201_cov_228",98.182,55,1,0,705,759,1303,1357,2.46e-19,97.1,54,54
"75004","Ntome_NODE_26997_length_758_cov_228","Nsylvestris_NODE_10010_length_2114_cov_49",84.505,555,44,17,1,519,357,905,7.42e-144,510,518,548
"75009","Ntome_NODE_27000_length_758_cov_182","Nsylvestris_NODE_30015_length_526_cov_19",86.111,540,35,14,140,655,524,1,2.03e-154,545,515,523
"75010","Ntome_NODE_27001_length_758_cov_143","Nsylvestris_NODE_378_length_6396_cov_152",83.939,660,85,12,97,755,920,281,1.98e-174,612,658,639
"75011","Ntome_NODE_27002_length_758_cov_91","Nsylvestris_NODE_3702_length_3334_cov_138",92.774,775,35,11,1,758,1523,753,0,1101,757,770
"75012","Ntome_NODE_27004_length_758_cov_30","Nsylvestris_NODE_24301_length_812_cov_62",91.344,774,42,12,1,757,45,810,0,1035,756,765
"75016","Ntome_NODE_27006_length_758_cov_20","Nsylvestris_NODE_21242_length_1011_cov_165",85.652,230,30,2,186,415,584,358,3.86e-62,239,229,226
"75022","Ntome_NODE_27011_length_758_cov_5","Nsylvestris_NODE_1095_length_4825_cov_164",94.73,759,37,3,1,758,3513,2757,0,1177,757,756
"75023","Ntome_NODE_27012_length_758_cov_3","Nsylvestris_NODE_24363_length_809_cov_22",95.994,724,29,0,23,746,808,85,0,1177,723,723
"75039","Ntome_NODE_27019_length_757_cov_67","Nsylvestris_NODE_3966_length_3244_cov_150",85.276,326,15,16,1,326,325,33,3.75e-82,305,325,292
"75040","Ntome_NODE_27020_length_757_cov_47","Nsylvestris_NODE_640_length_5580_cov_64",80.631,222,31,9,57,272,60,275,8.59e-39,161,215,215
"75041","Ntome_NODE_27021_length_757_cov_44","Nsylvestris_NODE_18148_length_1254_cov_188",98.182,55,1,0,703,757,840,786,2.46e-19,97.1,54,54
"75044","Ntome_NODE_27024_length_757_cov_34","Nsylvestris_NODE_16078_length_1442_cov_178",96.774,62,1,1,1,62,1030,1090,5.28e-21,102,61,60
"75048","Ntome_NODE_27026_length_757_cov_26","Nsylvestris_NODE_25726_length_732_cov_66",83.519,540,43,11,11,504,682,143,2.1e-129,462,493,539
"75062","Ntome_NODE_27034_length_757_cov_9","Nsylvestris_NODE_23626_length_853_cov_8",83.198,369,45,13,1,366,645,291,3.72e-87,322,365,354
"75063","Ntome_NODE_27036_length_757_cov_6","Nsylvestris_NODE_18373_length_1235_cov_7",93.548,62,4,0,696,757,828,889,3.18e-18,93.5,61,61
"75083","Ntome_NODE_27045_length_756_cov_65","Nsylvestris_NODE_20488_length_1065_cov_111",80.952,273,41,9,283,547,466,197,3.91e-52,206,264,269
"75095","Ntome_NODE_27053_length_756_cov_6","Nsylvestris_NODE_1740_length_4218_cov_204",100,52,0,0,705,756,3781,3730,2.45e-19,97.1,51,51
"75096","Ntome_NODE_27054_length_756_cov_6","Nsylvestris_NODE_16565_length_1394_cov_220",98.182,55,1,0,702,756,292,346,2.45e-19,97.1,54,54
"75097","Ntome_NODE_27055_length_756_cov_5","Nsylvestris_NODE_191_length_7430_cov_231",98.182,55,1,0,1,55,2841,2895,2.45e-19,97.1,54,54
"75114","Ntome_NODE_27065_length_755_cov_32","Nsylvestris_NODE_4090_length_3206_cov_119",82.729,579,81,12,107,680,1,565,5.75e-140,497,573,564
"75127","Ntome_NODE_27072_length_755_cov_14","Nsylvestris_NODE_2488_length_3800_cov_191",96.364,55,2,0,701,755,2050,2104,1.14e-17,91.6,54,54
"75128","Ntome_NODE_27074_length_755_cov_11","Nsylvestris_NODE_1120_length_4801_cov_124",94.57,755,32,4,1,755,1172,1917,0,1158,754,745
"75129","Ntome_NODE_27075_length_755_cov_9","Nsylvestris_NODE_18665_length_1212_cov_43",95.872,533,21,1,220,752,572,1103,0,861,532,531
"75130","Ntome_NODE_27076_length_755_cov_7","Nsylvestris_NODE_953_length_5012_cov_141",100,55,0,0,701,755,2228,2174,5.27e-21,102,54,54
"75131","Ntome_NODE_27079_length_754_cov_242","Nsylvestris_NODE_23857_length_840_cov_169",91.61,584,35,9,51,624,669,90,0,795,573,579
"75132","Ntome_NODE_27080_length_754_cov_224","Nsylvestris_NODE_25164_length_762_cov_177",92.173,741,44,7,12,752,753,27,0,1035,740,726
"75135","Ntome_NODE_27082_length_754_cov_85","Nsylvestris_NODE_28966_length_585_cov_22",94.318,88,5,0,145,232,489,402,5.19e-31,135,87,87
"75139","Ntome_NODE_27084_length_754_cov_27","Nsylvestris_NODE_9570_length_2167_cov_156",98.182,55,1,0,700,754,1395,1341,2.45e-19,97.1,54,54
"75140","Ntome_NODE_27085_length_754_cov_22","Nsylvestris_NODE_1753_length_4213_cov_100",98.182,55,1,0,1,55,534,480,2.45e-19,97.1,54,54
"75163","Ntome_NODE_27095_length_753_cov_252","Nsylvestris_NODE_21955_length_958_cov_186",95.134,596,29,0,90,685,901,306,0,941,595,595
"75166","Ntome_NODE_27098_length_753_cov_230","Nsylvestris_NODE_26534_length_694_cov_168",94.703,623,33,0,53,675,681,59,0,968,622,622
"75173","Ntome_NODE_27103_length_753_cov_15","Nsylvestris_NODE_23125_length_883_cov_186",100,55,0,0,1,55,567,513,5.25e-21,102,54,54
"75178","Ntome_NODE_27107_length_753_cov_8","Nsylvestris_NODE_15971_length_1452_cov_128",87.991,458,19,9,1,422,163,620,2.65e-143,508,421,457
"75179","Ntome_NODE_27109_length_753_cov_4","Nsylvestris_NODE_33157_length_347_cov_6",91.404,349,22,5,126,474,6,346,3.48e-132,472,348,340
"75186","Ntome_NODE_27112_length_752_cov_251","Nsylvestris_NODE_2885_length_3627_cov_163",94.915,59,2,1,1,59,2071,2128,1.14e-17,91.6,58,57
"75187","Ntome_NODE_27113_length_752_cov_237","Nsylvestris_NODE_233_length_7091_cov_109",96.732,612,19,1,1,611,1579,2190,0,1018,610,611
"75190","Ntome_NODE_27115_length_752_cov_189","Nsylvestris_NODE_439_length_6140_cov_164",90.217,736,61,6,1,733,5024,5751,0,950,732,727
"75194","Ntome_NODE_27117_length_752_cov_76","Nsylvestris_NODE_26464_length_697_cov_149",97.951,244,4,1,386,628,408,651,3.54e-117,422,242,243
"75205","Ntome_NODE_27121_length_752_cov_37","Nsylvestris_NODE_12376_length_1829_cov_187",98.182,55,1,0,698,752,1291,1345,2.44e-19,97.1,54,54
"75214","Ntome_NODE_27126_length_752_cov_11","Nsylvestris_NODE_31247_length_436_cov_2",93.111,450,15,10,190,638,2,436,0,645,448,434
"75224","Ntome_NODE_27132_length_751_cov_77","Nsylvestris_NODE_25779_length_729_cov_143",92.555,685,31,8,2,680,722,52,0,965,678,670
"75231","Ntome_NODE_27135_length_751_cov_55","Nsylvestris_NODE_22844_length_900_cov_121",94.641,765,24,8,3,751,126,889,0,1170,748,763
"75235","Ntome_NODE_27138_length_751_cov_18","Nsylvestris_NODE_10308_length_2074_cov_164",98.182,55,1,0,1,55,1488,1542,2.44e-19,97.1,54,54
"75244","Ntome_NODE_27143_length_751_cov_9","Nsylvestris_NODE_15982_length_1451_cov_15",82.609,115,14,4,565,673,698,584,2.44e-19,97.1,108,114
"75248","Ntome_NODE_27145_length_751_cov_4","Nsylvestris_NODE_2184_length_3944_cov_224",100,55,0,0,1,55,2963,2909,5.24e-21,102,54,54
"75256","Ntome_NODE_27148_length_750_cov_242","Nsylvestris_NODE_14744_length_1575_cov_136",93.855,537,31,2,215,750,1522,987,0,808,535,535
"75260","Ntome_NODE_27150_length_750_cov_153","Nsylvestris_NODE_3577_length_3372_cov_178",96.301,757,20,3,1,750,997,1752,0,1236,749,755
"75275","Ntome_NODE_27157_length_750_cov_33","Nsylvestris_NODE_3160_length_3523_cov_139",95.238,63,3,0,688,750,516,454,1.88e-20,100,62,62
"75282","Ntome_NODE_27161_length_750_cov_18","Nsylvestris_NODE_26148_length_712_cov_16",94.608,612,32,1,86,696,100,711,0,946,610,611
"75285","Ntome_NODE_27164_length_750_cov_12","Nsylvestris_NODE_27229_length_661_cov_19",92.143,140,7,3,277,415,183,319,8.39e-49,195,138,136
"75289","Ntome_NODE_27167_length_750_cov_8","Nsylvestris_NODE_28313_length_613_cov_223",100,55,0,0,696,750,222,168,5.23e-21,102,54,54
"75290","Ntome_NODE_27168_length_750_cov_8","Nsylvestris_NODE_5806_length_2799_cov_122",97.059,34,1,0,715,748,935,902,1.15e-07,58.4,33,33
"75291","Ntome_NODE_27169_length_750_cov_6","Nsylvestris_NODE_3829_length_3292_cov_117",100,55,0,0,696,750,2052,1998,5.23e-21,102,54,54
"75299","Ntome_NODE_27173_length_749_cov_255","Nsylvestris_NODE_16294_length_1420_cov_192",94.898,686,29,3,65,749,143,823,0,1068,684,680
"75304","Ntome_NODE_27175_length_749_cov_196","Nsylvestris_NODE_22281_length_937_cov_25",88.675,468,32,15,190,656,507,60,4.32e-156,551,466,447
"75319","Ntome_NODE_27184_length_748_cov_41","Nsylvestris_NODE_6592_length_2644_cov_144",86.063,287,34,5,34,316,294,10,1.33e-81,303,282,284
"75320","Ntome_NODE_27185_length_749_cov_34","Nsylvestris_NODE_17321_length_1330_cov_105",94.157,753,31,3,1,749,587,1330,0,1134,748,743
"75321","Ntome_NODE_27186_length_749_cov_24","Nsylvestris_NODE_13477_length_1708_cov_227",98.182,55,1,0,1,55,318,372,2.43e-19,97.1,54,54
"75322","Ntome_NODE_27187_length_749_cov_22","Nsylvestris_NODE_3005_length_3585_cov_136",98.182,55,1,0,1,55,561,507,2.43e-19,97.1,54,54
"75331","Ntome_NODE_27192_length_749_cov_7","Nsylvestris_NODE_10493_length_2050_cov_148",96.364,55,2,0,695,749,1601,1547,1.13e-17,91.6,54,54
"75335","Ntome_NODE_27195_length_748_cov_323","Nsylvestris_NODE_183_length_7488_cov_109",88.889,63,5,2,585,647,5233,5173,3.16e-13,76.8,62,60
"75340","Ntome_NODE_27197_length_748_cov_188","Nsylvestris_NODE_23858_length_840_cov_142",94.331,688,24,8,5,687,815,138,0,1040,682,677
"75341","Ntome_NODE_27198_length_748_cov_157","Nsylvestris_NODE_26164_length_711_cov_198",92.388,670,29,12,51,703,711,47,0,935,652,664
"75342","Ntome_NODE_27199_length_748_cov_137","Nsylvestris_NODE_23568_length_855_cov_191",80.885,497,87,5,49,538,175,670,4.63e-106,385,489,495
"75343","Ntome_NODE_27200_length_748_cov_123","Nsylvestris_NODE_5867_length_2789_cov_222",88.406,69,6,2,682,748,37,105,6.8e-15,82.4,66,68
"75344","Ntome_NODE_27201_length_748_cov_34","Nsylvestris_NODE_751_length_5349_cov_70",91.111,225,20,0,524,748,1684,1460,3.7e-82,305,224,224
"75345","Ntome_NODE_27202_length_748_cov_31","Nsylvestris_NODE_27205_length_664_cov_39",90.909,638,35,7,67,685,1,634,0,835,618,633
"75346","Ntome_NODE_27203_length_748_cov_29","Nsylvestris_NODE_11230_length_1959_cov_136",97.115,104,3,0,645,748,590,487,3.03e-43,176,103,103
"75371","Ntome_NODE_27214_length_747_cov_165","Nsylvestris_NODE_36614_length_259_cov_7",92.788,208,15,0,128,335,208,1,4.79e-81,302,207,207
"75404","Ntome_NODE_27226_length_747_cov_21","Nsylvestris_NODE_22125_length_947_cov_165",96.364,55,2,0,693,747,274,328,1.13e-17,91.6,54,54
"75408","Ntome_NODE_27228_length_747_cov_19","Nsylvestris_NODE_224_length_7162_cov_204",98.182,55,1,0,693,747,6104,6158,2.42e-19,97.1,54,54
"75414","Ntome_NODE_27232_length_747_cov_10","Nsylvestris_NODE_13487_length_1707_cov_225",98.182,55,1,0,693,747,126,180,2.42e-19,97.1,54,54
"75418","Ntome_NODE_27234_length_747_cov_9","Nsylvestris_NODE_22928_length_895_cov_190",100,55,0,0,1,55,208,262,5.21e-21,102,54,54
"75419","Ntome_NODE_27235_length_747_cov_6","Nsylvestris_NODE_11880_length_1882_cov_70",95.034,745,31,1,3,747,861,123,0,1166,744,738
"75420","Ntome_NODE_27238_length_746_cov_323","Nsylvestris_NODE_5172_length_2931_cov_224",95.728,749,26,3,1,746,125,870,0,1201,745,745
"75425","Ntome_NODE_27242_length_746_cov_43","Nsylvestris_NODE_17722_length_1292_cov_189",98.113,53,1,0,3,55,975,923,3.13e-18,93.5,52,52
"75430","Ntome_NODE_27244_length_746_cov_19","Nsylvestris_NODE_2119_length_3980_cov_44",98.182,55,1,0,692,746,2872,2926,2.42e-19,97.1,54,54
"75441","Ntome_NODE_27250_length_746_cov_13","Nsylvestris_NODE_30834_length_462_cov_5",82.292,192,21,5,523,713,374,195,1.42e-36,154,190,179
"75452","Ntome_NODE_27255_length_746_cov_8","Nsylvestris_NODE_26198_length_710_cov_7",94.842,698,34,1,7,704,697,2,0,1088,697,695
"75453","Ntome_NODE_27256_length_746_cov_8","Nsylvestris_NODE_16901_length_1365_cov_64",95.935,738,30,0,9,746,1306,569,0,1197,737,737
"75454","Ntome_NODE_27257_length_746_cov_7","Nsylvestris_NODE_12445_length_1822_cov_131",100,55,0,0,1,55,875,821,5.2e-21,102,54,54
"75462","Ntome_NODE_27260_length_745_cov_206","Nsylvestris_NODE_26767_length_684_cov_215",87.599,629,44,22,7,624,27,632,0,699,617,605
"75463","Ntome_NODE_27262_length_745_cov_94","Nsylvestris_NODE_25071_length_767_cov_105",86.329,395,41,12,351,742,715,331,4.54e-116,418,391,384
"75468","Ntome_NODE_27266_length_745_cov_30","Nsylvestris_NODE_586_length_5739_cov_225",98.182,55,1,0,1,55,5263,5317,2.42e-19,97.1,54,54
"75480","Ntome_NODE_27271_length_745_cov_10","Nsylvestris_NODE_12362_length_1831_cov_127",94.828,58,3,0,1,58,620,563,1.12e-17,91.6,57,57
"75486","Ntome_NODE_27275_length_745_cov_4","Nsylvestris_NODE_2151_length_3963_cov_131",97.035,742,22,0,1,742,3035,2294,0,1249,741,741
"75499","Ntome_NODE_27280_length_744_cov_87","Nsylvestris_NODE_20193_length_1087_cov_46",94.659,674,36,0,51,724,694,21,0,1046,673,673
"75505","Ntome_NODE_27283_length_743_cov_35","Nsylvestris_NODE_8705_length_2294_cov_81",86.131,137,18,1,13,149,2272,2137,2.36e-34,147,136,135
"75519","Ntome_NODE_27287_length_744_cov_24","Nsylvestris_NODE_3297_length_3474_cov_226",100,55,0,0,1,55,312,366,5.19e-21,102,54,54
"75524","Ntome_NODE_27292_length_744_cov_7","Nsylvestris_NODE_19577_length_1137_cov_13",88.707,735,82,1,1,734,105,839,0,896,733,734
"75525","Ntome_NODE_27293_length_744_cov_6","Nsylvestris_NODE_15895_length_1460_cov_212",96.364,55,2,0,1,55,537,483,1.12e-17,91.6,54,54
"75530","Ntome_NODE_27296_length_744_cov_2","Nsylvestris_NODE_17014_length_1356_cov_162",95.289,743,29,4,1,739,534,1274,0,1173,738,740
"75537","Ntome_NODE_27299_length_743_cov_253","Nsylvestris_NODE_7175_length_2539_cov_177",95,60,3,0,1,60,2153,2094,8.67e-19,95.3,59,59
"75541","Ntome_NODE_27302_length_743_cov_86","Nsylvestris_NODE_2525_length_3781_cov_209",92.045,88,7,0,608,695,609,696,1.11e-27,124,87,87
"75544","Ntome_NODE_27305_length_743_cov_39","Nsylvestris_NODE_27563_length_648_cov_56",89.423,104,8,3,166,268,98,199,8.55e-29,128,102,101
"75545","Ntome_NODE_27306_length_743_cov_27","Nsylvestris_NODE_6369_length_2685_cov_37",92.593,54,4,0,1,54,1959,1906,2.43e-14,80.5,53,53
"75549","Ntome_NODE_27309_length_743_cov_11","Nsylvestris_NODE_4953_length_2985_cov_127",90.382,759,55,11,1,743,839,83,0,981,742,756
"75554","Ntome_NODE_27311_length_743_cov_6","Nsylvestris_NODE_2645_length_3723_cov_14",88.764,178,9,4,576,743,852,1028,1.07e-52,207,167,176
"75555","Ntome_NODE_27312_length_743_cov_5","Nsylvestris_NODE_17681_length_1296_cov_37",97.039,743,22,0,1,743,961,219,0,1251,742,742
"75558","Ntome_NODE_27315_length_742_cov_245","Nsylvestris_NODE_4403_length_3124_cov_234",97.715,744,15,2,1,742,751,8,0,1279,741,743
"75561","Ntome_NODE_27317_length_742_cov_103","Nsylvestris_NODE_23364_length_868_cov_154",91.726,701,34,8,49,738,775,88,0,952,689,687
"75562","Ntome_NODE_27318_length_742_cov_62","Nsylvestris_NODE_26697_length_687_cov_106",88.292,726,30,19,25,734,687,1,0,819,709,686
"75567","Ntome_NODE_27322_length_742_cov_30","Nsylvestris_NODE_3610_length_3361_cov_195",100,55,0,0,688,742,2758,2704,5.17e-21,102,54,54
"75573","Ntome_NODE_27325_length_742_cov_16","Nsylvestris_NODE_1980_length_4066_cov_199",95.85,747,25,4,1,742,1202,457,0,1203,741,745
"75583","Ntome_NODE_27329_length_742_cov_11","Nsylvestris_NODE_2893_length_3623_cov_227",98.182,55,1,0,1,55,819,765,2.41e-19,97.1,54,54
"75584","Ntome_NODE_27330_length_742_cov_7","Nsylvestris_NODE_3759_length_3315_cov_143",98.182,55,1,0,688,742,2792,2738,2.41e-19,97.1,54,54
"75585","Ntome_NODE_27331_length_742_cov_6","Nsylvestris_NODE_34910_length_297_cov_6",96.296,297,11,0,206,502,297,1,3.4e-137,488,296,296
"75594","Ntome_NODE_27335_length_741_cov_290","Nsylvestris_NODE_12229_length_1844_cov_227",97.687,735,14,2,8,741,6,738,0,1260,733,732
"75595","Ntome_NODE_27336_length_741_cov_201","Nsylvestris_NODE_22148_length_945_cov_83",81.955,266,27,14,192,440,945,684,3.83e-52,206,248,261
"75600","Ntome_NODE_27339_length_741_cov_24","Nsylvestris_NODE_7478_length_2491_cov_172",91.655,743,29,7,1,741,799,1510,0,998,740,711
"75601","Ntome_NODE_27340_length_741_cov_23","Nsylvestris_NODE_25534_length_742_cov_36",92.708,576,31,7,33,602,125,695,0,821,569,570
"75605","Ntome_NODE_27342_length_741_cov_14","Nsylvestris_NODE_2538_length_3776_cov_43",95.469,640,26,2,1,637,3136,3775,0,1018,636,639
"75609","Ntome_NODE_27344_length_741_cov_10","Nsylvestris_NODE_35122_length_292_cov_4",94.186,258,14,1,483,740,1,257,2.74e-108,392,257,256
"75613","Ntome_NODE_27346_length_741_cov_10","Nsylvestris_NODE_24712_length_788_cov_62",72.688,703,163,23,38,723,3,693,1.06e-52,207,685,690
"75614","Ntome_NODE_27347_length_741_cov_8","Nsylvestris_NODE_1084_length_4832_cov_146",100,55,0,0,687,741,687,741,5.17e-21,102,54,54
"75615","Ntome_NODE_27348_length_741_cov_8","Nsylvestris_NODE_17293_length_1333_cov_29",86.739,739,98,0,1,739,214,952,0,822,738,738
"75623","Ntome_NODE_27352_length_741_cov_5","Nsylvestris_NODE_11666_length_1910_cov_91",100,55,0,0,687,741,639,585,5.17e-21,102,54,54
"75635","Ntome_NODE_27359_length_740_cov_41","Nsylvestris_NODE_28807_length_592_cov_15",93.426,502,20,4,186,685,100,590,0,732,499,490
"75636","Ntome_NODE_27360_length_740_cov_37","Nsylvestris_NODE_23177_length_880_cov_31",91.445,339,24,3,383,720,546,880,7.39e-129,460,337,334
"75639","Ntome_NODE_27362_length_740_cov_16","Nsylvestris_NODE_31986_length_394_cov_20",95.431,394,18,0,202,595,1,394,1.91e-179,628,393,393
"75640","Ntome_NODE_27365_length_740_cov_12","Nsylvestris_NODE_46_length_9533_cov_130",93.421,380,20,3,13,388,282,660,2.55e-158,558,375,378
"75641","Ntome_NODE_27367_length_740_cov_10","Nsylvestris_NODE_16049_length_1445_cov_121",100,51,0,0,686,736,736,686,8.63e-19,95.3,50,50
"75644","Ntome_NODE_27372_length_739_cov_248","Nsylvestris_NODE_3388_length_3442_cov_206",98.166,709,12,1,31,739,8,715,0,1236,708,707
"75665","Ntome_NODE_27381_length_739_cov_19","Nsylvestris_NODE_4680_length_3046_cov_154",91.781,73,6,0,609,681,2785,2857,5.15e-21,102,72,72
"75666","Ntome_NODE_27382_length_739_cov_13","Nsylvestris_NODE_25991_length_718_cov_44",88.764,267,30,0,473,739,63,329,7.81e-89,327,266,266
"75671","Ntome_NODE_27384_length_739_cov_9","Nsylvestris_NODE_21121_length_1020_cov_56",81.818,132,21,2,261,389,1,132,1.11e-22,108,128,131
"75672","Ntome_NODE_27385_length_739_cov_8","Nsylvestris_NODE_7664_length_2459_cov_64",100,53,0,0,3,55,720,668,6.66e-20,99,52,52
"75675","Ntome_NODE_27387_length_739_cov_7","Nsylvestris_NODE_5114_length_2946_cov_16",92.913,127,3,1,2,122,2820,2946,2.31e-44,180,120,126
"75685","Ntome_NODE_27392_length_738_cov_64","Nsylvestris_NODE_25628_length_738_cov_24",94.436,683,37,1,1,683,682,1,0,1050,682,681
"75686","Ntome_NODE_27393_length_738_cov_55","Nsylvestris_NODE_11607_length_1918_cov_211",100,55,0,0,1,55,312,258,5.14e-21,102,54,54
"75687","Ntome_NODE_27394_length_738_cov_47","Nsylvestris_NODE_7900_length_2421_cov_199",97.849,279,6,0,443,721,329,51,1.57e-135,483,278,278
"75694","Ntome_NODE_27397_length_738_cov_24","Nsylvestris_NODE_13054_length_1757_cov_145",98.305,59,0,1,1,59,814,871,5.14e-21,102,58,57
"75698","Ntome_NODE_27399_length_738_cov_17","Nsylvestris_NODE_12445_length_1822_cov_131",98.182,55,1,0,684,738,687,633,2.39e-19,97.1,54,54
"75699","Ntome_NODE_27400_length_738_cov_14","Nsylvestris_NODE_5280_length_2909_cov_186",89.018,774,39,19,1,738,1271,508,0,917,737,763
"75700","Ntome_NODE_27403_length_738_cov_6","Nsylvestris_NODE_1233_length_4668_cov_93",84.211,228,35,1,1,227,2378,2605,1.36e-56,220,226,227
"75701","Ntome_NODE_27404_length_738_cov_5","Nsylvestris_NODE_25309_length_754_cov_91",89.009,646,43,13,65,690,47,684,0,774,625,637
"75709","Ntome_NODE_27411_length_737_cov_43","Nsylvestris_NODE_5594_length_2841_cov_174",98.276,58,1,0,1,58,2145,2088,5.14e-21,102,57,57
"75724","Ntome_NODE_27416_length_737_cov_24","Nsylvestris_NODE_17308_length_1331_cov_81",98.305,59,1,0,679,737,828,770,1.43e-21,104,58,58
"75729","Ntome_NODE_27418_length_737_cov_21","Nsylvestris_NODE_7258_length_2525_cov_223",100,57,0,0,1,57,2229,2285,3.97e-22,106,56,56
"75758","Ntome_NODE_27435_length_736_cov_19","Nsylvestris_NODE_10660_length_2030_cov_188",98.182,55,1,0,682,736,921,867,2.39e-19,97.1,54,54
"75763","Ntome_NODE_27438_length_736_cov_11","Nsylvestris_NODE_8938_length_2258_cov_184",100,55,0,0,682,736,1251,1305,5.13e-21,102,54,54
"75778","Ntome_NODE_27446_length_735_cov_185","Nsylvestris_NODE_23737_length_846_cov_172",98.182,55,1,0,589,643,265,211,2.38e-19,97.1,54,54
"75781","Ntome_NODE_27449_length_735_cov_56","Nsylvestris_NODE_25511_length_743_cov_48",91.213,569,25,8,158,706,643,80,0,750,548,563
"75797","Ntome_NODE_27456_length_735_cov_18","Nsylvestris_NODE_14087_length_1640_cov_181",100,55,0,0,1,55,1135,1189,5.12e-21,102,54,54
"75800","Ntome_NODE_27458_length_735_cov_8","Nsylvestris_NODE_18085_length_1261_cov_7",85.638,188,24,1,538,722,8,195,8.22e-49,195,184,187
"75804","Ntome_NODE_27460_length_735_cov_7","Nsylvestris_NODE_8822_length_2276_cov_125",96.364,55,2,0,681,735,926,872,1.11e-17,91.6,54,54
"75805","Ntome_NODE_27461_length_735_cov_5","Nsylvestris_NODE_31511_length_419_cov_6",96.217,423,10,2,243,665,417,1,0,688,422,416
"75813","Ntome_NODE_27466_length_734_cov_89","Nsylvestris_NODE_14586_length_1590_cov_73",94.231,52,3,0,4,55,222,171,2.4e-14,80.5,51,51
"75814","Ntome_NODE_27467_length_733_cov_84","Nsylvestris_NODE_857_length_5151_cov_143",81.065,169,28,2,239,405,385,219,6.52e-30,132,166,166
"75815","Ntome_NODE_27469_length_734_cov_38","Nsylvestris_NODE_29804_length_544_cov_20",91.583,499,31,7,174,672,1,488,0,678,498,487
"75816","Ntome_NODE_27473_length_734_cov_15","Nsylvestris_NODE_1332_length_4562_cov_74",89.453,749,57,9,1,734,4396,3655,0,926,733,741
"75817","Ntome_NODE_27474_length_734_cov_9","Nsylvestris_NODE_4120_length_3196_cov_80",100,55,0,0,680,734,885,939,5.12e-21,102,54,54
"75818","Ntome_NODE_27476_length_734_cov_9","Nsylvestris_NODE_10927_length_1997_cov_48",85.889,737,101,3,1,734,1166,1902,0,782,733,736
"75819","Ntome_NODE_27477_length_734_cov_9","Nsylvestris_NODE_4792_length_3024_cov_63",100,53,0,0,1,53,285,233,6.62e-20,99,52,52
"75820","Ntome_NODE_27480_length_734_cov_6","Nsylvestris_NODE_752_length_5347_cov_24",82.87,216,35,2,44,257,587,372,2.95e-48,193,213,215
"75824","Ntome_NODE_27482_length_734_cov_4","Nsylvestris_NODE_13731_length_1681_cov_177",98.182,55,1,0,1,55,1048,994,2.38e-19,97.1,54,54
"75842","Ntome_NODE_27490_length_732_cov_22","Nsylvestris_NODE_719_length_5402_cov_127",93.333,60,4,0,1,60,1689,1748,3.97e-17,89.8,59,59
"75843","Ntome_NODE_27491_length_733_cov_21","Nsylvestris_NODE_22669_length_911_cov_72",87.483,751,53,25,16,733,133,875,0,828,717,742
"75848","Ntome_NODE_27493_length_733_cov_11","Nsylvestris_NODE_25193_length_761_cov_7",95.504,734,26,4,1,733,1,728,0,1166,732,727
"75851","Ntome_NODE_27496_length_733_cov_5","Nsylvestris_NODE_4462_length_3107_cov_171",100,55,0,0,679,733,604,658,5.11e-21,102,54,54
"75866","Ntome_NODE_27502_length_732_cov_94","Nsylvestris_NODE_2124_length_3978_cov_131",88.106,639,40,15,1,628,1854,1241,0,726,627,613
"75869","Ntome_NODE_27504_length_732_cov_30","Nsylvestris_NODE_11655_length_1912_cov_122",88.739,666,38,13,1,656,987,349,0,780,655,638
"75870","Ntome_NODE_27505_length_732_cov_27","Nsylvestris_NODE_5391_length_2887_cov_203",94.559,680,36,1,53,732,2809,2131,0,1050,679,678
"75886","Ntome_NODE_27512_length_731_cov_245","Nsylvestris_NODE_16103_length_1439_cov_141",94.479,489,27,0,243,731,285,773,0,754,488,488
"75887","Ntome_NODE_27513_length_731_cov_221","Nsylvestris_NODE_31040_length_448_cov_31",89.017,346,32,5,291,633,343,1,9.57e-118,424,342,342
"75890","Ntome_NODE_27516_length_731_cov_123","Nsylvestris_NODE_6094_length_2739_cov_90",96.581,234,8,0,1,234,2458,2691,3.49e-107,388,233,233
"75900","Ntome_NODE_27521_length_731_cov_41","Nsylvestris_NODE_17440_length_1319_cov_108",87.938,514,41,6,195,706,58,552,1.15e-166,586,511,494
"75901","Ntome_NODE_27522_length_731_cov_33","Nsylvestris_NODE_2674_length_3714_cov_123",98.182,55,1,0,677,731,1259,1313,2.37e-19,97.1,54,54
"75902","Ntome_NODE_27523_length_731_cov_16","Nsylvestris_NODE_19208_length_1167_cov_92",89.873,79,7,1,4,82,531,454,1.83e-20,100,78,77
"75905","Ntome_NODE_27525_length_731_cov_14","Nsylvestris_NODE_5168_length_2933_cov_147",98.182,55,1,0,1,55,2363,2309,2.37e-19,97.1,54,54
"75908","Ntome_NODE_27529_length_731_cov_8","Nsylvestris_NODE_2382_length_3850_cov_154",98.182,55,1,0,677,731,1821,1767,2.37e-19,97.1,54,54
"75909","Ntome_NODE_27531_length_731_cov_5","Nsylvestris_NODE_6589_length_2645_cov_75",92.73,619,34,6,123,731,2492,1875,0,883,608,617
"75910","Ntome_NODE_27532_length_731_cov_4","Nsylvestris_NODE_5967_length_2767_cov_17",90.972,432,39,0,45,476,620,189,1.49e-165,582,431,431
"75911","Ntome_NODE_27534_length_731_cov_3","Nsylvestris_NODE_19414_length_1151_cov_14",91.787,694,54,3,3,695,323,1014,0,963,692,691
"75918","Ntome_NODE_27537_length_730_cov_278","Nsylvestris_NODE_2198_length_3938_cov_197",93.466,704,21,10,38,730,726,37,0,1022,692,689
"75928","Ntome_NODE_27542_length_730_cov_159","Nsylvestris_NODE_29568_length_559_cov_164",90.783,434,34,4,257,686,471,40,2.49e-163,575,429,431
"75929","Ntome_NODE_27543_length_730_cov_140","Nsylvestris_NODE_7940_length_2413_cov_220",96.296,54,2,0,2,55,2215,2162,3.96e-17,89.8,53,53
"75930","Ntome_NODE_27544_length_730_cov_91","Nsylvestris_NODE_28729_length_596_cov_85",90.773,401,24,3,318,715,203,593,9.16e-148,523,397,390
"75943","Ntome_NODE_27551_length_730_cov_34","Nsylvestris_NODE_11011_length_1986_cov_187",95.313,256,12,0,265,520,95,350,9.63e-113,407,255,255
"75944","Ntome_NODE_27552_length_730_cov_30","Nsylvestris_NODE_12963_length_1767_cov_195",89.714,525,38,11,38,561,1764,1255,0,656,523,509
"75947","Ntome_NODE_27555_length_730_cov_10","Nsylvestris_NODE_22021_length_954_cov_193",86.25,240,24,3,149,387,351,582,4.77e-66,252,238,231
"75948","Ntome_NODE_27556_length_730_cov_10","Nsylvestris_NODE_14183_length_1632_cov_56",85.915,568,46,18,145,695,600,50,2.49e-163,575,550,550
"75949","Ntome_NODE_27557_length_730_cov_9","Nsylvestris_NODE_8420_length_2336_cov_168",100,55,0,0,676,730,1461,1407,5.09e-21,102,54,54
"75955","Ntome_NODE_27560_length_730_cov_6","Nsylvestris_NODE_24560_length_798_cov_11",85.449,701,55,25,49,730,1,673,0,686,681,672
"75958","Ntome_NODE_27562_length_730_cov_3","Nsylvestris_NODE_2043_length_4028_cov_17",97.387,727,19,0,1,727,1361,2087,0,1238,726,726
"75959","Ntome_NODE_27563_length_727_cov_291","Nsylvestris_NODE_1424_length_4474_cov_146",95.852,675,26,2,53,727,96,768,0,1090,674,672
"75960","Ntome_NODE_27564_length_729_cov_270","Nsylvestris_NODE_9450_length_2185_cov_215",95.289,743,17,6,4,729,2167,1426,0,1162,725,741
"75968","Ntome_NODE_27568_length_729_cov_100","Nsylvestris_NODE_23078_length_886_cov_60",91.107,506,32,6,27,525,76,575,0,673,498,499
"75984","Ntome_NODE_27578_length_729_cov_11","Nsylvestris_NODE_11937_length_1876_cov_219",94.545,55,3,0,1,55,428,482,5.12e-16,86.1,54,54
"75988","Ntome_NODE_27582_length_729_cov_6","Nsylvestris_NODE_9951_length_2122_cov_13",93.241,725,49,0,5,729,1044,1768,0,1068,724,724
"75989","Ntome_NODE_27583_length_729_cov_4","Nsylvestris_NODE_11487_length_1932_cov_58",94.688,640,27,7,94,729,1,637,0,987,635,636
"75992","Ntome_NODE_27586_length_728_cov_265","Nsylvestris_NODE_21056_length_1024_cov_176",97.222,252,7,0,1,252,723,974,7.37e-119,427,251,251
"76000","Ntome_NODE_27589_length_728_cov_239","Nsylvestris_NODE_3272_length_3482_cov_84",94.313,721,20,5,1,720,2772,3472,0,1085,719,700
"76005","Ntome_NODE_27591_length_728_cov_143","Nsylvestris_NODE_17356_length_1327_cov_16",89.032,310,30,4,1,308,631,938,5.82e-105,381,307,307
"76013","Ntome_NODE_27596_length_728_cov_32","Nsylvestris_NODE_11490_length_1931_cov_232",92.727,55,4,0,674,728,343,397,2.38e-14,80.5,54,54
"76016","Ntome_NODE_27599_length_728_cov_25","Nsylvestris_NODE_13427_length_1714_cov_30",89.056,731,74,5,1,728,966,239,0,902,727,727
"76020","Ntome_NODE_27601_length_728_cov_15","Nsylvestris_NODE_14324_length_1619_cov_19",81.579,152,27,1,578,728,288,137,1.08e-27,124,150,151
"76024","Ntome_NODE_27603_length_728_cov_11","Nsylvestris_NODE_24177_length_821_cov_16",92.17,728,31,9,1,728,766,65,0,1005,727,701
"76028","Ntome_NODE_27608_length_728_cov_9","Nsylvestris_NODE_16225_length_1427_cov_197",98.182,55,1,0,1,55,926,980,2.36e-19,97.1,54,54
"76032","Ntome_NODE_27612_length_728_cov_5","Nsylvestris_NODE_18226_length_1248_cov_15",95.166,724,25,4,1,716,724,3,0,1134,715,721
"76040","Ntome_NODE_27617_length_727_cov_117","Nsylvestris_NODE_14324_length_1619_cov_19",79.394,165,33,1,564,727,301,137,6.51e-25,115,163,164
"76060","Ntome_NODE_27625_length_727_cov_27","Nsylvestris_NODE_15411_length_1511_cov_215",96.364,55,2,0,673,727,1335,1389,1.1e-17,91.6,54,54
"76067","Ntome_NODE_27628_length_727_cov_11","Nsylvestris_NODE_2308_length_3890_cov_68",91.655,743,38,3,1,727,3110,2376,0,1007,726,734
"76068","Ntome_NODE_27629_length_727_cov_10","Nsylvestris_NODE_392_length_6304_cov_88",86.451,679,55,10,44,722,6253,5612,0,710,678,641
"76069","Ntome_NODE_27630_length_727_cov_10","Nsylvestris_NODE_6357_length_2687_cov_15",76.731,361,37,25,250,572,1736,2087,1.07e-37,158,322,351
"76073","Ntome_NODE_27632_length_727_cov_8","Nsylvestris_NODE_1481_length_4416_cov_26",94.353,726,34,5,4,727,2199,1479,0,1107,723,720
"76078","Ntome_NODE_27635_length_727_cov_6","Nsylvestris_NODE_10865_length_2005_cov_209",98.182,55,1,0,1,55,387,441,2.36e-19,97.1,54,54
"76089","Ntome_NODE_27640_length_726_cov_226","Nsylvestris_NODE_2895_length_3622_cov_84",97.444,626,14,2,49,673,3503,2879,0,1066,624,624
"76090","Ntome_NODE_27641_length_726_cov_160","Nsylvestris_NODE_17906_length_1276_cov_110",95.461,727,18,3,1,726,1139,427,0,1146,725,712
"76094","Ntome_NODE_27644_length_726_cov_84","Nsylvestris_NODE_26444_length_698_cov_173",92.427,647,36,3,66,712,668,35,0,911,646,633
"76095","Ntome_NODE_27645_length_726_cov_78","Nsylvestris_NODE_24762_length_785_cov_189",86.795,727,51,23,15,726,718,22,0,769,711,696
"76096","Ntome_NODE_27647_length_726_cov_44","Nsylvestris_NODE_4501_length_3100_cov_54",83.468,617,62,18,2,605,2496,3085,3.25e-152,538,603,589
"76099","Ntome_NODE_27650_length_726_cov_27","Nsylvestris_NODE_25906_length_723_cov_44",89.45,673,46,8,9,664,689,25,0,826,655,664
"76112","Ntome_NODE_27656_length_726_cov_4","Nsylvestris_NODE_26633_length_690_cov_11",84.783,276,18,10,125,378,685,412,3.67e-67,255,253,273
"76115","Ntome_NODE_27659_length_725_cov_266","Nsylvestris_NODE_6206_length_2715_cov_207",96.575,584,20,0,1,584,632,49,0,968,583,583
"76135","Ntome_NODE_27667_length_725_cov_26","Nsylvestris_NODE_13442_length_1713_cov_105",98.182,55,1,0,1,55,875,929,2.35e-19,97.1,54,54
"76140","Ntome_NODE_27672_length_725_cov_14","Nsylvestris_NODE_13011_length_1762_cov_185",98.182,55,1,0,1,55,1196,1142,2.35e-19,97.1,54,54
"76141","Ntome_NODE_27673_length_725_cov_11","Nsylvestris_NODE_16209_length_1429_cov_66",93.306,732,29,7,1,721,344,1066,0,1062,720,722
"76146","Ntome_NODE_27677_length_725_cov_7","Nsylvestris_NODE_17407_length_1322_cov_49",95.122,82,4,0,644,725,317,236,2.32e-29,130,81,81
"76147","Ntome_NODE_27678_length_725_cov_6","Nsylvestris_NODE_20513_length_1063_cov_220",96.364,55,2,0,671,725,380,434,1.09e-17,91.6,54,54
"76151","Ntome_NODE_27681_length_725_cov_3","Nsylvestris_NODE_5257_length_2913_cov_222",98.305,59,0,1,1,58,1683,1741,5.05e-21,102,57,58
"76162","Ntome_NODE_27685_length_724_cov_254","Nsylvestris_NODE_20587_length_1058_cov_147",89.088,614,38,15,128,724,163,764,0,736,596,601
"76166","Ntome_NODE_27687_length_724_cov_177","Nsylvestris_NODE_17452_length_1318_cov_142",90.511,685,32,9,1,666,648,1318,0,874,665,670
"76167","Ntome_NODE_27688_length_724_cov_88","Nsylvestris_NODE_12025_length_1866_cov_137",96.364,55,2,0,670,724,1748,1802,1.09e-17,91.6,54,54
"76180","Ntome_NODE_27694_length_724_cov_19","Nsylvestris_NODE_30680_length_472_cov_6",95.339,472,16,4,43,510,472,3,0,745,467,469
"76183","Ntome_NODE_27696_length_724_cov_14","Nsylvestris_NODE_6582_length_2645_cov_203",100,54,0,0,41,94,1431,1484,1.81e-20,100,53,53
"76186","Ntome_NODE_27698_length_724_cov_12","Nsylvestris_NODE_4715_length_3041_cov_186",95.161,62,3,0,663,724,554,615,6.52e-20,99,61,61
"76201","Ntome_NODE_27706_length_723_cov_302","Nsylvestris_NODE_6365_length_2685_cov_128",93.889,720,31,8,1,715,715,4,0,1074,714,711
"76210","Ntome_NODE_27709_length_723_cov_259","Nsylvestris_NODE_3192_length_3509_cov_181",96.401,639,22,1,85,723,1140,1777,0,1051,638,637
"76211","Ntome_NODE_27710_length_723_cov_258","Nsylvestris_NODE_18688_length_1210_cov_203",92.572,727,46,8,1,723,17,739,0,1037,722,722
"76223","Ntome_NODE_27714_length_723_cov_139","Nsylvestris_NODE_14688_length_1580_cov_204",93.286,700,47,0,24,723,143,842,0,1033,699,699
"76239","Ntome_NODE_27722_length_723_cov_35","Nsylvestris_NODE_4626_length_3066_cov_161",100,55,0,0,669,723,879,825,5.04e-21,102,54,54
"76240","Ntome_NODE_27723_length_723_cov_19","Nsylvestris_NODE_1908_length_4108_cov_197",98.182,55,1,0,669,723,1859,1913,2.34e-19,97.1,54,54
"76241","Ntome_NODE_27724_length_723_cov_17","Nsylvestris_NODE_14142_length_1636_cov_111",98.182,55,1,0,669,723,518,464,2.34e-19,97.1,54,54
"76242","Ntome_NODE_27725_length_723_cov_16","Nsylvestris_NODE_582_length_5746_cov_222",96.61,59,1,1,666,723,5105,5163,2.34e-19,97.1,57,58
"76243","Ntome_NODE_27726_length_723_cov_15","Nsylvestris_NODE_6824_length_2599_cov_234",98.182,55,1,0,1,55,1295,1241,2.34e-19,97.1,54,54
"76263","Ntome_NODE_27734_length_723_cov_8","Nsylvestris_NODE_4896_length_2996_cov_104",88.814,742,61,9,1,723,1641,903,0,891,722,738
"76266","Ntome_NODE_27736_length_723_cov_8","Nsylvestris_NODE_1079_length_4839_cov_117",97.483,715,16,2,10,722,4103,4817,0,1219,712,714
"76269","Ntome_NODE_27738_length_723_cov_6","Nsylvestris_NODE_33255_length_344_cov_5",89.489,352,22,8,336,683,341,1,5.66e-120,431,347,340
"76273","Ntome_NODE_27740_length_722_cov_309","Nsylvestris_NODE_12362_length_1831_cov_127",96.62,710,24,0,1,710,514,1223,0,1179,709,709
"76274","Ntome_NODE_27741_length_722_cov_256","Nsylvestris_NODE_2893_length_3623_cov_227",95.06,668,18,7,57,722,165,819,0,1037,665,654
"76280","Ntome_NODE_27744_length_722_cov_184","Nsylvestris_NODE_26235_length_708_cov_27",94.961,635,25,2,1,628,635,1,0,989,627,634
"76283","Ntome_NODE_27746_length_722_cov_43","Nsylvestris_NODE_27466_length_652_cov_166",80.328,305,41,13,231,535,300,585,2.23e-54,213,304,285
"76290","Ntome_NODE_27750_length_722_cov_31","Nsylvestris_NODE_3516_length_3393_cov_225",93.151,73,5,0,161,233,3143,3071,1.08e-22,108,72,72
"76328","Ntome_NODE_27770_length_721_cov_70","Nsylvestris_NODE_1391_length_4503_cov_114",91.837,735,40,7,1,721,3132,3860,0,1007,720,728
"76329","Ntome_NODE_27771_length_721_cov_59","Nsylvestris_NODE_6848_length_2594_cov_156",94.545,55,3,0,1,55,1127,1073,5.06e-16,86.1,54,54
"76332","Ntome_NODE_27773_length_721_cov_48","Nsylvestris_NODE_13895_length_1663_cov_216",98.182,55,1,0,667,721,1209,1263,2.34e-19,97.1,54,54
"76333","Ntome_NODE_27774_length_721_cov_47","Nsylvestris_NODE_6403_length_2679_cov_155",90.98,643,54,1,56,694,643,1,0,863,638,642
"76336","Ntome_NODE_27777_length_721_cov_22","Nsylvestris_NODE_1579_length_4344_cov_226",98.182,55,1,0,1,55,3372,3426,2.34e-19,97.1,54,54
"76337","Ntome_NODE_27778_length_721_cov_13","Nsylvestris_NODE_22107_length_949_cov_22",94.545,55,3,0,1,55,436,382,5.06e-16,86.1,54,54
"76340","Ntome_NODE_27780_length_721_cov_12","Nsylvestris_NODE_33483_length_337_cov_4",91.746,315,9,6,1,313,38,337,3.39e-117,422,312,299
"76341","Ntome_NODE_27783_length_721_cov_9","Nsylvestris_NODE_19550_length_1140_cov_7",95.672,670,29,0,1,670,671,2,0,1077,669,669
"76345","Ntome_NODE_27785_length_721_cov_7","Nsylvestris_NODE_33484_length_337_cov_4",90.728,302,20,5,417,712,337,38,2.06e-109,396,295,299
"76346","Ntome_NODE_27786_length_721_cov_6","Nsylvestris_NODE_27087_length_670_cov_5",87.349,166,13,7,118,280,614,454,1.74e-45,183,162,160
"76368","Ntome_NODE_27796_length_720_cov_111","Nsylvestris_NODE_22134_length_946_cov_128",96.322,707,14,2,14,720,946,252,0,1151,706,694
"76369","Ntome_NODE_27797_length_720_cov_65","Nsylvestris_NODE_154_length_7738_cov_75",80.444,721,139,2,1,720,5373,6092,1.49e-155,549,719,719
"76372","Ntome_NODE_27800_length_720_cov_26","Nsylvestris_NODE_15069_length_1544_cov_212",100,55,0,0,1,55,1191,1245,5.01e-21,102,54,54
"76373","Ntome_NODE_27802_length_720_cov_15","Nsylvestris_NODE_31195_length_438_cov_174",96,50,2,0,76,125,294,343,6.53e-15,82.4,49,49
"76376","Ntome_NODE_27804_length_720_cov_7","Nsylvestris_NODE_32917_length_356_cov_3",95.706,326,12,2,9,334,1,324,9.03e-148,523,325,323
"76379","Ntome_NODE_27808_length_719_cov_260","Nsylvestris_NODE_194_length_7403_cov_131",94.201,638,19,3,92,719,6315,6944,0,957,627,629
"76399","Ntome_NODE_27816_length_719_cov_11","Nsylvestris_NODE_15744_length_1476_cov_67",90,50,5,0,226,275,1031,982,6.57e-10,65.8,49,49
"76413","Ntome_NODE_27825_length_718_cov_249","Nsylvestris_NODE_5903_length_2781_cov_103",92.593,162,12,0,94,255,270,109,1.7e-60,233,161,161
"76414","Ntome_NODE_27826_length_718_cov_227","Nsylvestris_NODE_19514_length_1142_cov_39",91.231,707,47,7,10,701,421,1127,0,948,691,706
"76419","Ntome_NODE_27828_length_718_cov_87","Nsylvestris_NODE_8215_length_2370_cov_199",95.238,63,2,1,657,718,620,682,6.47e-20,99,61,62
"76420","Ntome_NODE_27829_length_718_cov_47","Nsylvestris_NODE_2420_length_3831_cov_129",94.298,719,35,5,1,718,2432,1719,0,1096,717,713
"76432","Ntome_NODE_27837_length_718_cov_9","Nsylvestris_NODE_21913_length_961_cov_26",94.868,721,34,1,1,718,882,162,0,1123,717,720
"76433","Ntome_NODE_27839_length_718_cov_7","Nsylvestris_NODE_8537_length_2320_cov_53",93.185,719,48,1,1,718,707,1425,0,1055,717,718
"76443","Ntome_NODE_27846_length_717_cov_191","Nsylvestris_NODE_783_length_5263_cov_121",94.785,652,11,10,1,641,4624,5263,0,994,640,639
"76453","Ntome_NODE_27856_length_716_cov_310","Nsylvestris_NODE_19015_length_1181_cov_187",94.895,666,32,2,47,712,52,715,0,1040,665,663
"76463","Ntome_NODE_27860_length_716_cov_248","Nsylvestris_NODE_5143_length_2939_cov_129",94.841,659,22,1,58,716,81,727,0,1018,658,646
"76467","Ntome_NODE_27862_length_716_cov_206","Nsylvestris_NODE_4762_length_3031_cov_80",92.308,65,4,1,380,443,1858,1922,1.08e-17,91.6,63,64
"76475","Ntome_NODE_27869_length_716_cov_36","Nsylvestris_NODE_2458_length_3810_cov_228",89.535,516,54,0,1,516,2928,3443,0,654,515,515
"76490","Ntome_NODE_27875_length_716_cov_11","Nsylvestris_NODE_20312_length_1076_cov_227",93.846,65,2,2,1,65,384,322,2.32e-19,97.1,64,62
"76491","Ntome_NODE_27877_length_716_cov_9","Nsylvestris_NODE_461_length_6060_cov_199",96.552,58,2,0,1,58,2788,2731,2.32e-19,97.1,57,57
"76500","Ntome_NODE_27885_length_715_cov_219","Nsylvestris_NODE_2767_length_3679_cov_43",98.322,715,12,0,1,715,1953,2667,0,1254,714,714
"76501","Ntome_NODE_27886_length_715_cov_128","Nsylvestris_NODE_7806_length_2435_cov_111",92.176,409,12,5,311,715,1842,2234,6.83e-159,560,404,392
"76502","Ntome_NODE_27887_length_715_cov_122","Nsylvestris_NODE_2867_length_3632_cov_225",94.545,55,3,0,661,715,2397,2451,5.01e-16,86.1,54,54
"76505","Ntome_NODE_27890_length_714_cov_72","Nsylvestris_NODE_7065_length_2560_cov_21",90.807,533,48,1,149,680,2513,1981,0,712,531,532
"76506","Ntome_NODE_27891_length_715_cov_43","Nsylvestris_NODE_6809_length_2602_cov_97",86.264,728,42,24,4,715,1256,571,0,737,711,685
"76528","Ntome_NODE_27902_length_715_cov_2","Nsylvestris_NODE_14127_length_1638_cov_36",97.331,712,19,0,4,715,1323,612,0,1210,711,711
"76532","Ntome_NODE_27904_length_714_cov_259","Nsylvestris_NODE_21562_length_987_cov_178",92.487,386,17,5,89,472,350,725,2.47e-153,542,383,375
"76533","Ntome_NODE_27905_length_714_cov_251","Nsylvestris_NODE_15870_length_1462_cov_205",97.347,377,10,0,338,714,1099,723,0,641,376,376
"76534","Ntome_NODE_27906_length_714_cov_217","Nsylvestris_NODE_10437_length_2057_cov_151",96.172,627,23,1,1,626,629,3,0,1024,625,626
"76535","Ntome_NODE_27907_length_714_cov_188","Nsylvestris_NODE_15330_length_1519_cov_139",96.391,665,21,3,43,706,200,862,0,1092,663,662
"76538","Ntome_NODE_27909_length_714_cov_185","Nsylvestris_NODE_27703_length_641_cov_163",87.399,373,36,9,242,609,435,69,4.35e-116,418,367,366
"76539","Ntome_NODE_27910_length_714_cov_134","Nsylvestris_NODE_10929_length_1996_cov_208",86.667,105,7,2,564,661,1085,981,2.97e-23,110,97,104
"76543","Ntome_NODE_27913_length_714_cov_84","Nsylvestris_NODE_29952_length_532_cov_7",94.792,384,16,2,309,688,1,384,1.87e-169,595,379,383
"76556","Ntome_NODE_27918_length_714_cov_39","Nsylvestris_NODE_2997_length_3588_cov_191",96.364,55,2,0,1,55,1834,1780,1.08e-17,91.6,54,54
"76561","Ntome_NODE_27921_length_714_cov_29","Nsylvestris_NODE_9106_length_2236_cov_13",91.045,67,6,0,547,613,371,437,1.08e-17,91.6,66,66
"76583","Ntome_NODE_27935_length_713_cov_209","Nsylvestris_NODE_10182_length_2090_cov_228",95.378,238,10,1,477,713,1531,1768,7.37e-104,377,236,237
"76589","Ntome_NODE_27939_length_713_cov_72","Nsylvestris_NODE_7269_length_2523_cov_226",100,55,0,0,1,55,1529,1583,4.96e-21,102,54,54
"76595","Ntome_NODE_27945_length_713_cov_29","Nsylvestris_NODE_11597_length_1920_cov_24",96.429,224,8,0,180,403,1312,1089,1.23e-101,370,223,223
"76598","Ntome_NODE_27947_length_713_cov_22","Nsylvestris_NODE_14215_length_1627_cov_193",90.722,485,37,2,1,485,191,667,0,640,484,476
"76615","Ntome_NODE_27958_length_712_cov_240","Nsylvestris_NODE_26744_length_685_cov_206",84.739,249,38,0,169,417,154,402,1.67e-65,250,248,248
"76616","Ntome_NODE_27959_length_712_cov_203","Nsylvestris_NODE_9715_length_2150_cov_241",96.364,55,2,0,658,712,1142,1088,1.07e-17,91.6,54,54
"76636","Ntome_NODE_27968_length_712_cov_24","Nsylvestris_NODE_12067_length_1861_cov_209",98.333,60,1,0,1,60,914,973,3.83e-22,106,59,59
"76651","Ntome_NODE_27978_length_711_cov_57","Nsylvestris_NODE_4268_length_3157_cov_206",88.809,697,34,16,1,688,662,1,0,815,687,661
"76656","Ntome_NODE_27981_length_711_cov_41","Nsylvestris_NODE_2938_length_3606_cov_209",100,55,0,0,1,55,2497,2443,4.95e-21,102,54,54
"76661","Ntome_NODE_27983_length_711_cov_39","Nsylvestris_NODE_31111_length_444_cov_80",91.241,411,15,7,257,646,2,412,8.85e-153,540,389,410
"76662","Ntome_NODE_27985_length_711_cov_36","Nsylvestris_NODE_2089_length_4001_cov_238",98.113,53,1,0,657,709,3476,3424,2.98e-18,93.5,52,52
"76667","Ntome_NODE_27990_length_711_cov_5","Nsylvestris_NODE_2284_length_3900_cov_169",98.113,53,1,0,1,53,2577,2525,2.98e-18,93.5,52,52
"76668","Ntome_NODE_27991_length_710_cov_299","Nsylvestris_NODE_20955_length_1031_cov_168",98.178,494,9,0,1,494,636,143,0,863,493,493
"76677","Ntome_NODE_27994_length_710_cov_265","Nsylvestris_NODE_3762_length_3314_cov_196",98.182,55,1,0,1,55,2019,2073,2.3e-19,97.1,54,54
"76690","Ntome_NODE_28000_length_710_cov_154","Nsylvestris_NODE_1902_length_4114_cov_132",91.667,660,38,13,10,656,1397,742,0,898,646,655
"76694","Ntome_NODE_28003_length_710_cov_55","Nsylvestris_NODE_5239_length_2918_cov_141",88.336,583,48,14,52,631,2702,2137,0,682,579,565
"76695","Ntome_NODE_28004_length_710_cov_48","Nsylvestris_NODE_26726_length_686_cov_18",81.008,516,61,25,8,488,3,516,2.64e-103,375,480,513
"76696","Ntome_NODE_28005_length_710_cov_29","Nsylvestris_NODE_1101_length_4821_cov_40",77.151,337,55,17,5,328,1368,1695,2.87e-43,176,323,327
"76697","Ntome_NODE_28006_length_710_cov_28","Nsylvestris_NODE_31428_length_424_cov_4",92.235,425,32,1,132,556,424,1,4e-171,601,424,423
"76705","Ntome_NODE_28010_length_710_cov_14","Nsylvestris_NODE_3863_length_3281_cov_32",94.258,209,11,1,25,232,2933,2725,4.51e-86,318,207,208
"76713","Ntome_NODE_28014_length_710_cov_3","Nsylvestris_NODE_29378_length_568_cov_11",90.359,446,31,6,142,578,126,568,2.42e-163,575,436,442
"76717","Ntome_NODE_28017_length_709_cov_71","Nsylvestris_NODE_17058_length_1352_cov_138",100,43,0,0,1,43,746,788,2.31e-14,80.5,42,42
"76729","Ntome_NODE_28028_length_709_cov_8","Nsylvestris_NODE_4047_length_3218_cov_167",98.182,55,1,0,1,55,1593,1647,2.3e-19,97.1,54,54
"76730","Ntome_NODE_28029_length_709_cov_7","Nsylvestris_NODE_20577_length_1059_cov_19",95.085,590,19,6,2,585,299,884,0,920,583,585
"76733","Ntome_NODE_28032_length_709_cov_5","Nsylvestris_NODE_12403_length_1826_cov_98",100,55,0,0,655,709,752,806,4.94e-21,102,54,54
"76734","Ntome_NODE_28033_length_709_cov_5","Nsylvestris_NODE_3165_length_3521_cov_149",100,55,0,0,655,709,2736,2790,4.94e-21,102,54,54
"76735","Ntome_NODE_28034_length_709_cov_4","Nsylvestris_NODE_27728_length_641_cov_6",85.645,411,41,8,104,508,243,641,1.55e-115,416,404,398
"76741","Ntome_NODE_28037_length_708_cov_221","Nsylvestris_NODE_5016_length_2968_cov_217",94.428,682,34,4,1,682,2255,2932,0,1046,681,677
"76764","Ntome_NODE_28051_length_708_cov_5","Nsylvestris_NODE_6807_length_2602_cov_101",91.445,713,51,5,2,708,587,1295,0,970,706,708
"76774","Ntome_NODE_28056_length_707_cov_152","Nsylvestris_NODE_9080_length_2241_cov_132",80.556,252,26,2,382,610,1266,1015,3.7e-42,172,228,251
"76777","Ntome_NODE_28058_length_707_cov_77","Nsylvestris_NODE_9478_length_2181_cov_148",84.141,227,36,0,11,237,754,528,1.3e-56,220,226,226
"76778","Ntome_NODE_28059_length_707_cov_68","Nsylvestris_NODE_7841_length_2430_cov_66",88.474,321,32,3,43,358,941,621,1.57e-105,383,315,320
"76782","Ntome_NODE_28061_length_707_cov_35","Nsylvestris_NODE_5641_length_2830_cov_32",94.237,295,16,1,413,707,1430,1137,1.53e-125,449,294,293
"76785","Ntome_NODE_28066_length_707_cov_13","Nsylvestris_NODE_26810_length_683_cov_6",90.909,649,32,11,16,655,649,19,0,846,639,630
"76786","Ntome_NODE_28067_length_707_cov_11","Nsylvestris_NODE_4925_length_2991_cov_185",100,55,0,0,653,707,1930,1984,4.92e-21,102,54,54
"76787","Ntome_NODE_28068_length_707_cov_11","Nsylvestris_NODE_27423_length_655_cov_4",87.915,422,26,12,118,524,653,242,9.05e-133,473,406,411
"76788","Ntome_NODE_28069_length_707_cov_10","Nsylvestris_NODE_851_length_5157_cov_67",94.231,104,6,0,1,104,4001,4104,2.88e-38,159,103,103
"76789","Ntome_NODE_28073_length_707_cov_6","Nsylvestris_NODE_3133_length_3533_cov_62",87.316,339,38,5,1,337,3514,3179,1.57e-105,383,336,335
"76793","Ntome_NODE_28078_length_706_cov_313","Nsylvestris_NODE_3354_length_3453_cov_229",98.3,706,12,0,1,706,1083,378,0,1238,705,705
"76816","Ntome_NODE_28089_length_706_cov_53","Nsylvestris_NODE_32199_length_385_cov_8",95.584,385,17,0,83,467,385,1,3.95e-176,617,384,384
"76833","Ntome_NODE_28099_length_706_cov_12","Nsylvestris_NODE_2502_length_3793_cov_20",97.866,703,15,0,4,706,1367,2069,0,1216,702,702
"76842","Ntome_NODE_28103_length_706_cov_9","Nsylvestris_NODE_4789_length_3024_cov_177",87.883,718,38,15,1,706,1683,2363,0,798,705,680
"76843","Ntome_NODE_28106_length_706_cov_3","Nsylvestris_NODE_20970_length_1030_cov_191",100,55,0,0,1,55,528,582,4.91e-21,102,54,54
"76847","Ntome_NODE_28108_length_705_cov_240","Nsylvestris_NODE_17170_length_1342_cov_199",91.876,517,25,7,206,705,247,763,0,706,499,516
"76851","Ntome_NODE_28110_length_705_cov_108","Nsylvestris_NODE_18153_length_1254_cov_120",97.549,408,10,0,127,534,1254,847,0,699,407,407
"76852","Ntome_NODE_28111_length_705_cov_28","Nsylvestris_NODE_11495_length_1931_cov_143",86.783,575,54,14,1,564,1337,774,3.05e-177,621,563,563
"76862","Ntome_NODE_28117_length_705_cov_9","Nsylvestris_NODE_6165_length_2723_cov_135",92.727,55,4,0,651,705,868,922,2.3e-14,80.5,54,54
"76863","Ntome_NODE_28118_length_705_cov_8","Nsylvestris_NODE_35096_length_293_cov_2",86.466,133,11,5,17,142,2,134,3.74e-32,139,125,132
"76864","Ntome_NODE_28119_length_705_cov_7","Nsylvestris_NODE_29625_length_558_cov_8",93.482,537,19,5,163,685,558,24,0,784,522,534
"76878","Ntome_NODE_28124_length_705_cov_5","Nsylvestris_NODE_3781_length_3307_cov_150",94.068,708,31,6,1,705,2252,1553,0,1064,704,699
"76889","Ntome_NODE_28131_length_704_cov_103","Nsylvestris_NODE_27545_length_649_cov_19",92.936,637,45,0,37,673,637,1,0,928,636,636
"76904","Ntome_NODE_28139_length_704_cov_21","Nsylvestris_NODE_29628_length_558_cov_6",91.971,548,29,4,169,701,1,548,0,754,532,547
"76905","Ntome_NODE_28140_length_704_cov_16","Nsylvestris_NODE_11508_length_1929_cov_221",98.182,55,1,0,650,704,1177,1123,2.28e-19,97.1,54,54
"76917","Ntome_NODE_28145_length_704_cov_5","Nsylvestris_NODE_34829_length_299_cov_4",91.837,147,9,2,36,180,153,298,4.7e-51,202,144,145
"76918","Ntome_NODE_28146_length_704_cov_5","Nsylvestris_NODE_6276_length_2702_cov_127",91.304,115,5,2,589,703,476,367,4.8e-36,152,114,109
"76942","Ntome_NODE_28157_length_703_cov_31","Nsylvestris_NODE_11334_length_1948_cov_103",98.077,52,1,0,1,52,858,909,1.06e-17,91.6,51,51
"76960","Ntome_NODE_28166_length_703_cov_12","Nsylvestris_NODE_16651_length_1386_cov_15",89.747,712,59,9,1,703,2,708,0,898,702,706
"76965","Ntome_NODE_28168_length_703_cov_11","Nsylvestris_NODE_26081_length_715_cov_13",94.034,704,38,2,1,703,2,702,0,1064,702,700
"76976","Ntome_NODE_28174_length_702_cov_301","Nsylvestris_NODE_12462_length_1820_cov_215",95.339,708,27,3,1,702,776,69,0,1120,701,707
"76977","Ntome_NODE_28175_length_702_cov_161","Nsylvestris_NODE_15252_length_1526_cov_129",97.586,290,6,1,1,290,677,965,1.92e-139,496,289,288
"76978","Ntome_NODE_28176_length_702_cov_123","Nsylvestris_NODE_22545_length_919_cov_159",88.797,607,34,5,4,597,705,120,0,713,593,585
"76982","Ntome_NODE_28178_length_701_cov_85","Nsylvestris_NODE_12587_length_1806_cov_206",93.359,256,17,0,345,600,1614,1359,2.01e-104,379,255,255
"76997","Ntome_NODE_28187_length_702_cov_9","Nsylvestris_NODE_2233_length_3922_cov_145",96.364,55,2,0,1,55,909,855,1.06e-17,91.6,54,54
"76998","Ntome_NODE_28188_length_702_cov_8","Nsylvestris_NODE_1017_length_4927_cov_127",92.063,441,35,0,262,702,4302,4742,3.03e-177,621,440,440
"76999","Ntome_NODE_28190_length_702_cov_7","Nsylvestris_NODE_21276_length_1008_cov_216",100,55,0,0,1,55,714,660,4.88e-21,102,54,54
"77002","Ntome_NODE_28192_length_702_cov_6","Nsylvestris_NODE_10194_length_2089_cov_144",100,53,0,0,648,700,415,363,6.32e-20,99,52,52
"77006","Ntome_NODE_28194_length_701_cov_314","Nsylvestris_NODE_8576_length_2313_cov_187",98.326,657,11,0,45,701,1924,1268,0,1153,656,656
"77032","Ntome_NODE_28207_length_701_cov_11","Nsylvestris_NODE_23997_length_832_cov_57",96.724,702,21,2,1,701,86,786,0,1168,700,700
"77033","Ntome_NODE_28209_length_701_cov_8","Nsylvestris_NODE_16555_length_1395_cov_112",94.545,55,3,0,1,55,131,185,4.91e-16,86.1,54,54
"77045","Ntome_NODE_28217_length_700_cov_50","Nsylvestris_NODE_8937_length_2258_cov_184",87.895,190,23,0,100,289,1453,1642,9.96e-58,224,189,189
"77062","Ntome_NODE_28224_length_700_cov_13","Nsylvestris_NODE_15861_length_1463_cov_22",95.908,391,15,1,311,700,1073,1463,1.4e-180,632,389,390
"77071","Ntome_NODE_28228_length_700_cov_8","Nsylvestris_NODE_3856_length_3282_cov_181",98.182,55,1,0,646,700,929,875,2.27e-19,97.1,54,54
"77072","Ntome_NODE_28229_length_700_cov_4","Nsylvestris_NODE_33832_length_327_cov_4",89.439,303,22,8,108,409,294,1,9.35e-103,374,301,293
"77073","Ntome_NODE_28230_length_700_cov_3","Nsylvestris_NODE_3220_length_3500_cov_115",96.364,55,2,0,1,55,2933,2987,1.05e-17,91.6,54,54
"77078","Ntome_NODE_28232_length_699_cov_281","Nsylvestris_NODE_23750_length_845_cov_228",89.474,684,28,9,1,667,125,781,0,824,666,656
"77084","Ntome_NODE_28235_length_699_cov_248","Nsylvestris_NODE_4462_length_3107_cov_171",92.705,658,23,9,1,633,658,1,0,926,632,657
"77091","Ntome_NODE_28238_length_699_cov_90","Nsylvestris_NODE_226_length_7160_cov_98",88.333,60,5,2,589,647,6650,6708,1.37e-11,71.3,58,58
"77137","Ntome_NODE_28258_length_699_cov_6","Nsylvestris_NODE_12337_length_1833_cov_218",100,55,0,0,645,699,978,1032,4.86e-21,102,54,54
"77138","Ntome_NODE_28259_length_699_cov_6","Nsylvestris_NODE_4216_length_3172_cov_159",91.492,717,36,9,2,699,2085,1375,0,963,697,710
"77152","Ntome_NODE_28265_length_698_cov_213","Nsylvestris_NODE_24940_length_774_cov_209",92.113,672,31,8,1,668,2,655,0,928,667,653
"77158","Ntome_NODE_28270_length_698_cov_101","Nsylvestris_NODE_22056_length_952_cov_186",94.629,391,21,0,308,698,1,391,8.44e-173,606,390,390
"77169","Ntome_NODE_28276_length_698_cov_59","Nsylvestris_NODE_35743_length_278_cov_12",90.517,232,15,1,474,698,267,36,1.6e-80,300,224,231
"77170","Ntome_NODE_28277_length_698_cov_51","Nsylvestris_NODE_16065_length_1443_cov_136",86.093,151,16,4,553,698,292,142,1.02e-37,158,145,150
"77171","Ntome_NODE_28278_length_698_cov_35","Nsylvestris_NODE_20808_length_1042_cov_99",86.192,717,50,23,3,684,806,104,0,730,681,702
"77179","Ntome_NODE_28281_length_698_cov_23","Nsylvestris_NODE_28024_length_628_cov_14",89.134,543,39,7,109,646,3,530,0,658,537,527
"77180","Ntome_NODE_28282_length_698_cov_23","Nsylvestris_NODE_31251_length_435_cov_23",90.492,305,27,2,3,306,435,132,4.28e-111,401,303,303
"77188","Ntome_NODE_28287_length_698_cov_20","Nsylvestris_NODE_3359_length_3452_cov_160",85.477,723,41,17,1,698,1778,2461,0,695,697,683
"77189","Ntome_NODE_28288_length_698_cov_19","Nsylvestris_NODE_2368_length_3858_cov_189",100,55,0,0,644,698,1786,1732,4.86e-21,102,54,54
"77190","Ntome_NODE_28289_length_698_cov_16","Nsylvestris_NODE_5053_length_2960_cov_68",95.349,688,21,5,1,678,1107,421,0,1083,677,686
"77197","Ntome_NODE_28292_length_698_cov_13","Nsylvestris_NODE_11884_length_1881_cov_221",94.545,55,3,0,1,55,1010,956,4.89e-16,86.1,54,54
"77206","Ntome_NODE_28295_length_698_cov_7","Nsylvestris_NODE_6372_length_2684_cov_161",94.545,55,3,0,644,698,872,818,4.89e-16,86.1,54,54
"77207","Ntome_NODE_28297_length_698_cov_6","Nsylvestris_NODE_13158_length_1743_cov_190",94.545,55,3,0,1,55,384,438,4.89e-16,86.1,54,54
"77208","Ntome_NODE_28298_length_698_cov_6","Nsylvestris_NODE_20725_length_1048_cov_10",91.717,664,47,6,1,663,357,1013,0,915,662,656
"77212","Ntome_NODE_28300_length_698_cov_3","Nsylvestris_NODE_483_length_6004_cov_227",100,55,0,0,644,698,3558,3504,4.86e-21,102,54,54
"77213","Ntome_NODE_28301_length_697_cov_395","Nsylvestris_NODE_5601_length_2840_cov_155",98.135,697,13,0,1,697,931,1627,0,1216,696,696
"77233","Ntome_NODE_28308_length_697_cov_22","Nsylvestris_NODE_5144_length_2938_cov_228",96.364,55,2,0,643,697,1206,1260,1.05e-17,91.6,54,54
"77234","Ntome_NODE_28309_length_697_cov_15","Nsylvestris_NODE_16032_length_1447_cov_17",86.325,468,41,10,121,572,1312,852,3.19e-137,488,451,460
"77235","Ntome_NODE_28310_length_697_cov_14","Nsylvestris_NODE_20236_length_1083_cov_192",94.545,55,3,0,643,697,583,637,4.88e-16,86.1,54,54
"77238","Ntome_NODE_28313_length_697_cov_9","Nsylvestris_NODE_7520_length_2483_cov_38",90.028,702,39,13,5,697,1586,2265,0,880,692,679
"77239","Ntome_NODE_28314_length_697_cov_8","Nsylvestris_NODE_22021_length_954_cov_193",98.182,55,1,0,643,697,432,378,2.26e-19,97.1,54,54
"77240","Ntome_NODE_28319_length_697_cov_4","Nsylvestris_NODE_5671_length_2823_cov_212",94.828,58,3,0,1,58,2762,2705,1.05e-17,91.6,57,57
"77241","Ntome_NODE_28320_length_696_cov_212","Nsylvestris_NODE_28038_length_627_cov_24",84.505,626,69,19,37,642,620,3,6.55e-169,593,605,617
"77244","Ntome_NODE_28323_length_696_cov_42","Nsylvestris_NODE_9344_length_2198_cov_224",96.364,55,2,0,642,696,324,378,1.05e-17,91.6,54,54
"77262","Ntome_NODE_28330_length_696_cov_11","Nsylvestris_NODE_24866_length_779_cov_39",87.306,709,56,17,1,688,1,696,0,780,687,695
"77269","Ntome_NODE_28336_length_695_cov_227","Nsylvestris_NODE_25741_length_731_cov_171",92.188,576,18,6,6,572,121,678,0,789,566,557
"77275","Ntome_NODE_28340_length_695_cov_96","Nsylvestris_NODE_8339_length_2350_cov_37",90,210,16,1,317,526,2076,2280,1.62e-70,267,209,204
"77288","Ntome_NODE_28349_length_695_cov_11","Nsylvestris_NODE_2362_length_3864_cov_70",100,55,0,0,641,695,1234,1288,4.83e-21,102,54,54
"77289","Ntome_NODE_28350_length_695_cov_8","Nsylvestris_NODE_21124_length_1020_cov_28",95.54,695,30,1,1,695,100,793,0,1110,694,693
"77295","Ntome_NODE_28354_length_695_cov_5","Nsylvestris_NODE_14878_length_1562_cov_189",89.58,595,56,6,104,695,1139,548,0,750,591,591
"77296","Ntome_NODE_28355_length_695_cov_4","Nsylvestris_NODE_1094_length_4827_cov_227",74.959,615,147,6,2,612,3936,4547,2.69e-73,276,610,611
"77297","Ntome_NODE_28356_length_695_cov_3","Nsylvestris_NODE_15851_length_1464_cov_7",89.937,636,56,6,1,633,828,1458,0,813,632,630
"77304","Ntome_NODE_28359_length_694_cov_239","Nsylvestris_NODE_18433_length_1229_cov_186",93.76,625,26,3,1,612,684,60,0,926,611,624
"77305","Ntome_NODE_28360_length_694_cov_220","Nsylvestris_NODE_28216_length_619_cov_176",90.774,607,48,7,50,653,1,602,0,804,603,601
"77314","Ntome_NODE_28365_length_694_cov_42","Nsylvestris_NODE_7732_length_2447_cov_143",93.06,317,22,0,1,317,645,329,5.34e-130,464,316,316
"77330","Ntome_NODE_28373_length_694_cov_17","Nsylvestris_NODE_3077_length_3551_cov_92",89.828,698,62,6,1,694,1488,2180,0,887,693,692
"77331","Ntome_NODE_28374_length_694_cov_12","Nsylvestris_NODE_13224_length_1736_cov_241",96.61,59,1,1,1,59,293,350,2.25e-19,97.1,58,57
"77335","Ntome_NODE_28376_length_694_cov_12","Nsylvestris_NODE_751_length_5349_cov_70",86.888,694,89,2,1,693,4236,3544,0,776,692,692
"77340","Ntome_NODE_28378_length_694_cov_10","Nsylvestris_NODE_6566_length_2649_cov_49",97.5,40,1,0,652,691,1723,1762,4.9e-11,69.4,39,39
"77341","Ntome_NODE_28379_length_694_cov_9","Nsylvestris_NODE_34034_length_322_cov_3",77.551,245,39,11,359,599,69,301,1.71e-30,134,240,232
"77346","Ntome_NODE_28384_length_694_cov_6","Nsylvestris_NODE_12788_length_1787_cov_219",100,55,0,0,640,694,451,397,4.83e-21,102,54,54
"77347","Ntome_NODE_28385_length_694_cov_3","Nsylvestris_NODE_31137_length_443_cov_3",89.316,234,21,3,1,231,251,19,9.6e-78,291,230,232
"77350","Ntome_NODE_28387_length_693_cov_126","Nsylvestris_NODE_25593_length_739_cov_214",92.066,668,38,5,30,691,674,16,0,926,661,658
"77351","Ntome_NODE_28388_length_693_cov_62","Nsylvestris_NODE_6081_length_2742_cov_112",87.692,65,5,3,17,80,95,157,3.78e-12,73.1,63,62
"77366","Ntome_NODE_28400_length_692_cov_267","Nsylvestris_NODE_1721_length_4235_cov_176",96.676,692,23,0,1,692,2197,2888,0,1151,691,691
"77367","Ntome_NODE_28401_length_692_cov_267","Nsylvestris_NODE_1497_length_4402_cov_208",95.044,686,12,6,1,670,3723,4402,0,1059,669,679
"77372","Ntome_NODE_28404_length_692_cov_117","Nsylvestris_NODE_7134_length_2548_cov_103",91.916,334,27,0,54,387,645,312,4.12e-131,468,333,333
"77375","Ntome_NODE_28406_length_692_cov_46","Nsylvestris_NODE_17950_length_1272_cov_38",95.018,562,17,7,59,612,116,674,0,872,553,558
"77376","Ntome_NODE_28407_length_692_cov_43","Nsylvestris_NODE_12394_length_1827_cov_20",95.699,465,20,0,1,465,1363,1827,0,749,464,464
"77377","Ntome_NODE_28409_length_692_cov_29","Nsylvestris_NODE_30994_length_452_cov_5",88.788,330,37,0,296,625,1,330,3.28e-112,405,329,329
"77380","Ntome_NODE_28411_length_691_cov_23","Nsylvestris_NODE_22992_length_892_cov_19",92.834,628,35,4,69,691,674,52,0,902,622,622
"77398","Ntome_NODE_28426_length_691_cov_159","Nsylvestris_NODE_26414_length_700_cov_12",83.425,181,26,4,514,691,498,319,6.04e-40,165,177,179
"77403","Ntome_NODE_28429_length_691_cov_95","Nsylvestris_NODE_29981_length_529_cov_123",79.63,162,29,4,12,170,495,335,2.22e-24,113,158,160
"77410","Ntome_NODE_28433_length_691_cov_48","Nsylvestris_NODE_2384_length_3848_cov_178",96.737,521,17,0,171,691,3331,2811,0,869,520,520
"77415","Ntome_NODE_28436_length_691_cov_25","Nsylvestris_NODE_25771_length_730_cov_23",92.89,661,34,5,30,683,1,655,0,948,653,654
"77420","Ntome_NODE_28438_length_691_cov_21","Nsylvestris_NODE_27851_length_635_cov_215",98.182,55,1,0,637,691,525,471,2.24e-19,97.1,54,54
"77421","Ntome_NODE_28441_length_691_cov_17","Nsylvestris_NODE_16451_length_1404_cov_217",100,55,0,0,637,691,1230,1176,4.81e-21,102,54,54
"77425","Ntome_NODE_28447_length_691_cov_6","Nsylvestris_NODE_3689_length_3339_cov_109",98.182,55,1,0,1,55,2586,2640,2.24e-19,97.1,54,54
"77426","Ntome_NODE_28450_length_690_cov_230","Nsylvestris_NODE_24068_length_827_cov_200",96.978,695,11,1,1,685,120,814,0,1158,684,694
"77429","Ntome_NODE_28454_length_690_cov_43","Nsylvestris_NODE_24269_length_814_cov_37",90.359,612,51,6,1,611,744,140,0,797,610,604
"77439","Ntome_NODE_28459_length_690_cov_24","Nsylvestris_NODE_7269_length_2523_cov_226",100,55,0,0,1,55,1712,1658,4.8e-21,102,54,54
"77440","Ntome_NODE_28461_length_690_cov_13","Nsylvestris_NODE_14439_length_1606_cov_175",96.364,55,2,0,636,690,1201,1255,1.04e-17,91.6,54,54
"77447","Ntome_NODE_28464_length_690_cov_12","Nsylvestris_NODE_10763_length_2018_cov_72",82.375,261,34,7,353,606,1167,912,1.64e-55,217,253,255
"77448","Ntome_NODE_28466_length_690_cov_11","Nsylvestris_NODE_11569_length_1922_cov_194",100,55,0,0,636,690,343,289,4.8e-21,102,54,54
"77449","Ntome_NODE_28471_length_690_cov_8","Nsylvestris_NODE_5556_length_2851_cov_31",94.762,630,24,1,1,630,2186,2806,0,972,629,620
"77455","Ntome_NODE_28475_length_690_cov_5","Nsylvestris_NODE_7118_length_2550_cov_86",83.926,647,102,2,6,651,1929,1284,3.85e-176,617,645,645
"77456","Ntome_NODE_28476_length_690_cov_5","Nsylvestris_NODE_6329_length_2693_cov_22",91.117,698,32,10,1,690,206,881,0,918,689,675
"77457","Ntome_NODE_28477_length_690_cov_3","Nsylvestris_NODE_6459_length_2668_cov_170",100,55,0,0,636,690,1017,963,4.8e-21,102,54,54
"77470","Ntome_NODE_28481_length_689_cov_154","Nsylvestris_NODE_6175_length_2721_cov_180",93.857,700,31,6,1,689,2656,1958,0,1044,688,698
"77471","Ntome_NODE_28482_length_689_cov_149","Nsylvestris_NODE_6335_length_2692_cov_121",89.482,599,16,7,1,595,556,1,0,713,594,555
"77504","Ntome_NODE_28499_length_689_cov_7","Nsylvestris_NODE_7595_length_2471_cov_125",94.545,55,3,0,635,689,1635,1689,4.82e-16,86.1,54,54
"77505","Ntome_NODE_28500_length_689_cov_5","Nsylvestris_NODE_16390_length_1410_cov_178",100,55,0,0,635,689,1034,980,4.79e-21,102,54,54
"77561","Ntome_NODE_28519_length_688_cov_17","Nsylvestris_NODE_24696_length_789_cov_56",93.353,692,31,7,1,687,58,739,0,1009,686,681
"77570","Ntome_NODE_28523_length_688_cov_9","Nsylvestris_NODE_1981_length_4066_cov_103",95.868,242,10,0,394,635,1,242,2.53e-108,392,241,241
"77574","Ntome_NODE_28526_length_688_cov_7","Nsylvestris_NODE_18017_length_1266_cov_197",98.305,59,1,0,2,60,288,346,1.33e-21,104,58,58
"77589","Ntome_NODE_28532_length_687_cov_256","Nsylvestris_NODE_6398_length_2680_cov_209",96.528,432,12,2,1,429,2011,2442,0,712,428,431
"77590","Ntome_NODE_28533_length_687_cov_165","Nsylvestris_NODE_26445_length_698_cov_170",93.294,686,29,5,6,674,13,698,0,996,668,685
"77591","Ntome_NODE_28535_length_687_cov_68","Nsylvestris_NODE_9444_length_2186_cov_173",96.591,88,3,0,2,89,573,660,2.18e-34,147,87,87
"77607","Ntome_NODE_28542_length_687_cov_10","Nsylvestris_NODE_169_length_7572_cov_81",83.153,647,103,5,42,685,4307,4950,1.08e-166,586,643,643
"77608","Ntome_NODE_28543_length_687_cov_7","Nsylvestris_NODE_457_length_6075_cov_161",96.657,688,20,3,1,687,3698,4383,0,1140,686,685
"77609","Ntome_NODE_28544_length_687_cov_4","Nsylvestris_NODE_8987_length_2253_cov_23",90.304,691,29,15,1,686,1281,624,0,870,685,657
"77617","Ntome_NODE_28551_length_686_cov_68","Nsylvestris_NODE_12498_length_1815_cov_144",100,33,0,0,544,576,1610,1578,8.09e-09,62.1,32,32
"77621","Ntome_NODE_28553_length_686_cov_24","Nsylvestris_NODE_31654_length_411_cov_5",82.677,127,22,0,482,608,156,282,2.2e-24,113,126,126
"77624","Ntome_NODE_28555_length_686_cov_13","Nsylvestris_NODE_488_length_5991_cov_125",98.182,55,1,0,1,55,508,562,2.22e-19,97.1,54,54
"77628","Ntome_NODE_28557_length_686_cov_12","Nsylvestris_NODE_7114_length_2550_cov_186",98.305,59,1,0,628,686,2091,2149,1.33e-21,104,58,58
"77635","Ntome_NODE_28562_length_686_cov_7","Nsylvestris_NODE_26586_length_692_cov_16",88.235,357,37,3,294,646,109,464,3.22e-117,422,352,355
"77658","Ntome_NODE_28573_length_685_cov_50","Nsylvestris_NODE_21959_length_958_cov_148",92.901,648,32,6,1,639,860,218,0,929,638,642
"77665","Ntome_NODE_28576_length_685_cov_21","Nsylvestris_NODE_29300_length_571_cov_11",80.993,584,76,16,49,620,11,571,5.35e-120,431,571,560
"77666","Ntome_NODE_28577_length_685_cov_21","Nsylvestris_NODE_2348_length_3871_cov_222",98.182,55,1,0,631,685,890,836,2.22e-19,97.1,54,54
"77680","Ntome_NODE_28582_length_685_cov_15","Nsylvestris_NODE_1133_length_4772_cov_213",98.182,55,1,0,631,685,2228,2282,2.22e-19,97.1,54,54
"77700","Ntome_NODE_28595_length_684_cov_128","Nsylvestris_NODE_1397_length_4496_cov_180",93.75,64,4,0,3,66,2149,2086,2.21e-19,97.1,63,63
"77708","Ntome_NODE_28599_length_684_cov_89","Nsylvestris_NODE_16007_length_1449_cov_18",93.939,66,4,0,619,684,1359,1424,1.71e-20,100,65,65
"77709","Ntome_NODE_28600_length_684_cov_67","Nsylvestris_NODE_29819_length_543_cov_7",95.316,427,17,2,54,480,120,543,0,675,426,423
"77710","Ntome_NODE_28601_length_684_cov_38","Nsylvestris_NODE_5539_length_2854_cov_143",92.19,589,44,2,53,639,614,26,0,832,586,588
"77718","Ntome_NODE_28606_length_684_cov_16","Nsylvestris_NODE_22021_length_954_cov_193",98.182,55,1,0,630,684,433,487,2.21e-19,97.1,54,54
"77722","Ntome_NODE_28611_length_684_cov_7","Nsylvestris_NODE_13731_length_1681_cov_177",98.182,55,1,0,1,55,670,724,2.21e-19,97.1,54,54
"77726","Ntome_NODE_28613_length_684_cov_6","Nsylvestris_NODE_5820_length_2797_cov_126",84.434,636,70,11,55,684,626,1238,1.38e-170,599,629,612
"77731","Ntome_NODE_28617_length_683_cov_73","Nsylvestris_NODE_26052_length_716_cov_81",95.714,560,18,4,14,567,609,50,0,896,553,559
"77732","Ntome_NODE_28618_length_683_cov_55","Nsylvestris_NODE_29391_length_567_cov_180",90.353,539,37,8,131,657,8,543,0,693,526,535
"77735","Ntome_NODE_28620_length_683_cov_44","Nsylvestris_NODE_24208_length_818_cov_152",86.877,381,42,5,309,683,405,27,1.15e-116,420,374,378
"77748","Ntome_NODE_28626_length_683_cov_13","Nsylvestris_NODE_241_length_7050_cov_29",98.182,55,1,0,1,55,2526,2580,2.21e-19,97.1,54,54
"77749","Ntome_NODE_28627_length_683_cov_11","Nsylvestris_NODE_1426_length_4473_cov_221",98.305,59,1,0,1,59,726,784,1.32e-21,104,58,58
"77750","Ntome_NODE_28628_length_683_cov_9","Nsylvestris_NODE_19954_length_1106_cov_184",96.226,53,2,0,3,55,659,607,1.33e-16,87.9,52,52
"77753","Ntome_NODE_28630_length_683_cov_5","Nsylvestris_NODE_18607_length_1217_cov_14",98.182,55,1,0,629,683,690,744,2.21e-19,97.1,54,54
"77754","Ntome_NODE_28631_length_682_cov_2","Nsylvestris_NODE_28760_length_595_cov_4",85.217,230,17,5,4,225,579,359,1.25e-56,220,221,220
"77755","Ntome_NODE_28632_length_682_cov_320","Nsylvestris_NODE_5909_length_2779_cov_239",96.774,682,22,0,1,682,2694,2013,0,1138,681,681
"77768","Ntome_NODE_28637_length_682_cov_238","Nsylvestris_NODE_20544_length_1061_cov_216",89.313,524,23,19,1,491,37,560,6.33e-179,627,490,523
"77769","Ntome_NODE_28638_length_682_cov_234","Nsylvestris_NODE_13122_length_1748_cov_119",95.758,660,21,5,1,658,1055,1709,0,1057,657,654
"77784","Ntome_NODE_28644_length_682_cov_32","Nsylvestris_NODE_27032_length_671_cov_42",95.455,440,16,2,1,440,658,223,0,699,439,435
"77785","Ntome_NODE_28645_length_682_cov_30","Nsylvestris_NODE_18468_length_1227_cov_82",93.182,44,2,1,517,560,418,376,2.24e-09,63.9,43,42
"77802","Ntome_NODE_28654_length_682_cov_9","Nsylvestris_NODE_4894_length_2996_cov_222",98.182,55,1,0,1,55,2252,2198,2.21e-19,97.1,54,54
"77806","Ntome_NODE_28656_length_682_cov_9","Nsylvestris_NODE_16294_length_1420_cov_192",98.305,59,0,1,625,682,765,823,4.74e-21,102,57,58
"77813","Ntome_NODE_28659_length_682_cov_6","Nsylvestris_NODE_9752_length_2146_cov_225",91.304,69,4,2,1,68,294,361,2.85e-18,93.5,67,67
"77822","Ntome_NODE_28669_length_681_cov_276","Nsylvestris_NODE_3180_length_3515_cov_118",94.168,703,14,5,1,681,3515,2818,0,1046,680,697
"77825","Ntome_NODE_28671_length_681_cov_190","Nsylvestris_NODE_25165_length_762_cov_165",92.193,538,41,1,99,635,674,137,0,760,536,537
"77826","Ntome_NODE_28674_length_681_cov_69","Nsylvestris_NODE_16217_length_1428_cov_106",94.696,641,22,3,44,681,485,1116,0,985,637,631
"77827","Ntome_NODE_28675_length_681_cov_41","Nsylvestris_NODE_9686_length_2154_cov_86",90.574,244,19,1,435,678,443,682,1.2e-86,320,243,239
"77842","Ntome_NODE_28686_length_681_cov_12","Nsylvestris_NODE_700_length_5429_cov_204",77.273,132,27,3,311,440,5004,4874,1.03e-12,75,129,130
"77845","Ntome_NODE_28689_length_681_cov_7","Nsylvestris_NODE_4529_length_3092_cov_128",90.058,684,57,3,1,681,2341,3016,0,876,680,675
"77853","Ntome_NODE_28693_length_680_cov_301","Nsylvestris_NODE_2368_length_3858_cov_189",98.523,677,10,0,4,680,1110,1786,0,1195,676,676
"77857","Ntome_NODE_28695_length_680_cov_247","Nsylvestris_NODE_28687_length_598_cov_22",95.265,528,22,2,109,635,598,73,0,833,526,525
"77861","Ntome_NODE_28697_length_680_cov_210","Nsylvestris_NODE_24354_length_809_cov_154",92.748,524,24,5,84,595,674,153,0,745,511,521
"77867","Ntome_NODE_28700_length_680_cov_115","Nsylvestris_NODE_26044_length_716_cov_213",97.101,276,8,0,405,680,66,341,1.45e-130,466,275,275
"77868","Ntome_NODE_28701_length_680_cov_62","Nsylvestris_NODE_10126_length_2100_cov_77",96.361,687,18,1,1,680,1351,665,0,1123,679,686
"77876","Ntome_NODE_28707_length_680_cov_17","Nsylvestris_NODE_3238_length_3495_cov_110",91.52,684,47,8,1,680,2950,2274,0,931,679,676
"77883","Ntome_NODE_28713_length_680_cov_5","Nsylvestris_NODE_723_length_5397_cov_179",93.642,692,17,4,1,680,1873,2549,0,1009,679,676
"77884","Ntome_NODE_28714_length_680_cov_3","Nsylvestris_NODE_768_length_5301_cov_83",98.182,55,1,0,626,680,3114,3168,2.2e-19,97.1,54,54
"77885","Ntome_NODE_28715_length_679_cov_297","Nsylvestris_NODE_2434_length_3824_cov_170",98.675,679,9,0,1,679,1073,1751,0,1205,678,678
"77893","Ntome_NODE_28719_length_679_cov_175","Nsylvestris_NODE_24417_length_806_cov_13",91.667,48,4,0,1,48,584,537,1.72e-10,67.6,47,47
"77896","Ntome_NODE_28722_length_679_cov_58","Nsylvestris_NODE_25414_length_748_cov_90",92.251,684,30,4,14,674,34,717,0,948,660,683
"77908","Ntome_NODE_28726_length_679_cov_41","Nsylvestris_NODE_4105_length_3201_cov_223",96.226,53,2,0,1,53,2778,2830,1.32e-16,87.9,52,52
"77917","Ntome_NODE_28733_length_679_cov_9","Nsylvestris_NODE_2368_length_3858_cov_189",100,55,0,0,1,55,1840,1786,4.72e-21,102,54,54
"77921","Ntome_NODE_28735_length_679_cov_8","Nsylvestris_NODE_10041_length_2111_cov_152",96.364,55,2,0,625,679,1709,1763,1.02e-17,91.6,54,54
"77922","Ntome_NODE_28738_length_679_cov_5","Nsylvestris_NODE_12210_length_1847_cov_213",96.364,55,2,0,1,55,871,925,1.02e-17,91.6,54,54
"77923","Ntome_NODE_28739_length_679_cov_4","Nsylvestris_NODE_233_length_7091_cov_109",87.5,704,49,25,1,679,4871,4182,0,776,678,689
"77926","Ntome_NODE_28741_length_679_cov_3","Nsylvestris_NODE_30961_length_454_cov_3",83.929,224,16,9,456,679,2,205,2.1e-49,196,223,203
"77942","Ntome_NODE_28747_length_678_cov_25","Nsylvestris_NODE_5280_length_2909_cov_186",100,53,0,0,3,55,2496,2444,6.09e-20,99,52,52
"77943","Ntome_NODE_28748_length_678_cov_22","Nsylvestris_NODE_11571_length_1922_cov_148",90.044,683,44,13,1,678,1266,603,0,863,677,663
"77944","Ntome_NODE_28749_length_678_cov_21","Nsylvestris_NODE_190_length_7434_cov_175",100,55,0,0,624,678,1562,1616,4.71e-21,102,54,54
"77947","Ntome_NODE_28751_length_678_cov_17","Nsylvestris_NODE_1294_length_4600_cov_109",93.953,678,31,5,1,678,1,668,0,1016,677,667
"77948","Ntome_NODE_28752_length_678_cov_11","Nsylvestris_NODE_2696_length_3706_cov_98",100,55,0,0,1,55,969,915,4.71e-21,102,54,54
"77958","Ntome_NODE_28761_length_677_cov_253","Nsylvestris_NODE_21649_length_981_cov_141",93.867,587,30,2,79,663,932,350,0,880,584,582
"77962","Ntome_NODE_28765_length_677_cov_200","Nsylvestris_NODE_4_length_15019_cov_122",98.182,55,1,0,623,677,1097,1151,2.19e-19,97.1,54,54
"77968","Ntome_NODE_28768_length_677_cov_173","Nsylvestris_NODE_10283_length_2077_cov_225",90.476,84,6,2,595,677,482,564,2.81e-23,110,82,82
"77969","Ntome_NODE_28769_length_677_cov_98","Nsylvestris_NODE_21398_length_999_cov_181",96.61,59,2,0,619,677,633,691,6.09e-20,99,58,58
"77980","Ntome_NODE_28778_length_677_cov_21","Nsylvestris_NODE_642_length_5580_cov_225",98.148,54,1,0,2,55,582,529,7.87e-19,95.3,53,53
"77984","Ntome_NODE_28780_length_677_cov_19","Nsylvestris_NODE_32182_length_386_cov_6",85.823,395,17,14,148,512,386,1,1.5e-105,383,364,385
"77985","Ntome_NODE_28781_length_677_cov_16","Nsylvestris_NODE_12906_length_1774_cov_144",98.182,55,1,0,623,677,175,229,2.19e-19,97.1,54,54
"77989","Ntome_NODE_28784_length_677_cov_7","Nsylvestris_NODE_5702_length_2820_cov_60",84.748,695,37,32,1,675,2311,1666,1.35e-180,632,674,645
"77990","Ntome_NODE_28786_length_677_cov_5","Nsylvestris_NODE_430_length_6172_cov_226",96.364,55,2,0,1,55,1033,979,1.02e-17,91.6,54,54
"77991","Ntome_NODE_28787_length_677_cov_5","Nsylvestris_NODE_4630_length_3064_cov_112",86.085,539,71,3,1,537,2340,2876,6.41e-164,577,536,536
"77992","Ntome_NODE_28788_length_677_cov_5","Nsylvestris_NODE_6956_length_2576_cov_117",93.058,677,28,2,1,677,390,1047,0,972,676,657
"77993","Ntome_NODE_28789_length_677_cov_5","Nsylvestris_NODE_1117_length_4804_cov_122",94.545,55,3,0,1,55,2601,2547,4.74e-16,86.1,54,54
"77994","Ntome_NODE_28790_length_676_cov_328","Nsylvestris_NODE_5231_length_2919_cov_224",97.92,673,14,0,4,676,2426,1754,0,1166,672,672
"78011","Ntome_NODE_28796_length_676_cov_180","Nsylvestris_NODE_3721_length_3328_cov_201",90.24,707,31,10,1,676,2629,3328,0,889,675,699
"78012","Ntome_NODE_28797_length_676_cov_37","Nsylvestris_NODE_31024_length_449_cov_11",88.862,413,38,6,60,470,27,433,3.96e-141,501,410,406
"78026","Ntome_NODE_28808_length_676_cov_8","Nsylvestris_NODE_20801_length_1043_cov_72",96.364,55,2,0,622,676,545,599,1.02e-17,91.6,54,54
"78029","Ntome_NODE_28810_length_676_cov_7","Nsylvestris_NODE_7868_length_2425_cov_220",94.444,36,2,0,1,36,514,549,3.71e-07,56.5,35,35
"78034","Ntome_NODE_28814_length_675_cov_163","Nsylvestris_NODE_27168_length_666_cov_43",96.063,127,5,0,546,672,392,518,9.66e-53,207,126,126
"78039","Ntome_NODE_28816_length_675_cov_91","Nsylvestris_NODE_12501_length_1815_cov_113",95.498,311,11,2,20,329,1709,1401,6.62e-139,494,309,308
"78043","Ntome_NODE_28818_length_675_cov_68","Nsylvestris_NODE_25096_length_766_cov_131",87.561,619,39,16,58,671,683,98,0,682,613,585
"78055","Ntome_NODE_28828_length_675_cov_9","Nsylvestris_NODE_15158_length_1534_cov_168",98.113,53,1,0,3,55,1274,1222,2.82e-18,93.5,52,52
"78059","Ntome_NODE_28831_length_675_cov_8","Nsylvestris_NODE_27204_length_664_cov_46",83.422,187,17,6,501,673,414,228,7.63e-39,161,172,186
"78068","Ntome_NODE_28839_length_674_cov_123","Nsylvestris_NODE_28790_length_593_cov_9",87.978,549,20,24,82,623,515,6,8.14e-173,606,541,509
"78085","Ntome_NODE_28848_length_674_cov_19","Nsylvestris_NODE_2038_length_4029_cov_212",98.182,55,1,0,620,674,1293,1239,2.18e-19,97.1,54,54
"78086","Ntome_NODE_28849_length_674_cov_14","Nsylvestris_NODE_24733_length_786_cov_10",94.828,116,6,0,559,674,642,757,5.85e-45,182,115,115
"78089","Ntome_NODE_28851_length_673_cov_13","Nsylvestris_NODE_20989_length_1028_cov_190",93.14,656,38,5,19,670,763,111,0,955,651,652
"78098","Ntome_NODE_28857_length_674_cov_8","Nsylvestris_NODE_23560_length_856_cov_13",85.985,685,66,15,6,674,677,7,0,706,668,670
"78099","Ntome_NODE_28861_length_674_cov_4","Nsylvestris_NODE_7908_length_2420_cov_108",96.364,55,2,0,1,55,146,200,1.01e-17,91.6,54,54
"78100","Ntome_NODE_28862_length_673_cov_270","Nsylvestris_NODE_11230_length_1959_cov_136",98.96,673,7,0,1,673,1430,758,0,1205,672,672
"78108","Ntome_NODE_28866_length_673_cov_64","Nsylvestris_NODE_43_length_9620_cov_55",83.969,131,19,2,1,130,9283,9154,9.98e-28,124,129,129
"78114","Ntome_NODE_28870_length_673_cov_20","Nsylvestris_NODE_9496_length_2178_cov_201",98.701,77,1,0,595,671,70,146,1.28e-31,137,76,76
"78124","Ntome_NODE_28876_length_673_cov_10","Nsylvestris_NODE_28272_length_616_cov_3",93.41,607,28,5,1,607,22,616,0,889,606,594
"78125","Ntome_NODE_28878_length_673_cov_5","Nsylvestris_NODE_17414_length_1321_cov_210",98.182,55,1,0,1,55,874,820,2.18e-19,97.1,54,54
"78128","Ntome_NODE_28881_length_672_cov_321","Nsylvestris_NODE_4596_length_3075_cov_216",96.28,672,25,0,1,672,1571,900,0,1103,671,671
"78133","Ntome_NODE_28884_length_672_cov_112","Nsylvestris_NODE_19525_length_1141_cov_111",94.042,621,25,5,1,621,490,1098,0,931,620,608
"78148","Ntome_NODE_28890_length_672_cov_30","Nsylvestris_NODE_28959_length_585_cov_154",96.552,58,0,1,1,56,317,374,7.81e-19,95.3,55,57
"78152","Ntome_NODE_28892_length_672_cov_23","Nsylvestris_NODE_26138_length_712_cov_181",98.113,53,1,0,1,53,255,203,2.81e-18,93.5,52,52
"78153","Ntome_NODE_28893_length_672_cov_20","Nsylvestris_NODE_2554_length_3767_cov_143",98.182,55,1,0,618,672,365,419,2.17e-19,97.1,54,54
"78154","Ntome_NODE_28895_length_672_cov_16","Nsylvestris_NODE_12028_length_1866_cov_79",96.364,55,2,0,618,672,662,716,1.01e-17,91.6,54,54
"78155","Ntome_NODE_28896_length_672_cov_13","Nsylvestris_NODE_9546_length_2170_cov_206",100,55,0,0,1,55,1791,1737,4.67e-21,102,54,54
"78159","Ntome_NODE_28900_length_672_cov_8","Nsylvestris_NODE_1261_length_4629_cov_84",99.107,672,6,0,1,672,3549,2878,0,1208,671,671
"78160","Ntome_NODE_28901_length_672_cov_7","Nsylvestris_NODE_3666_length_3345_cov_156",89.543,679,30,13,18,672,1307,1968,0,822,654,661
"78161","Ntome_NODE_28902_length_672_cov_7","Nsylvestris_NODE_2849_length_3638_cov_61",92.698,630,17,4,61,672,2,620,0,881,611,618
"78162","Ntome_NODE_28906_length_672_cov_5","Nsylvestris_NODE_10801_length_2013_cov_195",98.182,55,1,0,618,672,1425,1479,2.17e-19,97.1,54,54
"78163","Ntome_NODE_28907_length_672_cov_3","Nsylvestris_NODE_4551_length_3086_cov_38",98.837,172,2,0,501,672,3013,2842,9.22e-83,307,171,171
"78164","Ntome_NODE_28908_length_672_cov_3","Nsylvestris_NODE_1212_length_4693_cov_67",90.693,462,19,12,215,672,56,497,6.32e-169,593,457,441
"78165","Ntome_NODE_28909_length_671_cov_320","Nsylvestris_NODE_1924_length_4097_cov_211",93.89,671,41,0,1,671,1253,1923,0,1013,670,670
"78170","Ntome_NODE_28911_length_671_cov_275","Nsylvestris_NODE_593_length_5719_cov_204",94.805,539,15,2,133,671,3985,4510,0,828,538,525
"78175","Ntome_NODE_28914_length_671_cov_77","Nsylvestris_NODE_11250_length_1957_cov_20",80.176,227,42,3,200,424,1681,1906,1.63e-40,167,224,225
"78190","Ntome_NODE_28921_length_671_cov_15","Nsylvestris_NODE_8136_length_2382_cov_147",98.182,55,1,0,1,55,2069,2123,2.17e-19,97.1,54,54
"78191","Ntome_NODE_28923_length_671_cov_9","Nsylvestris_NODE_7302_length_2519_cov_57",96.88,673,19,2,1,671,1288,1960,0,1125,670,672
"78196","Ntome_NODE_28932_length_670_cov_294","Nsylvestris_NODE_2684_length_3711_cov_203",89.435,672,35,9,1,670,2425,3062,0,815,669,637
"78217","Ntome_NODE_28940_length_670_cov_52","Nsylvestris_NODE_25575_length_740_cov_153",95,60,3,0,611,670,559,500,7.79e-19,95.3,59,59
"78218","Ntome_NODE_28941_length_669_cov_46","Nsylvestris_NODE_518_length_5911_cov_122",85.167,209,21,8,132,339,5825,5626,3.44e-52,206,207,199
"78219","Ntome_NODE_28942_length_670_cov_44","Nsylvestris_NODE_5761_length_2808_cov_22",98.684,76,1,0,300,375,690,765,4.59e-31,135,75,75
"78230","Ntome_NODE_28947_length_670_cov_19","Nsylvestris_NODE_17508_length_1313_cov_13",88.444,225,18,4,447,670,656,439,5.61e-70,265,223,217
"78244","Ntome_NODE_28953_length_670_cov_9","Nsylvestris_NODE_298_length_6753_cov_119",95.582,679,21,2,1,670,4482,3804,0,1079,669,678
"78248","Ntome_NODE_28956_length_670_cov_6","Nsylvestris_NODE_21579_length_986_cov_140",96.364,55,2,0,1,55,275,221,1.01e-17,91.6,54,54
"78249","Ntome_NODE_28958_length_670_cov_4","Nsylvestris_NODE_30077_length_520_cov_199",94.915,59,2,1,1,58,271,213,1.01e-17,91.6,57,58
"78263","Ntome_NODE_28964_length_669_cov_116","Nsylvestris_NODE_1756_length_4201_cov_107",87.892,223,18,5,435,657,2116,1903,1.21e-66,254,222,213
"78264","Ntome_NODE_28966_length_667_cov_62","Nsylvestris_NODE_5079_length_2954_cov_97",90.698,86,6,2,485,570,119,202,2.14e-24,113,85,83
"78265","Ntome_NODE_28968_length_669_cov_51","Nsylvestris_NODE_23018_length_890_cov_58",94.558,588,24,4,36,620,846,264,0,902,584,582
"78279","Ntome_NODE_28974_length_669_cov_15","Nsylvestris_NODE_18298_length_1241_cov_110",98.182,55,1,0,1,55,623,569,2.16e-19,97.1,54,54
"78285","Ntome_NODE_28977_length_669_cov_12","Nsylvestris_NODE_13995_length_1649_cov_220",94.545,55,3,0,1,55,959,905,4.68e-16,86.1,54,54
"78298","Ntome_NODE_28985_length_668_cov_270","Nsylvestris_NODE_6092_length_2740_cov_29",95.455,132,6,0,537,668,56,187,7.39e-54,211,131,131
"78319","Ntome_NODE_28994_length_668_cov_38","Nsylvestris_NODE_17359_length_1326_cov_214",100,55,0,0,614,668,889,943,4.64e-21,102,54,54
"78331","Ntome_NODE_28999_length_668_cov_22","Nsylvestris_NODE_10896_length_2001_cov_82",99.439,535,2,1,120,654,1467,2000,0,970,534,533
"78339","Ntome_NODE_29002_length_668_cov_17","Nsylvestris_NODE_10401_length_2062_cov_90",100,55,0,0,1,55,584,530,4.64e-21,102,54,54
"78340","Ntome_NODE_29003_length_668_cov_12","Nsylvestris_NODE_25287_length_755_cov_69",87.097,124,15,1,545,668,450,328,3.54e-32,139,123,122
"78341","Ntome_NODE_29004_length_668_cov_12","Nsylvestris_NODE_741_length_5363_cov_225",98.182,55,1,0,1,55,512,458,2.16e-19,97.1,54,54
"78342","Ntome_NODE_29007_length_668_cov_8","Nsylvestris_NODE_30101_length_518_cov_10",91.441,222,17,2,375,596,3,222,1.18e-81,303,221,219
"78343","Ntome_NODE_29008_length_668_cov_7","Nsylvestris_NODE_3351_length_3455_cov_155",95.97,670,25,2,1,668,1725,1056,0,1086,667,669
"78347","Ntome_NODE_29012_length_668_cov_4","Nsylvestris_NODE_24163_length_822_cov_10",93.436,259,13,4,1,258,269,14,5.32e-105,381,257,255
"78355","Ntome_NODE_29017_length_667_cov_179","Nsylvestris_NODE_20502_length_1064_cov_101",96.6,500,15,2,116,615,886,389,0,828,499,497
"78364","Ntome_NODE_29020_length_667_cov_73","Nsylvestris_NODE_4439_length_3112_cov_79",94.153,667,29,3,1,667,1130,474,0,1007,666,656
"78371","Ntome_NODE_29023_length_667_cov_27","Nsylvestris_NODE_8165_length_2376_cov_214",96.364,55,2,0,1,55,799,853,1e-17,91.6,54,54
"78375","Ntome_NODE_29026_length_667_cov_15","Nsylvestris_NODE_4363_length_3136_cov_156",95.833,48,2,0,1,48,1067,1020,7.81e-14,78.7,47,47
"78382","Ntome_NODE_29029_length_667_cov_5","Nsylvestris_NODE_5374_length_2891_cov_212",94.545,55,3,0,613,667,1651,1705,4.66e-16,86.1,54,54
"78383","Ntome_NODE_29030_length_667_cov_5","Nsylvestris_NODE_1869_length_4137_cov_56",95.502,667,27,1,1,667,2747,3410,0,1062,666,663
"78389","Ntome_NODE_29034_length_666_cov_309","Nsylvestris_NODE_17109_length_1347_cov_220",98.198,666,12,0,1,666,200,865,0,1164,665,665
"78395","Ntome_NODE_29037_length_666_cov_69","Nsylvestris_NODE_2281_length_3901_cov_146",93.853,667,26,4,1,666,703,51,0,990,665,652
"78400","Ntome_NODE_29043_length_666_cov_27","Nsylvestris_NODE_22806_length_902_cov_148",86.866,670,51,16,1,661,201,842,0,715,660,641
"78408","Ntome_NODE_29047_length_666_cov_13","Nsylvestris_NODE_3156_length_3525_cov_35",96.741,675,13,1,1,666,1501,2175,0,1116,665,674
"78409","Ntome_NODE_29048_length_666_cov_13","Nsylvestris_NODE_13968_length_1654_cov_172",95.227,419,17,1,192,610,1189,1604,0,660,418,415
"78412","Ntome_NODE_29050_length_666_cov_7","Nsylvestris_NODE_4542_length_3088_cov_86",98.182,55,1,0,612,666,1224,1170,2.15e-19,97.1,54,54
"78413","Ntome_NODE_29051_length_666_cov_7","Nsylvestris_NODE_32614_length_367_cov_5",95.095,367,15,1,255,618,367,1,2.27e-163,575,363,366
"78414","Ntome_NODE_29052_length_666_cov_6","Nsylvestris_NODE_17138_length_1345_cov_27",83.23,161,24,3,481,640,505,663,7.58e-34,145,159,158
"78415","Ntome_NODE_29053_length_666_cov_5","Nsylvestris_NODE_27168_length_666_cov_43",96.154,52,2,0,615,666,518,467,4.66e-16,86.1,51,51
"78416","Ntome_NODE_29054_length_666_cov_4","Nsylvestris_NODE_31071_length_447_cov_4",89.552,67,6,1,30,95,341,407,1.68e-15,84.2,65,66
"78419","Ntome_NODE_29056_length_665_cov_238","Nsylvestris_NODE_28888_length_588_cov_85",89.807,569,33,13,13,575,10,559,0,706,562,549
"78420","Ntome_NODE_29057_length_665_cov_169","Nsylvestris_NODE_18286_length_1242_cov_169",86.438,553,41,10,72,602,1208,668,2.26e-163,575,530,540
"78423","Ntome_NODE_29059_length_665_cov_61","Nsylvestris_NODE_6624_length_2638_cov_134",94.34,53,3,0,3,55,1727,1675,6.02e-15,82.4,52,52
"78426","Ntome_NODE_29062_length_665_cov_37","Nsylvestris_NODE_12425_length_1824_cov_201",100,53,0,0,1,53,279,227,5.97e-20,99,52,52
"78430","Ntome_NODE_29065_length_665_cov_31","Nsylvestris_NODE_33929_length_324_cov_5",77.389,314,43,12,111,400,15,324,7.51e-39,161,289,309
"78439","Ntome_NODE_29068_length_665_cov_25","Nsylvestris_NODE_6758_length_2611_cov_233",98.182,55,1,0,1,55,2538,2592,2.15e-19,97.1,54,54
"78440","Ntome_NODE_29070_length_665_cov_20","Nsylvestris_NODE_22436_length_926_cov_22",96.296,54,2,0,612,665,714,661,3.6e-17,89.8,53,53
"78441","Ntome_NODE_29071_length_665_cov_19","Nsylvestris_NODE_1287_length_4606_cov_25",75.391,256,41,15,376,617,3122,3369,1.28e-21,104,241,247
"78458","Ntome_NODE_29080_length_665_cov_7","Nsylvestris_NODE_1592_length_4337_cov_26",93.344,646,29,9,1,639,2637,1999,0,942,638,638
"78459","Ntome_NODE_29081_length_665_cov_6","Nsylvestris_NODE_16908_length_1364_cov_192",96.364,55,2,0,611,665,1129,1075,1e-17,91.6,54,54
"78463","Ntome_NODE_29083_length_665_cov_5","Nsylvestris_NODE_14148_length_1635_cov_197",100,55,0,0,1,55,1114,1060,4.62e-21,102,54,54
"78464","Ntome_NODE_29084_length_665_cov_4","Nsylvestris_NODE_33354_length_341_cov_2",90.058,342,33,1,266,607,1,341,2.4e-123,442,341,340
"78474","Ntome_NODE_29089_length_664_cov_252","Nsylvestris_NODE_27557_length_648_cov_186",90.984,488,38,5,59,541,44,530,0,652,482,486
"78475","Ntome_NODE_29090_length_664_cov_247","Nsylvestris_NODE_1470_length_4425_cov_134",87.852,675,63,7,1,663,2160,2827,0,774,662,667
"78484","Ntome_NODE_29094_length_664_cov_128","Nsylvestris_NODE_5601_length_2840_cov_155",95.059,425,18,3,1,423,985,562,0,665,422,423
"78517","Ntome_NODE_29107_length_664_cov_10","Nsylvestris_NODE_15148_length_1535_cov_98",87.5,96,11,1,403,497,516,421,2.76e-23,110,94,95
"78522","Ntome_NODE_29110_length_664_cov_6","Nsylvestris_NODE_4867_length_3004_cov_27",90.761,552,38,5,122,664,92,639,0,725,542,547
"78523","Ntome_NODE_29111_length_664_cov_5","Nsylvestris_NODE_29644_length_557_cov_6",93.814,388,20,2,1,387,385,1,4.86e-165,580,386,384
"78524","Ntome_NODE_29112_length_664_cov_4","Nsylvestris_NODE_7929_length_2415_cov_68",97.959,49,1,0,1,49,1144,1192,4.64e-16,86.1,48,48
"78539","Ntome_NODE_29119_length_663_cov_237","Nsylvestris_NODE_29889_length_537_cov_11",88.699,469,37,9,55,511,530,66,2.27e-158,558,456,464
"78540","Ntome_NODE_29120_length_663_cov_206","Nsylvestris_NODE_23126_length_883_cov_182",97.143,280,8,0,384,663,453,732,8.47e-133,473,279,279
"78541","Ntome_NODE_29121_length_663_cov_200","Nsylvestris_NODE_8017_length_2400_cov_161",94.19,654,24,4,1,649,695,51,0,985,648,644
"78550","Ntome_NODE_29126_length_663_cov_22","Nsylvestris_NODE_23799_length_841_cov_74",84.716,229,28,5,6,229,722,496,3.39e-57,222,223,226
"78554","Ntome_NODE_29128_length_648_cov_17","Nsylvestris_NODE_14552_length_1594_cov_220",100,55,0,0,1,55,799,745,4.5e-21,102,54,54
"78558","Ntome_NODE_29134_length_663_cov_6","Nsylvestris_NODE_1546_length_4361_cov_224",94.737,38,2,0,578,615,4151,4114,2.81e-08,60.2,37,37
"78559","Ntome_NODE_29135_length_662_cov_265","Nsylvestris_NODE_17003_length_1357_cov_196",93.072,664,37,6,7,662,1348,686,0,963,655,662
"78565","Ntome_NODE_29137_length_662_cov_246","Nsylvestris_NODE_16833_length_1369_cov_202",97.751,489,11,0,174,662,53,541,0,843,488,488
"78566","Ntome_NODE_29138_length_662_cov_240","Nsylvestris_NODE_11023_length_1984_cov_201",92.754,621,18,7,1,614,1333,1933,0,872,613,600
"78567","Ntome_NODE_29139_length_662_cov_215","Nsylvestris_NODE_18595_length_1217_cov_222",96.791,592,18,1,1,591,626,1217,0,987,590,591
"78576","Ntome_NODE_29145_length_662_cov_67","Nsylvestris_NODE_7924_length_2417_cov_55",87.838,222,22,2,253,474,182,398,3.33e-67,255,221,216
"78577","Ntome_NODE_29146_length_662_cov_66","Nsylvestris_NODE_5799_length_2800_cov_195",98.182,55,1,0,608,662,2103,2049,2.14e-19,97.1,54,54
"78578","Ntome_NODE_29147_length_662_cov_63","Nsylvestris_NODE_9532_length_2172_cov_112",98.182,55,1,0,608,662,412,358,2.14e-19,97.1,54,54
"78579","Ntome_NODE_29148_length_662_cov_36","Nsylvestris_NODE_24351_length_809_cov_189",89.388,490,40,7,60,545,743,262,7.99e-173,606,485,481
"78587","Ntome_NODE_29152_length_662_cov_20","Nsylvestris_NODE_12018_length_1867_cov_178",95.71,373,11,4,253,623,2,371,1.73e-169,595,370,369
"78588","Ntome_NODE_29156_length_662_cov_13","Nsylvestris_NODE_1309_length_4585_cov_174",98.182,55,1,0,608,662,3661,3607,2.14e-19,97.1,54,54
"78589","Ntome_NODE_29157_length_662_cov_11","Nsylvestris_NODE_29498_length_563_cov_23",88.408,578,11,18,126,662,1,563,0,645,536,562
"78602","Ntome_NODE_29165_length_662_cov_5","Nsylvestris_NODE_11990_length_1870_cov_15",94.745,647,25,7,17,662,420,1058,0,998,645,638
"78610","Ntome_NODE_29172_length_661_cov_199","Nsylvestris_NODE_24833_length_781_cov_120",93.148,613,36,6,1,613,5,611,0,894,612,606
"78634","Ntome_NODE_29185_length_661_cov_4","Nsylvestris_NODE_3228_length_3497_cov_147",100,55,0,0,607,661,616,670,4.59e-21,102,54,54
"78638","Ntome_NODE_29187_length_660_cov_255","Nsylvestris_NODE_15094_length_1541_cov_209",100,55,0,0,1,55,581,635,4.58e-21,102,54,54
"78650","Ntome_NODE_29194_length_660_cov_56","Nsylvestris_NODE_28316_length_613_cov_110",93.648,614,25,7,15,622,606,1,0,905,607,605
"78651","Ntome_NODE_29195_length_660_cov_44","Nsylvestris_NODE_18380_length_1232_cov_96",84.153,183,25,4,455,635,470,650,9.57e-43,174,180,180
"78652","Ntome_NODE_29197_length_660_cov_38","Nsylvestris_NODE_10588_length_2039_cov_153",91.007,556,36,6,1,550,1486,2033,0,737,549,547
"78661","Ntome_NODE_29200_length_660_cov_26","Nsylvestris_NODE_6398_length_2680_cov_209",98.305,59,1,0,602,660,2069,2011,1.27e-21,104,58,58
"78677","Ntome_NODE_29209_length_660_cov_7","Nsylvestris_NODE_32217_length_385_cov_2",92.683,369,16,7,1,368,24,382,2.97e-147,521,367,358
"78683","Ntome_NODE_29212_length_659_cov_245","Nsylvestris_NODE_2610_length_3739_cov_199",91.921,656,29,10,7,659,1751,2385,0,896,652,634
"78688","Ntome_NODE_29215_length_659_cov_192","Nsylvestris_NODE_26301_length_705_cov_44",89.247,651,23,18,21,659,72,687,0,771,638,615
"78695","Ntome_NODE_29218_length_659_cov_100","Nsylvestris_NODE_28050_length_626_cov_35",90.747,616,34,12,12,617,1,603,0,800,605,602
"78702","Ntome_NODE_29221_length_659_cov_46","Nsylvestris_NODE_26873_length_679_cov_30",84.049,163,22,4,489,648,187,26,1.25e-36,154,159,161
"78708","Ntome_NODE_29226_length_659_cov_21","Nsylvestris_NODE_20105_length_1093_cov_203",96.364,55,2,0,605,659,141,195,9.9e-18,91.6,54,54
"78712","Ntome_NODE_29230_length_659_cov_14","Nsylvestris_NODE_27772_length_639_cov_9",81.984,383,58,9,105,479,464,85,5.4e-85,315,374,379
"78722","Ntome_NODE_29236_length_659_cov_7","Nsylvestris_NODE_24593_length_796_cov_9",94.548,642,33,2,18,659,157,796,0,990,641,639
"78723","Ntome_NODE_29237_length_659_cov_7","Nsylvestris_NODE_29533_length_562_cov_9",92.491,546,28,3,50,584,13,556,0,769,534,543
"78734","Ntome_NODE_29242_length_658_cov_285","Nsylvestris_NODE_4600_length_3073_cov_113",98,450,9,0,159,608,2979,2530,0,782,449,449
"78746","Ntome_NODE_29248_length_658_cov_125","Nsylvestris_NODE_8415_length_2337_cov_150",91.896,617,29,10,1,611,731,130,0,843,610,601
"78759","Ntome_NODE_29256_length_658_cov_13","Nsylvestris_NODE_24321_length_811_cov_181",98.182,55,1,0,1,55,418,364,2.12e-19,97.1,54,54
"78760","Ntome_NODE_29257_length_658_cov_12","Nsylvestris_NODE_18932_length_1189_cov_142",100,55,0,0,604,658,125,179,4.57e-21,102,54,54
"78761","Ntome_NODE_29260_length_663_cov_9","Nsylvestris_NODE_3173_length_3518_cov_50",87.762,286,28,4,379,663,358,79,6.98e-89,327,284,279
"78765","Ntome_NODE_29263_length_658_cov_3","Nsylvestris_NODE_2039_length_4029_cov_198",98.182,55,1,0,1,55,1821,1875,2.12e-19,97.1,54,54
"78790","Ntome_NODE_29279_length_657_cov_17","Nsylvestris_NODE_17403_length_1322_cov_162",98.182,55,1,0,603,657,751,697,2.12e-19,97.1,54,54
"78794","Ntome_NODE_29281_length_657_cov_15","Nsylvestris_NODE_17648_length_1298_cov_197",81.771,192,27,5,116,299,532,723,1.24e-36,154,183,191
"78795","Ntome_NODE_29282_length_657_cov_15","Nsylvestris_NODE_16368_length_1413_cov_34",96.364,55,2,0,603,657,354,300,9.87e-18,91.6,54,54
"78796","Ntome_NODE_29283_length_657_cov_13","Nsylvestris_NODE_2470_length_3807_cov_226",92.996,257,12,4,401,657,3519,3269,1.13e-101,370,256,250
"78797","Ntome_NODE_29285_length_657_cov_8","Nsylvestris_NODE_14546_length_1595_cov_174",98.182,55,1,0,1,55,895,841,2.12e-19,97.1,54,54
"78798","Ntome_NODE_29291_length_657_cov_5","Nsylvestris_NODE_695_length_5442_cov_40",93.243,74,5,0,397,470,5427,5354,2.73e-23,110,73,73
"78799","Ntome_NODE_29295_length_656_cov_214","Nsylvestris_NODE_35290_length_288_cov_133",91.837,147,6,1,157,303,236,96,1.57e-50,200,146,140
"78800","Ntome_NODE_29296_length_656_cov_160","Nsylvestris_NODE_894_length_5095_cov_234",90.406,271,18,5,393,656,5050,4781,1.47e-95,350,263,269
"78803","Ntome_NODE_29299_length_656_cov_107","Nsylvestris_NODE_27273_length_661_cov_69",90.844,557,29,6,121,656,608,53,0,726,535,555
"78810","Ntome_NODE_29302_length_656_cov_36","Nsylvestris_NODE_12423_length_1824_cov_235",94.545,55,3,0,1,55,720,774,4.59e-16,86.1,54,54
"78815","Ntome_NODE_29304_length_657_cov_31","Nsylvestris_NODE_13781_length_1675_cov_176",91.085,258,21,2,1,257,1607,1351,5.3e-95,348,256,256
"78816","Ntome_NODE_29305_length_656_cov_28","Nsylvestris_NODE_32872_length_357_cov_10",95.062,243,12,0,414,656,24,266,1.45e-105,383,242,242
"78821","Ntome_NODE_29308_length_656_cov_24","Nsylvestris_NODE_5661_length_2825_cov_50",84.286,210,23,5,438,639,2601,2808,2.03e-49,196,201,207
"78830","Ntome_NODE_29314_length_656_cov_13","Nsylvestris_NODE_266_length_6914_cov_199",100,54,0,0,602,655,5868,5921,1.64e-20,100,53,53
"78831","Ntome_NODE_29315_length_656_cov_12","Nsylvestris_NODE_9495_length_2179_cov_21",96.189,656,25,0,1,656,926,1581,0,1074,655,655
"78834","Ntome_NODE_29319_length_656_cov_9","Nsylvestris_NODE_26953_length_675_cov_86",86.792,212,25,3,331,540,330,540,1.55e-60,233,209,210
"78835","Ntome_NODE_29320_length_657_cov_8","Nsylvestris_NODE_1375_length_4524_cov_68",88.579,359,37,3,1,358,540,185,1.42e-120,433,357,355
"78836","Ntome_NODE_29322_length_656_cov_7","Nsylvestris_NODE_8445_length_2333_cov_185",96.364,55,2,0,602,656,872,818,9.85e-18,91.6,54,54
"78845","Ntome_NODE_29328_length_655_cov_46","Nsylvestris_NODE_11434_length_1937_cov_194",86.777,605,30,19,1,589,1874,1304,1.69e-179,628,588,570
"78860","Ntome_NODE_29330_length_655_cov_43","Nsylvestris_NODE_2436_length_3824_cov_65",98.015,655,13,0,1,655,2256,2910,0,1138,654,654
"78870","Ntome_NODE_29338_length_655_cov_10","Nsylvestris_NODE_25053_length_768_cov_214",93.991,649,22,8,1,637,86,729,0,966,636,643
"78873","Ntome_NODE_29343_length_655_cov_5","Nsylvestris_NODE_7803_length_2435_cov_201",100,55,0,0,1,55,968,914,4.55e-21,102,54,54
"78878","Ntome_NODE_29348_length_655_cov_3","Nsylvestris_NODE_9030_length_2247_cov_154",100,55,0,0,601,655,675,729,4.55e-21,102,54,54
"78893","Ntome_NODE_29354_length_654_cov_202","Nsylvestris_NODE_7491_length_2488_cov_59",88.406,552,44,8,113,654,108,649,0,647,541,541
"78910","Ntome_NODE_29364_length_654_cov_9","Nsylvestris_NODE_4233_length_3166_cov_191",96.364,55,2,0,600,654,835,889,9.82e-18,91.6,54,54
"78914","Ntome_NODE_29368_length_654_cov_8","Nsylvestris_NODE_6197_length_2718_cov_187",100,55,0,0,600,654,2005,1951,4.54e-21,102,54,54
"78926","Ntome_NODE_29374_length_654_cov_3","Nsylvestris_NODE_1603_length_4326_cov_45",92.966,654,40,2,1,654,1357,710,0,948,653,647
"78927","Ntome_NODE_29375_length_653_cov_202","Nsylvestris_NODE_26448_length_698_cov_84",93.186,587,25,14,18,595,2,582,0,848,577,580
"78941","Ntome_NODE_29382_length_653_cov_19","Nsylvestris_NODE_4616_length_3069_cov_74",85.437,206,28,2,380,583,1370,1575,2.01e-54,213,203,205
"78942","Ntome_NODE_29383_length_653_cov_13","Nsylvestris_NODE_8068_length_2392_cov_89",91.083,157,7,5,330,486,2187,2038,3.36e-52,206,156,149
"78949","Ntome_NODE_29386_length_653_cov_10","Nsylvestris_NODE_2920_length_3613_cov_81",95.732,656,25,1,1,653,1804,2459,0,1053,652,655
"78950","Ntome_NODE_29387_length_653_cov_10","Nsylvestris_NODE_11757_length_1898_cov_231",98.182,55,1,0,599,653,656,710,2.11e-19,97.1,54,54
"78951","Ntome_NODE_29388_length_653_cov_9","Nsylvestris_NODE_36070_length_272_cov_3",92.715,151,6,2,506,652,272,123,2.01e-54,213,146,149
"78954","Ntome_NODE_29390_length_653_cov_6","Nsylvestris_NODE_3180_length_3515_cov_118",96.631,653,22,0,1,653,1156,1808,0,1085,652,652
"78955","Ntome_NODE_29391_length_653_cov_5","Nsylvestris_NODE_9726_length_2150_cov_32",87.687,268,20,8,1,262,1268,1528,1.5e-80,300,261,260
"78975","Ntome_NODE_29399_length_652_cov_27","Nsylvestris_NODE_5876_length_2788_cov_230",98.182,55,1,0,598,652,542,488,2.1e-19,97.1,54,54
"78984","Ntome_NODE_29405_length_652_cov_11","Nsylvestris_NODE_1182_length_4716_cov_168",96.364,55,2,0,598,652,2766,2712,9.79e-18,91.6,54,54
"78992","Ntome_NODE_29413_length_652_cov_5","Nsylvestris_NODE_11140_length_1970_cov_184",96.141,622,5,5,1,618,202,808,0,998,617,606
"78995","Ntome_NODE_29415_length_651_cov_191","Nsylvestris_NODE_28315_length_613_cov_190",87.776,589,29,20,3,581,9,564,0,649,578,555
"79016","Ntome_NODE_29426_length_651_cov_17","Nsylvestris_NODE_20129_length_1092_cov_7",84.474,380,53,6,275,651,9,385,1.12e-101,370,376,376
"79020","Ntome_NODE_29429_length_650_cov_11","Nsylvestris_NODE_23163_length_881_cov_24",90.566,159,12,2,1,158,181,25,9.29e-53,207,157,156
"79021","Ntome_NODE_29430_length_651_cov_9","Nsylvestris_NODE_5023_length_2965_cov_224",98.182,55,1,0,597,651,1983,1929,2.1e-19,97.1,54,54
"79022","Ntome_NODE_29431_length_651_cov_8","Nsylvestris_NODE_2332_length_3881_cov_82",86.598,97,2,2,558,643,2119,2023,2.1e-19,97.1,85,96
"79046","Ntome_NODE_29441_length_650_cov_68","Nsylvestris_NODE_4927_length_2991_cov_41",98.182,55,1,0,1,55,2180,2234,2.1e-19,97.1,54,54
"79047","Ntome_NODE_29442_length_650_cov_64","Nsylvestris_NODE_25269_length_756_cov_144",90.476,462,29,6,1,457,690,239,1.7e-169,595,456,451
"79052","Ntome_NODE_29446_length_650_cov_21","Nsylvestris_NODE_10454_length_2056_cov_140",92.727,55,4,0,596,650,1083,1137,2.11e-14,80.5,54,54
"79053","Ntome_NODE_29447_length_650_cov_19","Nsylvestris_NODE_34473_length_309_cov_3",94.419,215,12,0,436,650,309,95,5.28e-90,331,214,214
"79061","Ntome_NODE_29454_length_650_cov_8","Nsylvestris_NODE_15988_length_1450_cov_168",100,55,0,0,596,650,823,769,4.51e-21,102,54,54
"79064","Ntome_NODE_29456_length_650_cov_6","Nsylvestris_NODE_33658_length_332_cov_4",88.52,331,38,0,291,621,2,332,3.97e-111,401,330,330
"79068","Ntome_NODE_29459_length_650_cov_5","Nsylvestris_NODE_6228_length_2711_cov_142",92.647,68,3,1,583,650,1611,1676,2.1e-19,97.1,67,65
"79089","Ntome_NODE_29469_length_649_cov_69","Nsylvestris_NODE_3869_length_3277_cov_192",96.364,55,2,0,1,55,1710,1656,9.75e-18,91.6,54,54
"79097","Ntome_NODE_29473_length_649_cov_22","Nsylvestris_NODE_2061_length_4017_cov_140",87.179,273,20,11,1,264,3653,3919,1.92e-79,296,263,266
"79098","Ntome_NODE_29474_length_649_cov_19","Nsylvestris_NODE_27298_length_660_cov_19",91.239,662,41,8,2,649,2,660,0,885,647,658
"79099","Ntome_NODE_29477_length_649_cov_12","Nsylvestris_NODE_675_length_5498_cov_231",98.182,55,1,0,595,649,2735,2789,2.09e-19,97.1,54,54
"79112","Ntome_NODE_29482_length_649_cov_8","Nsylvestris_NODE_672_length_5502_cov_227",100,52,0,0,1,52,985,1036,2.09e-19,97.1,51,51
"79120","Ntome_NODE_29487_length_649_cov_4","Nsylvestris_NODE_11019_length_1985_cov_42",93.178,557,30,4,97,648,1406,1959,0,811,551,553
"79126","Ntome_NODE_29489_length_648_cov_290","Nsylvestris_NODE_26004_length_718_cov_217",92.054,516,40,1,112,627,668,154,0,725,515,514
"79138","Ntome_NODE_29495_length_648_cov_188","Nsylvestris_NODE_13000_length_1763_cov_189",90.829,567,26,7,97,648,1741,1186,0,736,551,555
"79151","Ntome_NODE_29502_length_647_cov_27","Nsylvestris_NODE_29815_length_543_cov_85",92.115,520,26,7,143,647,4,523,0,719,504,519
"79159","Ntome_NODE_29508_length_648_cov_11","Nsylvestris_NODE_2775_length_3673_cov_218",100,55,0,0,594,648,2361,2415,4.5e-21,102,54,54
"79160","Ntome_NODE_29509_length_648_cov_8","Nsylvestris_NODE_5560_length_2850_cov_166",100,55,0,0,1,55,1147,1201,4.5e-21,102,54,54
"79161","Ntome_NODE_29510_length_648_cov_8","Nsylvestris_NODE_660_length_5527_cov_150",100,55,0,0,594,648,2096,2150,4.5e-21,102,54,54
"79162","Ntome_NODE_29511_length_648_cov_7","Nsylvestris_NODE_13771_length_1676_cov_222",92.857,70,3,1,579,648,874,807,1.62e-20,100,69,67
"79168","Ntome_NODE_29517_length_648_cov_6","Nsylvestris_NODE_2747_length_3683_cov_97",88.376,671,37,12,1,648,1991,2643,0,769,647,652
"79169","Ntome_NODE_29518_length_648_cov_6","Nsylvestris_NODE_12762_length_1790_cov_211",100,33,0,0,616,648,710,678,7.63e-09,62.1,32,32
"79172","Ntome_NODE_29522_length_647_cov_269","Nsylvestris_NODE_1293_length_4600_cov_194",96.61,59,1,1,590,647,2700,2642,2.09e-19,97.1,57,58
"79173","Ntome_NODE_29523_length_647_cov_204","Nsylvestris_NODE_21403_length_998_cov_222",94.964,556,17,2,1,545,556,1,0,861,544,555
"79174","Ntome_NODE_29524_length_647_cov_123","Nsylvestris_NODE_19643_length_1131_cov_203",91.068,571,25,9,4,558,124,684,0,749,554,560
"79175","Ntome_NODE_29525_length_647_cov_85","Nsylvestris_NODE_28662_length_599_cov_9",83.193,119,10,2,266,374,1,119,1.61e-20,100,108,118
"79179","Ntome_NODE_29527_length_647_cov_72","Nsylvestris_NODE_25723_length_732_cov_151",89.465,617,45,7,2,600,31,645,0,761,598,614
"79180","Ntome_NODE_29528_length_647_cov_43","Nsylvestris_NODE_19075_length_1177_cov_186",100,55,0,0,593,647,817,763,4.49e-21,102,54,54
"79183","Ntome_NODE_29530_length_647_cov_34","Nsylvestris_NODE_22_length_11544_cov_169",100,55,0,0,1,55,9027,9081,4.49e-21,102,54,54
"79184","Ntome_NODE_29531_length_647_cov_30","Nsylvestris_NODE_3109_length_3540_cov_201",96.043,657,11,5,1,647,2339,2990,0,1055,646,651
"79188","Ntome_NODE_29533_length_647_cov_20","Nsylvestris_NODE_24033_length_830_cov_103",100,55,0,0,593,647,234,288,4.49e-21,102,54,54
"79198","Ntome_NODE_29538_length_647_cov_7","Nsylvestris_NODE_3917_length_3260_cov_221",96.364,55,2,0,1,55,537,591,9.71e-18,91.6,54,54
"79204","Ntome_NODE_29540_length_646_cov_305","Nsylvestris_NODE_20956_length_1031_cov_137",95.765,614,23,3,34,646,51,662,0,987,612,611
"79205","Ntome_NODE_29541_length_646_cov_246","Nsylvestris_NODE_10771_length_2017_cov_93",90.032,622,35,8,28,646,23,620,0,780,618,597
"79208","Ntome_NODE_29544_length_646_cov_100","Nsylvestris_NODE_20912_length_1034_cov_190",92.473,93,6,1,1,92,802,710,5.71e-30,132,91,92
"79224","Ntome_NODE_29552_length_646_cov_16","Nsylvestris_NODE_6445_length_2670_cov_217",98.182,55,1,0,592,646,840,894,2.08e-19,97.1,54,54
"79233","Ntome_NODE_29557_length_646_cov_11","Nsylvestris_NODE_10746_length_2020_cov_154",96,50,2,0,2,51,687,736,5.84e-15,82.4,49,49
"79234","Ntome_NODE_29560_length_646_cov_8","Nsylvestris_NODE_4965_length_2982_cov_85",96.285,646,24,0,1,646,855,210,0,1061,645,645
"79255","Ntome_NODE_29570_length_645_cov_218","Nsylvestris_NODE_30699_length_471_cov_178",93.651,315,20,0,48,362,364,50,2.96e-132,472,314,314
"79268","Ntome_NODE_29576_length_641_cov_123","Nsylvestris_NODE_28324_length_607_cov_12",88.462,260,24,2,243,502,266,519,2.44e-83,309,259,253
"79269","Ntome_NODE_29577_length_645_cov_67","Nsylvestris_NODE_7396_length_2505_cov_201",95.363,647,20,5,1,645,1737,1099,0,1020,644,638
"79281","Ntome_NODE_29583_length_645_cov_18","Nsylvestris_NODE_23073_length_886_cov_179",98.113,53,1,0,1,53,781,833,2.69e-18,93.5,52,52
"79282","Ntome_NODE_29584_length_645_cov_15","Nsylvestris_NODE_6340_length_2691_cov_164",79.695,197,33,5,362,556,1044,1235,4.41e-31,135,194,191
"79285","Ntome_NODE_29586_length_645_cov_9","Nsylvestris_NODE_20745_length_1046_cov_224",100,47,0,0,3,49,221,175,1.25e-16,87.9,46,46
"79289","Ntome_NODE_29588_length_645_cov_7","Nsylvestris_NODE_1590_length_4338_cov_12",82.713,376,56,8,1,368,2370,2744,2.44e-88,326,367,374
"79290","Ntome_NODE_29590_length_645_cov_2","Nsylvestris_NODE_2439_length_3822_cov_189",96.774,62,1,1,585,645,1734,1795,4.47e-21,102,60,61
"79291","Ntome_NODE_29591_length_644_cov_323","Nsylvestris_NODE_6092_length_2740_cov_29",94.099,644,35,1,1,644,1519,2159,0,976,643,640
"79292","Ntome_NODE_29592_length_644_cov_272","Nsylvestris_NODE_2729_length_3690_cov_114",96.584,644,22,0,1,644,2191,2834,0,1068,643,643
"79293","Ntome_NODE_29593_length_644_cov_272","Nsylvestris_NODE_171_length_7558_cov_82",91.045,603,20,7,1,570,5099,5700,0,784,569,601
"79294","Ntome_NODE_29594_length_644_cov_186","Nsylvestris_NODE_2768_length_3678_cov_127",95.798,595,24,1,1,594,601,7,0,959,593,594
"79299","Ntome_NODE_29597_length_644_cov_44","Nsylvestris_NODE_5939_length_2772_cov_206",90.714,560,33,8,39,589,2682,2133,0,728,550,549
"79305","Ntome_NODE_29601_length_644_cov_17","Nsylvestris_NODE_1085_length_4831_cov_262",90,90,9,0,1,90,3505,3594,1.59e-25,117,89,89
"79316","Ntome_NODE_29608_length_644_cov_8","Nsylvestris_NODE_12344_length_1833_cov_167",100,55,0,0,1,55,1003,1057,4.47e-21,102,54,54
"79317","Ntome_NODE_29609_length_644_cov_6","Nsylvestris_NODE_26042_length_717_cov_5",92.292,480,26,5,1,477,221,692,0,671,476,471
"79323","Ntome_NODE_29614_length_644_cov_4","Nsylvestris_NODE_15694_length_1480_cov_225",96.364,55,2,0,590,644,166,112,9.67e-18,91.6,54,54
"79330","Ntome_NODE_29617_length_643_cov_245","Nsylvestris_NODE_21291_length_1007_cov_136",97.658,427,7,2,1,425,736,311,0,730,424,425
"79331","Ntome_NODE_29618_length_643_cov_173","Nsylvestris_NODE_1544_length_4363_cov_62",97.981,644,9,2,1,643,3750,3110,0,1114,642,640
"79332","Ntome_NODE_29619_length_643_cov_137","Nsylvestris_NODE_3499_length_3389_cov_128",96.875,640,19,1,4,643,3386,2748,0,1070,639,638
"79333","Ntome_NODE_29620_length_643_cov_104","Nsylvestris_NODE_28368_length_611_cov_51",91.829,514,25,5,102,601,1,511,0,701,499,510
"79348","Ntome_NODE_29630_length_643_cov_15","Nsylvestris_NODE_20_length_11989_cov_112",80.169,237,32,12,92,321,8821,8593,2.02e-39,163,229,228
"79371","Ntome_NODE_29642_length_643_cov_4","Nsylvestris_NODE_11407_length_1941_cov_91",95.082,61,3,0,1,61,499,439,2.07e-19,97.1,60,60
"79374","Ntome_NODE_29644_length_642_cov_245","Nsylvestris_NODE_21632_length_982_cov_165",94.746,590,28,3,54,642,853,266,0,915,588,587
"79383","Ntome_NODE_29648_length_642_cov_39","Nsylvestris_NODE_14039_length_1645_cov_214",98.182,55,1,0,588,642,1056,1002,2.07e-19,97.1,54,54
"79388","Ntome_NODE_29650_length_642_cov_31","Nsylvestris_NODE_21581_length_986_cov_78",93.178,645,41,1,1,642,973,329,0,944,641,644
"79389","Ntome_NODE_29653_length_642_cov_18","Nsylvestris_NODE_3094_length_3548_cov_24",100,28,0,0,452,479,2507,2534,4.55e-06,52.8,27,27
"79392","Ntome_NODE_29656_length_642_cov_11","Nsylvestris_NODE_4365_length_3135_cov_215",100,55,0,0,588,642,2264,2318,4.45e-21,102,54,54
"79408","Ntome_NODE_29662_length_642_cov_8","Nsylvestris_NODE_277_length_6827_cov_72",93.22,649,37,1,1,642,4448,5096,0,948,641,648
"79413","Ntome_NODE_29665_length_641_cov_286","Nsylvestris_NODE_14116_length_1639_cov_112",80.96,667,67,29,1,641,385,1017,8.18e-133,473,640,632
"79414","Ntome_NODE_29666_length_641_cov_205","Nsylvestris_NODE_23221_length_877_cov_100",88.324,531,18,10,83,588,512,1,4.65e-170,597,505,511
"79422","Ntome_NODE_29672_length_633_cov_33","Nsylvestris_NODE_13650_length_1690_cov_198",100,55,0,0,1,55,913,967,4.39e-21,102,54,54
"79426","Ntome_NODE_29674_length_641_cov_24","Nsylvestris_NODE_1238_length_4661_cov_94",90.442,565,30,10,74,624,2661,3215,0,723,550,554
"79427","Ntome_NODE_29675_length_641_cov_20","Nsylvestris_NODE_1216_length_4689_cov_233",98.182,55,1,0,587,641,672,618,2.07e-19,97.1,54,54
"79428","Ntome_NODE_29676_length_641_cov_14","Nsylvestris_NODE_13842_length_1669_cov_139",100,55,0,0,587,641,1176,1122,4.44e-21,102,54,54
"79429","Ntome_NODE_29677_length_641_cov_8","Nsylvestris_NODE_10954_length_1993_cov_208",98.182,55,1,0,587,641,933,879,2.07e-19,97.1,54,54
"79430","Ntome_NODE_29678_length_641_cov_7","Nsylvestris_NODE_743_length_5358_cov_205",98.182,55,1,0,1,55,965,911,2.07e-19,97.1,54,54
"79434","Ntome_NODE_29680_length_641_cov_6","Nsylvestris_NODE_18696_length_1209_cov_190",90.909,55,5,0,587,641,770,716,9.69e-13,75,54,54
"79438","Ntome_NODE_29682_length_641_cov_4","Nsylvestris_NODE_1544_length_4363_cov_62",95.853,651,17,2,1,641,651,1,0,1044,640,650
"79457","Ntome_NODE_29691_length_640_cov_26","Nsylvestris_NODE_13797_length_1673_cov_118",98.182,55,1,0,586,640,1484,1538,2.06e-19,97.1,54,54
"79464","Ntome_NODE_29696_length_640_cov_15","Nsylvestris_NODE_22876_length_898_cov_203",93.651,63,3,1,578,640,480,541,2.67e-18,93.5,62,61
"79465","Ntome_NODE_29697_length_640_cov_15","Nsylvestris_NODE_1293_length_4600_cov_194",100,54,0,0,2,55,3149,3096,1.6e-20,100,53,53
"79468","Ntome_NODE_29701_length_640_cov_10","Nsylvestris_NODE_27430_length_654_cov_98",97.55,449,11,0,1,449,158,606,0,769,448,448
"79473","Ntome_NODE_29708_length_639_cov_321","Nsylvestris_NODE_1419_length_4479_cov_206",97.966,639,13,0,1,639,2311,1673,0,1109,638,638
"79474","Ntome_NODE_29709_length_639_cov_313","Nsylvestris_NODE_388_length_6343_cov_161",97.34,639,17,0,1,639,1386,2024,0,1086,638,638
"79475","Ntome_NODE_29710_length_639_cov_270","Nsylvestris_NODE_6344_length_2690_cov_150",97.534,365,9,0,1,365,1496,1132,2.13e-178,625,364,364
"79476","Ntome_NODE_29711_length_639_cov_269","Nsylvestris_NODE_1684_length_4268_cov_97",97.027,639,19,0,1,639,1928,1290,0,1075,638,638
"79479","Ntome_NODE_29713_length_639_cov_245","Nsylvestris_NODE_25471_length_745_cov_189",81.89,381,53,5,7,372,143,522,8.75e-83,307,365,379
"79480","Ntome_NODE_29714_length_639_cov_205","Nsylvestris_NODE_11013_length_1986_cov_179",91.152,486,21,13,1,469,525,45,0,640,468,480
"79481","Ntome_NODE_29715_length_639_cov_184","Nsylvestris_NODE_11274_length_1954_cov_211",90.504,674,22,12,5,638,1,672,0,852,633,671
"79482","Ntome_NODE_29716_length_639_cov_129","Nsylvestris_NODE_5317_length_2902_cov_113",93.413,334,15,3,259,586,1311,979,2.91e-137,488,327,332
"79483","Ntome_NODE_29717_length_639_cov_74","Nsylvestris_NODE_32931_length_355_cov_11",84.765,361,43,6,218,577,350,1,3.98e-96,351,359,349
"79496","Ntome_NODE_29723_length_639_cov_20","Nsylvestris_NODE_4616_length_3069_cov_74",90,70,7,0,483,552,2498,2567,9.59e-18,91.6,69,69
"79500","Ntome_NODE_29726_length_639_cov_18","Nsylvestris_NODE_6280_length_2701_cov_100",100,55,0,0,1,55,2085,2031,4.43e-21,102,54,54
"79501","Ntome_NODE_29727_length_639_cov_15","Nsylvestris_NODE_29020_length_583_cov_11",96.822,535,17,0,1,535,535,1,0,894,534,534
"79502","Ntome_NODE_29728_length_639_cov_14","Nsylvestris_NODE_116_length_8164_cov_94",100,55,0,0,1,55,566,512,4.43e-21,102,54,54
"79505","Ntome_NODE_29730_length_639_cov_9","Nsylvestris_NODE_5240_length_2918_cov_116",100,55,0,0,1,55,2527,2473,4.43e-21,102,54,54
"79506","Ntome_NODE_29733_length_639_cov_7","Nsylvestris_NODE_22109_length_949_cov_14",96.708,638,21,0,2,639,840,203,0,1062,637,637
"79509","Ntome_NODE_29737_length_639_cov_4","Nsylvestris_NODE_17007_length_1357_cov_58",93.916,641,34,2,1,636,342,982,0,963,635,640
"79510","Ntome_NODE_29741_length_639_cov_3","Nsylvestris_NODE_20104_length_1093_cov_221",96.364,55,2,0,1,55,641,695,9.59e-18,91.6,54,54
"79511","Ntome_NODE_29742_length_638_cov_290","Nsylvestris_NODE_11357_length_1946_cov_88",96.395,638,23,0,1,638,1246,609,0,1051,637,637
"79514","Ntome_NODE_29746_length_638_cov_189","Nsylvestris_NODE_19145_length_1172_cov_56",93.182,44,1,2,75,117,298,256,2.09e-09,63.9,42,42
"79515","Ntome_NODE_29749_length_638_cov_60","Nsylvestris_NODE_18473_length_1226_cov_197",98.182,55,1,0,1,55,524,470,2.06e-19,97.1,54,54
"79516","Ntome_NODE_29750_length_638_cov_56","Nsylvestris_NODE_32898_length_356_cov_23",85.671,328,36,8,20,344,1,320,4.01e-91,335,324,319
"79524","Ntome_NODE_29755_length_638_cov_29","Nsylvestris_NODE_9793_length_2141_cov_203",98.182,55,1,0,1,55,573,627,2.06e-19,97.1,54,54
"79525","Ntome_NODE_29756_length_638_cov_20","Nsylvestris_NODE_6884_length_2588_cov_225",94.545,55,3,0,584,638,201,255,4.45e-16,86.1,54,54
"79526","Ntome_NODE_29757_length_638_cov_20","Nsylvestris_NODE_15116_length_1539_cov_57",98.039,51,1,0,1,51,1391,1341,3.44e-17,89.8,50,50
"79532","Ntome_NODE_29760_length_638_cov_8","Nsylvestris_NODE_23808_length_843_cov_6",84.95,598,70,11,1,580,598,3,2.78e-167,588,579,595
"79537","Ntome_NODE_29764_length_638_cov_6","Nsylvestris_NODE_24170_length_821_cov_219",93.74,639,20,2,1,635,39,661,0,941,634,622
"79540","Ntome_NODE_29767_length_637_cov_284","Nsylvestris_NODE_20883_length_1036_cov_227",94.127,613,16,3,3,604,655,52,0,915,601,603
"79544","Ntome_NODE_29769_length_637_cov_154","Nsylvestris_NODE_14633_length_1585_cov_216",98.182,55,1,0,583,637,1090,1144,2.05e-19,97.1,54,54
"79578","Ntome_NODE_29783_length_637_cov_12","Nsylvestris_NODE_18451_length_1228_cov_56",85.276,163,23,1,374,536,932,1093,1.54e-40,167,162,161
"79579","Ntome_NODE_29784_length_637_cov_10","Nsylvestris_NODE_13034_length_1759_cov_214",96.364,55,2,0,583,637,1337,1391,9.56e-18,91.6,54,54
"79580","Ntome_NODE_29785_length_637_cov_10","Nsylvestris_NODE_15576_length_1493_cov_42",88.305,590,21,5,1,569,876,1438,0,664,568,562
"79586","Ntome_NODE_29788_length_636_cov_223","Nsylvestris_NODE_17821_length_1284_cov_197",98.44,577,9,0,1,577,693,1269,0,1016,576,576
"79600","Ntome_NODE_29794_length_636_cov_54","Nsylvestris_NODE_35022_length_295_cov_2",96.271,295,11,0,167,461,295,1,3.75e-136,484,294,294
"79613","Ntome_NODE_29801_length_636_cov_8","Nsylvestris_NODE_24009_length_832_cov_6",86.655,577,68,4,25,600,23,591,4.55e-180,630,575,568
"79614","Ntome_NODE_29804_length_636_cov_7","Nsylvestris_NODE_1855_length_4146_cov_224",100,55,0,0,1,55,3596,3542,4.41e-21,102,54,54
"79620","Ntome_NODE_29808_length_636_cov_4","Nsylvestris_NODE_5028_length_2964_cov_173",98.305,59,0,1,1,59,1103,1160,4.41e-21,102,58,57
"79621","Ntome_NODE_29809_length_636_cov_3","Nsylvestris_NODE_5576_length_2848_cov_125",98.182,55,1,0,582,636,1247,1301,2.05e-19,97.1,54,54
"79632","Ntome_NODE_29813_length_635_cov_233","Nsylvestris_NODE_16168_length_1433_cov_119",92.379,643,30,8,1,635,37,668,0,898,634,631
"79637","Ntome_NODE_29815_length_635_cov_71","Nsylvestris_NODE_2412_length_3836_cov_48",89.731,409,40,2,228,635,43,450,2.85e-147,521,407,407
"79643","Ntome_NODE_29818_length_635_cov_38","Nsylvestris_NODE_12690_length_1797_cov_17",92.982,57,3,1,494,550,1608,1663,5.73e-15,82.4,56,55
"79644","Ntome_NODE_29819_length_635_cov_26","Nsylvestris_NODE_13713_length_1683_cov_190",98.182,55,1,0,581,635,824,770,2.05e-19,97.1,54,54
"79645","Ntome_NODE_29820_length_635_cov_23","Nsylvestris_NODE_4205_length_3174_cov_185",98.182,55,1,0,1,55,1627,1573,2.05e-19,97.1,54,54
"79657","Ntome_NODE_29825_length_635_cov_10","Nsylvestris_NODE_28024_length_628_cov_14",78.764,518,59,28,135,632,89,575,1.45e-80,300,497,486
"79658","Ntome_NODE_29826_length_635_cov_7","Nsylvestris_NODE_6239_length_2709_cov_188",98.182,55,1,0,581,635,1326,1272,2.05e-19,97.1,54,54
"79659","Ntome_NODE_29828_length_635_cov_5","Nsylvestris_NODE_6450_length_2670_cov_102",85.714,168,22,2,34,201,1486,1321,2.56e-43,176,167,165
"79660","Ntome_NODE_29830_length_635_cov_4","Nsylvestris_NODE_4718_length_3041_cov_13",91.818,330,23,4,308,635,803,476,8.15e-128,457,327,327
"79661","Ntome_NODE_29831_length_635_cov_4","Nsylvestris_NODE_17581_length_1305_cov_153",98.182,55,1,0,581,635,455,401,2.05e-19,97.1,54,54
"79679","Ntome_NODE_29841_length_634_cov_18","Nsylvestris_NODE_29120_length_578_cov_49",93.514,555,28,5,82,629,554,1,0,819,547,553
"79683","Ntome_NODE_29843_length_634_cov_14","Nsylvestris_NODE_19828_length_1115_cov_42",98.182,55,1,0,1,55,992,938,2.04e-19,97.1,54,54
"79684","Ntome_NODE_29844_length_634_cov_13","Nsylvestris_NODE_16316_length_1417_cov_127",84.724,635,47,9,1,619,617,17,7.69e-168,590,618,600
"79687","Ntome_NODE_29846_length_634_cov_12","Nsylvestris_NODE_6263_length_2704_cov_211",89.962,528,34,5,124,634,1718,2243,0,664,510,525
"79704","Ntome_NODE_29855_length_634_cov_3","Nsylvestris_NODE_12737_length_1792_cov_177",96.296,54,2,0,2,55,820,767,3.42e-17,89.8,53,53
"79705","Ntome_NODE_29856_length_633_cov_290","Nsylvestris_NODE_14527_length_1597_cov_146",95.156,578,28,0,56,633,1527,950,0,913,577,577
"79711","Ntome_NODE_29858_length_633_cov_266","Nsylvestris_NODE_22914_length_896_cov_186",94.127,613,31,4,1,611,759,150,0,928,610,609
"79716","Ntome_NODE_29861_length_633_cov_55","Nsylvestris_NODE_3572_length_3374_cov_109",97.368,38,1,0,1,38,1270,1233,5.76e-10,65.8,37,37
"79732","Ntome_NODE_29869_length_633_cov_17","Nsylvestris_NODE_14643_length_1584_cov_224",98.182,55,1,0,1,55,1106,1052,2.04e-19,97.1,54,54
"79739","Ntome_NODE_29872_length_633_cov_12","Nsylvestris_NODE_14856_length_1564_cov_190",98.182,55,1,0,579,633,666,612,2.04e-19,97.1,54,54
"79740","Ntome_NODE_29873_length_633_cov_10","Nsylvestris_NODE_19695_length_1129_cov_20",88.806,134,11,3,354,484,653,785,7.14e-39,161,130,132
"79767","Ntome_NODE_29885_length_632_cov_59","Nsylvestris_NODE_4421_length_3116_cov_218",87.719,57,4,3,95,149,58,3,2.07e-09,63.9,54,55
"79768","Ntome_NODE_29886_length_632_cov_57","Nsylvestris_NODE_13315_length_1725_cov_229",96.364,55,2,0,578,632,1038,1092,9.48e-18,91.6,54,54
"79772","Ntome_NODE_29888_length_632_cov_57","Nsylvestris_NODE_11445_length_1936_cov_194",100,55,0,0,1,55,780,834,4.38e-21,102,54,54
"79776","Ntome_NODE_29890_length_632_cov_47","Nsylvestris_NODE_13315_length_1725_cov_229",98.182,55,1,0,578,632,924,870,2.04e-19,97.1,54,54
"79787","Ntome_NODE_29895_length_632_cov_22","Nsylvestris_NODE_23171_length_880_cov_109",90.769,650,34,4,1,624,190,839,0,845,623,649
"79795","Ntome_NODE_29898_length_632_cov_12","Nsylvestris_NODE_8239_length_2366_cov_225",98.413,63,1,0,1,63,626,564,7.28e-24,111,62,62
"79801","Ntome_NODE_29901_length_632_cov_8","Nsylvestris_NODE_5454_length_2873_cov_18",79.518,166,32,2,137,301,805,969,1.56e-25,117,164,164
"79802","Ntome_NODE_29902_length_632_cov_5","Nsylvestris_NODE_10881_length_2003_cov_37",96.364,55,2,0,578,632,564,510,9.48e-18,91.6,54,54
"79803","Ntome_NODE_29903_length_632_cov_4","Nsylvestris_NODE_720_length_5402_cov_123",95.563,631,28,0,2,632,5189,4559,0,1011,630,630
"79804","Ntome_NODE_29904_length_632_cov_3","Nsylvestris_NODE_3585_length_3370_cov_91",94.462,632,22,2,1,632,2704,3322,0,961,631,618
"79808","Ntome_NODE_29907_length_631_cov_210","Nsylvestris_NODE_16767_length_1375_cov_88",85.652,230,26,5,407,631,289,62,4.13e-61,235,224,227
"79815","Ntome_NODE_29912_length_631_cov_56","Nsylvestris_NODE_1952_length_4084_cov_139",100,55,0,0,577,631,988,1042,4.37e-21,102,54,54
"79820","Ntome_NODE_29915_length_631_cov_18","Nsylvestris_NODE_12191_length_1848_cov_219",96.491,57,2,0,573,629,993,937,7.32e-19,95.3,56,56
"79831","Ntome_NODE_29921_length_631_cov_8","Nsylvestris_NODE_14888_length_1561_cov_219",100,55,0,0,1,55,1055,1109,4.37e-21,102,54,54
"79832","Ntome_NODE_29922_length_631_cov_8","Nsylvestris_NODE_2549_length_3770_cov_68",92.88,632,19,6,3,631,3327,2719,0,894,628,608
"79836","Ntome_NODE_29924_length_631_cov_7","Nsylvestris_NODE_8946_length_2258_cov_35",92.663,368,27,0,264,631,1875,1508,4.71e-150,531,367,367
"79850","Ntome_NODE_29930_length_630_cov_260","Nsylvestris_NODE_7480_length_2491_cov_81",94.928,552,28,0,52,603,567,16,0,865,551,551
"79861","Ntome_NODE_29935_length_630_cov_208","Nsylvestris_NODE_11194_length_1963_cov_184",91.825,526,29,7,108,630,1,515,0,721,522,514
"79862","Ntome_NODE_29937_length_630_cov_154","Nsylvestris_NODE_30105_length_518_cov_4",95.858,169,7,0,71,239,1,169,8.74e-73,274,168,168
"79873","Ntome_NODE_29943_length_630_cov_14","Nsylvestris_NODE_5967_length_2767_cov_17",91.697,277,23,0,1,277,653,929,3.87e-106,385,276,276
"79874","Ntome_NODE_29944_length_630_cov_14","Nsylvestris_NODE_23938_length_836_cov_12",89.157,332,23,7,222,551,516,836,3.84e-111,401,329,320
"79875","Ntome_NODE_29945_length_630_cov_13","Nsylvestris_NODE_1088_length_4831_cov_175",96.364,55,2,0,1,55,3134,3188,9.45e-18,91.6,54,54
"79876","Ntome_NODE_29947_length_630_cov_6","Nsylvestris_NODE_7348_length_2513_cov_124",98.182,55,1,0,576,630,1499,1445,2.03e-19,97.1,54,54
"79889","Ntome_NODE_29952_length_630_cov_4","Nsylvestris_NODE_11186_length_1964_cov_180",98.182,55,1,0,576,630,853,799,2.03e-19,97.1,54,54
"79890","Ntome_NODE_29954_length_630_cov_4","Nsylvestris_NODE_20832_length_1039_cov_193",100,55,0,0,1,55,554,500,4.37e-21,102,54,54
"79891","Ntome_NODE_29955_length_630_cov_4","Nsylvestris_NODE_19418_length_1151_cov_7",85.366,369,40,5,262,630,588,234,1.08e-101,370,368,354
"79928","Ntome_NODE_29974_length_629_cov_9","Nsylvestris_NODE_1426_length_4473_cov_221",98.182,55,1,0,575,629,1076,1022,2.03e-19,97.1,54,54
"79940","Ntome_NODE_29982_length_628_cov_286","Nsylvestris_NODE_19216_length_1166_cov_207",90.492,589,41,7,55,628,1166,578,0,763,573,588
"79948","Ntome_NODE_29985_length_628_cov_274","Nsylvestris_NODE_15070_length_1544_cov_211",95.826,575,24,0,1,575,924,1498,0,929,574,574
"79956","Ntome_NODE_29989_length_628_cov_14","Nsylvestris_NODE_13591_length_1697_cov_220",98.182,55,1,0,1,55,1146,1200,2.02e-19,97.1,54,54
"79957","Ntome_NODE_29990_length_628_cov_12","Nsylvestris_NODE_8757_length_2287_cov_21",95.494,577,26,0,1,577,577,1,0,922,576,576
"79958","Ntome_NODE_29991_length_628_cov_12","Nsylvestris_NODE_886_length_5105_cov_119",96.296,54,2,0,574,627,4261,4208,3.39e-17,89.8,53,53
"79959","Ntome_NODE_29992_length_628_cov_10","Nsylvestris_NODE_4776_length_3027_cov_117",95.644,551,19,1,78,628,592,47,0,880,550,545
"79960","Ntome_NODE_29993_length_628_cov_10","Nsylvestris_NODE_6097_length_2738_cov_161",98.182,55,1,0,1,55,2288,2234,2.02e-19,97.1,54,54
"79961","Ntome_NODE_29994_length_628_cov_7","Nsylvestris_NODE_25157_length_763_cov_9",97.963,589,12,0,37,625,1,589,0,1022,588,588
"79965","Ntome_NODE_29997_length_628_cov_5","Nsylvestris_NODE_1479_length_4417_cov_154",98.726,628,8,0,1,628,1069,442,0,1116,627,627
"79971","Ntome_NODE_30001_length_628_cov_3","Nsylvestris_NODE_24718_length_788_cov_19",88.281,512,35,8,3,506,134,628,7.62e-168,590,503,494
"79972","Ntome_NODE_30002_length_619_cov_118","Nsylvestris_NODE_14232_length_1625_cov_241",94.231,52,3,0,568,619,696,747,2.01e-14,80.5,51,51
"79973","Ntome_NODE_30003_length_627_cov_55","Nsylvestris_NODE_5279_length_2909_cov_201",96.364,55,2,0,1,55,766,820,9.4e-18,91.6,54,54
"79974","Ntome_NODE_30004_length_627_cov_51","Nsylvestris_NODE_2134_length_3972_cov_189",98.182,55,1,0,1,55,2119,2173,2.02e-19,97.1,54,54
"79977","Ntome_NODE_30007_length_627_cov_29","Nsylvestris_NODE_8038_length_2397_cov_164",96.552,58,2,0,570,627,1711,1768,2.02e-19,97.1,57,57
"79978","Ntome_NODE_30008_length_627_cov_22","Nsylvestris_NODE_24376_length_808_cov_123",86.458,576,57,10,54,627,685,129,1.62e-174,612,573,556
"79979","Ntome_NODE_30009_length_627_cov_21","Nsylvestris_NODE_13867_length_1666_cov_208",100,55,0,0,573,627,672,618,4.34e-21,102,54,54
"79980","Ntome_NODE_30010_length_627_cov_20","Nsylvestris_NODE_759_length_5326_cov_178",82.817,355,50,2,245,588,974,1328,8.58e-83,307,343,354
"79993","Ntome_NODE_30017_length_627_cov_12","Nsylvestris_NODE_31806_length_403_cov_5",96.114,386,15,0,141,526,1,386,4.48e-180,630,385,385
"79994","Ntome_NODE_30018_length_627_cov_11","Nsylvestris_NODE_5716_length_2817_cov_100",75.625,480,98,16,5,475,552,83,1.15e-56,220,470,469
"79997","Ntome_NODE_30021_length_627_cov_8","Nsylvestris_NODE_27675_length_643_cov_11",91.978,536,42,1,42,577,2,536,0,750,535,534
"79998","Ntome_NODE_30022_length_627_cov_8","Nsylvestris_NODE_1085_length_4831_cov_262",85.609,681,42,9,1,627,1758,2436,0,664,626,678
"80001","Ntome_NODE_30026_length_626_cov_332","Nsylvestris_NODE_929_length_5047_cov_157",97.444,626,16,0,1,626,1790,2415,0,1068,625,625
"80006","Ntome_NODE_30029_length_626_cov_166","Nsylvestris_NODE_1306_length_4588_cov_59",89.143,350,15,8,1,348,4218,4546,4.9e-115,414,347,328
"80009","Ntome_NODE_30031_length_626_cov_131","Nsylvestris_NODE_30248_length_506_cov_12",95.069,507,16,4,106,606,3,506,0,789,500,503
"80010","Ntome_NODE_30032_length_626_cov_123","Nsylvestris_NODE_18926_length_1190_cov_165",96.364,55,2,0,572,626,929,983,9.39e-18,91.6,54,54
"80013","Ntome_NODE_30035_length_626_cov_46","Nsylvestris_NODE_21880_length_963_cov_100",90,170,17,0,457,626,326,157,1.15e-56,220,169,169
"80014","Ntome_NODE_30036_length_626_cov_26","Nsylvestris_NODE_9612_length_2163_cov_137",87.452,526,44,12,59,566,1251,1772,9.82e-167,586,507,521
"80022","Ntome_NODE_30039_length_626_cov_18","Nsylvestris_NODE_27875_length_634_cov_17",92.308,221,12,3,407,626,252,36,2.38e-83,309,219,216
"80026","Ntome_NODE_30042_length_626_cov_7","Nsylvestris_NODE_5632_length_2832_cov_111",98.214,56,1,0,571,626,2239,2294,5.61e-20,99,55,55
"80027","Ntome_NODE_30044_length_626_cov_6","Nsylvestris_NODE_8806_length_2279_cov_24",96.272,617,22,1,11,626,2279,1663,0,1011,615,616
"80028","Ntome_NODE_30046_length_626_cov_5","Nsylvestris_NODE_28441_length_608_cov_40",82.908,392,65,2,126,516,391,1,3.9e-96,351,390,390
"80035","Ntome_NODE_30049_length_625_cov_320","Nsylvestris_NODE_13151_length_1744_cov_114",97.161,634,9,1,1,625,1261,628,0,1062,624,633
"80045","Ntome_NODE_30054_length_625_cov_197","Nsylvestris_NODE_14189_length_1631_cov_210",96.779,621,19,1,1,621,978,1597,0,1035,620,619
"80055","Ntome_NODE_30057_length_625_cov_101","Nsylvestris_NODE_29982_length_529_cov_108",87.711,415,34,7,108,521,529,131,3.71e-131,468,413,398
"80065","Ntome_NODE_30064_length_625_cov_23","Nsylvestris_NODE_25948_length_721_cov_85",93.849,634,22,8,1,621,657,28,0,939,620,629
"80066","Ntome_NODE_30065_length_625_cov_22","Nsylvestris_NODE_23400_length_866_cov_179",89.095,431,44,3,96,524,789,360,1.3e-150,532,428,429
"80072","Ntome_NODE_30068_length_625_cov_17","Nsylvestris_NODE_7774_length_2441_cov_218",98.182,55,1,0,571,625,1780,1726,2.01e-19,97.1,54,54
"80073","Ntome_NODE_30069_length_625_cov_16","Nsylvestris_NODE_1363_length_4531_cov_116",96.552,58,2,0,568,625,4157,4214,2.01e-19,97.1,57,57
"80091","Ntome_NODE_30079_length_624_cov_211","Nsylvestris_NODE_550_length_5825_cov_190",98.113,53,1,0,1,53,5517,5465,2.6e-18,93.5,52,52
"80101","Ntome_NODE_30082_length_624_cov_148","Nsylvestris_NODE_9758_length_2146_cov_119",94.391,624,27,3,1,624,943,328,0,952,623,615
"80102","Ntome_NODE_30083_length_624_cov_135","Nsylvestris_NODE_17532_length_1310_cov_52",80,370,59,5,1,368,900,544,2.42e-68,259,367,356
"80108","Ntome_NODE_30087_length_624_cov_48","Nsylvestris_NODE_652_length_5548_cov_203",91.845,515,21,11,119,624,1653,2155,0,699,505,502
"80118","Ntome_NODE_30093_length_624_cov_15","Nsylvestris_NODE_5826_length_2796_cov_168",100,55,0,0,1,55,1828,1882,4.32e-21,102,54,54
"80121","Ntome_NODE_30095_length_624_cov_10","Nsylvestris_NODE_28760_length_595_cov_4",91.765,85,4,1,540,624,1,82,5.55e-25,115,84,81
"80122","Ntome_NODE_30096_length_624_cov_10","Nsylvestris_NODE_24181_length_820_cov_161",100,52,0,0,570,621,665,716,2.01e-19,97.1,51,51
"80125","Ntome_NODE_30099_length_624_cov_7","Nsylvestris_NODE_19339_length_1156_cov_213",98.182,55,1,0,570,624,672,618,2.01e-19,97.1,54,54
"80135","Ntome_NODE_30103_length_624_cov_6","Nsylvestris_NODE_9249_length_2215_cov_234",100,53,0,0,570,622,1492,1440,5.59e-20,99,52,52
"80136","Ntome_NODE_30104_length_624_cov_5","Nsylvestris_NODE_30894_length_458_cov_5",96.061,457,18,0,125,581,457,1,0,745,456,456
"80139","Ntome_NODE_30106_length_623_cov_226","Nsylvestris_NODE_15511_length_1501_cov_37",93.814,291,16,2,56,344,1342,1052,1.04e-121,436,288,290
"80145","Ntome_NODE_30109_length_623_cov_200","Nsylvestris_NODE_19393_length_1152_cov_213",92.715,604,27,7,1,597,594,1,0,856,596,593
"80149","Ntome_NODE_30113_length_623_cov_153","Nsylvestris_NODE_6480_length_2664_cov_196",90.909,55,5,0,569,623,1978,2032,9.41e-13,75,54,54
"80152","Ntome_NODE_30115_length_623_cov_120","Nsylvestris_NODE_9064_length_2243_cov_183",84.286,280,17,8,195,473,2202,1949,5.24e-65,248,278,253
"80153","Ntome_NODE_30116_length_623_cov_60","Nsylvestris_NODE_564_length_5792_cov_77",100,52,0,0,572,623,1022,971,2.01e-19,97.1,51,51
"80156","Ntome_NODE_30118_length_623_cov_54","Nsylvestris_NODE_518_length_5911_cov_122",89.904,208,21,0,416,623,3264,3471,4.02e-71,268,207,207
"80165","Ntome_NODE_30122_length_623_cov_19","Nsylvestris_NODE_4297_length_3150_cov_44",85.965,114,8,5,9,120,745,638,5.54e-25,115,111,107
"80170","Ntome_NODE_30126_length_623_cov_12","Nsylvestris_NODE_8439_length_2334_cov_159",87.066,634,35,20,1,623,1245,1842,0,673,622,597
"80176","Ntome_NODE_30132_length_623_cov_7","Nsylvestris_NODE_33174_length_347_cov_3",97.126,348,9,1,160,507,1,347,9.77e-167,586,347,346
"80177","Ntome_NODE_30136_length_622_cov_322","Nsylvestris_NODE_1560_length_4354_cov_201",97.44,625,13,1,1,622,2126,1502,0,1062,621,624
"80181","Ntome_NODE_30138_length_622_cov_245","Nsylvestris_NODE_8241_length_2366_cov_187",92.88,618,22,13,14,622,2340,1736,0,878,608,604
"80182","Ntome_NODE_30139_length_622_cov_239","Nsylvestris_NODE_12355_length_1832_cov_97",94.828,580,19,5,43,622,1805,1237,0,894,579,568
"80188","Ntome_NODE_30141_length_622_cov_179","Nsylvestris_NODE_21137_length_1019_cov_96",88.306,496,31,12,131,622,858,386,9.82e-162,569,491,472
"80197","Ntome_NODE_30145_length_622_cov_44","Nsylvestris_NODE_1507_length_4394_cov_98",80.208,96,9,5,333,428,4125,4210,2.03e-09,63.9,95,85
"80204","Ntome_NODE_30149_length_622_cov_25","Nsylvestris_NODE_6978_length_2572_cov_226",98.182,55,1,0,1,55,1466,1412,2e-19,97.1,54,54
"80208","Ntome_NODE_30151_length_622_cov_17","Nsylvestris_NODE_7262_length_2524_cov_225",94.545,55,3,0,568,622,1849,1795,4.34e-16,86.1,54,54
"80209","Ntome_NODE_30152_length_622_cov_14","Nsylvestris_NODE_4893_length_2997_cov_18",94.85,602,31,0,7,608,2677,2076,0,941,601,601
"80212","Ntome_NODE_30154_length_622_cov_13","Nsylvestris_NODE_5685_length_2822_cov_42",98.182,55,1,0,1,55,581,527,2e-19,97.1,54,54
"80216","Ntome_NODE_30157_length_622_cov_10","Nsylvestris_NODE_1675_length_4270_cov_177",80.208,384,67,5,236,619,697,1071,1.85e-74,279,383,374
"80219","Ntome_NODE_30159_length_622_cov_6","Nsylvestris_NODE_8451_length_2332_cov_14",90.268,596,50,3,27,622,4,591,0,773,595,587
"80231","Ntome_NODE_30168_length_621_cov_90","Nsylvestris_NODE_27961_length_627_cov_40",91.975,162,8,2,460,621,307,151,3.16e-57,222,161,156
"80236","Ntome_NODE_30171_length_621_cov_44","Nsylvestris_NODE_3873_length_3276_cov_156",91.908,173,6,3,457,621,1288,1460,4.06e-61,235,164,172
"80260","Ntome_NODE_30185_length_621_cov_8","Nsylvestris_NODE_15136_length_1536_cov_84",86.383,470,40,10,5,458,1415,954,2.18e-138,492,453,461
"80270","Ntome_NODE_30190_length_620_cov_262","Nsylvestris_NODE_9661_length_2157_cov_188",93.688,602,21,7,22,620,1735,1148,0,885,598,587
"80277","Ntome_NODE_30193_length_620_cov_243","Nsylvestris_NODE_14296_length_1621_cov_127",92.444,622,20,7,1,596,1001,1621,0,863,595,620
"80278","Ntome_NODE_30194_length_620_cov_182","Nsylvestris_NODE_12630_length_1802_cov_192",92.898,521,18,6,1,519,1245,1748,0,739,518,503
"80279","Ntome_NODE_30195_length_620_cov_90","Nsylvestris_NODE_3807_length_3298_cov_39",93.645,299,18,1,97,395,2504,2207,1.72e-124,446,298,297
"80283","Ntome_NODE_30198_length_620_cov_60","Nsylvestris_NODE_35650_length_281_cov_2",91.266,229,20,0,1,229,229,1,1.82e-84,313,228,228
"80286","Ntome_NODE_30200_length_620_cov_29","Nsylvestris_NODE_20040_length_1099_cov_18",93.193,617,27,6,4,620,602,1,0,893,616,601
"80292","Ntome_NODE_30206_length_620_cov_11","Nsylvestris_NODE_2429_length_3826_cov_206",98.182,55,1,0,1,55,2543,2597,2e-19,97.1,54,54
"80293","Ntome_NODE_30207_length_620_cov_10","Nsylvestris_NODE_25687_length_735_cov_12",96.075,535,21,0,1,535,201,735,0,872,534,534
"80297","Ntome_NODE_30209_length_620_cov_7","Nsylvestris_NODE_11437_length_1937_cov_115",96.528,576,17,1,48,620,1734,1159,0,950,572,575
"80301","Ntome_NODE_30212_length_620_cov_5","Nsylvestris_NODE_800_length_5246_cov_116",95.33,621,28,1,1,620,1901,1281,0,985,619,620
"80309","Ntome_NODE_30215_length_620_cov_4","Nsylvestris_NODE_8767_length_2285_cov_28",95.968,620,25,0,1,620,2221,1602,0,1007,619,619
"80310","Ntome_NODE_30216_length_620_cov_3","Nsylvestris_NODE_1950_length_4086_cov_140",95.775,71,3,0,550,620,2252,2322,5.51e-25,115,70,70
"80311","Ntome_NODE_30217_length_619_cov_344","Nsylvestris_NODE_11101_length_1976_cov_64",95.8,619,26,0,1,619,823,1441,0,1000,618,618
"80312","Ntome_NODE_30218_length_619_cov_286","Nsylvestris_NODE_9538_length_2171_cov_147",97.254,619,17,0,1,619,1691,1073,0,1050,618,618
"80317","Ntome_NODE_30222_length_619_cov_55","Nsylvestris_NODE_28164_length_622_cov_13",89.32,103,8,1,177,279,352,253,2.54e-28,126,102,99
"80320","Ntome_NODE_30225_length_619_cov_36","Nsylvestris_NODE_13379_length_1719_cov_225",100,55,0,0,1,55,1295,1349,4.29e-21,102,54,54
"80326","Ntome_NODE_30230_length_619_cov_13","Nsylvestris_NODE_15816_length_1467_cov_200",94.545,55,3,0,565,619,515,569,4.32e-16,86.1,54,54
"80330","Ntome_NODE_30232_length_619_cov_9","Nsylvestris_NODE_11292_length_1953_cov_23",92.258,620,39,4,1,618,1107,1719,0,870,617,612
"80334","Ntome_NODE_30234_length_619_cov_6","Nsylvestris_NODE_12678_length_1798_cov_98",95.398,565,16,4,57,619,918,362,0,891,562,556
"80335","Ntome_NODE_30236_length_619_cov_4","Nsylvestris_NODE_2943_length_3595_cov_196",98.182,55,1,0,565,619,1311,1365,1.99e-19,97.1,54,54
"80341","Ntome_NODE_30239_length_618_cov_283","Nsylvestris_NODE_796_length_5248_cov_145",97.249,618,14,1,1,618,2920,3534,0,1044,617,614
"80347","Ntome_NODE_30242_length_618_cov_219","Nsylvestris_NODE_26871_length_679_cov_47",88.376,628,25,21,1,618,22,611,0,712,617,589
"80351","Ntome_NODE_30244_length_618_cov_169","Nsylvestris_NODE_8400_length_2340_cov_219",89.899,396,39,1,52,446,133,528,2.16e-143,508,394,395
"80352","Ntome_NODE_30245_length_618_cov_120","Nsylvestris_NODE_12316_length_1835_cov_210",95.815,454,18,1,1,453,454,1,0,732,452,453
"80357","Ntome_NODE_30249_length_618_cov_45","Nsylvestris_NODE_981_length_4979_cov_83",96.61,59,2,0,1,59,3846,3788,5.53e-20,99,58,58
"80364","Ntome_NODE_30252_length_618_cov_33","Nsylvestris_NODE_27787_length_638_cov_54",86.656,637,62,9,1,618,1,633,0,684,617,632
"80368","Ntome_NODE_30254_length_618_cov_25","Nsylvestris_NODE_785_length_5258_cov_225",100,55,0,0,1,55,1302,1248,4.28e-21,102,54,54
"80380","Ntome_NODE_30263_length_618_cov_9","Nsylvestris_NODE_23158_length_882_cov_5",98.413,63,1,0,556,618,1,63,7.11e-24,111,62,62
"80381","Ntome_NODE_30264_length_618_cov_7","Nsylvestris_NODE_19262_length_1163_cov_5",92.593,621,35,8,1,617,829,216,0,881,616,613
"80382","Ntome_NODE_30265_length_618_cov_7","Nsylvestris_NODE_17682_length_1296_cov_21",97.436,39,1,0,1,39,279,241,1.56e-10,67.6,38,38
"80398","Ntome_NODE_30274_length_617_cov_101","Nsylvestris_NODE_6162_length_2723_cov_217",100,55,0,0,1,55,2434,2488,4.27e-21,102,54,54
"80399","Ntome_NODE_30275_length_617_cov_82","Nsylvestris_NODE_26981_length_674_cov_13",93.506,77,5,0,389,465,80,4,5.49e-25,115,76,76
"80414","Ntome_NODE_30282_length_617_cov_18","Nsylvestris_NODE_8885_length_2266_cov_124",100,55,0,0,563,617,918,972,4.27e-21,102,54,54
"80418","Ntome_NODE_30285_length_617_cov_15","Nsylvestris_NODE_17004_length_1357_cov_173",98.276,58,1,0,560,617,341,398,4.27e-21,102,57,57
"80419","Ntome_NODE_30286_length_617_cov_13","Nsylvestris_NODE_25512_length_743_cov_35",84.765,617,89,3,1,616,106,718,4.44e-175,614,615,612
"80420","Ntome_NODE_30287_length_616_cov_11","Nsylvestris_NODE_10004_length_2114_cov_226",100,55,0,0,1,55,1512,1458,4.26e-21,102,54,54
"80421","Ntome_NODE_30288_length_617_cov_8","Nsylvestris_NODE_17915_length_1275_cov_232",96.364,55,2,0,1,55,768,714,9.25e-18,91.6,54,54
"80422","Ntome_NODE_30289_length_617_cov_7","Nsylvestris_NODE_13868_length_1666_cov_202",96.364,55,2,0,563,617,723,777,9.25e-18,91.6,54,54
"80423","Ntome_NODE_30290_length_617_cov_7","Nsylvestris_NODE_22170_length_944_cov_11",92.504,627,31,11,4,617,941,318,0,883,613,623
"80424","Ntome_NODE_30291_length_617_cov_6","Nsylvestris_NODE_36_length_9913_cov_207",95.082,61,3,0,557,617,8056,7996,1.99e-19,97.1,60,60
"80425","Ntome_NODE_30293_length_617_cov_3","Nsylvestris_NODE_5538_length_2854_cov_170",98.182,55,1,0,1,55,400,346,1.99e-19,97.1,54,54
"80426","Ntome_NODE_30294_length_617_cov_3","Nsylvestris_NODE_255_length_6967_cov_81",98.182,55,1,0,563,617,1108,1054,1.99e-19,97.1,54,54
"80444","Ntome_NODE_30303_length_616_cov_44","Nsylvestris_NODE_439_length_6140_cov_164",92.308,169,11,2,1,169,3418,3252,3.11e-62,239,168,166
"80445","Ntome_NODE_30305_length_616_cov_22","Nsylvestris_NODE_6579_length_2644_cov_175",94.915,59,2,1,1,59,697,640,9.23e-18,91.6,58,57
"80454","Ntome_NODE_30310_length_616_cov_12","Nsylvestris_NODE_19818_length_1116_cov_27",96.803,563,18,0,52,614,231,793,0,941,562,562
"80467","Ntome_NODE_30316_length_616_cov_6","Nsylvestris_NODE_22788_length_904_cov_5",92.762,525,35,2,1,522,742,218,0,756,521,524
"80479","Ntome_NODE_30324_length_615_cov_49","Nsylvestris_NODE_25783_length_729_cov_53",94.203,276,16,0,338,613,315,40,2.88e-117,422,275,275
"80492","Ntome_NODE_30330_length_615_cov_24","Nsylvestris_NODE_17840_length_1282_cov_229",96.364,55,2,0,1,55,668,722,9.21e-18,91.6,54,54
"80519","Ntome_NODE_30341_length_615_cov_9","Nsylvestris_NODE_35192_length_291_cov_3",93.836,292,9,7,51,338,4,290,4.78e-120,431,287,286
"80524","Ntome_NODE_30346_length_615_cov_5","Nsylvestris_NODE_11096_length_1977_cov_11",96.585,615,21,0,1,615,1549,935,0,1020,614,614
"80525","Ntome_NODE_30347_length_615_cov_3","Nsylvestris_NODE_4794_length_3023_cov_155",90.076,524,37,8,3,514,2437,2957,0,665,511,520
"80526","Ntome_NODE_30348_length_615_cov_3","Nsylvestris_NODE_7354_length_2512_cov_26",97.886,615,13,0,1,615,1503,889,0,1064,614,614
"80527","Ntome_NODE_30349_length_614_cov_260","Nsylvestris_NODE_22340_length_932_cov_203",95.717,537,21,2,1,536,316,851,0,863,535,535
"80530","Ntome_NODE_30351_length_614_cov_233","Nsylvestris_NODE_24831_length_781_cov_178",93.085,564,32,5,2,563,1,559,0,819,561,558
"80548","Ntome_NODE_30360_length_614_cov_8","Nsylvestris_NODE_22894_length_897_cov_214",98.182,55,1,0,560,614,164,218,1.98e-19,97.1,54,54
"80555","Ntome_NODE_30366_length_614_cov_3","Nsylvestris_NODE_11594_length_1918_cov_148",92.532,616,39,5,1,613,707,96,0,876,612,611
"80563","Ntome_NODE_30370_length_613_cov_213","Nsylvestris_NODE_11455_length_1935_cov_224",96.61,59,1,1,1,59,497,440,1.97e-19,97.1,58,57
"80571","Ntome_NODE_30373_length_613_cov_153","Nsylvestris_NODE_32986_length_353_cov_11",92.878,337,19,2,256,589,1,335,3.61e-136,484,333,334
"80582","Ntome_NODE_30382_length_613_cov_8","Nsylvestris_NODE_4271_length_3157_cov_158",93.579,623,25,7,1,610,1759,2379,0,915,609,620
"80583","Ntome_NODE_30383_length_613_cov_8","Nsylvestris_NODE_7421_length_2500_cov_78",90.909,506,28,7,117,611,1999,2497,0,664,494,498
"80592","Ntome_NODE_30388_length_612_cov_243","Nsylvestris_NODE_4718_length_3041_cov_13",95.8,619,19,3,1,612,2756,2138,0,992,611,618
"80601","Ntome_NODE_30393_length_612_cov_114","Nsylvestris_NODE_19396_length_1152_cov_102",90.385,52,3,1,6,55,192,243,1.54e-10,67.6,49,51
"80615","Ntome_NODE_30400_length_612_cov_15","Nsylvestris_NODE_31667_length_410_cov_6",90.217,92,9,0,32,123,18,109,1.17e-26,121,91,91
"80616","Ntome_NODE_30401_length_612_cov_15","Nsylvestris_NODE_1277_length_4614_cov_186",95.484,620,15,3,1,611,2243,2858,0,977,610,615
"80617","Ntome_NODE_30402_length_612_cov_14","Nsylvestris_NODE_2271_length_3905_cov_135",98.182,55,1,0,1,55,982,1036,1.97e-19,97.1,54,54
"80634","Ntome_NODE_30414_length_612_cov_5","Nsylvestris_NODE_325_length_6578_cov_78",93.878,49,3,0,564,612,5516,5564,9.23e-13,75,48,48
"80635","Ntome_NODE_30417_length_611_cov_261","Nsylvestris_NODE_14762_length_1573_cov_209",97.193,570,15,1,42,611,1562,994,0,963,569,568
"80641","Ntome_NODE_30420_length_611_cov_219","Nsylvestris_NODE_5338_length_2899_cov_112",92.791,541,19,6,15,536,2868,2329,0,765,521,539
"80647","Ntome_NODE_30424_length_611_cov_59","Nsylvestris_NODE_4338_length_3142_cov_186",94.393,535,27,2,4,535,593,59,0,819,531,534
"80662","Ntome_NODE_30432_length_611_cov_16","Nsylvestris_NODE_8674_length_2297_cov_227",98.182,55,1,0,557,611,1725,1779,1.97e-19,97.1,54,54
"80671","Ntome_NODE_30438_length_611_cov_9","Nsylvestris_NODE_22136_length_946_cov_48",89.217,575,32,7,4,553,789,220,0,691,549,569
"80676","Ntome_NODE_30443_length_611_cov_3","Nsylvestris_NODE_23633_length_852_cov_170",98.182,55,1,0,1,55,611,557,1.97e-19,97.1,54,54
"80684","Ntome_NODE_30447_length_610_cov_84","Nsylvestris_NODE_13868_length_1666_cov_202",98.276,58,1,0,553,610,542,599,4.22e-21,102,57,57
"80685","Ntome_NODE_30449_length_610_cov_53","Nsylvestris_NODE_12144_length_1853_cov_202",95.939,197,7,1,1,197,1469,1664,3.85e-86,318,196,195
"80686","Ntome_NODE_30450_length_610_cov_45","Nsylvestris_NODE_19493_length_1144_cov_120",87.7,626,40,14,1,610,960,356,0,695,609,604
"80691","Ntome_NODE_30453_length_610_cov_23","Nsylvestris_NODE_18484_length_1225_cov_207",98.182,55,1,0,556,610,573,627,1.96e-19,97.1,54,54
"80695","Ntome_NODE_30455_length_610_cov_18","Nsylvestris_NODE_3232_length_3496_cov_114",90.816,98,8,1,513,610,2818,2914,1.94e-29,130,97,96
"80696","Ntome_NODE_30456_length_610_cov_13","Nsylvestris_NODE_15954_length_1454_cov_179",98.182,55,1,0,556,610,541,595,1.96e-19,97.1,54,54
"80697","Ntome_NODE_30458_length_610_cov_12","Nsylvestris_NODE_24109_length_825_cov_27",91.005,567,33,2,1,567,138,686,0,749,566,548
"80708","Ntome_NODE_30464_length_610_cov_8","Nsylvestris_NODE_6529_length_2656_cov_114",100,31,0,0,32,62,2002,1972,9.27e-08,58.4,30,30
"80709","Ntome_NODE_30465_length_610_cov_7","Nsylvestris_NODE_4184_length_3180_cov_217",98.182,55,1,0,1,55,1934,1988,1.96e-19,97.1,54,54
"80712","Ntome_NODE_30467_length_610_cov_6","Nsylvestris_NODE_19247_length_1164_cov_51",92.809,598,34,8,16,605,648,52,0,857,589,596
"80713","Ntome_NODE_30468_length_610_cov_6","Nsylvestris_NODE_10180_length_2091_cov_60",100,55,0,0,556,610,979,1033,4.22e-21,102,54,54
"80714","Ntome_NODE_30469_length_610_cov_6","Nsylvestris_NODE_1628_length_4310_cov_50",98.182,55,1,0,556,610,2078,2024,1.96e-19,97.1,54,54
"80715","Ntome_NODE_30470_length_612_cov_6","Nsylvestris_NODE_9943_length_2122_cov_224",100,55,0,0,1,55,1388,1442,4.24e-21,102,54,54
"80721","Ntome_NODE_30472_length_610_cov_5","Nsylvestris_NODE_22243_length_939_cov_205",94.828,58,3,0,553,610,506,563,9.14e-18,91.6,57,57
"80722","Ntome_NODE_30473_length_610_cov_5","Nsylvestris_NODE_33671_length_332_cov_2",94.828,232,11,1,1,232,231,1,6.31e-99,361,231,230
"80723","Ntome_NODE_30474_length_610_cov_4","Nsylvestris_NODE_243_length_7034_cov_216",98.182,55,1,0,556,610,741,687,1.96e-19,97.1,54,54
"80734","Ntome_NODE_30481_length_609_cov_94","Nsylvestris_NODE_1064_length_4863_cov_92",88.565,481,26,14,92,555,4302,3834,7.48e-158,556,463,468
"80745","Ntome_NODE_30487_length_609_cov_35","Nsylvestris_NODE_16733_length_1378_cov_48",89.176,619,34,8,1,592,664,52,0,741,591,612
"80748","Ntome_NODE_30489_length_609_cov_19","Nsylvestris_NODE_7672_length_2457_cov_227",100,55,0,0,1,55,1869,1923,4.21e-21,102,54,54
"80749","Ntome_NODE_30490_length_609_cov_12","Nsylvestris_NODE_11362_length_1945_cov_222",100,55,0,0,1,55,1273,1219,4.21e-21,102,54,54
"80750","Ntome_NODE_30491_length_609_cov_10","Nsylvestris_NODE_3351_length_3455_cov_155",94.253,609,24,6,1,609,1829,2426,0,920,608,597
"80759","Ntome_NODE_30498_length_608_cov_307","Nsylvestris_NODE_4103_length_3201_cov_228",97.487,557,8,2,53,608,3081,2530,0,946,555,551
"80768","Ntome_NODE_30502_length_608_cov_37","Nsylvestris_NODE_996_length_4960_cov_234",96.364,55,2,0,554,608,4299,4245,9.11e-18,91.6,54,54
"80778","Ntome_NODE_30508_length_608_cov_11","Nsylvestris_NODE_1893_length_4121_cov_145",100,55,0,0,554,608,745,691,4.21e-21,102,54,54
"80796","Ntome_NODE_30520_length_607_cov_275","Nsylvestris_NODE_14632_length_1585_cov_224",96.727,550,14,2,62,607,1527,978,0,913,545,549
"80797","Ntome_NODE_30521_length_607_cov_254","Nsylvestris_NODE_13867_length_1666_cov_208",94.2,569,15,5,1,567,725,173,0,852,566,552
"80802","Ntome_NODE_30525_length_607_cov_144","Nsylvestris_NODE_10834_length_2009_cov_202",92.784,582,32,5,35,607,361,941,0,833,572,580
"80805","Ntome_NODE_30527_length_607_cov_66","Nsylvestris_NODE_23930_length_836_cov_29",93.25,400,22,3,73,468,108,506,3.42e-166,584,395,398
"80828","Ntome_NODE_30538_length_607_cov_9","Nsylvestris_NODE_23442_length_864_cov_8",89.268,205,13,6,1,198,1,203,5.1e-65,248,197,202
"80831","Ntome_NODE_30543_length_607_cov_4","Nsylvestris_NODE_4052_length_3217_cov_19",90.566,106,7,1,502,607,614,716,1.15e-31,137,105,102
"80842","Ntome_NODE_30548_length_606_cov_128","Nsylvestris_NODE_2297_length_3894_cov_189",90.762,617,43,8,2,606,2586,3200,0,811,604,614
"80843","Ntome_NODE_30549_length_606_cov_98","Nsylvestris_NODE_7342_length_2514_cov_92",100,55,0,0,552,606,667,613,4.19e-21,102,54,54
"80847","Ntome_NODE_30554_length_606_cov_15","Nsylvestris_NODE_4406_length_3123_cov_134",98.182,55,1,0,552,606,697,751,1.95e-19,97.1,54,54
"80848","Ntome_NODE_30555_length_606_cov_14","Nsylvestris_NODE_13525_length_1703_cov_191",94.545,55,3,0,552,606,1363,1309,4.22e-16,86.1,54,54
"80849","Ntome_NODE_30556_length_606_cov_11","Nsylvestris_NODE_192_length_7424_cov_227",100,55,0,0,1,55,560,506,4.19e-21,102,54,54
"80852","Ntome_NODE_30559_length_606_cov_7","Nsylvestris_NODE_18676_length_1212_cov_6",92.586,607,38,5,1,606,412,1012,0,865,605,600
"80859","Ntome_NODE_30563_length_606_cov_5","Nsylvestris_NODE_12487_length_1817_cov_19",88.39,534,46,9,1,530,887,366,1.56e-179,628,529,521
"80860","Ntome_NODE_30566_length_605_cov_257","Nsylvestris_NODE_1028_length_4900_cov_209",91.928,607,38,2,1,605,583,1180,0,839,604,597
"80864","Ntome_NODE_30568_length_605_cov_221","Nsylvestris_NODE_15355_length_1517_cov_86",87.337,537,29,13,1,524,688,178,1.59e-164,579,523,510
"80870","Ntome_NODE_30571_length_605_cov_34","Nsylvestris_NODE_24659_length_791_cov_47",92.626,556,30,5,5,556,622,74,0,789,551,548
"80871","Ntome_NODE_30572_length_605_cov_19","Nsylvestris_NODE_3098_length_3542_cov_230",96.364,55,2,0,1,55,689,743,9.06e-18,91.6,54,54
"80872","Ntome_NODE_30573_length_605_cov_12","Nsylvestris_NODE_22340_length_932_cov_203",94.545,55,3,0,1,55,724,670,4.21e-16,86.1,54,54
"80875","Ntome_NODE_30575_length_605_cov_10","Nsylvestris_NODE_5508_length_2860_cov_234",98.182,55,1,0,1,55,2333,2387,1.95e-19,97.1,54,54
"80879","Ntome_NODE_30578_length_605_cov_6","Nsylvestris_NODE_168_length_7585_cov_185",100,55,0,0,1,55,686,740,4.18e-21,102,54,54
"80880","Ntome_NODE_30581_length_605_cov_5","Nsylvestris_NODE_13367_length_1721_cov_35",87.654,243,9,2,315,547,232,1,1.81e-69,263,232,231
"80891","Ntome_NODE_30587_length_604_cov_124","Nsylvestris_NODE_15036_length_1547_cov_107",89.67,455,34,5,54,498,1096,1547,3.43e-161,568,444,451
"80917","Ntome_NODE_30599_length_604_cov_10","Nsylvestris_NODE_26544_length_694_cov_9",82.927,123,16,2,164,281,65,187,3.23e-22,106,117,122
"80921","Ntome_NODE_30601_length_604_cov_7","Nsylvestris_NODE_31791_length_404_cov_4",90.476,378,33,3,95,469,24,401,1.64e-139,496,374,377
"80922","Ntome_NODE_30602_length_604_cov_6","Nsylvestris_NODE_29641_length_557_cov_11",91.353,532,40,4,79,604,3,534,0,723,525,531
"80927","Ntome_NODE_30606_length_603_cov_266","Nsylvestris_NODE_24585_length_796_cov_56",87.931,522,38,12,63,568,29,541,2.03e-168,592,505,512
"80930","Ntome_NODE_30608_length_603_cov_202","Nsylvestris_NODE_16634_length_1388_cov_130",86.974,499,29,21,116,603,1335,862,1.61e-149,529,487,473
"80931","Ntome_NODE_30609_length_603_cov_196","Nsylvestris_NODE_7615_length_2468_cov_216",92.578,512,37,1,44,554,1822,2333,0,734,510,511
"80942","Ntome_NODE_30614_length_603_cov_33","Nsylvestris_NODE_17636_length_1299_cov_208",93.651,63,3,1,542,603,1127,1065,2.51e-18,93.5,61,62
"80946","Ntome_NODE_30617_length_603_cov_17","Nsylvestris_NODE_5914_length_2779_cov_116",95.745,47,2,0,1,47,2501,2547,2.53e-13,76.8,46,46
"80947","Ntome_NODE_30618_length_603_cov_15","Nsylvestris_NODE_9268_length_2211_cov_213",100,55,0,0,549,603,884,830,4.17e-21,102,54,54
"80948","Ntome_NODE_30619_length_603_cov_13","Nsylvestris_NODE_7900_length_2421_cov_199",96.364,55,2,0,1,55,1171,1225,9.03e-18,91.6,54,54
"80949","Ntome_NODE_30620_length_603_cov_12","Nsylvestris_NODE_25878_length_725_cov_6",86.433,457,27,22,173,603,725,278,3.57e-131,468,430,447
"80956","Ntome_NODE_30625_length_603_cov_11","Nsylvestris_NODE_3296_length_3475_cov_180",96.364,55,1,1,96,150,3223,3170,3.25e-17,89.8,54,53
"80957","Ntome_NODE_30626_length_603_cov_10","Nsylvestris_NODE_9465_length_2183_cov_134",98.182,55,1,0,1,55,1598,1544,1.94e-19,97.1,54,54
"80961","Ntome_NODE_30628_length_603_cov_8","Nsylvestris_NODE_3499_length_3389_cov_128",98.182,55,1,0,549,603,2802,2748,1.94e-19,97.1,54,54
"80965","Ntome_NODE_30630_length_603_cov_5","Nsylvestris_NODE_786_length_5256_cov_132",98.01,603,12,0,1,603,985,383,0,1048,602,602
"80966","Ntome_NODE_30631_length_603_cov_5","Nsylvestris_NODE_22606_length_915_cov_150",96.134,595,23,0,1,595,677,83,0,972,594,594
"80967","Ntome_NODE_30633_length_603_cov_4","Nsylvestris_NODE_8450_length_2333_cov_84",85.553,533,69,8,4,531,888,359,3.45e-156,551,527,529
"80968","Ntome_NODE_30634_length_603_cov_3","Nsylvestris_NODE_18825_length_1200_cov_14",93.576,576,34,1,26,601,629,57,0,856,575,572
"80969","Ntome_NODE_30635_length_602_cov_312","Nsylvestris_NODE_4923_length_2991_cov_219",98.671,602,8,0,1,602,1470,2071,0,1068,601,601
"80973","Ntome_NODE_30637_length_602_cov_253","Nsylvestris_NODE_1028_length_4900_cov_209",95.43,372,17,0,231,602,210,581,5.63e-169,593,371,371
"80974","Ntome_NODE_30638_length_602_cov_250","Nsylvestris_NODE_22604_length_915_cov_202",94.369,586,30,2,18,602,869,286,0,896,584,583
"80975","Ntome_NODE_30639_length_602_cov_236","Nsylvestris_NODE_11464_length_1934_cov_197",96.296,54,2,0,549,602,780,727,3.24e-17,89.8,53,53
"80984","Ntome_NODE_30645_length_602_cov_41","Nsylvestris_NODE_25358_length_751_cov_209",82.061,262,42,3,145,405,505,248,3.96e-56,219,260,257
"80988","Ntome_NODE_30647_length_602_cov_27","Nsylvestris_NODE_23859_length_840_cov_130",94.545,55,3,0,1,55,317,371,4.19e-16,86.1,54,54
"80993","Ntome_NODE_30650_length_602_cov_12","Nsylvestris_NODE_8162_length_2377_cov_167",100,55,0,0,548,602,1137,1191,4.16e-21,102,54,54
"80999","Ntome_NODE_30655_length_602_cov_4","Nsylvestris_NODE_12826_length_1783_cov_206",100,55,0,0,1,55,1142,1088,4.16e-21,102,54,54
"81000","Ntome_NODE_30656_length_601_cov_1","Nsylvestris_NODE_436_length_6152_cov_57",91.03,602,51,2,1,601,2001,2600,0,809,600,599
"81008","Ntome_NODE_30659_length_593_cov_263","Nsylvestris_NODE_27933_length_631_cov_160",90.317,537,24,8,28,556,627,111,0,678,528,516
"81017","Ntome_NODE_30663_length_601_cov_47","Nsylvestris_NODE_22709_length_894_cov_142",89.859,355,20,4,258,600,777,427,2.16e-123,442,342,350
"81018","Ntome_NODE_30664_length_601_cov_42","Nsylvestris_NODE_8415_length_2337_cov_150",96.364,55,2,0,547,601,1075,1021,9e-18,91.6,54,54
"81029","Ntome_NODE_30672_length_601_cov_11","Nsylvestris_NODE_9041_length_2245_cov_227",98.182,55,1,0,1,55,1578,1632,1.93e-19,97.1,54,54
"81030","Ntome_NODE_30673_length_601_cov_11","Nsylvestris_NODE_26687_length_688_cov_6",88.119,101,8,4,503,601,679,581,1.48e-25,117,98,98
"81031","Ntome_NODE_30674_length_601_cov_10","Nsylvestris_NODE_4507_length_3098_cov_64",89.31,290,22,4,302,591,451,731,2.89e-97,355,289,280
"81032","Ntome_NODE_30675_length_601_cov_10","Nsylvestris_NODE_1043_length_4887_cov_110",98.182,55,1,0,1,55,2942,2996,1.93e-19,97.1,54,54
"81042","Ntome_NODE_30684_length_601_cov_7","Nsylvestris_NODE_6197_length_2718_cov_187",100,55,0,0,547,601,781,727,4.16e-21,102,54,54
"81051","Ntome_NODE_30691_length_601_cov_4","Nsylvestris_NODE_470_length_6031_cov_12",83.163,196,31,2,348,543,668,475,6.71e-44,178,195,193
"81057","Ntome_NODE_30694_length_600_cov_173","Nsylvestris_NODE_22709_length_894_cov_142",98.148,54,1,0,2,55,427,480,6.94e-19,95.3,53,53
"81082","Ntome_NODE_30708_length_600_cov_5","Nsylvestris_NODE_36070_length_272_cov_3",92.143,140,8,2,1,140,137,1,6.65e-49,195,139,136
"81083","Ntome_NODE_30709_length_600_cov_5","Nsylvestris_NODE_24274_length_814_cov_24",96.078,51,2,0,51,101,764,814,1.5e-15,84.2,50,50
"81084","Ntome_NODE_30710_length_600_cov_4","Nsylvestris_NODE_19555_length_1139_cov_135",97.487,557,14,0,1,557,743,187,0,952,556,556
"81090","Ntome_NODE_30714_length_599_cov_164","Nsylvestris_NODE_4629_length_3065_cov_171",91.897,543,36,7,64,599,838,297,0,752,535,541
"81100","Ntome_NODE_30720_length_602_cov_23","Nsylvestris_NODE_904_length_5085_cov_203",98.182,55,1,0,1,55,2702,2648,1.94e-19,97.1,54,54
"81101","Ntome_NODE_30721_length_599_cov_21","Nsylvestris_NODE_7989_length_2405_cov_182",80.339,590,68,24,2,572,1650,2210,1.01e-111,403,570,560
"81105","Ntome_NODE_30723_length_599_cov_14","Nsylvestris_NODE_7293_length_2520_cov_171",98.113,53,1,0,545,597,776,724,2.49e-18,93.5,52,52
"81108","Ntome_NODE_30726_length_599_cov_11","Nsylvestris_NODE_4841_length_3009_cov_218",100,55,0,0,1,55,1184,1130,4.14e-21,102,54,54
"81118","Ntome_NODE_30733_length_599_cov_6","Nsylvestris_NODE_14458_length_1604_cov_147",100,55,0,0,1,55,1441,1387,4.14e-21,102,54,54
"81119","Ntome_NODE_30734_length_599_cov_5","Nsylvestris_NODE_12348_length_1833_cov_26",96.277,188,5,2,365,551,977,791,8.18e-83,307,186,186
"81120","Ntome_NODE_30735_length_599_cov_4","Nsylvestris_NODE_957_length_5003_cov_101",76.19,294,54,13,277,560,794,1081,8.78e-33,141,283,287
"81123","Ntome_NODE_30739_length_599_cov_4","Nsylvestris_NODE_14371_length_1613_cov_19",87.805,82,8,2,1,80,1092,1173,6.93e-19,95.3,79,81
"81124","Ntome_NODE_30740_length_599_cov_3","Nsylvestris_NODE_31331_length_430_cov_10",98.936,376,4,0,126,501,376,1,0,673,375,375
"81127","Ntome_NODE_30742_length_598_cov_259","Nsylvestris_NODE_87_length_8725_cov_115",85.714,168,15,3,440,598,5329,5162,4.02e-41,169,158,167
"81128","Ntome_NODE_30743_length_598_cov_243","Nsylvestris_NODE_3598_length_3365_cov_207",81.549,607,88,19,1,598,1776,1185,1.63e-134,479,597,591
"81152","Ntome_NODE_30753_length_598_cov_11","Nsylvestris_NODE_2241_length_3918_cov_140",100,55,0,0,544,598,1948,1894,4.13e-21,102,54,54
"81153","Ntome_NODE_30754_length_598_cov_9","Nsylvestris_NODE_3167_length_3519_cov_213",98.182,55,1,0,544,598,2802,2856,1.92e-19,97.1,54,54
"81156","Ntome_NODE_30756_length_598_cov_7","Nsylvestris_NODE_18027_length_1266_cov_17",92.347,588,20,7,1,568,145,727,0,813,567,582
"81160","Ntome_NODE_30758_length_598_cov_7","Nsylvestris_NODE_14039_length_1645_cov_214",100,55,0,0,544,598,563,617,4.13e-21,102,54,54
"81161","Ntome_NODE_30759_length_598_cov_6","Nsylvestris_NODE_4241_length_3163_cov_233",100,55,0,0,544,598,2102,2048,4.13e-21,102,54,54
"81165","Ntome_NODE_30761_length_598_cov_5","Nsylvestris_NODE_19232_length_1165_cov_82",97.059,544,16,0,55,598,202,745,0,917,543,543
"81172","Ntome_NODE_30764_length_597_cov_249","Nsylvestris_NODE_4924_length_2991_cov_194",95.31,597,25,3,3,597,40,635,0,944,594,595
"81173","Ntome_NODE_30765_length_597_cov_238","Nsylvestris_NODE_10705_length_2024_cov_232",94.545,55,3,0,543,597,151,97,4.16e-16,86.1,54,54
"81174","Ntome_NODE_30766_length_597_cov_202","Nsylvestris_NODE_9722_length_2150_cov_113",93.421,456,27,1,139,594,148,600,0,673,455,452
"81175","Ntome_NODE_30768_length_597_cov_163","Nsylvestris_NODE_28484_length_606_cov_157",90.926,551,22,9,1,550,56,579,0,715,549,523
"81176","Ntome_NODE_30769_length_597_cov_146","Nsylvestris_NODE_7020_length_2566_cov_169",88.018,217,22,3,140,353,984,1199,1.08e-66,254,213,215
"81177","Ntome_NODE_30770_length_597_cov_142","Nsylvestris_NODE_8785_length_2282_cov_10",95.455,66,3,0,1,66,1295,1230,3.19e-22,106,65,65
"81181","Ntome_NODE_30772_length_597_cov_86","Nsylvestris_NODE_24869_length_779_cov_21",93.038,158,11,0,60,217,162,319,5.04e-60,231,157,157
"81182","Ntome_NODE_30773_length_597_cov_61","Nsylvestris_NODE_1088_length_4831_cov_175",100,55,0,0,543,597,1222,1168,4.13e-21,102,54,54
"81183","Ntome_NODE_30774_length_597_cov_50","Nsylvestris_NODE_589_length_5728_cov_185",98.182,55,0,1,543,597,5533,5586,6.91e-19,95.3,54,53
"81205","Ntome_NODE_30782_length_597_cov_8","Nsylvestris_NODE_12506_length_1814_cov_205",98.182,55,1,0,1,55,1556,1610,1.92e-19,97.1,54,54
"81211","Ntome_NODE_30785_length_597_cov_5","Nsylvestris_NODE_9694_length_2153_cov_72",100,55,0,0,543,597,1150,1204,4.13e-21,102,54,54
"81212","Ntome_NODE_30786_length_597_cov_4","Nsylvestris_NODE_13323_length_1726_cov_128",90.909,55,5,0,1,55,1453,1399,9e-13,75,54,54
"81218","Ntome_NODE_30789_length_596_cov_170","Nsylvestris_NODE_3671_length_3344_cov_104",90.754,411,30,2,86,496,2863,3265,2.05e-153,542,410,402
"81227","Ntome_NODE_30795_length_596_cov_14","Nsylvestris_NODE_8295_length_2356_cov_67",80.682,264,33,12,38,297,1,250,3.07e-47,189,259,249
"81231","Ntome_NODE_30797_length_596_cov_13","Nsylvestris_NODE_13505_length_1705_cov_36",91.611,596,50,0,1,596,901,306,0,824,595,595
"81234","Ntome_NODE_30800_length_596_cov_11","Nsylvestris_NODE_2587_length_3751_cov_191",100,55,0,0,542,596,908,962,4.12e-21,102,54,54
"81235","Ntome_NODE_30801_length_596_cov_11","Nsylvestris_NODE_31452_length_422_cov_7",93.03,330,11,5,1,323,98,422,2.73e-132,472,322,324
"81238","Ntome_NODE_30803_length_596_cov_7","Nsylvestris_NODE_18174_length_1252_cov_208",98.305,59,1,0,1,59,567,625,1.15e-21,104,58,58
"81239","Ntome_NODE_30805_length_596_cov_6","Nsylvestris_NODE_6923_length_2581_cov_176",98.182,55,1,0,542,596,2003,1949,1.92e-19,97.1,54,54
"81240","Ntome_NODE_30806_length_596_cov_5","Nsylvestris_NODE_28540_length_604_cov_24",88.757,338,10,12,240,573,239,552,2.82e-107,388,333,313
"81241","Ntome_NODE_30807_length_596_cov_5","Nsylvestris_NODE_4943_length_2987_cov_232",98.182,55,1,0,542,596,979,1033,1.92e-19,97.1,54,54
"81247","Ntome_NODE_30812_length_595_cov_224","Nsylvestris_NODE_33040_length_352_cov_2",95.652,46,2,0,316,361,352,307,8.97e-13,75,45,45
"81250","Ntome_NODE_30815_length_595_cov_99","Nsylvestris_NODE_13186_length_1740_cov_136",100,55,0,0,1,55,311,365,4.11e-21,102,54,54
"81251","Ntome_NODE_30816_length_595_cov_98","Nsylvestris_NODE_4454_length_3108_cov_126",91.667,600,27,13,1,583,657,1250,0,809,582,593
"81254","Ntome_NODE_30818_length_595_cov_84","Nsylvestris_NODE_36_length_9913_cov_207",88.693,566,31,16,1,543,128,683,0,660,542,555
"81270","Ntome_NODE_30826_length_595_cov_22","Nsylvestris_NODE_14882_length_1562_cov_97",86.957,414,38,7,1,403,857,449,3.54e-126,451,402,408
"81271","Ntome_NODE_30827_length_595_cov_21","Nsylvestris_NODE_23170_length_880_cov_173",98.182,55,1,0,541,595,429,483,1.91e-19,97.1,54,54
"81278","Ntome_NODE_30830_length_595_cov_13","Nsylvestris_NODE_20700_length_1050_cov_10",86.364,242,33,0,1,242,242,1,4.96e-70,265,241,241
"81279","Ntome_NODE_30831_length_595_cov_13","Nsylvestris_NODE_1112_length_4810_cov_135",97.783,406,9,0,190,595,4035,3630,0,701,405,405
"81280","Ntome_NODE_30832_length_595_cov_11","Nsylvestris_NODE_20076_length_1096_cov_14",88.889,63,7,0,1,63,747,685,6.93e-14,78.7,62,62
"81281","Ntome_NODE_30833_length_595_cov_9","Nsylvestris_NODE_269_length_6858_cov_201",89.065,567,44,10,1,564,2143,2694,0,688,563,551
"81284","Ntome_NODE_30835_length_595_cov_7","Nsylvestris_NODE_17666_length_1297_cov_92",96.866,351,7,2,246,595,797,450,3.35e-166,584,349,347
"81296","Ntome_NODE_30842_length_594_cov_243","Nsylvestris_NODE_5508_length_2860_cov_234",94.802,481,13,5,126,594,2813,2333,0,739,468,480
"81301","Ntome_NODE_30845_length_594_cov_138","Nsylvestris_NODE_28646_length_600_cov_4",86.957,253,29,3,276,528,1,249,4.91e-75,281,252,248
"81305","Ntome_NODE_30848_length_594_cov_75","Nsylvestris_NODE_20651_length_1054_cov_62",95.556,45,2,0,550,594,593,637,3.22e-12,73.1,44,44
"81306","Ntome_NODE_30850_length_594_cov_56","Nsylvestris_NODE_16281_length_1421_cov_198",94.915,59,3,0,1,59,621,679,2.47e-18,93.5,58,58
"81312","Ntome_NODE_30855_length_594_cov_11","Nsylvestris_NODE_4077_length_3210_cov_199",93.103,58,1,1,540,594,2313,2256,5.35e-15,82.4,54,57
"81315","Ntome_NODE_30858_length_594_cov_6","Nsylvestris_NODE_10786_length_2015_cov_216",98.182,55,1,0,1,55,783,837,1.91e-19,97.1,54,54
"81323","Ntome_NODE_30864_length_594_cov_4","Nsylvestris_NODE_29947_length_532_cov_227",100,55,0,0,1,55,221,167,4.11e-21,102,54,54
"81324","Ntome_NODE_30865_length_594_cov_4","Nsylvestris_NODE_7929_length_2415_cov_68",96.364,55,2,0,1,55,866,812,8.89e-18,91.6,54,54
"81325","Ntome_NODE_30867_length_593_cov_330","Nsylvestris_NODE_19012_length_1182_cov_221",98.314,593,10,0,1,593,260,852,0,1040,592,592
"81329","Ntome_NODE_30869_length_593_cov_274","Nsylvestris_NODE_9615_length_2162_cov_237",99.157,593,5,0,1,593,52,644,0,1068,592,592
"81333","Ntome_NODE_30871_length_593_cov_86","Nsylvestris_NODE_23598_length_854_cov_69",87.092,612,45,13,1,593,210,806,0,662,592,596
"81336","Ntome_NODE_30873_length_593_cov_48","Nsylvestris_NODE_7453_length_2495_cov_163",100,28,0,0,566,593,1981,1954,4.19e-06,52.8,27,27
"81354","Ntome_NODE_30880_length_593_cov_12","Nsylvestris_NODE_5101_length_2948_cov_193",94.622,595,28,2,1,593,2089,1497,0,918,592,592
"81355","Ntome_NODE_30881_length_593_cov_12","Nsylvestris_NODE_4309_length_3147_cov_226",98.182,55,1,0,539,593,961,1015,1.91e-19,97.1,54,54
"81358","Ntome_NODE_30883_length_593_cov_9","Nsylvestris_NODE_20653_length_1054_cov_16",81.319,91,15,2,436,525,260,349,3.21e-12,73.1,89,89
"81361","Ntome_NODE_30885_length_593_cov_8","Nsylvestris_NODE_31792_length_404_cov_4",93.519,216,10,3,4,219,212,1,3.74e-86,318,215,211
"81362","Ntome_NODE_30886_length_593_cov_6","Nsylvestris_NODE_386_length_6356_cov_236",98.182,55,1,0,1,55,2612,2666,1.91e-19,97.1,54,54
"81366","Ntome_NODE_30888_length_593_cov_6","Nsylvestris_NODE_20007_length_1102_cov_107",100,55,0,0,1,55,613,667,4.1e-21,102,54,54
"81367","Ntome_NODE_30889_length_593_cov_5","Nsylvestris_NODE_1473_length_4423_cov_120",100,55,0,0,539,593,1613,1667,4.1e-21,102,54,54
"81368","Ntome_NODE_30890_length_594_cov_5","Nsylvestris_NODE_23407_length_866_cov_39",95.63,595,25,1,1,594,860,266,0,953,593,594
"81369","Ntome_NODE_30891_length_593_cov_5","Nsylvestris_NODE_28625_length_601_cov_6",89.695,262,23,3,113,370,601,340,4.8e-90,331,257,261
"81383","Ntome_NODE_30895_length_592_cov_309","Nsylvestris_NODE_22254_length_939_cov_29",87.013,308,29,7,1,303,168,469,1.03e-91,337,302,301
"81401","Ntome_NODE_30903_length_592_cov_92","Nsylvestris_NODE_4162_length_3186_cov_186",90.084,595,32,14,2,592,2384,1813,0,747,590,571
"81402","Ntome_NODE_30904_length_592_cov_84","Nsylvestris_NODE_15973_length_1452_cov_16",84.375,96,0,7,1,81,748,843,1.92e-14,80.5,80,95
"81405","Ntome_NODE_30906_length_592_cov_37","Nsylvestris_NODE_7185_length_2537_cov_222",98.148,54,1,0,539,592,1106,1159,6.85e-19,95.3,53,53
"81419","Ntome_NODE_30913_length_592_cov_17","Nsylvestris_NODE_10689_length_2027_cov_73",100,55,0,0,1,55,608,662,4.09e-21,102,54,54
"81422","Ntome_NODE_30916_length_592_cov_13","Nsylvestris_NODE_26761_length_685_cov_13",86.563,387,51,1,154,540,680,295,2.14e-118,425,386,385
"81423","Ntome_NODE_30917_length_592_cov_8","Nsylvestris_NODE_18257_length_1244_cov_39",96.364,55,2,0,1,55,293,347,8.86e-18,91.6,54,54
"81424","Ntome_NODE_30918_length_592_cov_8","Nsylvestris_NODE_4209_length_3173_cov_240",98.182,55,1,0,538,592,2032,1978,1.9e-19,97.1,54,54
"81425","Ntome_NODE_30919_length_592_cov_8","Nsylvestris_NODE_17593_length_1304_cov_64",98.182,55,1,0,538,592,848,902,1.9e-19,97.1,54,54
"81430","Ntome_NODE_30922_length_592_cov_5","Nsylvestris_NODE_3377_length_3446_cov_67",88.285,589,38,15,26,592,2714,3293,0,676,566,579
"81431","Ntome_NODE_30923_length_592_cov_5","Nsylvestris_NODE_4640_length_3060_cov_163",94.676,601,23,3,1,592,10,610,0,924,591,600
"81432","Ntome_NODE_30924_length_592_cov_5","Nsylvestris_NODE_12956_length_1768_cov_62",97.133,593,16,1,1,592,655,63,0,1000,591,592
"81435","Ntome_NODE_30927_length_591_cov_313","Nsylvestris_NODE_23089_length_885_cov_213",96.447,591,21,0,1,591,186,776,0,976,590,590
"81436","Ntome_NODE_30928_length_591_cov_249","Nsylvestris_NODE_23297_length_872_cov_197",95.884,413,12,4,1,412,391,799,0,664,411,408
"81440","Ntome_NODE_30930_length_591_cov_112","Nsylvestris_NODE_1684_length_4268_cov_97",93.823,599,27,5,1,591,3577,2981,0,893,590,596
"81444","Ntome_NODE_30933_length_591_cov_25","Nsylvestris_NODE_6045_length_2751_cov_61",98.182,55,1,0,1,55,724,778,1.9e-19,97.1,54,54
"81458","Ntome_NODE_30941_length_591_cov_11","Nsylvestris_NODE_11680_length_1907_cov_226",98.182,55,1,0,537,591,1281,1335,1.9e-19,97.1,54,54
"81459","Ntome_NODE_30942_length_591_cov_10","Nsylvestris_NODE_5571_length_2849_cov_104",100,55,0,0,537,591,1477,1423,4.08e-21,102,54,54
"81460","Ntome_NODE_30943_length_591_cov_8","Nsylvestris_NODE_28253_length_617_cov_7",86.331,556,63,10,1,549,46,595,5.53e-169,593,548,549
"81466","Ntome_NODE_30946_length_591_cov_7","Nsylvestris_NODE_4297_length_3150_cov_44",90.625,64,6,0,528,591,781,718,4.11e-16,86.1,63,63
"81467","Ntome_NODE_30950_length_591_cov_5","Nsylvestris_NODE_20097_length_1094_cov_149",83.733,584,74,10,21,583,259,842,1.22e-150,532,562,583
"81468","Ntome_NODE_30952_length_591_cov_3","Nsylvestris_NODE_112_length_8276_cov_92",90.444,293,21,5,221,509,4983,5272,1.68e-104,379,288,289
"81476","Ntome_NODE_30957_length_590_cov_177","Nsylvestris_NODE_9937_length_2123_cov_168",100,55,0,0,536,590,1306,1360,4.08e-21,102,54,54
"81479","Ntome_NODE_30959_length_590_cov_87","Nsylvestris_NODE_18356_length_1236_cov_112",100,55,0,0,536,590,492,438,4.08e-21,102,54,54
"81482","Ntome_NODE_30962_length_590_cov_60","Nsylvestris_NODE_29975_length_530_cov_7",92.203,513,34,2,84,590,513,1,0,721,506,512
"81483","Ntome_NODE_30963_length_590_cov_29","Nsylvestris_NODE_21627_length_983_cov_13",90.099,101,10,0,1,101,966,866,5.2e-30,132,100,100
"81502","Ntome_NODE_30971_length_590_cov_17","Nsylvestris_NODE_26237_length_708_cov_24",89.268,205,21,1,105,308,683,479,2.96e-67,255,203,204
"81512","Ntome_NODE_30977_length_590_cov_11","Nsylvestris_NODE_3683_length_3340_cov_179",89.655,116,5,2,31,146,1007,1115,8.64e-33,141,115,108
"81513","Ntome_NODE_30978_length_590_cov_10","Nsylvestris_NODE_26668_length_688_cov_46",94.147,598,18,7,1,588,81,671,0,894,587,590
"81516","Ntome_NODE_30980_length_590_cov_7","Nsylvestris_NODE_2591_length_3745_cov_142",90.52,538,27,2,1,538,557,44,0,689,537,513
"81538","Ntome_NODE_30993_length_589_cov_259","Nsylvestris_NODE_329_length_6566_cov_122",100,55,0,0,535,589,3934,3880,4.07e-21,102,54,54
"81539","Ntome_NODE_30994_length_589_cov_227","Nsylvestris_NODE_7299_length_2519_cov_218",92.461,451,16,7,151,589,2477,2033,1.51e-179,628,438,444
"81540","Ntome_NODE_30995_length_589_cov_174","Nsylvestris_NODE_10312_length_2074_cov_68",96.374,524,17,1,1,524,1476,1997,0,861,523,521
"81541","Ntome_NODE_30996_length_589_cov_169","Nsylvestris_NODE_7210_length_2532_cov_151",84.407,590,32,12,1,588,1905,2436,2.04e-148,525,587,531
"81542","Ntome_NODE_30997_length_589_cov_116","Nsylvestris_NODE_491_length_5983_cov_168",86.05,595,60,12,1,589,1927,1350,3.27e-176,617,588,577
"81543","Ntome_NODE_30998_length_590_cov_95","Nsylvestris_NODE_7001_length_2569_cov_126",86.713,429,26,14,1,416,2131,2541,4.55e-125,448,415,410
"81544","Ntome_NODE_30999_length_589_cov_73","Nsylvestris_NODE_27032_length_671_cov_42",86.526,475,37,13,140,587,571,97,4.44e-140,497,447,474
"81551","Ntome_NODE_31002_length_589_cov_32","Nsylvestris_NODE_8384_length_2343_cov_89",94.397,589,33,0,1,589,1026,1614,0,905,588,588
"81552","Ntome_NODE_31003_length_589_cov_19","Nsylvestris_NODE_16471_length_1402_cov_172",89.159,452,43,3,4,452,864,1312,2.01e-158,558,448,448
"81555","Ntome_NODE_31007_length_589_cov_8","Nsylvestris_NODE_5665_length_2824_cov_133",96.364,55,2,0,1,55,1399,1453,8.81e-18,91.6,54,54
"81563","Ntome_NODE_31011_length_589_cov_6","Nsylvestris_NODE_13088_length_1752_cov_119",98.182,55,1,0,1,55,526,472,1.89e-19,97.1,54,54
"81599","Ntome_NODE_31035_length_588_cov_5","Nsylvestris_NODE_16034_length_1446_cov_205",90.769,65,5,1,1,65,366,429,4.09e-16,86.1,64,63
"81602","Ntome_NODE_31037_length_588_cov_4","Nsylvestris_NODE_4231_length_3167_cov_154",100,55,0,0,1,55,805,859,4.06e-21,102,54,54
"81613","Ntome_NODE_31041_length_587_cov_239","Nsylvestris_NODE_5156_length_2935_cov_229",93.867,587,25,1,1,587,2330,2905,0,874,586,575
"81627","Ntome_NODE_31046_length_587_cov_56","Nsylvestris_NODE_10437_length_2057_cov_151",84.211,114,11,5,50,162,1625,1518,1.13e-21,104,112,107
"81638","Ntome_NODE_31051_length_587_cov_24","Nsylvestris_NODE_2203_length_3936_cov_195",96.552,58,2,0,530,587,1117,1174,1.89e-19,97.1,57,57
"81642","Ntome_NODE_31053_length_587_cov_18","Nsylvestris_NODE_2554_length_3767_cov_143",100,55,0,0,1,55,1392,1338,4.05e-21,102,54,54
"81643","Ntome_NODE_31056_length_587_cov_12","Nsylvestris_NODE_2522_length_3782_cov_186",100,52,0,0,533,584,1248,1299,1.89e-19,97.1,51,51
"81646","Ntome_NODE_31058_length_587_cov_8","Nsylvestris_NODE_13193_length_1739_cov_223",92.724,591,39,3,1,587,986,1576,0,850,586,590
"81670","Ntome_NODE_31068_length_586_cov_67","Nsylvestris_NODE_2629_length_3729_cov_94",100,55,0,0,1,55,2695,2749,4.05e-21,102,54,54
"81671","Ntome_NODE_31069_length_586_cov_66","Nsylvestris_NODE_36010_length_274_cov_3",78.344,157,26,5,274,422,1,157,6.77e-19,95.3,148,156
"81672","Ntome_NODE_31070_length_586_cov_53","Nsylvestris_NODE_9278_length_2210_cov_92",83.624,287,40,7,239,522,869,587,1.75e-69,263,283,282
"81673","Ntome_NODE_31071_length_586_cov_28","Nsylvestris_NODE_8399_length_2341_cov_19",96.698,212,7,0,1,212,2034,1823,1.01e-96,353,211,211
"81677","Ntome_NODE_31075_length_586_cov_17","Nsylvestris_NODE_14683_length_1581_cov_28",91.239,331,25,3,256,586,1578,1252,4.51e-125,448,330,326
"81681","Ntome_NODE_31078_length_586_cov_14","Nsylvestris_NODE_8073_length_2391_cov_206",96.364,55,2,0,1,55,1605,1551,8.76e-18,91.6,54,54
"81693","Ntome_NODE_31083_length_586_cov_6","Nsylvestris_NODE_6716_length_2619_cov_34",91.623,191,16,0,1,191,209,399,4.88e-70,265,190,190
"81694","Ntome_NODE_31084_length_586_cov_5","Nsylvestris_NODE_36502_length_262_cov_4",94.737,266,10,1,27,292,262,1,5.92e-114,411,265,261
"81695","Ntome_NODE_31086_length_586_cov_5","Nsylvestris_NODE_2271_length_3905_cov_135",100,42,0,0,1,42,1233,1274,6.82e-14,78.7,41,41
"81699","Ntome_NODE_31088_length_589_cov_3","Nsylvestris_NODE_580_length_5749_cov_105",80.788,203,34,4,1,201,3890,3691,1.11e-36,154,200,199
"81700","Ntome_NODE_31089_length_586_cov_3","Nsylvestris_NODE_3334_length_3462_cov_46",80.052,381,76,0,116,496,824,1204,1.35e-75,283,380,380
"81727","Ntome_NODE_31099_length_585_cov_94","Nsylvestris_NODE_9524_length_2173_cov_143",92.675,587,34,5,1,585,1473,894,0,837,584,579
"81732","Ntome_NODE_31101_length_585_cov_45","Nsylvestris_NODE_4059_length_3215_cov_143",81.399,586,77,16,1,577,1609,2171,1.25e-125,449,576,562
"81733","Ntome_NODE_31102_length_585_cov_41","Nsylvestris_NODE_8303_length_2354_cov_219",96.154,78,3,0,1,78,2275,2352,6.67e-29,128,77,77
"81734","Ntome_NODE_31103_length_585_cov_31","Nsylvestris_NODE_14998_length_1550_cov_183",98.182,55,1,0,1,55,855,909,1.88e-19,97.1,54,54
"81737","Ntome_NODE_31107_length_585_cov_17","Nsylvestris_NODE_13054_length_1757_cov_145",96.364,55,2,0,1,55,604,658,8.75e-18,91.6,54,54
"81748","Ntome_NODE_31111_length_585_cov_15","Nsylvestris_NODE_8879_length_2266_cov_223",98.182,55,1,0,1,55,777,831,1.88e-19,97.1,54,54
"81749","Ntome_NODE_31114_length_585_cov_10","Nsylvestris_NODE_447_length_6114_cov_26",92.941,170,12,0,88,257,3638,3807,4.9e-65,248,169,169
"81750","Ntome_NODE_31116_length_585_cov_10","Nsylvestris_NODE_18676_length_1212_cov_6",96.911,259,8,0,1,259,259,1,3.51e-121,435,258,258
"81751","Ntome_NODE_31118_length_585_cov_6","Nsylvestris_NODE_12780_length_1789_cov_18",88.98,608,34,8,4,585,1505,905,0,721,581,600
"81754","Ntome_NODE_31122_length_584_cov_252","Nsylvestris_NODE_28911_length_587_cov_164",91.317,357,31,0,218,574,360,4,2.65e-137,488,356,356
"81755","Ntome_NODE_31123_length_583_cov_148","Nsylvestris_NODE_1273_length_4618_cov_150",98,50,0,1,530,578,2214,2263,4.05e-16,86.1,48,49
"81759","Ntome_NODE_31125_length_584_cov_70","Nsylvestris_NODE_2066_length_4014_cov_202",92.095,253,13,2,1,246,2468,2216,1.3e-95,350,245,252
"81779","Ntome_NODE_31136_length_584_cov_17","Nsylvestris_NODE_16367_length_1413_cov_145",98.182,55,1,0,530,584,936,882,1.88e-19,97.1,54,54
"81782","Ntome_NODE_31138_length_584_cov_12","Nsylvestris_NODE_17942_length_1273_cov_34",95.704,582,19,3,8,583,1221,640,0,931,575,581
"81790","Ntome_NODE_31142_length_584_cov_8","Nsylvestris_NODE_12229_length_1844_cov_227",100,33,0,0,1,33,655,687,6.85e-09,62.1,32,32
"81791","Ntome_NODE_31143_length_584_cov_8","Nsylvestris_NODE_5531_length_2855_cov_219",100,55,0,0,1,55,895,841,4.03e-21,102,54,54
"81796","Ntome_NODE_31147_length_584_cov_5","Nsylvestris_NODE_4885_length_2999_cov_182",98.276,58,1,0,1,58,2256,2199,4.03e-21,102,57,57
"81797","Ntome_NODE_31148_length_584_cov_4","Nsylvestris_NODE_21096_length_1021_cov_57",98.182,55,1,0,1,55,621,567,1.88e-19,97.1,54,54
"81802","Ntome_NODE_31152_length_583_cov_222","Nsylvestris_NODE_26770_length_684_cov_177",92.34,235,6,5,1,235,407,629,7.89e-88,324,234,222
"81808","Ntome_NODE_31156_length_583_cov_114","Nsylvestris_NODE_16636_length_1387_cov_230",96.364,55,2,0,529,583,345,291,8.71e-18,91.6,54,54
"81817","Ntome_NODE_31160_length_583_cov_32","Nsylvestris_NODE_13737_length_1680_cov_215",100,55,0,0,1,55,877,823,4.03e-21,102,54,54
"81824","Ntome_NODE_31165_length_583_cov_12","Nsylvestris_NODE_25717_length_733_cov_11",93.46,581,38,0,1,581,65,645,0,863,580,580
"81834","Ntome_NODE_31169_length_583_cov_10","Nsylvestris_NODE_6359_length_2686_cov_190",100,55,0,0,1,55,1768,1822,4.03e-21,102,54,54
"81837","Ntome_NODE_31171_length_583_cov_9","Nsylvestris_NODE_9131_length_2232_cov_66",98.182,55,1,0,529,583,1736,1790,1.87e-19,97.1,54,54
"81843","Ntome_NODE_31174_length_583_cov_8","Nsylvestris_NODE_1491_length_4405_cov_40",97.942,583,11,1,1,583,2038,1457,0,1009,582,581
"81848","Ntome_NODE_31181_length_583_cov_4","Nsylvestris_NODE_7261_length_2525_cov_94",100,55,0,0,1,55,557,611,4.03e-21,102,54,54
"81868","Ntome_NODE_31189_length_582_cov_136","Nsylvestris_NODE_3394_length_3440_cov_159",94.889,587,22,2,1,582,2232,2815,0,911,581,583
"81876","Ntome_NODE_31193_length_582_cov_19","Nsylvestris_NODE_6963_length_2574_cov_217",96.552,58,2,0,1,58,894,837,1.87e-19,97.1,57,57
"81877","Ntome_NODE_31194_length_582_cov_14","Nsylvestris_NODE_28164_length_622_cov_13",91.379,522,22,9,82,580,545,24,0,693,498,521
"81878","Ntome_NODE_31195_length_582_cov_10","Nsylvestris_NODE_8438_length_2334_cov_174",96.364,55,2,0,528,582,1388,1442,8.7e-18,91.6,54,54
"81881","Ntome_NODE_31198_length_582_cov_7","Nsylvestris_NODE_10114_length_2101_cov_153",98.182,55,1,0,1,55,1199,1253,1.87e-19,97.1,54,54
"81882","Ntome_NODE_31199_length_582_cov_5","Nsylvestris_NODE_11891_length_1881_cov_84",93.962,265,13,2,121,382,265,1,4.58e-110,398,261,264
"81883","Ntome_NODE_31201_length_582_cov_4","Nsylvestris_NODE_27532_length_650_cov_5",93.966,580,35,0,3,582,64,643,0,878,579,579
"81915","Ntome_NODE_31213_length_581_cov_52","Nsylvestris_NODE_1112_length_4810_cov_135",95.353,581,24,1,1,581,3684,3107,0,920,580,577
"81920","Ntome_NODE_31218_length_581_cov_13","Nsylvestris_NODE_16014_length_1448_cov_200",93.596,203,13,0,379,581,585,383,1.02e-81,303,202,202
"81923","Ntome_NODE_31221_length_581_cov_8","Nsylvestris_NODE_18968_length_1186_cov_125",100,55,0,0,527,581,711,765,4.01e-21,102,54,54
"81927","Ntome_NODE_31224_length_581_cov_5","Nsylvestris_NODE_12572_length_1808_cov_57",96.902,581,18,0,1,581,1582,1002,0,974,580,580
"81930","Ntome_NODE_31227_length_580_cov_303","Nsylvestris_NODE_518_length_5911_cov_122",95.345,580,27,0,1,580,4566,5145,0,922,579,579
"81931","Ntome_NODE_31228_length_580_cov_275","Nsylvestris_NODE_9562_length_2168_cov_194",94.128,545,18,3,48,580,2167,1625,0,817,532,542
"81932","Ntome_NODE_31230_length_580_cov_42","Nsylvestris_NODE_23042_length_888_cov_223",100,55,0,0,1,55,387,333,4e-21,102,54,54
"81933","Ntome_NODE_31231_length_580_cov_29","Nsylvestris_NODE_23675_length_850_cov_39",93.497,569,25,6,1,564,17,578,0,835,563,561
"81943","Ntome_NODE_31235_length_580_cov_14","Nsylvestris_NODE_1056_length_4873_cov_105",96.364,55,2,0,1,55,517,571,8.67e-18,91.6,54,54
"81947","Ntome_NODE_31238_length_580_cov_8","Nsylvestris_NODE_14304_length_1620_cov_222",100,55,0,0,1,55,1380,1434,4e-21,102,54,54
"81948","Ntome_NODE_31239_length_580_cov_8","Nsylvestris_NODE_7052_length_2561_cov_214",100,55,0,0,1,55,990,936,4e-21,102,54,54
"81953","Ntome_NODE_31248_length_579_cov_229","Nsylvestris_NODE_11101_length_1976_cov_64",87.352,506,29,18,95,579,1878,1387,4.27e-155,547,484,491
"81954","Ntome_NODE_31249_length_579_cov_169","Nsylvestris_NODE_15814_length_1468_cov_104",95.009,581,20,5,1,579,1246,673,0,904,578,573
"81967","Ntome_NODE_31254_length_579_cov_49","Nsylvestris_NODE_1021_length_4922_cov_89",98.182,55,1,0,525,579,3892,3946,1.86e-19,97.1,54,54
"81975","Ntome_NODE_31261_length_579_cov_13","Nsylvestris_NODE_9603_length_2164_cov_167",98.182,55,1,0,525,579,1271,1217,1.86e-19,97.1,54,54
"81983","Ntome_NODE_31265_length_579_cov_11","Nsylvestris_NODE_6211_length_2714_cov_218",98.148,54,1,0,526,579,772,825,6.69e-19,95.3,53,53
"81987","Ntome_NODE_31267_length_579_cov_9","Nsylvestris_NODE_4984_length_2978_cov_39",94.483,580,30,1,2,579,2395,2974,0,893,577,579
"81990","Ntome_NODE_31270_length_579_cov_8","Nsylvestris_NODE_10519_length_2048_cov_222",100,55,0,0,525,579,474,420,4e-21,102,54,54
"81994","Ntome_NODE_31272_length_579_cov_7","Nsylvestris_NODE_6362_length_2681_cov_177",98.182,55,1,0,1,55,571,625,1.86e-19,97.1,54,54
"81999","Ntome_NODE_31275_length_579_cov_5","Nsylvestris_NODE_2535_length_3777_cov_83",93.909,591,21,6,1,579,461,1048,0,878,578,587
"82000","Ntome_NODE_31276_length_579_cov_5","Nsylvestris_NODE_3956_length_3249_cov_116",96.213,581,17,4,1,579,1772,1195,0,946,578,577
"82001","Ntome_NODE_31277_length_579_cov_4","Nsylvestris_NODE_20791_length_1044_cov_12",94.107,577,23,6,1,573,682,113,0,867,572,569
"82002","Ntome_NODE_31278_length_579_cov_4","Nsylvestris_NODE_1983_length_4066_cov_70",79.483,580,109,9,4,578,1992,2566,9.78e-112,403,574,574
"82013","Ntome_NODE_31285_length_578_cov_147","Nsylvestris_NODE_5119_length_2944_cov_187",96.066,305,12,0,1,305,353,49,4.36e-140,497,304,304
"82018","Ntome_NODE_31289_length_578_cov_36","Nsylvestris_NODE_1068_length_4859_cov_121",94.772,593,14,1,1,576,2486,3078,0,907,575,592
"82019","Ntome_NODE_31290_length_578_cov_30","Nsylvestris_NODE_11087_length_1978_cov_66",95.701,442,12,3,104,539,1476,1036,0,704,435,440
"82023","Ntome_NODE_31292_length_578_cov_28","Nsylvestris_NODE_26075_length_715_cov_39",92.885,506,23,4,1,500,19,517,0,723,499,498
"82027","Ntome_NODE_31297_length_578_cov_16","Nsylvestris_NODE_1925_length_4097_cov_157",89.263,624,14,20,1,578,2817,3433,0,732,577,616
"82028","Ntome_NODE_31298_length_578_cov_16","Nsylvestris_NODE_3431_length_3427_cov_77",96.552,58,2,0,521,578,626,683,1.86e-19,97.1,57,57
"82033","Ntome_NODE_31303_length_578_cov_10","Nsylvestris_NODE_30957_length_454_cov_4",87.056,394,28,9,53,436,446,66,7.5e-118,424,383,380
"82037","Ntome_NODE_31305_length_578_cov_9","Nsylvestris_NODE_21471_length_993_cov_245",100,55,0,0,524,578,810,864,3.99e-21,102,54,54
"82038","Ntome_NODE_31306_length_578_cov_8","Nsylvestris_NODE_3260_length_3486_cov_120",94.545,55,3,0,335,389,1198,1252,4.02e-16,86.1,54,54
"82048","Ntome_NODE_31311_length_577_cov_199","Nsylvestris_NODE_615_length_5670_cov_177",89.326,356,10,6,224,577,961,1290,2.69e-117,422,353,329
"82055","Ntome_NODE_31315_length_577_cov_80","Nsylvestris_NODE_9687_length_2154_cov_62",96.194,578,18,2,1,577,687,1261,0,942,576,574
"82056","Ntome_NODE_31316_length_577_cov_27","Nsylvestris_NODE_22007_length_955_cov_171",95.745,47,2,0,531,577,482,436,2.41e-13,76.8,46,46
"82059","Ntome_NODE_31318_length_577_cov_22","Nsylvestris_NODE_5610_length_2838_cov_123",91.864,590,31,9,1,577,880,1465,0,808,576,585
"82062","Ntome_NODE_31321_length_577_cov_19","Nsylvestris_NODE_7509_length_2484_cov_213",98.182,55,1,0,1,55,1315,1261,1.85e-19,97.1,54,54
"82070","Ntome_NODE_31327_length_577_cov_9","Nsylvestris_NODE_21619_length_983_cov_127",98.182,55,1,0,1,55,681,627,1.85e-19,97.1,54,54
"82071","Ntome_NODE_31328_length_577_cov_7","Nsylvestris_NODE_548_length_5829_cov_125",96.364,55,2,0,523,577,350,296,8.62e-18,91.6,54,54
"82072","Ntome_NODE_31329_length_577_cov_5","Nsylvestris_NODE_20129_length_1092_cov_7",85.135,222,33,0,340,561,3,224,6.3e-59,228,221,221
"82073","Ntome_NODE_31333_length_576_cov_204","Nsylvestris_NODE_2601_length_3731_cov_112",97.688,173,4,0,404,576,2585,2757,4.72e-80,298,172,172
"82077","Ntome_NODE_31336_length_576_cov_78","Nsylvestris_NODE_7186_length_2537_cov_219",100,55,0,0,1,55,1295,1241,3.98e-21,102,54,54
"82084","Ntome_NODE_31339_length_576_cov_48","Nsylvestris_NODE_22822_length_901_cov_106",91.077,325,20,5,261,576,562,886,4.46e-120,431,315,324
"82091","Ntome_NODE_31344_length_576_cov_15","Nsylvestris_NODE_7744_length_2445_cov_191",93.75,64,4,0,513,576,1810,1873,1.85e-19,97.1,63,63
"82092","Ntome_NODE_31345_length_576_cov_11","Nsylvestris_NODE_10492_length_2051_cov_156",98.182,55,1,0,522,576,577,631,1.85e-19,97.1,54,54
"82093","Ntome_NODE_31348_length_576_cov_6","Nsylvestris_NODE_22778_length_904_cov_162",98.148,54,1,0,522,575,244,297,6.65e-19,95.3,53,53
"82094","Ntome_NODE_31350_length_576_cov_5","Nsylvestris_NODE_4619_length_3067_cov_197",98.077,52,1,0,525,576,1181,1130,8.61e-18,91.6,51,51
"82097","Ntome_NODE_31353_length_575_cov_4","Nsylvestris_NODE_8408_length_2339_cov_73",90.811,370,33,1,207,575,1614,1245,5.6e-139,494,368,369
"82110","Ntome_NODE_31360_length_575_cov_274","Nsylvestris_NODE_8685_length_2296_cov_149",92.225,463,24,8,61,523,158,608,0,645,462,450
"82122","Ntome_NODE_31365_length_575_cov_114","Nsylvestris_NODE_1812_length_4165_cov_60",96.54,578,17,1,1,575,2872,2295,0,953,574,577
"82126","Ntome_NODE_31369_length_575_cov_49","Nsylvestris_NODE_5303_length_2905_cov_190",79.814,431,81,6,3,429,593,1021,2.18e-83,309,426,428
"82127","Ntome_NODE_31370_length_575_cov_42","Nsylvestris_NODE_24304_length_812_cov_28",85.373,335,38,9,190,516,584,253,9.99e-92,337,326,331
"82136","Ntome_NODE_31374_length_575_cov_14","Nsylvestris_NODE_2025_length_4037_cov_130",90.563,604,18,10,1,573,3570,2975,0,763,572,595
"82150","Ntome_NODE_31381_length_575_cov_9","Nsylvestris_NODE_8993_length_2251_cov_233",95.161,248,12,0,1,248,1604,1851,2.1e-108,392,247,247
"82151","Ntome_NODE_31382_length_575_cov_7","Nsylvestris_NODE_10434_length_2058_cov_208",95.455,66,2,1,511,575,1139,1074,1.1e-21,104,64,65
"82160","Ntome_NODE_31387_length_575_cov_5","Nsylvestris_NODE_8841_length_2273_cov_230",100,55,0,0,1,55,1483,1537,3.97e-21,102,54,54
"82179","Ntome_NODE_31396_length_574_cov_282","Nsylvestris_NODE_18310_length_1240_cov_191",95.354,495,19,2,84,574,1181,687,0,784,490,494
"82193","Ntome_NODE_31407_length_574_cov_37","Nsylvestris_NODE_888_length_5103_cov_159",98.148,54,1,0,1,54,3748,3801,6.63e-19,95.3,53,53
"82194","Ntome_NODE_31408_length_574_cov_23","Nsylvestris_NODE_601_length_5703_cov_231",96.154,52,2,0,523,574,3332,3281,3.99e-16,86.1,51,51
"82199","Ntome_NODE_31411_length_574_cov_19","Nsylvestris_NODE_97_length_8472_cov_99",96.667,60,2,0,515,574,671,612,1.42e-20,100,59,59
"82200","Ntome_NODE_31412_length_574_cov_17","Nsylvestris_NODE_13224_length_1736_cov_241",100,55,0,0,520,574,561,615,3.96e-21,102,54,54
"82205","Ntome_NODE_31416_length_574_cov_5","Nsylvestris_NODE_20155_length_1090_cov_40",89.225,529,35,8,58,574,1060,542,0,641,516,518
"82206","Ntome_NODE_31419_length_574_cov_2","Nsylvestris_NODE_17086_length_1350_cov_24",94.545,55,3,0,520,574,473,419,3.99e-16,86.1,54,54
"82216","Ntome_NODE_31424_length_573_cov_192","Nsylvestris_NODE_11198_length_1966_cov_101",89.848,197,20,0,256,452,866,1062,1.03e-66,254,196,196
"82217","Ntome_NODE_31425_length_573_cov_131","Nsylvestris_NODE_1554_length_4357_cov_152",89.535,602,20,8,1,573,1386,1973,0,723,572,587
"82218","Ntome_NODE_31426_length_573_cov_125","Nsylvestris_NODE_11517_length_1928_cov_194",100,55,0,0,519,573,1104,1158,3.95e-21,102,54,54
"82226","Ntome_NODE_31429_length_573_cov_35","Nsylvestris_NODE_25322_length_753_cov_124",87.179,195,24,1,112,305,2,196,1.05e-56,220,193,194
"82227","Ntome_NODE_31430_length_573_cov_34","Nsylvestris_NODE_30761_length_467_cov_224",96.364,55,2,0,1,55,360,414,8.56e-18,91.6,54,54
"82228","Ntome_NODE_31431_length_573_cov_33","Nsylvestris_NODE_5316_length_2902_cov_131",98.182,55,1,0,519,573,2047,2101,1.84e-19,97.1,54,54
"82231","Ntome_NODE_31436_length_573_cov_13","Nsylvestris_NODE_2937_length_3606_cov_213",96.296,54,2,0,2,55,2691,2744,3.08e-17,89.8,53,53
"82238","Ntome_NODE_31442_length_573_cov_8","Nsylvestris_NODE_15429_length_1510_cov_49",96.143,363,14,0,211,573,1463,1101,5.35e-169,593,362,362
"82243","Ntome_NODE_31444_length_573_cov_7","Nsylvestris_NODE_13616_length_1694_cov_24",86.979,576,66,5,1,573,1523,954,0,640,572,569
"82248","Ntome_NODE_31447_length_573_cov_6","Nsylvestris_NODE_14817_length_1567_cov_223",98.182,55,1,0,519,573,400,454,1.84e-19,97.1,54,54
"82251","Ntome_NODE_31449_length_573_cov_5","Nsylvestris_NODE_717_length_5403_cov_52",86.314,548,70,4,30,573,3706,3160,1.92e-168,592,543,546
"82260","Ntome_NODE_31454_length_572_cov_208","Nsylvestris_NODE_19512_length_1142_cov_56",81.818,473,44,22,120,572,114,564,2.12e-98,359,452,450
"82270","Ntome_NODE_31458_length_572_cov_61","Nsylvestris_NODE_12640_length_1801_cov_105",98.305,59,1,0,1,59,1284,1226,1.1e-21,104,58,58
"82271","Ntome_NODE_31460_length_572_cov_43","Nsylvestris_NODE_17359_length_1326_cov_214",92.754,69,2,2,1,66,504,436,1.84e-19,97.1,65,68
"82281","Ntome_NODE_31466_length_572_cov_24","Nsylvestris_NODE_11562_length_1923_cov_157",89.3,243,16,8,86,319,88,329,1.69e-79,296,233,241
"82282","Ntome_NODE_31468_length_572_cov_23","Nsylvestris_NODE_27576_length_648_cov_6",90.614,277,14,5,286,562,648,384,7.63e-98,357,276,264
"82292","Ntome_NODE_31482_length_572_cov_6","Nsylvestris_NODE_327_length_6565_cov_225",100,55,0,0,518,572,3973,3919,3.95e-21,102,54,54
"82297","Ntome_NODE_31487_length_571_cov_281","Nsylvestris_NODE_2341_length_3877_cov_216",97.373,571,15,0,1,571,3048,2478,0,972,570,570
"82300","Ntome_NODE_31489_length_571_cov_228","Nsylvestris_NODE_321_length_6601_cov_132",80,310,62,0,262,571,3106,3415,1.73e-59,230,309,309
"82304","Ntome_NODE_31491_length_571_cov_213","Nsylvestris_NODE_9388_length_2195_cov_91",94.898,294,14,1,278,571,1445,1737,2.03e-128,459,293,292
"82307","Ntome_NODE_31493_length_571_cov_198","Nsylvestris_NODE_2353_length_3868_cov_168",91.054,313,28,0,1,313,1108,1420,7.4e-118,424,312,312
"82313","Ntome_NODE_31496_length_571_cov_105","Nsylvestris_NODE_2341_length_3877_cov_216",95.622,571,25,0,1,571,2478,3048,0,917,570,570
"82319","Ntome_NODE_31499_length_571_cov_24","Nsylvestris_NODE_6542_length_2653_cov_180",84.642,293,40,5,281,571,1,290,1.01e-76,287,290,289
"82323","Ntome_NODE_31502_length_571_cov_15","Nsylvestris_NODE_5324_length_2901_cov_131",91.346,208,14,4,35,241,2710,2506,4.71e-75,281,206,204
"82327","Ntome_NODE_31504_length_571_cov_12","Nsylvestris_NODE_27912_length_632_cov_102",98.182,55,1,0,1,55,241,187,1.83e-19,97.1,54,54
"82393","Ntome_NODE_31506_length_571_cov_11","Nsylvestris_NODE_1342_length_4555_cov_98",100,55,0,0,1,55,2032,1978,3.94e-21,102,54,54
"82400","Ntome_NODE_31509_length_571_cov_9","Nsylvestris_NODE_10544_length_2044_cov_204",94.545,55,3,0,517,571,1790,1736,3.97e-16,86.1,54,54
"82405","Ntome_NODE_31513_length_571_cov_5","Nsylvestris_NODE_13870_length_1666_cov_165",96.923,65,0,2,507,571,547,485,8.47e-23,108,64,62
"82406","Ntome_NODE_31514_length_571_cov_4","Nsylvestris_NODE_1171_length_4729_cov_147",76.879,173,31,6,12,184,2685,2522,3.07e-17,89.8,172,163
"82407","Ntome_NODE_31516_length_570_cov_292","Nsylvestris_NODE_2341_length_3877_cov_216",98.421,570,9,0,1,570,1028,1597,0,1003,569,569
"82413","Ntome_NODE_31519_length_570_cov_238","Nsylvestris_NODE_2775_length_3673_cov_218",91.058,548,40,6,26,570,3673,3132,0,732,544,541
"82416","Ntome_NODE_31521_length_570_cov_135","Nsylvestris_NODE_14802_length_1569_cov_126",85.739,568,35,19,10,570,1566,1038,1.94e-158,558,560,528
"82417","Ntome_NODE_31522_length_570_cov_116","Nsylvestris_NODE_19790_length_1118_cov_123",96.108,334,10,2,240,570,966,633,1.96e-153,542,330,333
"82420","Ntome_NODE_31524_length_570_cov_70","Nsylvestris_NODE_16187_length_1430_cov_232",98.077,52,1,0,1,52,421,472,8.51e-18,91.6,51,51
"82424","Ntome_NODE_31526_length_570_cov_45","Nsylvestris_NODE_28680_length_598_cov_43",92.171,281,22,0,148,428,171,451,4.48e-110,398,280,280
"82425","Ntome_NODE_31527_length_570_cov_43","Nsylvestris_NODE_4284_length_3155_cov_71",95.775,568,24,0,3,570,1681,1114,0,917,567,567
"82429","Ntome_NODE_31530_length_570_cov_23","Nsylvestris_NODE_9642_length_2159_cov_174",97.018,570,17,0,1,570,426,995,0,959,569,569
"82435","Ntome_NODE_31535_length_570_cov_8","Nsylvestris_NODE_32973_length_354_cov_4",88.601,193,22,0,134,326,1,193,3.72e-61,235,192,192
"82447","Ntome_NODE_31542_length_569_cov_266","Nsylvestris_NODE_18923_length_1190_cov_196",97.925,482,9,1,1,482,663,1143,0,833,481,480
"82458","Ntome_NODE_31548_length_569_cov_62","Nsylvestris_NODE_5858_length_2790_cov_218",94.545,55,0,1,515,569,2032,2083,5.11e-15,82.4,54,51
"82461","Ntome_NODE_31551_length_569_cov_27","Nsylvestris_NODE_12643_length_1801_cov_65",76.205,332,57,21,247,569,1083,765,2.97e-37,156,322,318
"82462","Ntome_NODE_31552_length_569_cov_26","Nsylvestris_NODE_5448_length_2873_cov_215",100,55,0,0,1,55,662,608,3.93e-21,102,54,54
"82473","Ntome_NODE_31559_length_569_cov_11","Nsylvestris_NODE_1681_length_4268_cov_215",98.182,55,1,0,515,569,2011,1957,1.83e-19,97.1,54,54
"82474","Ntome_NODE_31561_length_569_cov_8","Nsylvestris_NODE_20558_length_1060_cov_127",87.029,239,26,5,1,239,246,479,4.73e-70,265,238,233
"82475","Ntome_NODE_31563_length_569_cov_6","Nsylvestris_NODE_20705_length_1049_cov_109",86.466,133,18,0,137,269,819,951,1.79e-34,147,132,132
"82480","Ntome_NODE_31568_length_569_cov_3","Nsylvestris_NODE_2149_length_3963_cov_234",98.077,52,1,0,518,569,1635,1584,8.5e-18,91.6,51,51
"82492","Ntome_NODE_31573_length_568_cov_264","Nsylvestris_NODE_14398_length_1610_cov_201",97.711,568,13,0,1,568,1,568,0,977,567,567
"82493","Ntome_NODE_31574_length_568_cov_244","Nsylvestris_NODE_2814_length_3657_cov_225",97.535,568,14,0,1,568,2393,1826,0,972,567,567
"82497","Ntome_NODE_31579_length_568_cov_15","Nsylvestris_NODE_8219_length_2369_cov_222",96.364,55,2,0,514,568,1464,1518,8.48e-18,91.6,54,54
"82498","Ntome_NODE_31580_length_568_cov_14","Nsylvestris_NODE_29541_length_562_cov_3",81.218,197,23,9,150,335,40,233,1.78e-34,147,185,193
"82499","Ntome_NODE_31581_length_568_cov_14","Nsylvestris_NODE_13525_length_1703_cov_191",100,55,0,0,1,55,815,761,3.92e-21,102,54,54
"82514","Ntome_NODE_31590_length_568_cov_5","Nsylvestris_NODE_9059_length_2243_cov_223",98.182,55,1,0,514,568,1092,1146,1.82e-19,97.1,54,54
"82515","Ntome_NODE_31593_length_568_cov_4","Nsylvestris_NODE_26928_length_676_cov_199",100,33,0,0,536,568,183,151,6.65e-09,62.1,32,32
"82520","Ntome_NODE_31597_length_567_cov_215","Nsylvestris_NODE_30013_length_526_cov_193",94.297,526,26,3,45,567,1,525,0,802,522,524
"82521","Ntome_NODE_31598_length_567_cov_201","Nsylvestris_NODE_4829_length_3012_cov_215",93.196,485,9,7,88,567,51,516,0,691,479,465
"82522","Ntome_NODE_31599_length_567_cov_88","Nsylvestris_NODE_17261_length_1335_cov_204",96.364,55,2,0,513,567,547,493,8.46e-18,91.6,54,54
"82527","Ntome_NODE_31602_length_567_cov_22","Nsylvestris_NODE_18733_length_1206_cov_38",98.182,55,1,0,1,55,298,352,1.82e-19,97.1,54,54
"82530","Ntome_NODE_31604_length_567_cov_14","Nsylvestris_NODE_10119_length_2100_cov_204",86.432,199,27,0,97,295,1657,1459,3.72e-56,219,198,198
"82531","Ntome_NODE_31605_length_567_cov_12","Nsylvestris_NODE_10887_length_2002_cov_94",96.364,55,2,0,1,55,577,523,8.46e-18,91.6,54,54
"82532","Ntome_NODE_31606_length_567_cov_12","Nsylvestris_NODE_4688_length_3048_cov_106",94.911,393,19,1,176,567,413,805,4.06e-175,614,391,392
"82538","Ntome_NODE_31609_length_566_cov_10","Nsylvestris_NODE_14740_length_1575_cov_216",79.904,209,26,11,362,564,389,191,2.98e-32,139,202,198
"82539","Ntome_NODE_31611_length_567_cov_10","Nsylvestris_NODE_14060_length_1644_cov_83",86.749,566,75,0,1,566,124,689,4.03e-180,630,565,565
"82540","Ntome_NODE_31612_length_567_cov_10","Nsylvestris_NODE_16435_length_1406_cov_171",96.364,55,2,0,513,567,533,587,8.46e-18,91.6,54,54
"82541","Ntome_NODE_31613_length_567_cov_9","Nsylvestris_NODE_18523_length_1222_cov_206",92.453,53,4,0,1,53,445,393,2.37e-13,76.8,52,52
"82542","Ntome_NODE_31614_length_567_cov_9","Nsylvestris_NODE_21276_length_1008_cov_216",100,55,0,0,513,567,661,607,3.91e-21,102,54,54
"82546","Ntome_NODE_31617_length_567_cov_7","Nsylvestris_NODE_4572_length_3080_cov_106",91.021,568,31,9,1,567,1728,2276,0,750,566,548
"82552","Ntome_NODE_31622_length_567_cov_5","Nsylvestris_NODE_2823_length_3651_cov_234",98.182,55,1,0,1,55,2152,2098,1.82e-19,97.1,54,54
"82553","Ntome_NODE_31623_length_567_cov_5","Nsylvestris_NODE_11933_length_1877_cov_104",93.827,567,32,2,1,567,1103,1666,0,850,566,563
"82554","Ntome_NODE_31624_length_567_cov_4","Nsylvestris_NODE_5114_length_2946_cov_16",100,53,0,0,2,54,2820,2872,5.06e-20,99,52,52
"82559","Ntome_NODE_31628_length_566_cov_230","Nsylvestris_NODE_16225_length_1427_cov_197",94.876,566,29,0,1,566,776,211,0,885,565,565
"82565","Ntome_NODE_31631_length_566_cov_95","Nsylvestris_NODE_2967_length_3599_cov_46",95.238,567,26,1,1,566,3574,3008,0,896,565,566
"82566","Ntome_NODE_31632_length_566_cov_42","Nsylvestris_NODE_20139_length_1089_cov_26",94.444,54,3,0,1,54,301,248,1.41e-15,84.2,53,53
"82567","Ntome_NODE_31633_length_566_cov_38","Nsylvestris_NODE_33270_length_343_cov_61",92.44,291,9,9,244,525,312,26,9.56e-112,403,281,286
"82588","Ntome_NODE_31644_length_566_cov_11","Nsylvestris_NODE_28259_length_617_cov_3",93.82,534,30,3,5,535,84,617,0,800,530,533
"82593","Ntome_NODE_31646_length_566_cov_7","Nsylvestris_NODE_23738_length_846_cov_126",96.481,540,19,0,23,562,802,263,0,893,539,539
"82597","Ntome_NODE_31649_length_566_cov_7","Nsylvestris_NODE_6441_length_2670_cov_233",100,53,0,0,1,53,943,995,5.05e-20,99,52,52
"82603","Ntome_NODE_31653_length_566_cov_5","Nsylvestris_NODE_35787_length_278_cov_3",94.245,278,16,0,57,334,1,278,2.04e-118,425,277,277
"82619","Ntome_NODE_31662_length_565_cov_261","Nsylvestris_NODE_1915_length_4101_cov_231",93.695,571,25,3,1,562,569,1,0,845,561,568
"82620","Ntome_NODE_31663_length_565_cov_56","Nsylvestris_NODE_22025_length_954_cov_83",93.822,518,25,2,1,518,649,139,0,773,517,510
"82623","Ntome_NODE_31665_length_565_cov_48","Nsylvestris_NODE_15137_length_1536_cov_37",92.248,387,24,1,180,560,1,387,5.39e-154,544,380,386
"82644","Ntome_NODE_31674_length_565_cov_11","Nsylvestris_NODE_21228_length_1012_cov_88",91.765,85,4,3,260,343,589,507,5e-25,115,83,82
"82649","Ntome_NODE_31677_length_565_cov_7","Nsylvestris_NODE_4146_length_3190_cov_89",84.716,229,21,8,73,301,2326,2112,1.33e-55,217,228,214
"82658","Ntome_NODE_31683_length_565_cov_5","Nsylvestris_NODE_6690_length_2624_cov_125",100,55,0,0,511,565,1449,1503,3.9e-21,102,54,54
"82659","Ntome_NODE_31687_length_564_cov_300","Nsylvestris_NODE_4047_length_3218_cov_167",98.759,564,7,0,1,564,1647,1084,0,1003,563,563
"82692","Ntome_NODE_31702_length_564_cov_8","Nsylvestris_NODE_29706_length_554_cov_3",83.455,550,44,15,31,564,551,33,3.33e-131,468,533,518
"82693","Ntome_NODE_31703_length_564_cov_8","Nsylvestris_NODE_22_length_11544_cov_169",88.086,512,39,10,53,564,8619,8130,2.45e-167,588,511,489
"82694","Ntome_NODE_31705_length_564_cov_7","Nsylvestris_NODE_23582_length_855_cov_13",75.157,318,78,1,48,364,587,270,4.93e-35,148,316,317
"82695","Ntome_NODE_31708_length_564_cov_5","Nsylvestris_NODE_770_length_5296_cov_183",100,55,0,0,510,564,1583,1637,3.89e-21,102,54,54
"82698","Ntome_NODE_31712_length_564_cov_2","Nsylvestris_NODE_12013_length_1868_cov_204",92.727,55,4,0,510,564,1030,976,1.82e-14,80.5,54,54
"82708","Ntome_NODE_31716_length_563_cov_138","Nsylvestris_NODE_9718_length_2150_cov_153",87.162,296,24,7,270,563,487,204,7.61e-88,324,293,283
"82723","Ntome_NODE_31724_length_563_cov_14","Nsylvestris_NODE_5949_length_2768_cov_63",98.182,55,1,0,1,55,1988,2042,1.81e-19,97.1,54,54
"82738","Ntome_NODE_31730_length_563_cov_5","Nsylvestris_NODE_1472_length_4425_cov_108",96.364,55,2,0,509,563,1654,1600,8.4e-18,91.6,54,54
"82739","Ntome_NODE_31732_length_563_cov_4","Nsylvestris_NODE_28377_length_611_cov_7",97.333,225,6,0,14,238,268,492,1.24e-105,383,224,224
"82740","Ntome_NODE_31734_length_563_cov_3","Nsylvestris_NODE_2502_length_3793_cov_20",87.034,563,40,11,4,563,612,80,2.43e-172,604,559,532
"82769","Ntome_NODE_31749_length_562_cov_18","Nsylvestris_NODE_18424_length_1230_cov_91",98.182,55,1,0,1,55,925,871,1.8e-19,97.1,54,54
"82770","Ntome_NODE_31750_length_562_cov_13","Nsylvestris_NODE_33437_length_338_cov_5",94.118,306,18,0,201,506,338,33,1.19e-130,466,305,305
"82781","Ntome_NODE_31758_length_562_cov_7","Nsylvestris_NODE_6983_length_2571_cov_225",94.545,55,3,0,508,562,775,721,3.9e-16,86.1,54,54
"82782","Ntome_NODE_31759_length_562_cov_7","Nsylvestris_NODE_7324_length_2516_cov_99",85.507,138,15,3,135,270,2011,2145,2.95e-32,139,135,134
"82786","Ntome_NODE_31761_length_562_cov_5","Nsylvestris_NODE_178_length_7523_cov_18",82.648,559,92,4,1,557,3027,2472,7.08e-138,490,556,555
"82794","Ntome_NODE_31765_length_561_cov_227","Nsylvestris_NODE_25946_length_721_cov_167",90.98,510,35,4,11,512,1,507,0,676,501,506
"82795","Ntome_NODE_31766_length_561_cov_148","Nsylvestris_NODE_31731_length_406_cov_17",87.037,216,22,5,7,218,30,243,2.83e-62,239,211,213
"82796","Ntome_NODE_31767_length_561_cov_27","Nsylvestris_NODE_14399_length_1610_cov_199",87.379,206,17,3,356,561,913,1109,6.12e-59,228,205,196
"82807","Ntome_NODE_31774_length_561_cov_11","Nsylvestris_NODE_1908_length_4108_cov_197",96.667,60,1,1,503,561,3941,4000,5e-20,99,58,59
"82811","Ntome_NODE_31776_length_561_cov_10","Nsylvestris_NODE_15179_length_1532_cov_208",98.182,55,1,0,507,561,1221,1167,1.8e-19,97.1,54,54
"82812","Ntome_NODE_31777_length_561_cov_9","Nsylvestris_NODE_9561_length_2168_cov_212",97.727,44,1,0,2,45,1364,1321,2.34e-13,76.8,43,43
"82813","Ntome_NODE_31778_length_561_cov_9","Nsylvestris_NODE_18218_length_1248_cov_188",96.154,52,2,0,507,558,246,297,3.89e-16,86.1,51,51
"82818","Ntome_NODE_31782_length_561_cov_2","Nsylvestris_NODE_2216_length_3931_cov_39",97.133,558,16,0,1,558,2672,3229,0,942,557,557
"82826","Ntome_NODE_31787_length_560_cov_29","Nsylvestris_NODE_15771_length_1472_cov_224",100,55,0,0,1,55,579,525,3.86e-21,102,54,54
"82836","Ntome_NODE_31793_length_560_cov_18","Nsylvestris_NODE_17079_length_1350_cov_234",98.182,55,1,0,1,55,634,580,1.8e-19,97.1,54,54
"82837","Ntome_NODE_31795_length_560_cov_12","Nsylvestris_NODE_5906_length_2780_cov_139",94.34,53,3,0,3,55,1819,1871,5.03e-15,82.4,52,52
"82844","Ntome_NODE_31798_length_560_cov_8","Nsylvestris_NODE_2678_length_3712_cov_190",95.11,409,20,0,117,525,3281,3689,0,645,408,408
"82849","Ntome_NODE_31803_length_560_cov_7","Nsylvestris_NODE_1433_length_4465_cov_232",96.154,52,2,0,509,560,1331,1280,3.89e-16,86.1,51,51
"82852","Ntome_NODE_31806_length_560_cov_6","Nsylvestris_NODE_22075_length_951_cov_8",84.122,296,42,4,264,558,66,357,4.62e-75,281,294,291
"82856","Ntome_NODE_31809_length_560_cov_5","Nsylvestris_NODE_6203_length_2716_cov_142",98.182,55,1,0,506,560,361,307,1.8e-19,97.1,54,54
"82857","Ntome_NODE_31810_length_560_cov_5","Nsylvestris_NODE_1956_length_4081_cov_157",95.652,115,5,0,230,344,2731,2617,3.73e-46,185,114,114
"82860","Ntome_NODE_31812_length_560_cov_4","Nsylvestris_NODE_18838_length_1198_cov_184",100,55,0,0,1,55,767,713,3.86e-21,102,54,54
"82861","Ntome_NODE_31813_length_560_cov_4","Nsylvestris_NODE_31494_length_420_cov_4",92.695,397,29,0,1,397,397,1,6.81e-163,573,396,396
"82862","Ntome_NODE_31815_length_559_cov_211","Nsylvestris_NODE_12973_length_1766_cov_23",85.47,117,16,1,444,559,1220,1336,1.06e-26,121,115,116
"82865","Ntome_NODE_31819_length_559_cov_63","Nsylvestris_NODE_1805_length_4172_cov_65",81.503,346,32,16,211,543,68,394,2.79e-67,255,332,326
"82875","Ntome_NODE_31826_length_559_cov_20","Nsylvestris_NODE_25737_length_731_cov_196",84.545,220,24,4,233,442,390,171,2.21e-53,209,209,219
"82879","Ntome_NODE_31829_length_559_cov_12","Nsylvestris_NODE_15049_length_1546_cov_180",94.555,551,22,4,1,546,936,1483,0,845,545,547
"82883","Ntome_NODE_31831_length_559_cov_11","Nsylvestris_NODE_5418_length_2882_cov_140",100,55,0,0,1,55,2563,2509,3.85e-21,102,54,54
"82884","Ntome_NODE_31832_length_559_cov_11","Nsylvestris_NODE_16515_length_1398_cov_203",98.182,55,1,0,505,559,1335,1281,1.79e-19,97.1,54,54
"82888","Ntome_NODE_31835_length_559_cov_10","Nsylvestris_NODE_13848_length_1668_cov_195",100,55,0,0,505,559,856,802,3.85e-21,102,54,54
"82889","Ntome_NODE_31836_length_559_cov_10","Nsylvestris_NODE_29888_length_537_cov_27",94.382,356,20,0,1,356,54,409,4.12e-155,547,355,355
"82896","Ntome_NODE_31840_length_559_cov_8","Nsylvestris_NODE_190_length_7434_cov_175",98.182,55,1,0,505,559,1264,1318,1.79e-19,97.1,54,54
"82897","Ntome_NODE_31841_length_559_cov_7","Nsylvestris_NODE_5844_length_2793_cov_164",100,55,0,0,1,55,1262,1208,3.85e-21,102,54,54
"82900","Ntome_NODE_31844_length_559_cov_5","Nsylvestris_NODE_17068_length_1351_cov_69",92.308,559,22,7,1,559,291,828,0,774,558,537
"82911","Ntome_NODE_31852_length_558_cov_32","Nsylvestris_NODE_28162_length_622_cov_19",87.478,559,42,14,4,558,538,4,8.59e-177,619,554,534
"82918","Ntome_NODE_31857_length_558_cov_13","Nsylvestris_NODE_29634_length_557_cov_68",99.82,556,0,1,1,556,3,557,0,1020,555,554
"82926","Ntome_NODE_31861_length_558_cov_7","Nsylvestris_NODE_12858_length_1780_cov_172",98.182,55,1,0,1,55,995,1049,1.79e-19,97.1,54,54
"82927","Ntome_NODE_31862_length_558_cov_7","Nsylvestris_NODE_3180_length_3515_cov_118",94.718,568,19,3,1,558,2422,1856,0,872,557,566
"82936","Ntome_NODE_31870_length_557_cov_217","Nsylvestris_NODE_21593_length_985_cov_153",91.739,230,17,2,329,557,985,757,3.5e-86,318,228,228
"82951","Ntome_NODE_31882_length_558_cov_10","Nsylvestris_NODE_7642_length_2464_cov_216",98.182,55,1,0,1,55,1963,2017,1.79e-19,97.1,54,54
"82954","Ntome_NODE_31885_length_557_cov_9","Nsylvestris_NODE_34514_length_307_cov_7",87.926,323,18,10,142,463,1,303,5.74e-99,361,321,302
"82955","Ntome_NODE_31886_length_557_cov_8","Nsylvestris_NODE_15632_length_1487_cov_11",78.155,206,41,4,354,557,778,575,6.33e-29,128,203,203
"82956","Ntome_NODE_31887_length_557_cov_8","Nsylvestris_NODE_2463_length_3810_cov_99",96.364,55,2,0,1,55,3412,3466,8.31e-18,91.6,54,54
"82961","Ntome_NODE_31893_length_557_cov_4","Nsylvestris_NODE_11313_length_1949_cov_216",100,55,0,0,503,557,1027,973,3.84e-21,102,54,54
"82962","Ntome_NODE_31894_length_557_cov_4","Nsylvestris_NODE_971_length_4991_cov_57",89.337,347,24,7,3,346,2060,1724,7.21e-118,424,343,336
"82965","Ntome_NODE_31896_length_557_cov_4","Nsylvestris_NODE_10276_length_2078_cov_220",98.182,55,1,0,503,557,936,882,1.79e-19,97.1,54,54
"82974","Ntome_NODE_31901_length_556_cov_199","Nsylvestris_NODE_9117_length_2234_cov_82",86.57,484,50,11,49,518,1749,2231,8.93e-147,520,469,482
"82975","Ntome_NODE_31902_length_556_cov_74","Nsylvestris_NODE_27165_length_666_cov_52",90.21,286,8,2,1,274,389,666,2.66e-97,355,273,277
"82979","Ntome_NODE_31904_length_556_cov_44","Nsylvestris_NODE_11673_length_1909_cov_117",96.364,55,2,0,1,55,715,661,8.29e-18,91.6,54,54
"82980","Ntome_NODE_31906_length_556_cov_15","Nsylvestris_NODE_11334_length_1948_cov_103",94.444,54,2,1,13,65,1559,1612,4.99e-15,82.4,52,53
"82981","Ntome_NODE_31907_length_556_cov_11","Nsylvestris_NODE_12111_length_1856_cov_192",94.545,55,3,0,502,556,828,882,3.86e-16,86.1,54,54
"82982","Ntome_NODE_31908_length_556_cov_9","Nsylvestris_NODE_119_length_8138_cov_130",91.525,236,15,4,54,286,426,659,9.72e-87,320,232,233
"82983","Ntome_NODE_31910_length_556_cov_7","Nsylvestris_NODE_10489_length_2052_cov_56",90.244,82,8,0,7,88,385,466,8.23e-23,108,81,81
"82987","Ntome_NODE_31912_length_556_cov_7","Nsylvestris_NODE_4106_length_3201_cov_220",95.238,63,2,1,1,63,1076,1015,4.96e-20,99,62,61
"82988","Ntome_NODE_31918_length_556_cov_4","Nsylvestris_NODE_2852_length_3637_cov_127",96.667,60,2,0,1,60,1213,1154,1.38e-20,100,59,59
"82997","Ntome_NODE_31923_length_555_cov_215","Nsylvestris_NODE_5577_length_2849_cov_113",93.449,519,32,2,37,555,2849,2333,0,769,518,516
"82998","Ntome_NODE_31924_length_555_cov_178","Nsylvestris_NODE_32762_length_361_cov_9",83.862,378,32,12,31,403,1,354,1.25e-90,333,372,353
"82999","Ntome_NODE_31926_length_555_cov_97","Nsylvestris_NODE_3788_length_3304_cov_184",96.364,55,2,0,501,555,2596,2542,8.28e-18,91.6,54,54
"83005","Ntome_NODE_31930_length_555_cov_32","Nsylvestris_NODE_13268_length_1731_cov_200",92.727,55,4,0,501,555,694,748,1.79e-14,80.5,54,54
"83006","Ntome_NODE_31932_length_555_cov_13","Nsylvestris_NODE_17446_length_1319_cov_7",90.244,328,16,10,216,532,1,323,4.32e-115,414,316,322
"83007","Ntome_NODE_31936_length_555_cov_5","Nsylvestris_NODE_34846_length_299_cov_3",92.683,41,3,0,73,113,41,1,2.33e-08,60.2,40,40
"83010","Ntome_NODE_31938_length_555_cov_4","Nsylvestris_NODE_12064_length_1862_cov_33",95.238,189,8,1,1,189,1550,1737,4.54e-80,298,188,187
"83015","Ntome_NODE_31945_length_554_cov_10","Nsylvestris_NODE_30928_length_456_cov_4",94.737,228,5,2,1,221,228,1,4.44e-95,348,220,227
"83016","Ntome_NODE_31947_length_554_cov_8","Nsylvestris_NODE_13624_length_1693_cov_20",92.593,189,12,1,7,195,1454,1640,9.89e-72,270,188,186
"83017","Ntome_NODE_31950_length_553_cov_278","Nsylvestris_NODE_281_length_6805_cov_139",90.385,468,33,8,93,553,6757,6295,2.38e-172,604,460,462
"83018","Ntome_NODE_31951_length_553_cov_262","Nsylvestris_NODE_5671_length_2823_cov_212",86.992,123,15,1,431,553,2779,2658,1.04e-31,137,122,121
"83019","Ntome_NODE_31952_length_553_cov_86","Nsylvestris_NODE_26463_length_697_cov_179",91.446,491,19,8,79,553,507,24,0,652,474,483
"83020","Ntome_NODE_31953_length_553_cov_13","Nsylvestris_NODE_23477_length_861_cov_138",82.051,117,21,0,99,215,699,583,1.37e-20,100,116,116
"83021","Ntome_NODE_31954_length_553_cov_10","Nsylvestris_NODE_7707_length_2452_cov_42",87.29,417,39,10,3,409,1097,1509,4.22e-130,464,406,412
"83024","Ntome_NODE_31956_length_553_cov_8","Nsylvestris_NODE_11755_length_1899_cov_75",97.238,543,15,0,11,553,1087,545,0,920,542,542
"83025","Ntome_NODE_31958_length_553_cov_7","Nsylvestris_NODE_30853_length_460_cov_8",89.979,479,21,9,10,486,1,454,5.16e-169,593,476,453
"83028","Ntome_NODE_31960_length_553_cov_6","Nsylvestris_NODE_2097_length_3995_cov_89",94.595,37,1,1,139,174,749,713,3.01e-07,56.5,35,36
"83031","Ntome_NODE_31967_length_552_cov_202","Nsylvestris_NODE_9690_length_2153_cov_145",91.549,568,17,8,1,552,20,572,0,754,551,552
"83034","Ntome_NODE_31971_length_552_cov_23","Nsylvestris_NODE_17206_length_1341_cov_15",86.364,352,43,3,188,537,467,815,1.57e-104,379,349,348
"83038","Ntome_NODE_31975_length_552_cov_8","Nsylvestris_NODE_23522_length_858_cov_43",95.135,555,24,1,1,552,291,845,0,872,551,554
"83043","Ntome_NODE_31982_length_551_cov_229","Nsylvestris_NODE_16320_length_1417_cov_49",87.903,124,15,0,51,174,1079,1202,1.73e-34,147,123,123
"83044","Ntome_NODE_31983_length_551_cov_224","Nsylvestris_NODE_10437_length_2057_cov_151",89.412,85,9,0,64,148,1634,1550,8.16e-23,108,84,84
"83047","Ntome_NODE_31985_length_551_cov_30","Nsylvestris_NODE_29737_length_551_cov_55",90.647,556,40,9,1,551,2,550,0,728,550,548
"83048","Ntome_NODE_31986_length_551_cov_29","Nsylvestris_NODE_178_length_7523_cov_18",83.721,516,73,8,1,510,6201,5691,5.4e-134,477,509,510
"83052","Ntome_NODE_31989_length_551_cov_9","Nsylvestris_NODE_23596_length_854_cov_124",94.374,551,10,5,6,551,298,832,0,826,545,534
"83055","Ntome_NODE_31992_length_551_cov_5","Nsylvestris_NODE_8084_length_2390_cov_37",95.396,543,22,1,12,551,2187,1645,0,861,539,542
"83061","Ntome_NODE_31998_length_550_cov_102","Nsylvestris_NODE_27662_length_643_cov_153",89.961,518,38,7,34,550,78,582,0,656,516,504
"83062","Ntome_NODE_32002_length_550_cov_10","Nsylvestris_NODE_2569_length_3762_cov_29",79.505,283,42,9,261,540,2315,2046,1.02e-46,187,279,269
"83063","Ntome_NODE_32003_length_550_cov_9","Nsylvestris_NODE_28760_length_595_cov_4",89.919,248,14,5,1,238,101,347,2.08e-83,309,237,246
"83064","Ntome_NODE_32004_length_550_cov_6","Nsylvestris_NODE_14012_length_1648_cov_10",89.175,388,30,4,1,376,442,55,6.97e-133,473,375,387
"83065","Ntome_NODE_32006_length_550_cov_4","Nsylvestris_NODE_15217_length_1530_cov_74",82.573,241,39,3,40,279,594,356,2.17e-53,209,239,238
"83068","Ntome_NODE_32009_length_549_cov_240","Nsylvestris_NODE_3588_length_3369_cov_123",96.539,549,19,0,1,549,1140,592,0,909,548,548
"83069","Ntome_NODE_32013_length_548_cov_9","Nsylvestris_NODE_19770_length_1121_cov_9",93.25,400,22,4,153,548,1121,723,3.07e-166,584,395,398
"83076","Ntome_NODE_32023_length_548_cov_68","Nsylvestris_NODE_32488_length_372_cov_16",89.109,101,11,0,76,176,372,272,2.24e-28,126,100,100
"83077","Ntome_NODE_32026_length_548_cov_21","Nsylvestris_NODE_24999_length_771_cov_191",95.463,551,20,3,3,548,569,19,0,874,545,550
"83078","Ntome_NODE_32028_length_528_cov_10","Nsylvestris_NODE_30566_length_481_cov_8",85.171,263,37,2,50,311,219,480,3.38e-71,268,261,261
"83079","Ntome_NODE_32029_length_548_cov_9","Nsylvestris_NODE_19450_length_1148_cov_44",89.655,58,5,1,133,189,864,807,2.96e-12,73.1,56,57
"83080","Ntome_NODE_32034_length_548_cov_5","Nsylvestris_NODE_23361_length_869_cov_5",96.907,291,9,0,258,548,1,291,2.48e-137,488,290,290
"83081","Ntome_NODE_32038_length_547_cov_12","Nsylvestris_NODE_30198_length_510_cov_6",88,425,25,16,19,424,419,2,1.49e-134,479,405,417
"83087","Ntome_NODE_32042_length_547_cov_3","Nsylvestris_NODE_11368_length_1944_cov_59",84.3,293,43,1,59,348,249,541,1.25e-75,283,289,292
"83088","Ntome_NODE_32043_length_546_cov_318","Nsylvestris_NODE_878_length_5113_cov_120",98.535,546,8,0,1,546,3986,4531,0,965,545,545
"83089","Ntome_NODE_32044_length_546_cov_310","Nsylvestris_NODE_8976_length_2254_cov_231",98.718,546,7,0,1,546,547,2,0,970,545,545
"83092","Ntome_NODE_32046_length_546_cov_211","Nsylvestris_NODE_6871_length_2591_cov_168",100,55,0,0,492,546,1525,1471,3.76e-21,102,54,54
"83093","Ntome_NODE_32047_length_546_cov_38","Nsylvestris_NODE_27137_length_667_cov_177",91.731,520,36,3,34,546,644,125,0,715,512,519
"83094","Ntome_NODE_32049_length_546_cov_11","Nsylvestris_NODE_1114_length_4809_cov_126",73.82,233,47,10,14,244,3254,3474,1.76e-14,80.5,230,220
"83095","Ntome_NODE_32050_length_546_cov_7","Nsylvestris_NODE_32536_length_371_cov_4",87.356,87,11,0,460,546,99,185,1.35e-20,100,86,86
"83096","Ntome_NODE_32051_length_546_cov_5","Nsylvestris_NODE_547_length_5834_cov_83",92.308,546,24,4,1,546,993,1520,0,760,545,527
"83097","Ntome_NODE_32054_length_546_cov_2","Nsylvestris_NODE_19620_length_1134_cov_7",93.91,509,21,8,15,521,506,1006,0,760,506,500
"83101","Ntome_NODE_32056_length_545_cov_274","Nsylvestris_NODE_25834_length_726_cov_219",97.746,488,7,4,58,545,40,523,0,837,487,483
"83107","Ntome_NODE_32061_length_545_cov_23","Nsylvestris_NODE_13563_length_1699_cov_212",85.507,69,10,0,174,242,659,727,2.94e-12,73.1,68,68
"83108","Ntome_NODE_32063_length_545_cov_9","Nsylvestris_NODE_22957_length_894_cov_117",81.25,192,23,11,364,545,552,740,2.21e-33,143,181,188
"83113","Ntome_NODE_32070_length_544_cov_234","Nsylvestris_NODE_450_length_6107_cov_148",92.705,329,17,4,222,544,44,371,3.2e-131,468,322,327
"83118","Ntome_NODE_32074_length_544_cov_72","Nsylvestris_NODE_30738_length_469_cov_11",95.148,371,18,0,174,544,434,64,8.48e-167,586,370,370
"83119","Ntome_NODE_32076_length_544_cov_12","Nsylvestris_NODE_27365_length_657_cov_181",93.153,555,21,5,1,544,44,592,0,798,543,548
"83120","Ntome_NODE_32077_length_544_cov_10","Nsylvestris_NODE_28868_length_589_cov_22",90.744,551,31,5,5,535,6,556,0,717,530,550
"83121","Ntome_NODE_32079_length_544_cov_7","Nsylvestris_NODE_12439_length_1823_cov_60",98.713,544,7,0,1,544,851,1394,0,966,543,543
"83122","Ntome_NODE_32080_length_544_cov_5","Nsylvestris_NODE_2652_length_3722_cov_60",92.87,547,22,6,2,544,1298,765,0,778,542,533
"83123","Ntome_NODE_32081_length_544_cov_4","Nsylvestris_NODE_7002_length_2569_cov_99",94.249,539,28,3,1,538,351,887,0,821,537,536
"83124","Ntome_NODE_32082_length_543_cov_259","Nsylvestris_NODE_3013_length_3582_cov_220",95.76,283,4,2,1,283,251,525,1.16e-125,449,282,274
"83127","Ntome_NODE_32085_length_543_cov_37","Nsylvestris_NODE_9236_length_2217_cov_54",80,100,6,7,137,236,44,129,6.34e-09,62.1,99,85
"83128","Ntome_NODE_32086_length_543_cov_16","Nsylvestris_NODE_16065_length_1443_cov_136",84.783,414,60,3,11,422,1239,827,1.52e-114,412,411,412
"83129","Ntome_NODE_32087_length_543_cov_15","Nsylvestris_NODE_26722_length_686_cov_53",86.755,302,28,9,229,525,383,89,2.04e-88,326,296,294
"83130","Ntome_NODE_32090_length_543_cov_7","Nsylvestris_NODE_5565_length_2850_cov_21",94.28,542,27,4,4,542,1926,1386,0,826,538,540
"83136","Ntome_NODE_32097_length_542_cov_233","Nsylvestris_NODE_8482_length_2327_cov_80",94.348,460,21,2,10,465,744,286,0,701,455,458
"83143","Ntome_NODE_32100_length_542_cov_202","Nsylvestris_NODE_6822_length_2600_cov_142",91.111,405,30,5,89,491,69,469,5.16e-154,544,402,400
"83144","Ntome_NODE_32101_length_542_cov_171","Nsylvestris_NODE_19169_length_1170_cov_66",90.625,288,18,5,107,390,835,1117,7.16e-103,374,283,282
"83147","Ntome_NODE_32103_length_542_cov_107","Nsylvestris_NODE_31814_length_403_cov_3",90.582,361,33,1,57,417,1,360,5.3e-134,477,360,359
"83159","Ntome_NODE_32114_length_541_cov_247","Nsylvestris_NODE_7001_length_2569_cov_126",95.379,541,25,0,1,541,2185,1645,0,861,540,540
"83160","Ntome_NODE_32115_length_541_cov_214","Nsylvestris_NODE_856_length_5155_cov_44",93.738,543,32,1,1,541,1701,1159,0,813,540,542
"83161","Ntome_NODE_32116_length_541_cov_199","Nsylvestris_NODE_9358_length_2199_cov_205",92.664,518,30,6,30,541,522,7,0,739,511,515
"83166","Ntome_NODE_32121_length_541_cov_6","Nsylvestris_NODE_33442_length_338_cov_4",93.671,316,17,2,225,540,338,26,8.86e-132,470,315,312
"83169","Ntome_NODE_32124_length_541_cov_4","Nsylvestris_NODE_34055_length_320_cov_8",96.721,122,4,0,197,318,320,199,9.92e-52,204,121,121
"83177","Ntome_NODE_32127_length_540_cov_264","Nsylvestris_NODE_4817_length_3016_cov_149",94.781,479,25,0,1,479,2659,2181,0,747,478,478
"83188","Ntome_NODE_32132_length_540_cov_32","Nsylvestris_NODE_6750_length_2613_cov_142",85.714,448,38,9,78,516,431,1,1.15e-125,449,438,430
"83195","Ntome_NODE_32139_length_539_cov_277","Nsylvestris_NODE_19214_length_1166_cov_211",96.728,489,16,0,50,538,1087,599,0,815,488,488
"83203","Ntome_NODE_32143_length_539_cov_111","Nsylvestris_NODE_4928_length_2990_cov_223",85.106,94,5,3,92,178,150,59,1.04e-16,87.9,86,91
"83207","Ntome_NODE_32145_length_539_cov_85","Nsylvestris_NODE_24612_length_794_cov_52",93.542,542,23,7,1,532,235,774,0,797,531,539
"83208","Ntome_NODE_32149_length_539_cov_9","Nsylvestris_NODE_6512_length_2659_cov_61",91.728,544,29,10,4,539,358,893,0,741,535,535
"83211","Ntome_NODE_32154_length_539_cov_4","Nsylvestris_NODE_5716_length_2817_cov_100",91.423,548,38,4,1,539,1179,632,0,743,538,547
"83223","Ntome_NODE_32159_length_538_cov_220","Nsylvestris_NODE_17300_length_1331_cov_225",91.63,454,23,7,1,440,879,1331,3.85e-175,614,439,452
"83224","Ntome_NODE_32160_length_538_cov_146","Nsylvestris_NODE_13726_length_1682_cov_113",88.976,127,10,4,397,523,1314,1192,1.01e-36,154,126,122
"83228","Ntome_NODE_32167_length_538_cov_10","Nsylvestris_NODE_18313_length_1240_cov_76",80.071,281,39,10,76,354,808,543,2.14e-48,193,278,265
"83229","Ntome_NODE_32169_length_538_cov_8","Nsylvestris_NODE_34775_length_301_cov_2",95.154,227,11,0,13,239,227,1,1.99e-98,359,226,226
"83232","Ntome_NODE_32173_length_538_cov_6","Nsylvestris_NODE_14668_length_1582_cov_193",98.039,51,1,0,488,538,778,728,2.88e-17,89.8,50,50
"83233","Ntome_NODE_32174_length_538_cov_4","Nsylvestris_NODE_15650_length_1485_cov_34",85.294,476,31,19,3,449,674,209,2.47e-127,455,446,465
"83234","Ntome_NODE_32175_length_538_cov_3","Nsylvestris_NODE_6967_length_2574_cov_160",85.043,468,67,3,49,515,1397,1862,6.81e-133,473,466,465
"83235","Ntome_NODE_32176_length_537_cov_353","Nsylvestris_NODE_5601_length_2840_cov_155",97.233,506,11,2,1,503,2335,2840,0,854,502,505
"83239","Ntome_NODE_32179_length_537_cov_65","Nsylvestris_NODE_61_length_9229_cov_221",88.722,266,24,3,188,448,1604,1868,9.37e-87,320,260,264
"83243","Ntome_NODE_32184_length_537_cov_10","Nsylvestris_NODE_30930_length_456_cov_3",90,400,21,9,2,401,381,1,1.12e-140,499,399,380
"83244","Ntome_NODE_32188_length_537_cov_5","Nsylvestris_NODE_31339_length_430_cov_4",97.297,37,1,0,1,37,37,1,1.74e-09,63.9,36,36
"83245","Ntome_NODE_32191_length_537_cov_4","Nsylvestris_NODE_33621_length_333_cov_5",86.331,278,33,5,136,412,333,60,4.39e-80,298,276,273
"83256","Ntome_NODE_32200_length_536_cov_5","Nsylvestris_NODE_470_length_6031_cov_12",80,185,33,4,6,187,476,659,1.31e-30,134,181,183
"83257","Ntome_NODE_32201_length_536_cov_4","Nsylvestris_NODE_7068_length_2559_cov_117",96.082,536,21,0,1,536,1269,734,0,874,535,535
"83262","Ntome_NODE_32206_length_535_cov_220","Nsylvestris_NODE_4481_length_3103_cov_221",93.484,353,18,5,188,535,1551,1903,8.57e-147,520,347,352
"83265","Ntome_NODE_32213_length_535_cov_5","Nsylvestris_NODE_17942_length_1273_cov_34",95.42,524,24,0,3,526,638,115,0,835,523,523
"83276","Ntome_NODE_32218_length_534_cov_118","Nsylvestris_NODE_4977_length_2979_cov_209",87.059,85,10,1,9,92,1314,1398,6.15e-19,95.3,83,84
"83279","Ntome_NODE_32220_length_534_cov_12","Nsylvestris_NODE_14103_length_1640_cov_36",92.826,460,30,2,37,493,1586,1127,0,664,456,459
"83280","Ntome_NODE_32221_length_534_cov_8","Nsylvestris_NODE_1783_length_4188_cov_199",95.918,49,2,0,1,49,2508,2556,1.72e-14,80.5,48,48
"83281","Ntome_NODE_32223_length_534_cov_5","Nsylvestris_NODE_5393_length_2887_cov_156",97.749,533,11,1,1,533,1892,1361,0,917,532,531
"83285","Ntome_NODE_32229_length_533_cov_200","Nsylvestris_NODE_6952_length_2576_cov_227",94.545,55,3,0,476,530,1445,1499,3.69e-16,86.1,54,54
"83286","Ntome_NODE_32231_length_533_cov_54","Nsylvestris_NODE_15628_length_1485_cov_170",83.912,317,40,5,1,313,134,443,2.03e-78,292,312,309
"83287","Ntome_NODE_32232_length_533_cov_20","Nsylvestris_NODE_25329_length_753_cov_33",92.25,529,24,10,1,515,744,219,0,734,514,525
"83309","Ntome_NODE_32245_length_532_cov_20","Nsylvestris_NODE_5862_length_2790_cov_52",83.333,186,24,6,351,532,692,874,4.6e-40,165,181,182
"83315","Ntome_NODE_32255_length_532_cov_5","Nsylvestris_NODE_4019_length_3229_cov_69",81.609,261,41,7,276,532,545,802,2.1e-53,209,256,257
"83316","Ntome_NODE_32258_length_531_cov_197","Nsylvestris_NODE_13073_length_1754_cov_209",91.315,403,12,12,132,531,1739,1357,1.41e-149,529,399,382
"83317","Ntome_NODE_32259_length_531_cov_168","Nsylvestris_NODE_25402_length_749_cov_8",94.969,477,24,0,1,477,199,675,0,749,476,476
"83318","Ntome_NODE_32260_length_531_cov_167","Nsylvestris_NODE_23519_length_858_cov_79",84.308,325,29,8,227,531,505,827,4.34e-80,298,304,322
"83327","Ntome_NODE_32264_length_531_cov_10","Nsylvestris_NODE_19549_length_1140_cov_8",95.085,529,21,3,8,531,1108,580,0,828,523,528
"83331","Ntome_NODE_32275_length_530_cov_294","Nsylvestris_NODE_4718_length_3041_cov_13",95.857,531,12,5,1,524,1573,2100,0,850,523,527
"83337","Ntome_NODE_32279_length_530_cov_13","Nsylvestris_NODE_7118_length_2550_cov_86",87.361,538,57,8,2,530,2415,1880,6.33e-173,606,528,535
"83338","Ntome_NODE_32280_length_530_cov_11","Nsylvestris_NODE_29341_length_569_cov_37",91.885,382,31,0,2,383,511,130,3.03e-151,534,381,381
"83339","Ntome_NODE_32285_length_530_cov_4","Nsylvestris_NODE_736_length_5378_cov_103",93.774,530,33,0,1,530,1592,1063,0,797,529,529
"83342","Ntome_NODE_32288_length_529_cov_219","Nsylvestris_NODE_4669_length_3052_cov_215",92.689,383,16,7,149,529,3015,2643,1.81e-153,542,380,372
"83343","Ntome_NODE_32289_length_529_cov_141","Nsylvestris_NODE_24030_length_830_cov_146",93.045,532,31,2,1,529,20,548,0,773,528,528
"83375","Ntome_NODE_32308_length_527_cov_289","Nsylvestris_NODE_3835_length_3289_cov_234",96.604,530,10,7,2,527,1,526,0,872,525,525
"83383","Ntome_NODE_32313_length_527_cov_4","Nsylvestris_NODE_14563_length_1593_cov_153",74.905,263,62,4,267,527,1,261,1.29e-25,117,260,260
"83384","Ntome_NODE_32315_length_526_cov_268","Nsylvestris_NODE_24297_length_812_cov_211",93.981,432,17,6,55,478,333,763,0,645,423,430
"83414","Ntome_NODE_32334_length_525_cov_196","Nsylvestris_NODE_13520_length_1704_cov_147",95.192,312,12,1,217,525,1656,1345,6.59e-138,490,308,311
"83422","Ntome_NODE_32340_length_525_cov_9","Nsylvestris_NODE_7124_length_2550_cov_25",91.429,525,36,6,1,525,1120,605,0,712,524,515
"83423","Ntome_NODE_32343_length_525_cov_5","Nsylvestris_NODE_5961_length_2768_cov_40",94.4,250,9,4,278,525,1123,877,1.49e-104,379,247,246
"83432","Ntome_NODE_32354_length_524_cov_9","Nsylvestris_NODE_13639_length_1692_cov_8",92.435,542,20,8,1,524,1269,731,0,754,523,538
"83433","Ntome_NODE_32361_length_524_cov_4","Nsylvestris_NODE_31419_length_424_cov_9",89.681,407,38,3,4,407,19,424,1.09e-145,516,403,405
"83434","Ntome_NODE_32363_length_524_cov_4","Nsylvestris_NODE_34438_length_310_cov_2",91.824,318,12,8,1,316,5,310,4.04e-120,431,315,305
"83437","Ntome_NODE_32366_length_523_cov_286","Nsylvestris_NODE_19964_length_1105_cov_214",94.091,440,26,0,1,440,618,1057,0,669,439,439
"83446","Ntome_NODE_32370_length_523_cov_20","Nsylvestris_NODE_26454_length_698_cov_33",92.593,54,2,2,194,247,341,290,2.18e-13,76.8,53,51
"83447","Ntome_NODE_32372_length_523_cov_12","Nsylvestris_NODE_3195_length_3508_cov_113",86.966,445,33,15,87,521,1959,1530,5.11e-134,477,434,429
"83458","Ntome_NODE_32380_length_522_cov_234","Nsylvestris_NODE_1810_length_4167_cov_65",85.223,291,10,8,265,522,3926,3636,3.34e-71,268,257,290
"83459","Ntome_NODE_32381_length_522_cov_172","Nsylvestris_NODE_5986_length_2763_cov_198",88.041,393,31,13,138,522,2565,2181,3.09e-126,451,384,384
"83469","Ntome_NODE_32387_length_522_cov_6","Nsylvestris_NODE_2052_length_4025_cov_56",98.269,520,9,0,3,522,2493,1974,0,911,519,519
"83470","Ntome_NODE_32388_length_522_cov_4","Nsylvestris_NODE_4065_length_3214_cov_89",93.487,522,25,2,1,522,2688,3200,0,767,521,512
"83471","Ntome_NODE_32389_length_522_cov_3","Nsylvestris_NODE_7012_length_2568_cov_63",91.116,439,31,3,83,521,1574,2004,2.26e-167,588,438,430
"83472","Ntome_NODE_32391_length_521_cov_234","Nsylvestris_NODE_1564_length_4352_cov_229",95.343,408,17,2,1,408,3892,4297,0,647,407,405
"83476","Ntome_NODE_32395_length_521_cov_186","Nsylvestris_NODE_6058_length_2747_cov_104",100,54,0,0,2,55,874,821,1.29e-20,100,53,53
"83477","Ntome_NODE_32396_length_521_cov_162","Nsylvestris_NODE_1932_length_4096_cov_106",100,56,0,0,466,521,2789,2844,9.95e-22,104,55,55
"83478","Ntome_NODE_32399_length_521_cov_8","Nsylvestris_NODE_33720_length_330_cov_3",98.246,57,1,0,1,57,96,152,1.29e-20,100,56,56
"83479","Ntome_NODE_32400_length_521_cov_6","Nsylvestris_NODE_14299_length_1621_cov_75",95.202,521,25,0,1,521,744,224,0,824,520,520
"83480","Ntome_NODE_32403_length_521_cov_4","Nsylvestris_NODE_717_length_5403_cov_52",88.29,427,33,8,1,418,4333,3915,1.41e-139,496,417,418
"83481","Ntome_NODE_32404_length_521_cov_4","Nsylvestris_NODE_3263_length_3485_cov_128",82.028,217,31,7,6,217,312,525,5.78e-44,178,211,213
"83487","Ntome_NODE_32409_length_520_cov_25","Nsylvestris_NODE_29765_length_548_cov_11",91.154,520,28,10,1,515,528,22,0,689,514,506
"83488","Ntome_NODE_32410_length_520_cov_19","Nsylvestris_NODE_25799_length_728_cov_86",92.471,518,31,3,3,520,565,56,0,734,517,509
"83491","Ntome_NODE_32416_length_520_cov_4","Nsylvestris_NODE_17120_length_1347_cov_20",90.267,524,46,3,1,520,370,892,0,680,519,522
"83492","Ntome_NODE_32419_length_520_cov_2","Nsylvestris_NODE_1361_length_4533_cov_189",82.883,111,19,0,378,488,4270,4380,1.28e-20,100,110,110
"83498","Ntome_NODE_32422_length_519_cov_269","Nsylvestris_NODE_6283_length_2700_cov_169",95.563,293,13,0,227,519,1971,1679,8.48e-132,470,292,292
"83499","Ntome_NODE_32423_length_518_cov_200","Nsylvestris_NODE_4264_length_3159_cov_142",92.208,77,4,2,444,518,2451,2375,7.65e-23,108,74,76
"83500","Ntome_NODE_32425_length_519_cov_8","Nsylvestris_NODE_12020_length_1867_cov_165",78.244,524,104,6,1,519,1223,705,5.4e-89,327,518,518
"83501","Ntome_NODE_32427_length_519_cov_7","Nsylvestris_NODE_21527_length_990_cov_5",92.124,419,24,3,1,417,412,1,1.04e-165,582,416,411
"83508","Ntome_NODE_32436_length_518_cov_317","Nsylvestris_NODE_22568_length_917_cov_246",97.297,518,14,0,1,518,400,917,0,880,517,517
"83511","Ntome_NODE_32438_length_518_cov_236","Nsylvestris_NODE_8400_length_2340_cov_219",80.87,115,19,3,213,326,403,291,9.96e-17,87.9,113,112
"83512","Ntome_NODE_32440_length_518_cov_8","Nsylvestris_NODE_14740_length_1575_cov_216",82.955,88,13,2,236,322,182,268,5.99e-14,78.7,86,86
"83513","Ntome_NODE_32441_length_518_cov_8","Nsylvestris_NODE_31281_length_433_cov_6",87.066,317,22,10,1,302,74,386,6.92e-93,340,301,312
"83514","Ntome_NODE_32445_length_518_cov_4","Nsylvestris_NODE_20_length_11989_cov_112",81.065,507,87,4,10,516,3287,2790,1.46e-109,396,506,497
"83515","Ntome_NODE_32446_length_517_cov_304","Nsylvestris_NODE_8449_length_2333_cov_141",98.453,517,8,0,1,517,1609,1093,0,911,516,516
"83516","Ntome_NODE_32448_length_517_cov_254","Nsylvestris_NODE_3611_length_3361_cov_172",98.182,55,1,0,463,517,1509,1563,1.65e-19,97.1,54,54
"83517","Ntome_NODE_32450_length_517_cov_235","Nsylvestris_NODE_14928_length_1557_cov_183",94.872,507,24,1,1,507,1028,1532,0,791,506,504
"83520","Ntome_NODE_32452_length_517_cov_219","Nsylvestris_NODE_7795_length_2437_cov_161",94.639,485,17,4,1,485,1955,2430,0,743,484,475
"83521","Ntome_NODE_32454_length_517_cov_171","Nsylvestris_NODE_15542_length_1497_cov_202",96.296,189,7,0,329,517,152,340,5.42e-84,311,188,188
"83522","Ntome_NODE_32455_length_516_cov_28","Nsylvestris_NODE_18222_length_1248_cov_66",98.649,370,4,1,2,370,1200,831,0,654,368,369
"83523","Ntome_NODE_32459_length_517_cov_4","Nsylvestris_NODE_18420_length_1231_cov_16",83.333,108,17,1,303,409,182,75,4.59e-20,99,106,107
"83524","Ntome_NODE_32461_length_517_cov_2","Nsylvestris_NODE_731_length_5383_cov_93",96.132,517,20,0,1,517,3913,3397,0,845,516,516
"83527","Ntome_NODE_32463_length_516_cov_262","Nsylvestris_NODE_18940_length_1188_cov_199",92.979,527,25,2,1,515,1142,616,0,758,514,526
"83530","Ntome_NODE_32465_length_516_cov_256","Nsylvestris_NODE_25602_length_739_cov_49",80.061,326,21,15,60,362,682,378,3.4e-51,202,302,304
"83531","Ntome_NODE_32467_length_516_cov_245","Nsylvestris_NODE_2814_length_3657_cov_225",97.868,516,11,0,1,516,1880,1365,0,893,515,515
"83532","Ntome_NODE_32469_length_516_cov_232","Nsylvestris_NODE_26487_length_696_cov_190",92.373,236,15,3,281,516,647,415,1.15e-90,333,235,232
"83533","Ntome_NODE_32476_length_516_cov_4","Nsylvestris_NODE_12064_length_1862_cov_33",96.32,462,17,0,4,465,505,44,0,760,461,461
"83534","Ntome_NODE_32478_length_515_cov_31","Nsylvestris_NODE_313_length_6655_cov_133",82.789,459,45,22,2,432,1516,1968,1.46e-104,379,430,452
"83545","Ntome_NODE_32485_length_515_cov_4","Nsylvestris_NODE_1390_length_4504_cov_41",95.525,514,16,4,1,514,1808,2314,0,815,513,506
"83553","Ntome_NODE_32493_length_514_cov_14","Nsylvestris_NODE_22274_length_937_cov_99",84.274,496,23,8,1,441,302,797,1.1e-120,433,440,495
"83554","Ntome_NODE_32495_length_514_cov_7","Nsylvestris_NODE_23779_length_844_cov_18",96.032,378,15,0,137,514,1,378,1.02e-175,616,377,377
"83555","Ntome_NODE_32497_length_513_cov_271","Nsylvestris_NODE_658_length_5531_cov_126",84.778,519,46,17,1,513,5531,5040,6.43e-138,490,512,491
"83556","Ntome_NODE_32498_length_513_cov_242","Nsylvestris_NODE_34050_length_320_cov_215",94.485,272,14,1,242,513,271,1,3.08e-116,418,271,270
"83560","Ntome_NODE_32500_length_513_cov_178","Nsylvestris_NODE_3939_length_3254_cov_167",95.109,368,11,3,1,368,1634,1274,6.21e-163,573,367,360
"83561","Ntome_NODE_32503_length_513_cov_14","Nsylvestris_NODE_4295_length_3152_cov_16",93.798,129,8,0,180,308,312,440,5.65e-49,195,128,128
"83564","Ntome_NODE_32507_length_513_cov_4","Nsylvestris_NODE_67_length_9106_cov_194",87.091,519,57,9,1,513,1864,2378,1.33e-164,579,512,514
"83565","Ntome_NODE_32508_length_513_cov_3","Nsylvestris_NODE_15951_length_1455_cov_19",96.97,495,15,0,19,513,1,495,0,832,494,494
"83566","Ntome_NODE_32509_length_512_cov_287","Nsylvestris_NODE_11794_length_1893_cov_233",94.531,512,13,4,1,512,6,502,0,776,511,496
"83567","Ntome_NODE_32510_length_512_cov_276","Nsylvestris_NODE_6211_length_2714_cov_218",99.023,512,5,0,1,512,1104,1615,0,918,511,511
"83573","Ntome_NODE_32514_length_512_cov_11","Nsylvestris_NODE_28130_length_623_cov_100",89.734,526,28,11,5,512,586,69,0,649,507,517
"83574","Ntome_NODE_32522_length_511_cov_163","Nsylvestris_NODE_85_length_8745_cov_88",81.585,429,60,14,85,511,2276,1865,8.83e-92,337,426,411
"83575","Ntome_NODE_32523_length_511_cov_31","Nsylvestris_NODE_35102_length_292_cov_138",87.379,103,13,0,86,188,270,168,3.48e-26,119,102,102
"83576","Ntome_NODE_32526_length_511_cov_8","Nsylvestris_NODE_7906_length_2421_cov_25",93.75,512,21,4,1,511,1023,522,0,758,510,501
"83580","Ntome_NODE_32528_length_511_cov_6","Nsylvestris_NODE_34257_length_314_cov_11",95.094,265,10,3,182,445,314,52,3.97e-115,414,263,262
"83581","Ntome_NODE_32530_length_511_cov_6","Nsylvestris_NODE_12867_length_1779_cov_22",95.322,513,9,5,1,511,49,548,0,800,510,499
"83582","Ntome_NODE_32532_length_511_cov_3","Nsylvestris_NODE_11680_length_1907_cov_226",100,33,0,0,479,511,504,536,5.95e-09,62.1,32,32
"83589","Ntome_NODE_32536_length_510_cov_13","Nsylvestris_NODE_30138_length_514_cov_24",89.61,385,18,9,118,498,20,386,8.33e-132,470,380,366
"83590","Ntome_NODE_32539_length_510_cov_8","Nsylvestris_NODE_6835_length_2597_cov_209",100,33,0,0,1,33,824,792,5.94e-09,62.1,32,32
"83593","Ntome_NODE_32542_length_509_cov_328","Nsylvestris_NODE_1684_length_4268_cov_97",97.446,509,13,0,1,509,2209,2717,0,869,508,508
"83597","Ntome_NODE_32544_length_509_cov_265","Nsylvestris_NODE_12970_length_1766_cov_169",97.692,260,6,0,250,509,1766,1507,3.89e-125,448,259,259
"83615","Ntome_NODE_32557_length_508_cov_288","Nsylvestris_NODE_25764_length_730_cov_159",92.771,415,29,1,1,414,1,415,1.01e-170,599,413,414
"83616","Ntome_NODE_32558_length_508_cov_257","Nsylvestris_NODE_3213_length_3502_cov_192",93.32,509,30,2,1,508,1640,1135,0,749,507,505
"83627","Ntome_NODE_32566_length_508_cov_9","Nsylvestris_NODE_26286_length_706_cov_26",82.749,342,44,12,168,505,373,703,6.93e-78,291,337,330
"83628","Ntome_NODE_32567_length_508_cov_7","Nsylvestris_NODE_6505_length_2660_cov_47",87.5,128,16,0,31,158,384,257,4.41e-35,148,127,127
"83629","Ntome_NODE_32569_length_508_cov_6","Nsylvestris_NODE_10374_length_2065_cov_166",89.362,470,29,13,24,486,618,163,2.21e-162,571,462,455
"83633","Ntome_NODE_32576_length_507_cov_241","Nsylvestris_NODE_5003_length_2972_cov_234",96.901,484,13,1,1,482,484,1,0,809,481,483
"83648","Ntome_NODE_32585_length_507_cov_11","Nsylvestris_NODE_18201_length_1250_cov_56",84.375,448,45,11,1,440,56,486,1.09e-115,416,439,430
"83660","Ntome_NODE_32595_length_506_cov_22","Nsylvestris_NODE_25393_length_749_cov_27",85.855,509,46,9,1,505,589,103,2.91e-146,518,504,486
"83661","Ntome_NODE_32596_length_506_cov_18","Nsylvestris_NODE_31983_length_395_cov_2",85.175,371,28,12,33,378,1,369,2.41e-97,355,345,368
"83662","Ntome_NODE_32598_length_506_cov_8","Nsylvestris_NODE_16839_length_1369_cov_19",90.323,93,8,1,132,223,1364,1272,9.58e-27,121,91,92
"83696","Ntome_NODE_32611_length_505_cov_16","Nsylvestris_NODE_11230_length_1959_cov_136",100,55,0,0,1,55,644,590,3.46e-21,102,54,54
"83702","Ntome_NODE_32616_length_505_cov_6","Nsylvestris_NODE_3627_length_3356_cov_205",96.825,504,10,2,1,504,2840,3337,0,837,503,497
"83706","Ntome_NODE_32622_length_504_cov_348","Nsylvestris_NODE_2341_length_3877_cov_216",99.008,504,5,0,1,504,3497,2994,0,904,503,503
"83720","Ntome_NODE_32628_length_504_cov_113","Nsylvestris_NODE_12167_length_1851_cov_173",95.465,441,15,2,64,503,1,437,0,699,439,436
"83721","Ntome_NODE_32629_length_504_cov_13","Nsylvestris_NODE_21265_length_1009_cov_206",93.443,122,6,2,383,504,175,56,1.55e-44,180,121,119
"83730","Ntome_NODE_32640_length_503_cov_117","Nsylvestris_NODE_22621_length_914_cov_147",84.466,515,34,15,8,503,753,266,1.06e-130,466,495,487
"83731","Ntome_NODE_32645_length_502_cov_245","Nsylvestris_NODE_1791_length_4183_cov_176",95.626,503,16,4,1,502,2579,3076,0,802,501,497
"83738","Ntome_NODE_32654_length_502_cov_4","Nsylvestris_NODE_2926_length_3611_cov_103",96.593,499,14,2,6,502,1589,1092,0,824,496,497
"83749","Ntome_NODE_32659_length_501_cov_205","Nsylvestris_NODE_23589_length_854_cov_199",95.495,333,13,2,1,332,537,206,3.7e-150,531,331,331
"83752","Ntome_NODE_32666_length_501_cov_4","Nsylvestris_NODE_33516_length_336_cov_4",90.355,197,18,1,7,203,196,1,6.93e-68,257,196,195
"83759","Ntome_NODE_32669_length_500_cov_250","Nsylvestris_NODE_254_length_6984_cov_159",92.505,467,14,4,1,463,5587,5138,0,649,462,449
"83762","Ntome_NODE_32673_length_500_cov_6","Nsylvestris_NODE_1781_length_4188_cov_188",90.467,514,20,9,4,500,1793,2294,0,651,496,501
"83763","Ntome_NODE_32674_length_500_cov_6","Nsylvestris_NODE_1764_length_4205_cov_87",95.8,500,21,0,1,500,2937,2438,0,808,499,499
"83764","Ntome_NODE_32676_length_500_cov_6","Nsylvestris_NODE_25702_length_734_cov_39",95.8,500,21,0,1,500,193,692,0,808,499,499
"83774","Ntome_NODE_32683_length_499_cov_246","Nsylvestris_NODE_11799_length_1893_cov_118",89.167,360,22,6,136,483,1504,1858,1.07e-120,433,347,354
"83775","Ntome_NODE_32684_length_499_cov_234","Nsylvestris_NODE_28723_length_596_cov_187",92.402,408,15,6,104,499,48,451,2.81e-161,568,395,403
"83776","Ntome_NODE_32685_length_499_cov_232","Nsylvestris_NODE_5097_length_2949_cov_228",91.039,491,25,10,11,499,2946,2473,0,645,488,473
"83779","Ntome_NODE_32688_length_499_cov_203","Nsylvestris_NODE_23045_length_888_cov_169",94.236,347,20,0,1,347,400,54,3.68e-150,531,346,346
"83780","Ntome_NODE_32689_length_499_cov_162","Nsylvestris_NODE_2721_length_3696_cov_166",85.099,302,30,11,178,476,1527,1238,5.26e-79,294,298,289
"83788","Ntome_NODE_32697_length_499_cov_7","Nsylvestris_NODE_237_length_7070_cov_115",91.499,447,13,6,56,499,3455,3031,1.66e-168,592,443,424
"83793","Ntome_NODE_32703_length_498_cov_125","Nsylvestris_NODE_1071_length_4854_cov_182",93.789,161,8,2,126,285,2786,2945,6.93e-63,241,159,159
"83800","Ntome_NODE_32707_length_498_cov_2","Nsylvestris_NODE_8767_length_2285_cov_28",94.534,494,27,0,1,494,619,1112,0,763,493,493
"83813","Ntome_NODE_32710_length_497_cov_241","Nsylvestris_NODE_33585_length_334_cov_5",87.9,281,19,8,217,497,1,266,1.12e-85,316,280,265
"83817","Ntome_NODE_32713_length_497_cov_14","Nsylvestris_NODE_23779_length_844_cov_18",96.41,390,14,0,1,390,367,756,0,643,389,389
"83818","Ntome_NODE_32715_length_497_cov_11","Nsylvestris_NODE_1827_length_4160_cov_61",82.734,417,27,19,108,497,3798,3400,1.44e-89,329,389,398
"83819","Ntome_NODE_32717_length_497_cov_7","Nsylvestris_NODE_20664_length_1052_cov_219",89.136,405,44,0,86,490,256,660,2.22e-142,505,404,404
"83820","Ntome_NODE_32718_length_497_cov_4","Nsylvestris_NODE_1518_length_4385_cov_78",78.782,476,88,6,28,495,2387,1917,6.72e-83,307,467,470
"83821","Ntome_NODE_32721_length_497_cov_2","Nsylvestris_NODE_22168_length_944_cov_16",95.976,497,20,0,1,497,256,752,0,808,496,496
"83825","Ntome_NODE_32724_length_496_cov_227","Nsylvestris_NODE_725_length_5395_cov_89",95.161,496,20,2,1,496,727,1218,0,780,495,491
"83834","Ntome_NODE_32727_length_496_cov_131","Nsylvestris_NODE_28229_length_618_cov_145",95.172,290,12,2,117,404,47,336,6.3e-128,457,287,289
"83835","Ntome_NODE_32728_length_496_cov_62","Nsylvestris_NODE_29906_length_535_cov_163",91.515,495,29,12,2,491,511,25,0,669,489,486
"83838","Ntome_NODE_32730_length_496_cov_14","Nsylvestris_NODE_35923_length_275_cov_3",96.538,260,7,2,220,478,259,1,1.37e-119,429,258,258
"83839","Ntome_NODE_32731_length_496_cov_10","Nsylvestris_NODE_31957_length_395_cov_11",97.368,114,3,0,383,496,247,134,5.45e-49,195,113,113
"83840","Ntome_NODE_32732_length_496_cov_9","Nsylvestris_NODE_29954_length_532_cov_6",90.549,455,32,7,1,447,452,1,1.65e-168,592,446,451
"83841","Ntome_NODE_32735_length_496_cov_5","Nsylvestris_NODE_16559_length_1395_cov_28",96.371,496,14,2,1,496,1351,860,0,813,495,491
"83842","Ntome_NODE_32736_length_496_cov_5","Nsylvestris_NODE_7765_length_2443_cov_69",91.182,499,31,5,3,492,1659,1165,0,665,489,494
"83845","Ntome_NODE_32739_length_495_cov_223","Nsylvestris_NODE_7681_length_2454_cov_67",90.582,361,32,2,135,494,1815,2174,4.82e-134,477,359,359
"83851","Ntome_NODE_32747_length_495_cov_7","Nsylvestris_NODE_5564_length_2850_cov_40",76.8,375,61,15,1,366,843,486,9.1e-47,187,365,357
"83861","Ntome_NODE_32752_length_495_cov_4","Nsylvestris_NODE_22076_length_951_cov_8",83.106,367,32,10,134,495,951,610,6.7e-83,307,361,341
"83875","Ntome_NODE_32762_length_494_cov_10","Nsylvestris_NODE_28731_length_596_cov_44",85.193,466,56,10,33,494,54,510,1.04e-130,466,461,456
"83890","Ntome_NODE_32773_length_493_cov_168","Nsylvestris_NODE_17302_length_1331_cov_208",91.154,260,14,7,1,253,258,1,5.08e-94,344,252,257
"83891","Ntome_NODE_32775_length_493_cov_28","Nsylvestris_NODE_305_length_6696_cov_117",91.875,160,13,0,334,493,6520,6679,6.91e-58,224,159,159
"83896","Ntome_NODE_32781_length_493_cov_6","Nsylvestris_NODE_3737_length_3306_cov_55",87.5,104,6,4,1,97,948,1051,1.56e-24,113,96,103
"83900","Ntome_NODE_32788_length_493_cov_2","Nsylvestris_NODE_22566_length_918_cov_5",90.239,461,35,8,39,493,1,457,4.57e-169,593,454,456
"83908","Ntome_NODE_32792_length_492_cov_84","Nsylvestris_NODE_6373_length_2684_cov_149",95.575,113,5,0,1,113,643,531,4.21e-45,182,112,112
"83909","Ntome_NODE_32793_length_492_cov_27","Nsylvestris_NODE_1539_length_4370_cov_181",85.668,307,26,8,93,386,3862,4163,6.65e-83,307,293,301
"83910","Ntome_NODE_32794_length_492_cov_27","Nsylvestris_NODE_23453_length_863_cov_26",83.516,182,28,2,289,469,396,576,3.28e-41,169,180,180
"83911","Ntome_NODE_32797_length_492_cov_12","Nsylvestris_NODE_30620_length_477_cov_10",93.96,447,22,4,41,484,477,33,0,671,443,444
"83912","Ntome_NODE_32799_length_492_cov_8","Nsylvestris_NODE_2502_length_3793_cov_20",94.512,492,27,0,1,492,605,1096,0,760,491,491
"83913","Ntome_NODE_32804_length_492_cov_4","Nsylvestris_NODE_12547_length_1810_cov_12",98.577,492,7,0,1,492,75,566,0,870,491,491
"83919","Ntome_NODE_32807_length_491_cov_231","Nsylvestris_NODE_11618_length_1917_cov_164",90.368,353,8,10,104,438,59,403,6.27e-123,440,334,344
"83931","Ntome_NODE_32814_length_491_cov_5","Nsylvestris_NODE_15547_length_1497_cov_13",88.889,72,5,2,299,367,153,82,3.39e-16,86.1,68,71
"83937","Ntome_NODE_32818_length_490_cov_171","Nsylvestris_NODE_563_length_5793_cov_227",90,390,26,7,62,443,5358,5742,1.7e-138,492,381,384
"83938","Ntome_NODE_32820_length_490_cov_52","Nsylvestris_NODE_4121_length_3195_cov_193",93.224,487,27,4,4,489,76,557,0,712,485,481
"83945","Ntome_NODE_32825_length_490_cov_6","Nsylvestris_NODE_14849_length_1565_cov_9",95.671,231,9,1,3,233,58,287,8.33e-102,370,230,229
"83948","Ntome_NODE_32832_length_490_cov_3","Nsylvestris_NODE_15892_length_1461_cov_28",96.531,490,15,2,2,490,55,543,0,809,488,488
"83951","Ntome_NODE_32834_length_489_cov_273","Nsylvestris_NODE_944_length_5028_cov_210",96.881,481,15,0,1,481,3348,2868,0,806,480,480
"83955","Ntome_NODE_32836_length_489_cov_192","Nsylvestris_NODE_27004_length_672_cov_30",84.519,239,32,4,85,320,668,432,4.09e-60,231,235,236
"83958","Ntome_NODE_32839_length_489_cov_25","Nsylvestris_NODE_22069_length_951_cov_32",91.2,125,11,0,207,331,640,764,9.05e-42,171,124,124
"83959","Ntome_NODE_32843_length_489_cov_5","Nsylvestris_NODE_2352_length_3869_cov_60",97.692,130,3,0,360,489,3060,2931,6.85e-58,224,129,129
"83960","Ntome_NODE_32844_length_487_cov_4","Nsylvestris_NODE_12899_length_1775_cov_65",81.017,295,49,7,174,463,1158,866,5.27e-59,228,289,292
"83975","Ntome_NODE_32857_length_488_cov_5","Nsylvestris_NODE_8033_length_2398_cov_26",88.471,399,13,5,120,488,254,649,2.88e-126,451,368,395
"83976","Ntome_NODE_32858_length_488_cov_4","Nsylvestris_NODE_1624_length_4314_cov_47",87.309,457,50,8,36,488,4271,3819,1.01e-145,516,452,452
"83981","Ntome_NODE_32863_length_487_cov_247","Nsylvestris_NODE_21788_length_970_cov_201",96.729,428,11,3,62,487,926,500,0,710,425,426
"83986","Ntome_NODE_32870_length_487_cov_9","Nsylvestris_NODE_13987_length_1651_cov_133",83.693,417,61,7,44,457,878,466,8.22e-107,387,413,412
"83987","Ntome_NODE_32871_length_487_cov_7","Nsylvestris_NODE_8946_length_2258_cov_35",97.228,469,13,0,16,484,107,575,0,795,468,468
"83988","Ntome_NODE_32872_length_487_cov_7","Nsylvestris_NODE_24490_length_801_cov_69",100,34,0,0,401,434,535,568,1.57e-09,63.9,33,33
"83989","Ntome_NODE_32873_length_487_cov_5","Nsylvestris_NODE_23060_length_887_cov_121",93.204,103,7,0,384,486,592,694,3.26e-36,152,102,102
"83990","Ntome_NODE_32877_length_487_cov_3","Nsylvestris_NODE_6338_length_2692_cov_86",86.931,505,41,18,3,487,1286,1785,4.61e-154,544,484,499
"83991","Ntome_NODE_32878_length_487_cov_2","Nsylvestris_NODE_641_length_5582_cov_124",90.632,459,37,4,30,487,1715,2168,2.08e-172,604,457,453
"83992","Ntome_NODE_32879_length_486_cov_315","Nsylvestris_NODE_10182_length_2090_cov_228",97.942,486,10,0,1,486,1052,1537,0,843,485,485
"83993","Ntome_NODE_32881_length_486_cov_168","Nsylvestris_NODE_19701_length_1127_cov_141",83.333,108,18,0,368,475,47,154,1.2e-20,100,107,107
"83994","Ntome_NODE_32883_length_486_cov_17","Nsylvestris_NODE_32838_length_359_cov_3",87.97,266,32,0,205,470,349,84,3.92e-85,315,265,265
"83995","Ntome_NODE_32888_length_485_cov_301","Nsylvestris_NODE_4007_length_3231_cov_195",94.545,440,12,3,48,485,122,551,0,669,437,429
"84001","Ntome_NODE_32891_length_485_cov_259","Nsylvestris_NODE_9179_length_2226_cov_105",94.186,430,16,4,3,431,2035,1614,0,647,428,421
"84008","Ntome_NODE_32901_length_484_cov_3","Nsylvestris_NODE_22887_length_898_cov_22",83.431,513,46,18,1,482,799,295,6.18e-123,440,481,504
"84013","Ntome_NODE_32904_length_484_cov_263","Nsylvestris_NODE_9615_length_2162_cov_237",99.38,484,3,0,1,484,642,1125,0,878,483,483
"84020","Ntome_NODE_32907_length_484_cov_122","Nsylvestris_NODE_4440_length_3112_cov_46",92.36,445,32,2,41,484,721,278,0,632,443,443
"84023","Ntome_NODE_32909_length_484_cov_15","Nsylvestris_NODE_28263_length_616_cov_14",87.931,522,19,12,1,484,595,80,1.62e-163,575,483,515
"84029","Ntome_NODE_32914_length_484_cov_5","Nsylvestris_NODE_8943_length_2258_cov_101",96.466,481,17,0,1,481,1440,1920,0,795,480,480
"84030","Ntome_NODE_32915_length_484_cov_4","Nsylvestris_NODE_35_length_10031_cov_87",89.72,107,7,2,2,105,5632,5527,1.17e-30,134,103,105
"84031","Ntome_NODE_32917_length_483_cov_345","Nsylvestris_NODE_16434_length_1406_cov_212",92.063,126,9,1,3,128,325,201,1.92e-43,176,125,124
"84034","Ntome_NODE_32919_length_483_cov_250","Nsylvestris_NODE_14820_length_1567_cov_208",88.632,475,36,12,17,483,1360,896,1.26e-159,562,466,464
"84035","Ntome_NODE_32921_length_483_cov_213","Nsylvestris_NODE_10968_length_1991_cov_223",96.632,386,8,4,1,382,1574,1958,0,636,381,384
"84043","Ntome_NODE_32924_length_483_cov_39","Nsylvestris_NODE_20788_length_1044_cov_34",91.832,404,25,5,26,428,402,6,5.87e-158,556,402,396
"84047","Ntome_NODE_32928_length_483_cov_7","Nsylvestris_NODE_46_length_9533_cov_130",86.423,383,35,6,1,373,7709,8084,8.09e-112,403,372,375
"84048","Ntome_NODE_32930_length_483_cov_5","Nsylvestris_NODE_12677_length_1798_cov_102",91.429,490,34,3,1,483,1195,1683,0,665,482,488
"84051","Ntome_NODE_32932_length_483_cov_4","Nsylvestris_NODE_233_length_7091_cov_109",84.821,224,12,5,43,247,5800,5580,2.45e-52,206,204,220
"84052","Ntome_NODE_32933_length_483_cov_4","Nsylvestris_NODE_4713_length_3042_cov_55",95.807,477,17,1,6,482,2034,1561,0,767,476,473
"84053","Ntome_NODE_32935_length_482_cov_291","Nsylvestris_NODE_13151_length_1744_cov_114",97.032,438,7,2,1,435,1207,1641,0,732,434,434
"84054","Ntome_NODE_32936_length_482_cov_246","Nsylvestris_NODE_11695_length_1905_cov_222",94.186,344,17,1,1,344,482,142,2.14e-147,521,343,340
"84060","Ntome_NODE_32941_length_482_cov_6","Nsylvestris_NODE_21430_length_997_cov_19",83,500,26,27,3,450,994,502,3.76e-110,398,447,492
"84061","Ntome_NODE_32944_length_482_cov_4","Nsylvestris_NODE_28456_length_604_cov_5",91.765,255,18,3,229,482,443,191,2.97e-96,351,253,252
"84062","Ntome_NODE_32947_length_481_cov_291","Nsylvestris_NODE_19839_length_1114_cov_205",93.168,322,15,3,1,315,696,375,1.01e-130,466,314,321
"84063","Ntome_NODE_32948_length_481_cov_268","Nsylvestris_NODE_19002_length_1183_cov_187",96.652,448,15,0,34,481,944,497,0,745,447,447
"84064","Ntome_NODE_32949_length_481_cov_262","Nsylvestris_NODE_20867_length_1037_cov_179",96.849,476,12,3,6,481,925,453,0,793,475,472
"84067","Ntome_NODE_32951_length_481_cov_165","Nsylvestris_NODE_19077_length_1177_cov_112",96.899,387,12,0,1,387,439,53,0,649,386,386
"84075","Ntome_NODE_32958_length_481_cov_6","Nsylvestris_NODE_3019_length_3579_cov_52",93.958,480,26,2,1,480,1907,1431,0,723,479,476
"84076","Ntome_NODE_32961_length_481_cov_4","Nsylvestris_NODE_29797_length_545_cov_6",88.337,463,26,14,28,473,93,544,3.54e-150,531,445,451
"84077","Ntome_NODE_32963_length_481_cov_3","Nsylvestris_NODE_11993_length_1870_cov_205",96.429,56,2,0,1,56,743,688,1.98e-18,93.5,55,55
"84085","Ntome_NODE_32966_length_480_cov_199","Nsylvestris_NODE_8639_length_2302_cov_223",98.182,55,1,0,426,480,1456,1402,1.53e-19,97.1,54,54
"84095","Ntome_NODE_32976_length_480_cov_4","Nsylvestris_NODE_9873_length_2131_cov_17",95.914,465,19,0,1,465,668,204,0,754,464,464
"84096","Ntome_NODE_32977_length_480_cov_4","Nsylvestris_NODE_18093_length_1260_cov_64",95.082,488,15,1,1,479,718,1205,0,760,478,487
"84100","Ntome_NODE_32980_length_480_cov_2","Nsylvestris_NODE_8232_length_2367_cov_106",94.248,452,14,7,1,447,1923,2367,0,680,446,444
"84101","Ntome_NODE_32981_length_479_cov_314","Nsylvestris_NODE_9499_length_2178_cov_108",97.077,479,14,0,1,479,432,910,0,808,478,478
"84104","Ntome_NODE_32983_length_479_cov_88","Nsylvestris_NODE_10152_length_2095_cov_102",91.525,59,4,1,372,430,2095,2038,1.53e-14,80.5,58,57
"84105","Ntome_NODE_32989_length_479_cov_7","Nsylvestris_NODE_6292_length_2698_cov_12",94.572,479,25,1,1,478,754,276,0,739,477,478
"84106","Ntome_NODE_32992_length_478_cov_320","Nsylvestris_NODE_12869_length_1778_cov_218",98.745,478,6,0,1,478,813,1290,0,850,477,477
"84107","Ntome_NODE_32993_length_478_cov_308","Nsylvestris_NODE_1125_length_4786_cov_219",98.117,478,9,0,1,478,2039,2516,0,833,477,477
"84108","Ntome_NODE_32994_length_478_cov_6","Nsylvestris_NODE_29864_length_539_cov_24",77.46,315,51,16,100,398,141,451,8.83e-42,171,298,310
"84109","Ntome_NODE_32996_length_478_cov_4","Nsylvestris_NODE_6674_length_2627_cov_24",97.49,478,12,0,1,478,2260,1783,0,817,477,477
"84117","Ntome_NODE_33003_length_477_cov_195","Nsylvestris_NODE_4205_length_3174_cov_185",94.545,55,2,1,423,477,1553,1606,1.18e-15,84.2,54,53
"84120","Ntome_NODE_33007_length_476_cov_9","Nsylvestris_NODE_11454_length_1936_cov_9",86.749,483,41,11,1,476,781,315,9.81e-146,516,475,466
"84123","Ntome_NODE_33011_length_477_cov_5","Nsylvestris_NODE_18234_length_1248_cov_94",89.93,427,19,9,52,475,1160,755,1.26e-149,529,423,405
"84127","Ntome_NODE_33014_length_477_cov_2","Nsylvestris_NODE_4004_length_3232_cov_132",94.845,97,5,0,1,97,2736,2832,3.19e-36,152,96,96
"84128","Ntome_NODE_33015_length_476_cov_330","Nsylvestris_NODE_9114_length_2234_cov_211",97.689,476,11,0,1,476,728,1203,0,819,475,475
"84136","Ntome_NODE_33020_length_476_cov_95","Nsylvestris_NODE_3099_length_3543_cov_226",96.364,55,2,0,1,55,224,170,7.04e-18,91.6,54,54
"84140","Ntome_NODE_33024_length_476_cov_9","Nsylvestris_NODE_32296_length_381_cov_158",95.545,202,8,1,83,284,56,256,2.29e-87,322,201,200
"84146","Ntome_NODE_33033_length_475_cov_219","Nsylvestris_NODE_13865_length_1666_cov_220",94.737,456,19,2,1,455,456,5,0,704,454,451
"84154","Ntome_NODE_33038_length_475_cov_9","Nsylvestris_NODE_34610_length_305_cov_3",96.226,53,2,0,3,55,53,1,9.09e-17,87.9,52,52
"84157","Ntome_NODE_33041_length_475_cov_4","Nsylvestris_NODE_11157_length_1968_cov_20",88.057,494,33,10,1,473,1781,1293,1.24e-159,562,472,488
"84169","Ntome_NODE_33055_length_473_cov_211","Nsylvestris_NODE_18887_length_1195_cov_90",95.298,319,13,1,50,368,882,566,2.11e-142,505,318,316
"84170","Ntome_NODE_33057_length_473_cov_19","Nsylvestris_NODE_29681_length_555_cov_18",87.719,171,20,1,3,172,403,233,4.01e-50,198,169,170
"84174","Ntome_NODE_33060_length_473_cov_9","Nsylvestris_NODE_565_length_5790_cov_105",84.141,227,29,6,241,461,1486,1711,1.43e-54,213,220,225
"84177","Ntome_NODE_33062_length_473_cov_4","Nsylvestris_NODE_3890_length_3271_cov_159",100,28,0,0,41,68,1482,1455,3.3e-06,52.8,27,27
"84178","Ntome_NODE_33063_length_473_cov_4","Nsylvestris_NODE_2058_length_4019_cov_229",100,33,0,0,441,473,2361,2393,5.49e-09,62.1,32,32
"84179","Ntome_NODE_33064_length_473_cov_4","Nsylvestris_NODE_30520_length_484_cov_10",95.181,83,4,0,280,362,83,1,4.12e-30,132,82,82
"84182","Ntome_NODE_33066_length_473_cov_3","Nsylvestris_NODE_923_length_5059_cov_127",91.892,74,6,0,394,467,2404,2477,8.99e-22,104,73,73
"84183","Ntome_NODE_33069_length_472_cov_331","Nsylvestris_NODE_3337_length_3460_cov_237",97.034,472,14,0,1,472,2791,3262,0,795,471,471
"84184","Ntome_NODE_33070_length_472_cov_245","Nsylvestris_NODE_18437_length_1229_cov_114",93.556,419,27,0,52,470,740,322,1.55e-178,625,418,418
"84185","Ntome_NODE_33071_length_472_cov_190","Nsylvestris_NODE_23794_length_843_cov_139",87.5,264,11,6,1,261,523,279,2.98e-76,285,260,244
"84186","Ntome_NODE_33074_length_472_cov_9","Nsylvestris_NODE_30055_length_523_cov_8",92.632,95,7,0,89,183,276,370,8.84e-32,137,94,94
"84191","Ntome_NODE_33082_length_470_cov_272","Nsylvestris_NODE_8589_length_2311_cov_189",93.989,366,14,4,104,469,1477,1834,3.43e-155,547,365,357
"84194","Ntome_NODE_33089_length_471_cov_4","Nsylvestris_NODE_30817_length_463_cov_4",95.749,447,11,2,33,471,5,451,0,713,438,446
"84205","Ntome_NODE_33096_length_470_cov_183","Nsylvestris_NODE_5655_length_2826_cov_233",90.725,345,11,7,1,328,2486,2826,5.99e-123,440,327,340
"84212","Ntome_NODE_33102_length_469_cov_316","Nsylvestris_NODE_6505_length_2660_cov_47",95.096,469,23,0,1,469,871,403,0,739,468,468
"84215","Ntome_NODE_33104_length_469_cov_279","Nsylvestris_NODE_25377_length_750_cov_189",96.905,420,13,0,50,469,618,199,0,704,419,419
"84219","Ntome_NODE_33106_length_469_cov_98","Nsylvestris_NODE_2007_length_4049_cov_178",90.147,477,15,8,4,469,3590,4045,1.56e-168,592,465,455
"84220","Ntome_NODE_33108_length_469_cov_24","Nsylvestris_NODE_12723_length_1793_cov_175",100,44,0,0,426,469,1332,1375,4.17e-15,82.4,43,43
"84221","Ntome_NODE_33109_length_469_cov_21","Nsylvestris_NODE_11835_length_1888_cov_80",90.476,147,12,1,224,370,145,1,1.85e-48,193,146,144
"84224","Ntome_NODE_33112_length_469_cov_10","Nsylvestris_NODE_1752_length_4213_cov_121",93.243,444,28,1,1,442,1147,1590,0,652,441,443
"84225","Ntome_NODE_33114_length_469_cov_8","Nsylvestris_NODE_9985_length_2118_cov_23",95.494,466,21,0,3,468,771,1236,0,745,465,465
"84226","Ntome_NODE_33117_length_469_cov_4","Nsylvestris_NODE_10543_length_2045_cov_14",95.075,467,20,1,3,469,888,425,0,732,466,463
"84227","Ntome_NODE_33119_length_469_cov_3","Nsylvestris_NODE_16841_length_1369_cov_14",97.228,469,12,1,1,469,1031,564,0,793,468,467
"84241","Ntome_NODE_33124_length_468_cov_15","Nsylvestris_NODE_8140_length_2378_cov_42",94.34,53,2,1,414,466,1496,1547,1.5e-14,80.5,52,51
"84244","Ntome_NODE_33135_length_467_cov_232","Nsylvestris_NODE_16667_length_1384_cov_154",95.166,331,16,0,137,467,584,914,5.74e-148,523,330,330
"84245","Ntome_NODE_33136_length_467_cov_210","Nsylvestris_NODE_10048_length_2110_cov_219",91.111,315,22,4,154,467,2074,1765,2.16e-117,422,313,309
"84251","Ntome_NODE_33139_length_467_cov_15","Nsylvestris_NODE_7617_length_2468_cov_191",100,35,0,0,364,398,679,713,4.18e-10,65.8,34,34
"84252","Ntome_NODE_33140_length_467_cov_13","Nsylvestris_NODE_11138_length_1971_cov_40",93.376,468,29,2,1,467,11,477,0,691,466,466
"84253","Ntome_NODE_33146_length_467_cov_4","Nsylvestris_NODE_3200_length_3506_cov_27",91.543,473,28,7,1,467,2562,3028,0,641,466,466
"84254","Ntome_NODE_33148_length_466_cov_285","Nsylvestris_NODE_19839_length_1114_cov_205",97.59,332,8,0,1,332,642,973,7.26e-162,569,331,331
"84255","Ntome_NODE_33151_length_466_cov_217","Nsylvestris_NODE_6431_length_2672_cov_217",95.165,393,14,4,1,393,2191,2578,9.19e-176,616,392,387
"84256","Ntome_NODE_33152_length_466_cov_108","Nsylvestris_NODE_25312_length_754_cov_26",89.13,276,24,3,195,466,288,15,2.23e-92,339,271,273
"84257","Ntome_NODE_33154_length_466_cov_21","Nsylvestris_NODE_5249_length_2916_cov_85",84.514,381,28,13,1,361,2547,2916,3.7e-95,348,360,369
"84264","Ntome_NODE_33163_length_466_cov_3","Nsylvestris_NODE_2678_length_3712_cov_190",99.785,466,1,0,1,466,1908,1443,0,856,465,465
"84271","Ntome_NODE_33168_length_465_cov_16","Nsylvestris_NODE_15768_length_1473_cov_54",94.928,414,20,1,6,418,1282,869,0,647,412,413
"84277","Ntome_NODE_33173_length_465_cov_8","Nsylvestris_NODE_31369_length_427_cov_220",96.573,321,11,0,91,411,55,375,9.5e-151,532,320,320
"84280","Ntome_NODE_33180_length_465_cov_3","Nsylvestris_NODE_7684_length_2456_cov_172",94.194,465,25,2,2,465,2171,1708,0,708,463,463
"84281","Ntome_NODE_33181_length_466_cov_2","Nsylvestris_NODE_11262_length_1955_cov_223",97.98,99,2,0,1,99,449,547,2.39e-42,172,98,98
"84286","Ntome_NODE_33184_length_464_cov_14","Nsylvestris_NODE_16164_length_1432_cov_196",82.729,469,75,4,2,464,336,804,1.29e-114,412,462,468
"84290","Ntome_NODE_33186_length_464_cov_9","Nsylvestris_NODE_4290_length_3154_cov_88",82.949,217,36,1,67,282,711,927,5.08e-49,195,215,216
"84291","Ntome_NODE_33187_length_464_cov_7","Nsylvestris_NODE_27859_length_635_cov_18",88.352,352,38,1,57,408,395,47,7.7e-117,420,351,348
"84292","Ntome_NODE_33190_length_464_cov_5","Nsylvestris_NODE_1613_length_4320_cov_178",98.276,464,8,0,1,464,2270,1807,0,813,463,463
"84293","Ntome_NODE_33192_length_463_cov_300","Nsylvestris_NODE_8857_length_2270_cov_237",95.623,297,12,1,167,463,1,296,1.62e-133,475,296,295
"84299","Ntome_NODE_33195_length_463_cov_253","Nsylvestris_NODE_6498_length_2660_cov_219",88.337,463,17,14,35,463,722,1181,2.05e-147,521,428,459
"84300","Ntome_NODE_33196_length_463_cov_209","Nsylvestris_NODE_25989_length_719_cov_69",94.012,334,20,0,83,416,50,383,5.73e-143,507,333,333
"84301","Ntome_NODE_33197_length_463_cov_189","Nsylvestris_NODE_14740_length_1575_cov_216",83.696,92,14,1,163,253,176,267,3.18e-16,86.1,90,91
"84305","Ntome_NODE_33199_length_463_cov_19","Nsylvestris_NODE_23083_length_886_cov_21",86.957,276,33,3,155,428,611,885,6.24e-83,307,273,274
"84309","Ntome_NODE_33203_length_463_cov_10","Nsylvestris_NODE_7906_length_2421_cov_25",93.261,460,22,7,4,455,537,79,0,669,451,458
"84310","Ntome_NODE_33204_length_463_cov_10","Nsylvestris_NODE_15829_length_1465_cov_86",90.132,456,34,4,8,463,427,871,9.26e-166,582,455,444
"84318","Ntome_NODE_33213_length_462_cov_13","Nsylvestris_NODE_25912_length_723_cov_12",95.72,257,11,0,1,257,379,123,3.57e-115,414,256,256
"84329","Ntome_NODE_33222_length_462_cov_4","Nsylvestris_NODE_23583_length_855_cov_11",92.537,469,24,5,1,461,556,91,0,662,460,465
"84330","Ntome_NODE_33224_length_462_cov_3","Nsylvestris_NODE_24790_length_784_cov_7",94.231,468,20,4,1,462,730,264,0,708,461,466
"84342","Ntome_NODE_33231_length_461_cov_88","Nsylvestris_NODE_28486_length_606_cov_92",91.589,214,14,3,209,422,1,210,1.74e-78,292,213,209
"84343","Ntome_NODE_33232_length_461_cov_37","Nsylvestris_NODE_23938_length_836_cov_12",92.473,93,7,0,65,157,1,93,1.12e-30,134,92,92
"84344","Ntome_NODE_33234_length_461_cov_11","Nsylvestris_NODE_18815_length_1200_cov_194",95.833,48,2,0,414,461,490,537,5.3e-14,78.7,47,47
"84345","Ntome_NODE_33235_length_461_cov_7","Nsylvestris_NODE_32767_length_361_cov_7",95.989,349,11,1,109,457,346,1,3.34e-160,564,348,345
"84348","Ntome_NODE_33239_length_461_cov_5","Nsylvestris_NODE_16023_length_1448_cov_18",96.312,461,17,0,1,461,874,1334,0,758,460,460
"84351","Ntome_NODE_33242_length_460_cov_4","Nsylvestris_NODE_5945_length_2770_cov_132",84.946,372,47,6,65,433,953,1318,2.8e-101,368,368,365
"84352","Ntome_NODE_33243_length_461_cov_4","Nsylvestris_NODE_415_length_6229_cov_48",98.048,461,9,0,1,461,2583,3043,0,802,460,460
"84353","Ntome_NODE_33245_length_461_cov_4","Nsylvestris_NODE_2276_length_3904_cov_67",89.063,384,15,9,95,461,995,622,2.71e-126,451,366,373
"84369","Ntome_NODE_33252_length_460_cov_198","Nsylvestris_NODE_15924_length_1458_cov_42",89.391,443,42,4,1,441,519,958,7.21e-157,553,440,439
"84375","Ntome_NODE_33261_length_459_cov_268","Nsylvestris_NODE_20303_length_1077_cov_187",96.135,414,15,1,1,413,497,910,0,675,412,413
"84376","Ntome_NODE_33262_length_459_cov_258","Nsylvestris_NODE_453_length_6090_cov_227",93.435,457,17,3,16,459,3,459,0,665,443,456
"84383","Ntome_NODE_33267_length_459_cov_11","Nsylvestris_NODE_30776_length_466_cov_14",93.705,413,22,3,2,410,413,1,9.04e-176,616,408,412
"84386","Ntome_NODE_33272_length_459_cov_6","Nsylvestris_NODE_7574_length_2473_cov_152",100,35,0,0,1,35,2165,2131,4.11e-10,65.8,34,34
"84387","Ntome_NODE_33273_length_459_cov_5","Nsylvestris_NODE_30348_length_498_cov_10",95.842,457,18,1,3,459,10,465,0,737,456,455
"84395","Ntome_NODE_33283_length_458_cov_12","Nsylvestris_NODE_25936_length_722_cov_11",93.689,412,21,4,19,426,455,45,1.17e-174,612,407,410
"84396","Ntome_NODE_33285_length_458_cov_8","Nsylvestris_NODE_1512_length_4390_cov_53",92.593,81,3,3,381,458,2191,2271,1.44e-24,113,77,80
"84397","Ntome_NODE_33287_length_458_cov_6","Nsylvestris_NODE_15512_length_1501_cov_13",94.077,287,15,2,172,458,1058,774,2.71e-121,435,286,284
"84401","Ntome_NODE_33291_length_458_cov_5","Nsylvestris_NODE_5938_length_2773_cov_35",88.53,279,18,1,193,457,131,409,1.7e-88,326,264,278
"84402","Ntome_NODE_33292_length_458_cov_3","Nsylvestris_NODE_19183_length_1169_cov_30",84.632,462,47,9,1,456,270,713,2.1e-122,438,455,443
"84403","Ntome_NODE_33294_length_457_cov_303","Nsylvestris_NODE_2341_length_3877_cov_216",96.718,457,15,0,1,457,2210,1754,0,761,456,456
"84406","Ntome_NODE_33297_length_457_cov_13","Nsylvestris_NODE_6851_length_2594_cov_32",91.87,123,10,0,335,457,287,165,2.34e-42,172,122,122
"84410","Ntome_NODE_33304_length_457_cov_4","Nsylvestris_NODE_25133_length_764_cov_55",95.624,457,18,2,1,457,495,41,0,732,456,454
"84423","Ntome_NODE_33313_length_456_cov_11","Nsylvestris_NODE_22729_length_907_cov_8",89.579,451,34,3,6,456,1,438,4.27e-159,560,450,437
"84428","Ntome_NODE_33321_length_456_cov_5","Nsylvestris_NODE_18603_length_1217_cov_62",91.353,451,39,0,3,453,262,712,2.5e-176,617,450,450
"84429","Ntome_NODE_33322_length_456_cov_4","Nsylvestris_NODE_24163_length_822_cov_10",91.304,161,10,2,289,448,474,317,1.06e-55,217,159,157
"84433","Ntome_NODE_33325_length_455_cov_242","Nsylvestris_NODE_3167_length_3519_cov_213",97.5,440,11,0,1,440,456,17,0,752,439,439
"84441","Ntome_NODE_33330_length_455_cov_165","Nsylvestris_NODE_17950_length_1272_cov_38",95.012,401,7,3,63,455,1203,808,2.49e-176,617,392,395
"84442","Ntome_NODE_33331_length_455_cov_37","Nsylvestris_NODE_33742_length_329_cov_36",90.036,281,10,10,107,385,271,7,3.61e-95,348,278,264
"84452","Ntome_NODE_33335_length_455_cov_7","Nsylvestris_NODE_21573_length_987_cov_8",89.352,432,37,5,8,438,283,706,2.58e-151,534,430,423
"84453","Ntome_NODE_33337_length_455_cov_7","Nsylvestris_NODE_10378_length_2065_cov_14",89.625,453,24,4,1,452,476,906,1.98e-157,555,451,430
"84457","Ntome_NODE_33342_length_455_cov_3","Nsylvestris_NODE_835_length_5180_cov_93",96.053,456,12,4,1,454,999,1450,0,737,453,451
"84465","Ntome_NODE_33349_length_454_cov_275","Nsylvestris_NODE_4198_length_3176_cov_225",94.581,406,21,1,1,406,505,101,4.13e-179,627,405,404
"84468","Ntome_NODE_33351_length_454_cov_257","Nsylvestris_NODE_6750_length_2613_cov_142",97.602,417,6,2,39,454,2017,2430,0,712,415,413
"84469","Ntome_NODE_33356_length_454_cov_5","Nsylvestris_NODE_519_length_5903_cov_73",96.667,60,2,0,131,190,2238,2297,1.11e-20,100,59,59
"84470","Ntome_NODE_33358_length_454_cov_4","Nsylvestris_NODE_2625_length_3730_cov_103",96.744,430,14,0,1,430,813,1242,0,717,429,429
"84471","Ntome_NODE_33359_length_454_cov_4","Nsylvestris_NODE_6470_length_2666_cov_21",81.223,458,65,14,6,450,217,666,1e-95,350,444,449
"84472","Ntome_NODE_33360_length_454_cov_4","Nsylvestris_NODE_32184_length_386_cov_4",95.439,285,13,0,166,450,1,285,2.06e-127,455,284,284
"84473","Ntome_NODE_33364_length_453_cov_303","Nsylvestris_NODE_5157_length_2935_cov_218",98.234,453,8,0,1,453,1265,813,0,793,452,452
"84476","Ntome_NODE_33366_length_453_cov_256","Nsylvestris_NODE_10520_length_2048_cov_189",92.967,455,18,5,1,453,21,463,0,651,452,442
"84480","Ntome_NODE_33368_length_453_cov_36","Nsylvestris_NODE_12174_length_1850_cov_160",93.316,374,20,3,82,452,1207,1578,3.3e-155,547,370,371
"84489","Ntome_NODE_33375_length_453_cov_4","Nsylvestris_NODE_12956_length_1768_cov_62",96.239,452,17,0,1,452,1400,949,0,741,451,451
"84490","Ntome_NODE_33377_length_453_cov_3","Nsylvestris_NODE_32307_length_381_cov_5",86.207,290,29,5,56,345,279,1,7.89e-82,303,289,278
"84491","Ntome_NODE_33378_length_452_cov_3","Nsylvestris_NODE_13639_length_1692_cov_8",93.216,398,21,4,49,444,243,636,3.25e-165,580,395,393
"84492","Ntome_NODE_33380_length_453_cov_2","Nsylvestris_NODE_8895_length_2264_cov_136",93.16,307,17,4,1,303,637,943,3.44e-125,448,302,306
"84493","Ntome_NODE_33381_length_452_cov_249","Nsylvestris_NODE_7576_length_2473_cov_113",97.849,93,2,0,360,452,1363,1455,5.01e-39,161,92,92
"84494","Ntome_NODE_33382_length_452_cov_181","Nsylvestris_NODE_430_length_6172_cov_226",96.053,380,15,0,73,452,4590,4211,6.88e-177,619,379,379
"84505","Ntome_NODE_33391_length_452_cov_6","Nsylvestris_NODE_12473_length_1819_cov_51",96.438,393,14,0,1,393,565,957,0,649,392,392
"84506","Ntome_NODE_33393_length_451_cov_343","Nsylvestris_NODE_4032_length_3223_cov_132",99.326,445,3,0,7,451,186,630,0,806,444,444
"84519","Ntome_NODE_33400_length_451_cov_9","Nsylvestris_NODE_20995_length_1028_cov_36",95.482,332,15,0,4,335,621,952,3.31e-150,531,331,331
"84522","Ntome_NODE_33404_length_451_cov_6","Nsylvestris_NODE_5748_length_2810_cov_173",89.103,312,29,5,81,388,688,378,9.8e-106,383,307,310
"84523","Ntome_NODE_33406_length_451_cov_5","Nsylvestris_NODE_24487_length_801_cov_107",95.362,345,14,2,17,361,273,615,3.28e-155,547,344,342
"84524","Ntome_NODE_33407_length_451_cov_4","Nsylvestris_NODE_21152_length_1018_cov_130",90.343,466,25,4,1,451,275,735,4.16e-169,593,450,460
"84525","Ntome_NODE_33409_length_451_cov_4","Nsylvestris_NODE_17912_length_1276_cov_55",91.814,452,35,2,1,451,574,1024,1.14e-179,628,450,450
"84526","Ntome_NODE_33412_length_450_cov_272","Nsylvestris_NODE_18694_length_1209_cov_225",94.419,430,13,3,1,423,426,1,0,651,422,425
"84529","Ntome_NODE_33414_length_450_cov_213","Nsylvestris_NODE_20693_length_1050_cov_131",96.338,355,12,1,95,449,1024,671,8.98e-166,582,354,353
"84532","Ntome_NODE_33416_length_450_cov_132","Nsylvestris_NODE_26932_length_673_cov_90",85.66,265,17,7,129,390,334,580,1.72e-68,259,261,246
"84535","Ntome_NODE_33422_length_450_cov_7","Nsylvestris_NODE_3504_length_3400_cov_72",92.015,263,19,2,36,297,630,369,2.74e-101,368,261,261
"84536","Ntome_NODE_33423_length_450_cov_7","Nsylvestris_NODE_33751_length_329_cov_6",95.636,275,12,0,78,352,275,1,1.59e-123,442,274,274
"84537","Ntome_NODE_33427_length_450_cov_4","Nsylvestris_NODE_12402_length_1826_cov_110",90.244,451,40,4,3,450,575,1024,6.94e-167,586,447,449
"84538","Ntome_NODE_33428_length_450_cov_4","Nsylvestris_NODE_3820_length_3294_cov_59",82.353,442,48,12,13,446,2191,1772,5.93e-98,357,433,419
"84539","Ntome_NODE_33429_length_450_cov_4","Nsylvestris_NODE_8854_length_2272_cov_17",93.612,454,18,3,6,450,270,721,0,667,444,451
"84540","Ntome_NODE_33431_length_449_cov_313","Nsylvestris_NODE_4596_length_3075_cov_216",89.978,459,24,8,1,437,2414,2872,5.39e-163,573,436,458
"84552","Ntome_NODE_33436_length_449_cov_188","Nsylvestris_NODE_10679_length_2028_cov_233",100,55,0,0,1,55,1181,1127,3.06e-21,102,54,54
"84553","Ntome_NODE_33437_length_449_cov_177","Nsylvestris_NODE_7244_length_2527_cov_220",88.478,460,38,8,1,449,1463,1918,1.52e-153,542,448,455
"84567","Ntome_NODE_33447_length_449_cov_6","Nsylvestris_NODE_24175_length_821_cov_53",88.601,193,16,1,58,244,172,364,1.34e-59,230,186,192
"84568","Ntome_NODE_33448_length_449_cov_6","Nsylvestris_NODE_565_length_5790_cov_105",83.516,182,29,1,34,215,3855,3675,2.97e-41,169,181,180
"84569","Ntome_NODE_33450_length_449_cov_6","Nsylvestris_NODE_28091_length_625_cov_3",81.637,452,42,15,1,438,2,426,7.7e-92,337,437,424
"84570","Ntome_NODE_33453_length_449_cov_4","Nsylvestris_NODE_8193_length_2372_cov_193",99.777,449,1,0,1,449,966,1414,0,824,448,448
"84571","Ntome_NODE_33454_length_449_cov_4","Nsylvestris_NODE_185_length_7475_cov_83",93.946,446,26,1,4,449,3903,4347,0,673,445,444
"84572","Ntome_NODE_33456_length_449_cov_3","Nsylvestris_NODE_2714_length_3698_cov_83",76.871,294,54,7,157,449,2166,2446,8.33e-37,154,292,280
"84576","Ntome_NODE_33460_length_448_cov_13","Nsylvestris_NODE_16889_length_1366_cov_5",94.152,171,10,0,37,207,1013,843,4.76e-69,261,170,170
"84577","Ntome_NODE_33461_length_448_cov_12","Nsylvestris_NODE_17432_length_1320_cov_18",78.28,465,77,18,4,448,484,24,4.72e-74,278,444,460
"84583","Ntome_NODE_33464_length_448_cov_9","Nsylvestris_NODE_6256_length_2706_cov_34",83.452,423,45,11,2,418,1342,1745,7.58e-102,370,416,403
"84589","Ntome_NODE_33471_length_448_cov_4","Nsylvestris_NODE_1679_length_4269_cov_83",92.443,397,30,0,52,448,1025,629,2.5e-161,568,396,396
"84594","Ntome_NODE_33475_length_447_cov_270","Nsylvestris_NODE_24249_length_815_cov_184",94.161,411,20,2,1,408,410,1,5.26e-178,623,407,409
"84598","Ntome_NODE_33477_length_447_cov_258","Nsylvestris_NODE_9546_length_2170_cov_206",93.842,406,14,8,52,447,2087,1683,2.46e-171,601,395,404
"84599","Ntome_NODE_33478_length_447_cov_219","Nsylvestris_NODE_19551_length_1139_cov_203",96.981,265,8,0,183,447,49,313,1.22e-124,446,264,264
"84611","Ntome_NODE_33484_length_447_cov_6","Nsylvestris_NODE_13901_length_1661_cov_177",88.43,242,26,2,73,314,1661,1422,6.05e-78,291,241,239
"84612","Ntome_NODE_33485_length_447_cov_6","Nsylvestris_NODE_3016_length_3581_cov_108",89.195,435,32,8,5,434,1588,2012,1.18e-149,529,429,424
"84615","Ntome_NODE_33489_length_447_cov_4","Nsylvestris_NODE_6292_length_2698_cov_12",91.696,289,7,4,1,272,2410,2698,2.7e-106,385,271,288
"84616","Ntome_NODE_33490_length_447_cov_4","Nsylvestris_NODE_36828_length_255_cov_4",98.99,99,1,0,349,447,255,157,4.92e-44,178,98,98
"84632","Ntome_NODE_33502_length_446_cov_5","Nsylvestris_NODE_25760_length_731_cov_4",94.515,237,12,1,1,236,495,731,3.51e-100,364,235,236
"84639","Ntome_NODE_33506_length_445_cov_257","Nsylvestris_NODE_1028_length_4900_cov_209",91.457,398,28,4,3,397,1128,1522,1.51e-153,542,394,394
"84645","Ntome_NODE_33509_length_445_cov_20","Nsylvestris_NODE_6706_length_2621_cov_218",92.132,394,25,5,1,391,101,491,2.5e-156,551,390,390
"84646","Ntome_NODE_33510_length_445_cov_17","Nsylvestris_NODE_24302_length_812_cov_37",92.511,454,17,4,1,445,515,70,0,634,444,445
"84652","Ntome_NODE_33513_length_445_cov_10","Nsylvestris_NODE_6641_length_2635_cov_38",86.42,81,11,0,230,310,1568,1648,2.36e-17,89.8,80,80
"84657","Ntome_NODE_33516_length_445_cov_8","Nsylvestris_NODE_434_length_6157_cov_161",100,30,0,0,416,445,2237,2208,2.39e-07,56.5,29,29
"84663","Ntome_NODE_33526_length_444_cov_282","Nsylvestris_NODE_221_length_7194_cov_203",97.297,444,12,0,1,444,2289,1846,0,754,443,443
"84664","Ntome_NODE_33527_length_444_cov_260","Nsylvestris_NODE_32529_length_371_cov_5",97.006,334,9,1,112,444,371,38,4.15e-159,560,332,333
"84665","Ntome_NODE_33529_length_444_cov_11","Nsylvestris_NODE_30014_length_526_cov_75",94.432,449,20,2,1,444,26,474,0,686,443,448
"84666","Ntome_NODE_33531_length_444_cov_9","Nsylvestris_NODE_1246_length_4653_cov_184",98.333,60,1,0,385,444,1768,1709,2.34e-22,106,59,59
"84667","Ntome_NODE_33533_length_444_cov_8","Nsylvestris_NODE_20292_length_1078_cov_31",94.595,444,24,0,1,444,163,606,0,688,443,443
"84668","Ntome_NODE_33534_length_444_cov_7","Nsylvestris_NODE_26317_length_704_cov_34",90.948,232,21,0,1,232,243,474,1.28e-84,313,231,231
"84669","Ntome_NODE_33536_length_444_cov_7","Nsylvestris_NODE_24201_length_819_cov_12",92.487,386,22,3,66,444,8,393,1.16e-154,545,378,385
"84670","Ntome_NODE_33539_length_444_cov_3","Nsylvestris_NODE_25006_length_771_cov_23",92.747,455,17,11,1,444,480,31,0,643,443,449
"84678","Ntome_NODE_33549_length_443_cov_6","Nsylvestris_NODE_20602_length_1058_cov_4",76.385,343,60,18,87,426,358,682,3.79e-40,165,339,324
"84686","Ntome_NODE_33559_length_442_cov_206","Nsylvestris_NODE_18655_length_1213_cov_134",96.438,393,14,0,50,442,44,436,0,649,392,392
"84690","Ntome_NODE_33561_length_442_cov_11","Nsylvestris_NODE_30686_length_472_cov_5",82.394,142,20,5,304,442,184,45,2.99e-26,119,138,139
"84693","Ntome_NODE_33567_length_442_cov_4","Nsylvestris_NODE_25027_length_770_cov_9",92.551,443,18,8,1,441,665,236,1.87e-177,621,440,429
"84694","Ntome_NODE_33569_length_442_cov_3","Nsylvestris_NODE_23087_length_886_cov_10",96.615,384,10,1,42,422,186,569,0,634,380,383
"84695","Ntome_NODE_33570_length_442_cov_2","Nsylvestris_NODE_36632_length_259_cov_4",92.899,169,8,2,276,442,18,184,1.7e-63,243,166,166
"84710","Ntome_NODE_33577_length_441_cov_17","Nsylvestris_NODE_31695_length_408_cov_5",87.468,391,26,12,1,385,374,1,1.21e-119,429,384,373
"84711","Ntome_NODE_33578_length_441_cov_7","Nsylvestris_NODE_17647_length_1298_cov_205",100,36,0,0,406,441,1248,1213,1.09e-10,67.6,35,35
"84712","Ntome_NODE_33586_length_441_cov_3","Nsylvestris_NODE_15892_length_1461_cov_28",97.506,441,11,0,1,441,591,1031,0,754,440,440
"84718","Ntome_NODE_33588_length_440_cov_221","Nsylvestris_NODE_17284_length_1333_cov_212",98.107,317,6,0,1,317,598,282,6.88e-157,553,316,316
"84725","Ntome_NODE_33592_length_440_cov_64","Nsylvestris_NODE_4978_length_2979_cov_174",89.165,443,19,7,4,440,51,470,1.5e-148,525,436,419
"84726","Ntome_NODE_33594_length_440_cov_9","Nsylvestris_NODE_4542_length_3088_cov_86",94.545,55,3,0,335,389,3034,3088,3.02e-16,86.1,54,54
"84727","Ntome_NODE_33596_length_440_cov_8","Nsylvestris_NODE_1851_length_4149_cov_39",95.441,329,15,0,109,437,112,440,1.5e-148,525,328,328
"84732","Ntome_NODE_33606_length_439_cov_283","Nsylvestris_NODE_11344_length_1947_cov_142",97.025,437,8,2,3,439,1923,1492,0,730,436,431
"84736","Ntome_NODE_33608_length_439_cov_241","Nsylvestris_NODE_518_length_5911_cov_122",97.267,439,12,0,1,439,5529,5091,0,745,438,438
"84737","Ntome_NODE_33609_length_439_cov_160","Nsylvestris_NODE_10954_length_1993_cov_208",97.727,88,2,0,352,439,966,879,2.92e-36,152,87,87
"84738","Ntome_NODE_33615_length_439_cov_4","Nsylvestris_NODE_30538_length_483_cov_7",95.056,445,14,3,1,439,16,458,0,693,438,442
"84739","Ntome_NODE_33616_length_439_cov_2","Nsylvestris_NODE_2547_length_3770_cov_126",95.444,439,20,0,1,439,3097,3535,0,701,438,438
"84742","Ntome_NODE_33618_length_438_cov_249","Nsylvestris_NODE_3162_length_3522_cov_228",94.511,419,18,3,21,438,3506,3092,0,641,417,414
"84743","Ntome_NODE_33619_length_438_cov_227","Nsylvestris_NODE_14495_length_1600_cov_218",93.976,415,14,2,1,412,1191,1597,2.39e-176,617,411,406
"84768","Ntome_NODE_33628_length_438_cov_6","Nsylvestris_NODE_31202_length_438_cov_8",79.602,201,14,3,226,399,235,435,2.96e-26,119,173,200
"84772","Ntome_NODE_33632_length_438_cov_4","Nsylvestris_NODE_6835_length_2597_cov_209",96.97,33,1,0,318,350,2507,2475,2.35e-07,56.5,32,32
"84773","Ntome_NODE_33633_length_438_cov_4","Nsylvestris_NODE_24229_length_817_cov_28",81.548,168,24,5,97,260,273,109,3.8e-30,132,163,164
"84782","Ntome_NODE_33638_length_437_cov_240","Nsylvestris_NODE_6163_length_2723_cov_202",89.412,425,22,10,1,421,409,4,3.22e-145,514,420,405
"84785","Ntome_NODE_33640_length_437_cov_179","Nsylvestris_NODE_2056_length_4023_cov_145",88.201,339,22,12,117,437,3986,3648,2.04e-107,388,320,338
"84786","Ntome_NODE_33642_length_437_cov_14","Nsylvestris_NODE_6954_length_2576_cov_125",95.202,396,16,3,41,433,1455,1060,5.13e-178,623,392,395
"84789","Ntome_NODE_33644_length_437_cov_9","Nsylvestris_NODE_13616_length_1694_cov_24",87.783,442,43,4,2,437,983,1419,5.39e-143,507,435,436
"84793","Ntome_NODE_33648_length_437_cov_5","Nsylvestris_NODE_794_length_5249_cov_112",88.562,306,35,0,132,437,5249,4944,2.05e-102,372,305,305
"84801","Ntome_NODE_33651_length_437_cov_4","Nsylvestris_NODE_21726_length_975_cov_178",89.888,445,24,5,1,436,734,302,6.83e-157,553,435,432
"84802","Ntome_NODE_33652_length_436_cov_221","Nsylvestris_NODE_6846_length_2594_cov_222",95.349,43,2,0,394,436,306,348,3.01e-11,69.4,42,42
"84807","Ntome_NODE_33658_length_436_cov_7","Nsylvestris_NODE_25314_length_754_cov_21",94.118,102,6,0,53,154,180,79,2.24e-37,156,101,101
"84808","Ntome_NODE_33664_length_436_cov_6","Nsylvestris_NODE_11060_length_1981_cov_10",94.931,434,22,0,3,436,618,185,0,680,433,433
"84812","Ntome_NODE_33670_length_436_cov_4","Nsylvestris_NODE_3508_length_3398_cov_87",91.41,454,20,6,1,436,2691,3143,1.85e-172,604,435,452
"84813","Ntome_NODE_33671_length_436_cov_4","Nsylvestris_NODE_12727_length_1793_cov_31",91.253,423,31,5,15,436,1750,1333,1.88e-162,571,421,417
"84814","Ntome_NODE_33674_length_436_cov_3","Nsylvestris_NODE_20453_length_1068_cov_84",93.721,430,15,5,10,436,636,216,0,634,426,420
"84815","Ntome_NODE_33676_length_436_cov_2","Nsylvestris_NODE_31672_length_410_cov_3",94.468,235,13,0,1,235,235,1,1.23e-99,363,234,234
"84816","Ntome_NODE_33677_length_435_cov_230","Nsylvestris_NODE_747_length_5354_cov_175",99.08,435,4,0,1,435,3325,2891,0,782,434,434
"84817","Ntome_NODE_33678_length_434_cov_228","Nsylvestris_NODE_27294_length_658_cov_54",87.784,352,34,5,1,350,457,113,7.22e-112,403,349,344
"84818","Ntome_NODE_33679_length_435_cov_222","Nsylvestris_NODE_5158_length_2934_cov_139",88.859,368,26,4,1,368,397,45,1.99e-122,438,367,352
"84819","Ntome_NODE_33680_length_435_cov_178","Nsylvestris_NODE_2144_length_3968_cov_35",92.5,160,11,1,95,253,1,160,4.68e-59,228,158,159
"84820","Ntome_NODE_33686_length_435_cov_10","Nsylvestris_NODE_6026_length_2755_cov_94",78.276,290,46,10,94,371,1075,1359,8e-42,171,277,284
"84825","Ntome_NODE_33693_length_435_cov_4","Nsylvestris_NODE_1281_length_4612_cov_158",97.27,403,11,0,1,403,4210,4612,0,684,402,402
"84833","Ntome_NODE_33702_length_434_cov_44","Nsylvestris_NODE_3988_length_3236_cov_33",85.821,134,19,0,31,164,7,140,1.74e-33,143,133,133
"84834","Ntome_NODE_33703_length_434_cov_27","Nsylvestris_NODE_7443_length_2497_cov_100",88.453,433,27,3,1,431,2076,2487,2.49e-141,501,430,411
"84838","Ntome_NODE_33709_length_434_cov_7","Nsylvestris_NODE_17763_length_1289_cov_15",86.444,450,27,11,1,434,1108,677,1.18e-129,462,433,431
"84843","Ntome_NODE_33716_length_434_cov_3","Nsylvestris_NODE_914_length_5072_cov_55",86.364,154,19,2,278,429,4786,4633,1.03e-40,167,151,153
"84849","Ntome_NODE_33719_length_433_cov_137","Nsylvestris_NODE_8642_length_2302_cov_199",93.995,433,16,6,1,431,1858,2282,0,647,430,424
"84850","Ntome_NODE_33723_length_433_cov_9","Nsylvestris_NODE_18504_length_1224_cov_38",87.327,434,37,6,1,433,511,95,3.24e-135,481,432,416
"84854","Ntome_NODE_33725_length_433_cov_6","Nsylvestris_NODE_5498_length_2862_cov_86",97.46,433,11,0,1,433,2765,2333,0,739,432,432
"84855","Ntome_NODE_33726_length_433_cov_6","Nsylvestris_NODE_23987_length_833_cov_8",90.466,451,23,8,1,433,146,594,4.01e-164,577,432,448
"84856","Ntome_NODE_33731_length_433_cov_3","Nsylvestris_NODE_4097_length_3204_cov_34",89.569,441,16,10,1,433,2516,2098,8.81e-151,532,432,418
"84857","Ntome_NODE_33732_length_432_cov_320","Nsylvestris_NODE_917_length_5066_cov_179",96.991,432,13,0,1,432,2496,2065,0,726,431,431
"84867","Ntome_NODE_33737_length_432_cov_63","Nsylvestris_NODE_932_length_5045_cov_32",90.402,323,15,7,115,422,4821,4500,4.3e-114,411,307,321
"84868","Ntome_NODE_33740_length_432_cov_18","Nsylvestris_NODE_23295_length_873_cov_7",91.197,284,21,3,4,285,285,4,9.36e-106,383,281,281
"84872","Ntome_NODE_33744_length_432_cov_8","Nsylvestris_NODE_20744_length_1047_cov_5",95.843,433,15,3,1,432,527,957,0,697,431,430
"84873","Ntome_NODE_33745_length_432_cov_6","Nsylvestris_NODE_35512_length_284_cov_3",86.232,276,34,4,1,274,11,284,1.26e-79,296,273,273
"84874","Ntome_NODE_33750_length_432_cov_4","Nsylvestris_NODE_1613_length_4320_cov_178",98.38,432,7,0,1,432,1212,1643,0,760,431,431
"84875","Ntome_NODE_33752_length_432_cov_4","Nsylvestris_NODE_11162_length_1967_cov_129",87.5,56,4,3,11,64,423,369,4.98e-09,62.1,53,54
"84876","Ntome_NODE_33753_length_432_cov_3","Nsylvestris_NODE_20906_length_1035_cov_6",96.759,432,14,0,1,432,565,996,0,721,431,431
"84881","Ntome_NODE_33755_length_431_cov_323","Nsylvestris_NODE_1674_length_4270_cov_208",97.448,431,11,0,1,431,2551,2121,0,736,430,430
"84882","Ntome_NODE_33756_length_431_cov_272","Nsylvestris_NODE_953_length_5012_cov_141",97.106,311,9,0,121,431,1044,734,1.47e-148,525,310,310
"84886","Ntome_NODE_33758_length_431_cov_228","Nsylvestris_NODE_29438_length_565_cov_157",89.61,385,29,8,1,378,386,6,1.16e-134,479,377,380
"84887","Ntome_NODE_33759_length_431_cov_224","Nsylvestris_NODE_9843_length_2134_cov_229",93.61,313,9,4,1,311,351,48,5.43e-128,457,310,303
"84888","Ntome_NODE_33760_length_431_cov_222","Nsylvestris_NODE_4332_length_3143_cov_193",90.462,325,22,6,1,325,2376,2061,7.12e-117,420,324,315
"84889","Ntome_NODE_33761_length_431_cov_213","Nsylvestris_NODE_6589_length_2645_cov_75",92.969,256,16,2,1,256,615,868,2.02e-102,372,255,253
"84890","Ntome_NODE_33764_length_431_cov_26","Nsylvestris_NODE_14115_length_1639_cov_113",92.188,128,10,0,171,298,1053,1180,3.66e-45,182,127,127
"84900","Ntome_NODE_33777_length_431_cov_4","Nsylvestris_NODE_27071_length_670_cov_46",87.543,289,32,2,4,289,615,328,3.43e-90,331,285,287
"84901","Ntome_NODE_33778_length_431_cov_4","Nsylvestris_NODE_8120_length_2384_cov_207",100,35,0,0,1,35,1859,1825,3.84e-10,65.8,34,34
"84906","Ntome_NODE_33783_length_430_cov_304","Nsylvestris_NODE_4229_length_3167_cov_223",99.07,430,4,0,1,430,1190,761,0,773,429,429
"84907","Ntome_NODE_33784_length_430_cov_233","Nsylvestris_NODE_6818_length_2600_cov_211",83.333,144,11,3,1,140,1141,1275,8.07e-27,121,139,134
"84908","Ntome_NODE_33785_length_430_cov_227","Nsylvestris_NODE_14420_length_1608_cov_229",89.135,451,26,9,1,430,492,44,5.23e-153,540,429,448
"84909","Ntome_NODE_33788_length_430_cov_8","Nsylvestris_NODE_532_length_5864_cov_158",94.375,160,8,1,1,159,2332,2491,4.59e-64,244,158,159
"84912","Ntome_NODE_33797_length_430_cov_4","Nsylvestris_NODE_3504_length_3400_cov_72",91.852,135,10,1,3,137,1168,1035,7.84e-47,187,134,133
"84915","Ntome_NODE_33800_length_429_cov_323","Nsylvestris_NODE_4720_length_3040_cov_107",96.737,429,14,0,1,429,1900,2328,0,715,428,428
"84920","Ntome_NODE_33807_length_429_cov_9","Nsylvestris_NODE_11038_length_1983_cov_32",83.432,169,21,5,262,429,1172,1010,1.03e-35,150,167,162
"84921","Ntome_NODE_33811_length_429_cov_4","Nsylvestris_NODE_31159_length_441_cov_4",96.382,387,14,0,1,387,55,441,0,638,386,386
"84922","Ntome_NODE_33812_length_429_cov_3","Nsylvestris_NODE_2411_length_3836_cov_99",93.208,427,18,1,3,429,1799,2214,2.34e-176,617,426,415
"84923","Ntome_NODE_33813_length_429_cov_3","Nsylvestris_NODE_28140_length_623_cov_8",93.316,374,25,0,1,374,249,622,6.7e-157,553,373,373
"84930","Ntome_NODE_33818_length_428_cov_178","Nsylvestris_NODE_14979_length_1552_cov_164",92.808,292,19,2,99,389,1254,1544,1.97e-117,422,290,290
"84931","Ntome_NODE_33823_length_428_cov_6","Nsylvestris_NODE_6305_length_2696_cov_150",88.293,205,7,6,181,369,2242,2039,1.28e-59,230,188,203
"84932","Ntome_NODE_33824_length_428_cov_6","Nsylvestris_NODE_923_length_5059_cov_127",80.252,238,37,8,60,296,3155,3383,7.86e-42,171,236,228
"84940","Ntome_NODE_33830_length_428_cov_4","Nsylvestris_NODE_7118_length_2550_cov_86",84.186,430,64,4,1,428,1953,2380,3.29e-115,414,427,427
"84945","Ntome_NODE_33835_length_428_cov_2","Nsylvestris_NODE_8380_length_2344_cov_16",85.106,188,18,4,79,259,2344,2160,1.01e-45,183,180,184
"84946","Ntome_NODE_33836_length_427_cov_309","Nsylvestris_NODE_3581_length_3371_cov_225",98.815,422,5,0,1,422,2058,2479,0,752,421,421
"84950","Ntome_NODE_33838_length_427_cov_210","Nsylvestris_NODE_25724_length_730_cov_145",94.311,334,11,2,92,425,47,372,1.89e-142,505,333,325
"84954","Ntome_NODE_33840_length_427_cov_6","Nsylvestris_NODE_17887_length_1278_cov_43",85.116,430,54,7,1,427,328,750,3.26e-120,431,426,422
"84955","Ntome_NODE_33841_length_427_cov_6","Nsylvestris_NODE_18444_length_1228_cov_192",100,45,0,0,383,427,731,687,1.05e-15,84.2,44,44
"84956","Ntome_NODE_33846_length_427_cov_3","Nsylvestris_NODE_2539_length_3775_cov_56",93.617,376,24,0,52,427,1854,1479,1.11e-159,562,375,375
"84960","Ntome_NODE_33850_length_426_cov_183","Nsylvestris_NODE_27446_length_653_cov_174",98.182,55,1,0,372,426,193,247,1.35e-19,97.1,54,54
"84968","Ntome_NODE_33856_length_426_cov_8","Nsylvestris_NODE_31412_length_425_cov_4",93.416,243,10,5,93,330,372,131,2.01e-97,355,237,241
"84969","Ntome_NODE_33861_length_426_cov_6","Nsylvestris_NODE_20376_length_1073_cov_20",92.471,425,22,6,2,426,93,507,8.42e-171,599,424,414
"84970","Ntome_NODE_33863_length_426_cov_6","Nsylvestris_NODE_26221_length_709_cov_10",88.969,417,41,4,8,423,46,458,4.06e-144,510,415,412
"84971","Ntome_NODE_33865_length_426_cov_5","Nsylvestris_NODE_13843_length_1669_cov_72",96.948,426,13,0,1,426,283,708,0,715,425,425
"84972","Ntome_NODE_33866_length_426_cov_5","Nsylvestris_NODE_13843_length_1669_cov_72",90.345,435,24,5,1,426,871,1296,1.85e-157,555,425,425
"84980","Ntome_NODE_33873_length_425_cov_247","Nsylvestris_NODE_21398_length_999_cov_181",95.787,356,15,0,1,356,586,941,1.41e-163,575,355,355
"84981","Ntome_NODE_33875_length_425_cov_23","Nsylvestris_NODE_30137_length_514_cov_26",89.441,322,27,4,73,394,40,354,9.14e-111,399,321,314
"84982","Ntome_NODE_33876_length_425_cov_12","Nsylvestris_NODE_7994_length_2405_cov_30",96.429,56,1,1,365,420,878,932,6.25e-18,91.6,55,54
"84985","Ntome_NODE_33880_length_425_cov_7","Nsylvestris_NODE_35771_length_278_cov_4",91.2,125,11,0,1,125,154,278,7.8e-42,171,124,124
"84986","Ntome_NODE_33882_length_425_cov_6","Nsylvestris_NODE_10945_length_1995_cov_9",97.647,425,10,0,1,425,1060,636,0,730,424,424
"84987","Ntome_NODE_33883_length_425_cov_6","Nsylvestris_NODE_23308_length_872_cov_72",94.118,153,9,0,1,153,716,868,9.81e-61,233,152,152
"84988","Ntome_NODE_33887_length_425_cov_5","Nsylvestris_NODE_18145_length_1255_cov_7",91.206,398,32,3,10,404,385,782,1.86e-152,538,394,397
"84989","Ntome_NODE_33889_length_425_cov_4","Nsylvestris_NODE_33156_length_347_cov_6",85.801,331,17,12,113,425,341,23,5.66e-88,324,312,318
"84990","Ntome_NODE_33891_length_425_cov_4","Nsylvestris_NODE_32435_length_375_cov_6",87.719,399,21,18,3,397,1,375,5.38e-123,440,394,374
"84991","Ntome_NODE_33892_length_425_cov_3","Nsylvestris_NODE_16792_length_1373_cov_156",100,28,0,0,1,28,268,295,2.95e-06,52.8,27,27
"84992","Ntome_NODE_33894_length_425_cov_3","Nsylvestris_NODE_32802_length_360_cov_6",92.973,185,12,1,15,199,261,78,2.69e-71,268,184,183
"84995","Ntome_NODE_33896_length_424_cov_43","Nsylvestris_NODE_32005_length_394_cov_2",87.831,378,35,10,57,424,6,382,8.99e-121,433,367,376
"84996","Ntome_NODE_33898_length_424_cov_9","Nsylvestris_NODE_1983_length_4066_cov_70",84.894,331,50,0,77,407,2865,2535,2.61e-91,335,330,330
"84999","Ntome_NODE_33900_length_424_cov_7","Nsylvestris_NODE_4101_length_3202_cov_120",98.349,424,7,0,1,424,1426,1003,0,745,423,423
"85000","Ntome_NODE_33901_length_424_cov_5","Nsylvestris_NODE_36476_length_263_cov_2",94.444,234,13,0,1,234,30,263,4.3e-99,361,233,233
"85011","Ntome_NODE_33911_length_423_cov_252","Nsylvestris_NODE_2874_length_3629_cov_168",93.87,261,10,1,169,423,60,320,1.97e-107,388,254,260
"85030","Ntome_NODE_33915_length_425_cov_10","Nsylvestris_NODE_23521_length_858_cov_45",89.091,220,21,3,47,265,817,600,7.48e-72,270,218,217
"85035","Ntome_NODE_33918_length_423_cov_7","Nsylvestris_NODE_13314_length_1727_cov_7",92.891,422,29,1,3,423,110,531,1.07e-174,612,420,421
"85036","Ntome_NODE_33920_length_423_cov_6","Nsylvestris_NODE_26082_length_715_cov_9",97.585,207,5,0,2,208,207,1,2e-97,355,206,206
"85037","Ntome_NODE_33921_length_423_cov_5","Nsylvestris_NODE_23283_length_874_cov_7",90.323,403,29,6,26,423,856,459,6.69e-147,520,397,397
"85041","Ntome_NODE_33924_length_423_cov_4","Nsylvestris_NODE_178_length_7523_cov_18",83.911,404,65,0,7,410,3920,3517,7.08e-107,387,403,403
"85042","Ntome_NODE_33925_length_423_cov_4","Nsylvestris_NODE_10945_length_1995_cov_9",92,425,32,1,1,423,130,554,1.08e-169,595,422,424
"85043","Ntome_NODE_33928_length_422_cov_287","Nsylvestris_NODE_22533_length_920_cov_15",82.772,267,24,12,1,264,269,516,2.73e-56,219,263,247
"85050","Ntome_NODE_33931_length_422_cov_236","Nsylvestris_NODE_2842_length_3640_cov_76",93.425,365,24,0,4,368,4,368,1.42e-153,542,364,364
"85051","Ntome_NODE_33933_length_422_cov_131","Nsylvestris_NODE_12164_length_1851_cov_208",87.622,307,9,8,136,422,1851,1554,1.21e-89,329,286,297
"85052","Ntome_NODE_33934_length_422_cov_9","Nsylvestris_NODE_392_length_6304_cov_88",93.478,46,2,1,239,284,3405,3361,1.04e-10,67.6,45,44
"85053","Ntome_NODE_33935_length_422_cov_8","Nsylvestris_NODE_10497_length_2051_cov_80",94.537,421,21,2,4,422,87,507,0,649,418,420
"85057","Ntome_NODE_33938_length_422_cov_5","Nsylvestris_NODE_35442_length_285_cov_5",96.629,267,9,0,1,267,268,2,4.13e-124,444,266,266
"85061","Ntome_NODE_33943_length_422_cov_4","Nsylvestris_NODE_18603_length_1217_cov_62",88.918,379,25,8,1,367,704,1077,2.47e-126,451,366,373
"85062","Ntome_NODE_33944_length_422_cov_4","Nsylvestris_NODE_30598_length_479_cov_5",95.469,309,14,0,114,422,1,309,4.04e-139,494,308,308
"85076","Ntome_NODE_33960_length_421_cov_4","Nsylvestris_NODE_22730_length_907_cov_5",90.845,426,27,5,1,421,602,184,3.92e-159,560,420,418
"85077","Ntome_NODE_33961_length_421_cov_4","Nsylvestris_NODE_526_length_5885_cov_49",90.909,231,17,2,194,421,2844,3073,5.64e-83,307,227,229
"85078","Ntome_NODE_33962_length_421_cov_4","Nsylvestris_NODE_31873_length_400_cov_3",90.254,236,20,3,184,418,1,234,2.03e-82,305,234,233
"85079","Ntome_NODE_33966_length_421_cov_3","Nsylvestris_NODE_36596_length_260_cov_3",96.154,260,10,0,162,421,1,260,1.49e-118,425,259,259
"85080","Ntome_NODE_33967_length_421_cov_3","Nsylvestris_NODE_2201_length_3937_cov_72",96.651,418,14,0,1,418,2899,3316,0,695,417,417
"85083","Ntome_NODE_33970_length_420_cov_223","Nsylvestris_NODE_12024_length_1867_cov_41",91.481,270,12,4,1,263,1682,1417,4.26e-99,361,262,265
"85086","Ntome_NODE_33981_length_420_cov_4","Nsylvestris_NODE_4965_length_2982_cov_85",95.714,420,18,0,1,420,1349,930,0,676,419,419
"85090","Ntome_NODE_33986_length_419_cov_299","Nsylvestris_NODE_266_length_6914_cov_199",98.565,418,6,0,1,418,5504,5921,0,739,417,417
"85095","Ntome_NODE_33988_length_419_cov_207","Nsylvestris_NODE_11087_length_1978_cov_66",89.64,222,22,1,198,419,1477,1697,3.4e-75,281,221,220
"85104","Ntome_NODE_33992_length_419_cov_20","Nsylvestris_NODE_25092_length_766_cov_209",98.182,55,1,0,1,55,109,55,1.32e-19,97.1,54,54
"85110","Ntome_NODE_33994_length_419_cov_11","Nsylvestris_NODE_11059_length_1981_cov_16",95.652,414,18,0,6,419,1172,1585,0,665,413,413
"85111","Ntome_NODE_33997_length_419_cov_7","Nsylvestris_NODE_11310_length_1950_cov_42",91.045,67,5,1,203,268,356,290,2.21e-17,89.8,65,66
"85114","Ntome_NODE_34000_length_419_cov_6","Nsylvestris_NODE_22772_length_905_cov_5",85.052,194,14,8,241,419,692,885,9.87e-46,183,178,193
"85115","Ntome_NODE_34002_length_419_cov_6","Nsylvestris_NODE_371_length_6406_cov_51",91.706,422,25,7,1,419,4231,4645,3.87e-164,577,418,414
"85116","Ntome_NODE_34013_length_419_cov_2","Nsylvestris_NODE_25114_length_765_cov_70",93.478,230,15,0,1,230,280,51,1.54e-93,342,229,229
"85117","Ntome_NODE_34015_length_419_cov_2","Nsylvestris_NODE_12379_length_1828_cov_214",93.271,431,17,3,1,419,1320,1750,1.36e-178,625,418,430
"85118","Ntome_NODE_34017_length_418_cov_266","Nsylvestris_NODE_10339_length_2070_cov_166",93.541,418,27,0,1,418,1749,1332,4.89e-178,623,417,417
"85122","Ntome_NODE_34019_length_418_cov_261","Nsylvestris_NODE_26335_length_703_cov_170",94.753,324,16,1,49,372,81,403,6.65e-142,503,323,322
"85123","Ntome_NODE_34020_length_418_cov_223","Nsylvestris_NODE_21508_length_991_cov_181",88.693,283,17,6,140,418,27,298,3.32e-90,331,278,271
"85124","Ntome_NODE_34021_length_418_cov_179","Nsylvestris_NODE_886_length_5105_cov_119",93.243,370,24,1,48,417,4576,4208,3.92e-154,544,369,368
"85132","Ntome_NODE_34030_length_418_cov_6","Nsylvestris_NODE_24184_length_820_cov_81",89.806,412,18,2,2,401,173,572,5.14e-143,507,399,399
"85139","Ntome_NODE_34037_length_418_cov_5","Nsylvestris_NODE_18014_length_1267_cov_8",95.349,387,13,2,1,384,790,1174,3.81e-174,610,383,384
"85140","Ntome_NODE_34040_length_418_cov_4","Nsylvestris_NODE_28820_length_591_cov_176",93.907,279,17,0,4,282,223,501,1.92e-117,422,278,278
"85141","Ntome_NODE_34041_length_418_cov_3","Nsylvestris_NODE_7986_length_2406_cov_17",92.601,419,25,4,1,418,1070,1483,2.97e-170,597,417,413
"85147","Ntome_NODE_34047_length_417_cov_282","Nsylvestris_NODE_27639_length_644_cov_211",97.135,349,9,1,1,348,438,90,1.78e-167,588,347,348
"85148","Ntome_NODE_34048_length_417_cov_252","Nsylvestris_NODE_20254_length_1082_cov_181",88.81,420,18,15,1,416,568,962,1.86e-137,488,415,394
"85149","Ntome_NODE_34049_length_417_cov_197","Nsylvestris_NODE_2446_length_3819_cov_208",92.823,418,28,2,1,417,3727,3311,1.77e-172,604,416,416
"85153","Ntome_NODE_34051_length_417_cov_164","Nsylvestris_NODE_5108_length_2946_cov_219",100,55,0,0,363,417,1900,1846,2.83e-21,102,54,54
"85159","Ntome_NODE_34054_length_417_cov_7","Nsylvestris_NODE_8071_length_2392_cov_22",90.67,418,31,3,1,417,577,167,8.4e-156,549,416,410
"85160","Ntome_NODE_34056_length_417_cov_6","Nsylvestris_NODE_27974_length_630_cov_7",89.97,329,16,4,1,325,306,621,1.49e-113,409,324,315
"85161","Ntome_NODE_34058_length_417_cov_5","Nsylvestris_NODE_178_length_7523_cov_18",75.839,298,59,13,25,315,6067,5776,2.16e-32,139,290,291
"85165","Ntome_NODE_34062_length_417_cov_3","Nsylvestris_NODE_2547_length_3770_cov_126",94.484,417,22,1,1,417,599,1014,0,641,416,415
"85166","Ntome_NODE_34063_length_417_cov_3","Nsylvestris_NODE_21627_length_983_cov_13",84.184,392,48,5,1,384,185,570,2.53e-101,368,383,385
"85171","Ntome_NODE_34067_length_416_cov_11","Nsylvestris_NODE_30555_length_482_cov_6",91.111,405,24,3,12,416,76,468,1.81e-152,538,404,392
"85174","Ntome_NODE_34069_length_416_cov_6","Nsylvestris_NODE_26588_length_692_cov_10",80.142,423,45,20,1,409,39,436,1.21e-74,279,408,397
"85180","Ntome_NODE_34075_length_415_cov_123","Nsylvestris_NODE_3659_length_3348_cov_71",96.296,54,2,0,362,415,507,560,2.19e-17,89.8,53,53
"85183","Ntome_NODE_34081_length_415_cov_5","Nsylvestris_NODE_84_length_8749_cov_18",93.689,412,22,2,1,412,5924,6331,2.92e-175,614,411,407
"85184","Ntome_NODE_34084_length_415_cov_4","Nsylvestris_NODE_4233_length_3166_cov_191",90.237,338,33,0,75,412,1960,2297,1.46e-123,442,337,337
"85200","Ntome_NODE_34099_length_414_cov_190","Nsylvestris_NODE_6778_length_2607_cov_223",92.655,177,5,2,164,339,75,244,3.41e-65,248,175,169
"85203","Ntome_NODE_34101_length_414_cov_57","Nsylvestris_NODE_859_length_5149_cov_157",91.545,343,22,7,72,411,50,388,8.64e-131,466,339,338
"85207","Ntome_NODE_34110_length_414_cov_5","Nsylvestris_NODE_25238_length_758_cov_16",89.333,75,8,0,167,241,549,623,4.7e-19,95.3,74,74
"85208","Ntome_NODE_34111_length_414_cov_5","Nsylvestris_NODE_29609_length_559_cov_7",100,160,0,0,60,219,4,163,1.2e-79,296,159,159
"85209","Ntome_NODE_34112_length_414_cov_4","Nsylvestris_NODE_11140_length_1970_cov_184",91.667,432,11,10,4,414,1404,1831,1.38e-163,575,410,427
"85213","Ntome_NODE_34114_length_414_cov_4","Nsylvestris_NODE_955_length_5006_cov_56",77.434,226,49,2,71,296,3359,3582,9.95e-31,134,225,223
"85214","Ntome_NODE_34119_length_413_cov_9","Nsylvestris_NODE_1210_length_4696_cov_145",97.23,361,9,1,13,373,360,1,3.76e-174,610,360,359
"85215","Ntome_NODE_34128_length_413_cov_5","Nsylvestris_NODE_1138_length_4768_cov_89",97.619,42,1,0,1,42,3198,3157,2.19e-12,73.1,41,41
"85216","Ntome_NODE_34131_length_409_cov_3","Nsylvestris_NODE_35875_length_276_cov_3",94.301,193,10,1,68,259,84,276,4.26e-79,294,191,192
"85220","Ntome_NODE_34137_length_412_cov_271","Nsylvestris_NODE_2944_length_3605_cov_194",86.34,388,17,8,54,412,3554,3174,5.32e-108,390,358,380
"85221","Ntome_NODE_34138_length_412_cov_234","Nsylvestris_NODE_7098_length_2553_cov_170",96.359,412,15,0,1,412,1289,1700,0,678,411,411
"85225","Ntome_NODE_34140_length_412_cov_151","Nsylvestris_NODE_929_length_5047_cov_157",93.617,94,3,3,321,412,2453,2361,7.65e-32,137,91,92
"85232","Ntome_NODE_34143_length_412_cov_11","Nsylvestris_NODE_7480_length_2491_cov_81",80.337,178,33,2,132,308,1678,1502,9.9e-31,134,176,176
"85233","Ntome_NODE_34145_length_412_cov_5","Nsylvestris_NODE_1532_length_4373_cov_108",98.783,411,5,0,2,412,3892,4302,0,732,410,410
"85234","Ntome_NODE_34146_length_412_cov_5","Nsylvestris_NODE_19147_length_1172_cov_10",95.732,164,7,0,214,377,380,217,3.37e-70,265,163,163
"85238","Ntome_NODE_34151_length_412_cov_2","Nsylvestris_NODE_5684_length_2822_cov_82",88.506,435,21,9,4,412,1891,1460,8.47e-141,499,408,431
"85239","Ntome_NODE_34152_length_411_cov_314","Nsylvestris_NODE_2388_length_3847_cov_109",93.917,411,10,4,1,411,1772,1377,4.84e-173,606,410,395
"85240","Ntome_NODE_34153_length_411_cov_307","Nsylvestris_NODE_20166_length_1089_cov_124",93.274,223,15,0,3,225,488,710,1.17e-89,329,222,222
"85245","Ntome_NODE_34156_length_411_cov_75","Nsylvestris_NODE_5350_length_2897_cov_38",89.958,239,11,3,123,360,1,227,1.19e-79,296,237,226
"85248","Ntome_NODE_34164_length_411_cov_4","Nsylvestris_NODE_32036_length_392_cov_6",90.411,365,23,5,1,356,31,392,6.63e-132,470,355,361
"85249","Ntome_NODE_34167_length_411_cov_4","Nsylvestris_NODE_18732_length_1207_cov_72",89.448,417,36,1,3,411,27,443,6.49e-147,520,408,416
"85252","Ntome_NODE_34172_length_410_cov_322","Nsylvestris_NODE_11357_length_1946_cov_88",98.228,395,7,0,16,410,1586,1192,0,691,394,394
"85253","Ntome_NODE_34173_length_410_cov_188","Nsylvestris_NODE_4683_length_3049_cov_232",86.066,366,17,17,1,340,2947,2590,1.15e-99,363,339,357
"85258","Ntome_NODE_34176_length_410_cov_139","Nsylvestris_NODE_5288_length_2908_cov_48",91.667,408,34,0,1,408,2029,2436,8.2e-161,566,407,407
"85259","Ntome_NODE_34180_length_410_cov_12","Nsylvestris_NODE_26041_length_717_cov_6",92.464,345,23,3,1,343,247,590,5.07e-138,490,342,343
"85260","Ntome_NODE_34181_length_410_cov_10","Nsylvestris_NODE_720_length_5402_cov_123",95.62,411,17,1,1,410,4150,4560,0,658,409,410
"85263","Ntome_NODE_34185_length_410_cov_6","Nsylvestris_NODE_22583_length_917_cov_9",90.754,411,28,7,1,409,516,114,4.97e-153,540,408,402
"85264","Ntome_NODE_34199_length_409_cov_356","Nsylvestris_NODE_116_length_8164_cov_94",95.61,410,17,1,1,409,3778,3369,0,656,408,409
"85271","Ntome_NODE_34204_length_409_cov_190","Nsylvestris_NODE_873_length_5122_cov_131",96.364,55,2,0,355,409,1049,995,6e-18,91.6,54,54
"85278","Ntome_NODE_34215_length_409_cov_7","Nsylvestris_NODE_805_length_5240_cov_38",91.398,93,5,3,147,239,1783,1694,5.91e-28,124,92,89
"85281","Ntome_NODE_34220_length_409_cov_5","Nsylvestris_NODE_12068_length_1861_cov_200",94.578,332,13,2,1,327,1030,1361,1.4e-143,508,326,331
"85282","Ntome_NODE_34223_length_409_cov_4","Nsylvestris_NODE_14327_length_1619_cov_15",93.95,281,12,3,1,276,281,1,6.73e-117,420,275,280
"85283","Ntome_NODE_34226_length_409_cov_2","Nsylvestris_NODE_18535_length_1221_cov_174",100,39,0,0,1,39,796,758,2.17e-12,73.1,38,38
"85284","Ntome_NODE_34227_length_408_cov_250","Nsylvestris_NODE_3873_length_3276_cov_156",96.073,331,12,1,1,330,2001,2331,1.78e-152,538,329,330
"85292","Ntome_NODE_34231_length_408_cov_7","Nsylvestris_NODE_11545_length_1925_cov_12",96.33,218,5,3,191,408,1595,1809,1.92e-97,355,217,214
"85296","Ntome_NODE_34235_length_408_cov_6","Nsylvestris_NODE_1124_length_4787_cov_79",92.718,412,15,9,1,408,358,758,2.91e-165,580,407,400
"85297","Ntome_NODE_34237_length_408_cov_5","Nsylvestris_NODE_1707_length_4246_cov_148",91.554,296,14,6,2,286,2604,2309,3.15e-110,398,284,295
"85300","Ntome_NODE_34240_length_408_cov_4","Nsylvestris_NODE_3971_length_3240_cov_210",91.139,158,10,2,68,225,244,91,4.4e-54,211,157,153
"85304","Ntome_NODE_34246_length_408_cov_2","Nsylvestris_NODE_702_length_5427_cov_195",88.542,96,11,0,302,397,4731,4826,9.87e-26,117,95,95
"85309","Ntome_NODE_34248_length_407_cov_301","Nsylvestris_NODE_6464_length_2667_cov_224",97.297,407,11,0,1,407,1893,2299,0,691,406,406
"85312","Ntome_NODE_34250_length_407_cov_200","Nsylvestris_NODE_22755_length_905_cov_188",90.476,294,11,5,1,291,469,190,1.9e-102,372,290,279
"85313","Ntome_NODE_34253_length_407_cov_10","Nsylvestris_NODE_76_length_8864_cov_174",91.667,228,19,0,170,397,3748,3975,9.04e-86,316,227,227
"85314","Ntome_NODE_34255_length_407_cov_8","Nsylvestris_NODE_402_length_6268_cov_86",85.294,272,14,9,123,378,1368,1629,5.56e-68,257,255,261
"85315","Ntome_NODE_34260_length_407_cov_4","Nsylvestris_NODE_3651_length_3351_cov_18",96.232,345,13,0,1,345,2555,2899,8.13e-161,566,344,344
"85316","Ntome_NODE_34261_length_407_cov_3","Nsylvestris_NODE_30491_length_487_cov_5",97.472,356,6,1,52,407,1,353,1.72e-172,604,355,352
"85319","Ntome_NODE_34263_length_407_cov_3","Nsylvestris_NODE_16276_length_1422_cov_32",90.61,426,18,5,4,407,639,214,1.06e-154,545,403,425
"85320","Ntome_NODE_34265_length_407_cov_3","Nsylvestris_NODE_23916_length_837_cov_9",96.337,273,9,1,1,272,451,723,3.07e-125,448,271,272
"85321","Ntome_NODE_34266_length_406_cov_285","Nsylvestris_NODE_16942_length_1361_cov_169",87.5,424,33,7,1,406,808,1229,1.82e-132,472,405,421
"85327","Ntome_NODE_34268_length_406_cov_269","Nsylvestris_NODE_13224_length_1736_cov_241",95.821,335,14,0,72,406,67,401,1.37e-153,542,334,334
"85330","Ntome_NODE_34270_length_406_cov_211","Nsylvestris_NODE_2161_length_3960_cov_137",98.649,74,1,0,333,406,49,122,3.51e-30,132,73,73
"85335","Ntome_NODE_34272_length_406_cov_190","Nsylvestris_NODE_21081_length_1023_cov_16",94.118,221,12,1,186,406,995,776,2.49e-91,335,220,219
"85343","Ntome_NODE_34280_length_406_cov_7","Nsylvestris_NODE_3377_length_3446_cov_67",90.975,277,15,5,130,406,2561,2295,3.18e-100,364,276,266
"85347","Ntome_NODE_34283_length_407_cov_5","Nsylvestris_NODE_5600_length_2841_cov_77",90.698,387,25,9,6,387,1697,1317,1.8e-142,505,381,380
"85348","Ntome_NODE_34287_length_406_cov_3","Nsylvestris_NODE_392_length_6304_cov_88",87.869,305,31,5,102,406,2497,2795,6.87e-97,353,304,298
"85349","Ntome_NODE_34289_length_409_cov_286","Nsylvestris_NODE_2463_length_3810_cov_99",94.03,402,21,1,8,409,3810,3412,4.82e-173,606,401,398
"85358","Ntome_NODE_34305_length_405_cov_4","Nsylvestris_NODE_10026_length_2113_cov_9",96.049,405,16,0,1,405,1138,734,0,660,404,404
"85366","Ntome_NODE_34315_length_404_cov_11","Nsylvestris_NODE_12989_length_1764_cov_210",80.556,144,24,3,35,176,1230,1371,5.88e-23,108,141,141
"85367","Ntome_NODE_34318_length_404_cov_7","Nsylvestris_NODE_5007_length_2971_cov_102",93.103,116,6,2,199,313,654,768,2.66e-41,169,114,114
"85368","Ntome_NODE_34320_length_404_cov_7","Nsylvestris_NODE_6630_length_2637_cov_30",96.25,400,15,0,1,400,562,961,0,656,399,399
"85369","Ntome_NODE_34322_length_404_cov_6","Nsylvestris_NODE_8132_length_2383_cov_14",89.286,392,12,12,15,404,383,20,3.03e-130,464,389,363
"85375","Ntome_NODE_34335_length_403_cov_161","Nsylvestris_NODE_1183_length_4715_cov_148",91.748,412,11,9,1,403,2635,3032,2.25e-156,551,402,397
"85378","Ntome_NODE_34342_length_403_cov_4","Nsylvestris_NODE_3463_length_3414_cov_112",96.97,33,1,0,3,35,417,385,2.15e-07,56.5,32,32
"85379","Ntome_NODE_34346_length_402_cov_237","Nsylvestris_NODE_1161_length_4742_cov_191",95.152,330,13,3,1,329,1889,2216,2.28e-146,518,328,327
"85380","Ntome_NODE_34347_length_402_cov_231","Nsylvestris_NODE_24339_length_810_cov_61",90.157,254,25,0,1,254,412,665,3.19e-90,331,253,253
"85383","Ntome_NODE_34349_length_402_cov_226","Nsylvestris_NODE_4_length_15019_cov_122",94,300,14,4,1,300,9860,10155,2.34e-126,451,299,295
"85384","Ntome_NODE_34350_length_402_cov_195","Nsylvestris_NODE_1684_length_4268_cov_97",93.612,407,19,4,1,401,3822,4227,2.2e-171,601,400,405
"85385","Ntome_NODE_34351_length_393_cov_19","Nsylvestris_NODE_8584_length_2312_cov_105",82.323,198,25,9,75,268,361,170,1.2e-39,163,193,191
"85386","Ntome_NODE_34355_length_402_cov_8","Nsylvestris_NODE_15840_length_1464_cov_208",95.455,44,2,0,1,44,548,505,7.67e-12,71.3,43,43
"85387","Ntome_NODE_34359_length_402_cov_6","Nsylvestris_NODE_954_length_5008_cov_96",100,30,0,0,85,114,4901,4872,2.15e-07,56.5,29,29
"85388","Ntome_NODE_34362_length_402_cov_5","Nsylvestris_NODE_13505_length_1705_cov_36",95.255,274,13,0,1,274,324,51,2.36e-121,435,273,273
"85391","Ntome_NODE_34370_length_401_cov_280","Nsylvestris_NODE_28095_length_624_cov_198",92.614,352,21,3,55,401,493,142,2.29e-141,501,346,351
"85392","Ntome_NODE_34371_length_401_cov_266","Nsylvestris_NODE_14533_length_1597_cov_7",90.025,401,31,8,1,401,1154,1545,3.8e-144,510,400,391
"85401","Ntome_NODE_34376_length_401_cov_9","Nsylvestris_NODE_31495_length_420_cov_4",90.909,231,12,4,4,233,235,13,2.49e-81,302,229,222
"85409","Ntome_NODE_34383_length_401_cov_4","Nsylvestris_NODE_6863_length_2592_cov_72",91.045,402,34,2,1,401,847,447,1.35e-153,542,400,400
"85412","Ntome_NODE_34385_length_401_cov_3","Nsylvestris_NODE_7525_length_2482_cov_20",92.768,401,28,1,1,401,1607,1208,1.03e-164,579,400,399
"85413","Ntome_NODE_34387_length_401_cov_3","Nsylvestris_NODE_5628_length_2831_cov_167",100,30,0,0,1,30,1867,1896,2.14e-07,56.5,29,29
"85428","Ntome_NODE_34393_length_400_cov_41","Nsylvestris_NODE_31945_length_396_cov_14",94.695,377,19,1,25,400,393,17,2.2e-166,584,375,376
"85429","Ntome_NODE_34395_length_400_cov_10","Nsylvestris_NODE_12690_length_1797_cov_17",92.771,83,6,0,87,169,1295,1213,7.47e-27,121,82,82
"85432","Ntome_NODE_34397_length_400_cov_6","Nsylvestris_NODE_1569_length_4350_cov_62",87.963,108,11,2,93,200,720,825,1.61e-28,126,107,105
"85442","Ntome_NODE_34402_length_400_cov_5","Nsylvestris_NODE_30059_length_523_cov_4",96.988,166,5,0,1,166,166,1,1.16e-74,279,165,165
"85443","Ntome_NODE_34403_length_400_cov_5","Nsylvestris_NODE_1286_length_4606_cov_150",82.051,273,44,4,127,398,2386,2118,4.28e-59,228,271,268
"85446","Ntome_NODE_34405_length_400_cov_5","Nsylvestris_NODE_16021_length_1448_cov_25",91.111,405,22,10,1,397,361,759,6.26e-152,536,396,398
"85447","Ntome_NODE_34408_length_400_cov_4","Nsylvestris_NODE_8504_length_2324_cov_16",89.526,401,36,5,2,399,437,834,6.35e-142,503,397,397
"85448","Ntome_NODE_34411_length_400_cov_2","Nsylvestris_NODE_16914_length_1364_cov_50",90.647,417,12,4,1,399,205,612,1.05e-149,529,398,407
"85449","Ntome_NODE_34412_length_400_cov_2","Nsylvestris_NODE_5548_length_2852_cov_35",88.512,383,21,11,1,365,2137,1760,1.4e-123,442,364,377
"85456","Ntome_NODE_34417_length_399_cov_5","Nsylvestris_NODE_8863_length_2270_cov_43",100,29,0,0,82,110,1068,1096,7.69e-07,54.7,28,28
"85459","Ntome_NODE_34421_length_399_cov_4","Nsylvestris_NODE_17919_length_1275_cov_69",93.155,336,23,0,1,336,593,258,3.82e-139,494,335,335
"85469","Ntome_NODE_34429_length_398_cov_12","Nsylvestris_NODE_3548_length_3387_cov_13",93.516,401,13,5,1,398,871,481,2.2e-166,584,397,390
"85470","Ntome_NODE_34431_length_398_cov_7","Nsylvestris_NODE_17715_length_1292_cov_43",93.979,382,15,3,21,398,464,87,1.71e-162,571,377,377
"85474","Ntome_NODE_34434_length_398_cov_6","Nsylvestris_NODE_20880_length_1037_cov_8",94.595,37,1,1,175,211,188,223,2.13e-07,56.5,36,35
"85477","Ntome_NODE_34439_length_398_cov_5","Nsylvestris_NODE_4237_length_3166_cov_10",96.977,397,12,0,1,397,2416,2812,0,667,396,396
"85481","Ntome_NODE_34442_length_398_cov_4","Nsylvestris_NODE_33131_length_348_cov_4",96.491,228,8,0,171,398,1,228,4.01e-104,377,227,227
"85482","Ntome_NODE_34443_length_398_cov_3","Nsylvestris_NODE_51_length_9473_cov_96",94.472,398,22,0,1,398,2340,2737,2.81e-175,614,397,397
"85492","Ntome_NODE_34447_length_397_cov_165","Nsylvestris_NODE_5268_length_2911_cov_223",83.571,420,37,12,1,391,2762,2346,3.11e-100,364,390,416
"85497","Ntome_NODE_34451_length_397_cov_8","Nsylvestris_NODE_8703_length_2294_cov_112",89.443,341,32,4,38,376,180,518,3.91e-119,427,338,338
"85498","Ntome_NODE_34457_length_397_cov_4","Nsylvestris_NODE_35668_length_280_cov_4",82.784,273,21,6,125,397,280,34,7.13e-57,220,272,246
"85499","Ntome_NODE_34459_length_397_cov_4","Nsylvestris_NODE_8005_length_2403_cov_15",91.085,258,23,0,100,357,535,278,8.71e-96,350,257,257
"85500","Ntome_NODE_34460_length_398_cov_3","Nsylvestris_NODE_1091_length_4831_cov_112",97.917,384,5,1,2,382,3572,3189,0,662,380,383
"85504","Ntome_NODE_34467_length_398_cov_300","Nsylvestris_NODE_68_length_9073_cov_176",95.226,398,16,2,1,398,6938,7332,3.6e-179,627,397,394
"85505","Ntome_NODE_34468_length_396_cov_297","Nsylvestris_NODE_8576_length_2313_cov_187",90.836,371,16,5,12,367,1946,2313,2.95e-135,481,355,367
"85506","Ntome_NODE_34469_length_396_cov_271","Nsylvestris_NODE_9496_length_2178_cov_201",98.113,53,1,0,342,394,94,146,1.62e-18,93.5,52,52
"85509","Ntome_NODE_34471_length_396_cov_199","Nsylvestris_NODE_20944_length_1033_cov_184",89.873,395,17,6,1,395,515,886,6.35e-137,486,394,371
"85510","Ntome_NODE_34475_length_396_cov_11","Nsylvestris_NODE_27223_length_663_cov_74",82.873,181,28,1,185,362,425,605,1.57e-38,159,177,180
"85515","Ntome_NODE_34484_length_396_cov_5","Nsylvestris_NODE_7986_length_2406_cov_17",94.697,396,21,0,1,396,121,516,7.76e-176,616,395,395
"85516","Ntome_NODE_34486_length_396_cov_4","Nsylvestris_NODE_9106_length_2236_cov_13",76.349,241,54,3,130,368,860,621,1.59e-28,126,238,239
"85517","Ntome_NODE_34489_length_396_cov_3","Nsylvestris_NODE_13752_length_1679_cov_135",97.727,396,9,0,1,396,848,1243,0,682,395,395
"85518","Ntome_NODE_34491_length_396_cov_2","Nsylvestris_NODE_3902_length_3266_cov_141",84.487,419,29,16,2,396,1993,1587,3.08e-105,381,394,406
"85519","Ntome_NODE_34492_length_395_cov_316","Nsylvestris_NODE_10299_length_2075_cov_135",99.494,395,2,0,1,395,1123,1517,0,719,394,394
"85520","Ntome_NODE_34493_length_395_cov_199","Nsylvestris_NODE_9955_length_2121_cov_172",92.462,398,25,4,1,393,1580,1183,2.84e-160,564,392,397
"85521","Ntome_NODE_34495_length_395_cov_9","Nsylvestris_NODE_31784_length_404_cov_7",96.571,175,4,1,1,175,232,404,1.92e-77,289,174,172
"85525","Ntome_NODE_34499_length_395_cov_7","Nsylvestris_NODE_37046_length_251_cov_3",84.016,244,27,5,61,292,246,3,5.48e-58,224,231,243
"85526","Ntome_NODE_34502_length_395_cov_6","Nsylvestris_NODE_29037_length_582_cov_13",92.929,396,22,3,1,392,157,550,1.7e-162,571,391,393
"85527","Ntome_NODE_34506_length_395_cov_4","Nsylvestris_NODE_22248_length_939_cov_154",97.959,49,1,0,1,49,196,244,2.7e-16,86.1,48,48
"85528","Ntome_NODE_34507_length_395_cov_3","Nsylvestris_NODE_8671_length_2298_cov_84",95.696,395,17,0,1,395,1173,1567,0,636,394,394
"85529","Ntome_NODE_34509_length_395_cov_2","Nsylvestris_NODE_10762_length_2018_cov_72",91.667,72,6,0,221,292,1947,2018,9.63e-21,100,71,71
"85530","Ntome_NODE_34510_length_394_cov_315","Nsylvestris_NODE_23962_length_834_cov_136",94.937,237,12,0,158,394,163,399,1.84e-102,372,236,236
"85531","Ntome_NODE_34511_length_394_cov_291","Nsylvestris_NODE_11253_length_1956_cov_223",97.462,394,10,0,1,394,876,1269,0,673,393,393
"85532","Ntome_NODE_34512_length_394_cov_275","Nsylvestris_NODE_2434_length_3824_cov_170",97.661,342,8,0,53,394,786,1127,1.68e-167,588,341,341
"85535","Ntome_NODE_34515_length_394_cov_207","Nsylvestris_NODE_10924_length_1997_cov_209",95.053,283,14,0,1,283,391,109,1.07e-124,446,282,282
"85536","Ntome_NODE_34516_length_394_cov_194","Nsylvestris_NODE_17929_length_1274_cov_179",91.624,394,33,0,1,394,552,945,1.03e-154,545,393,393
"85537","Ntome_NODE_34517_length_394_cov_192","Nsylvestris_NODE_9955_length_2121_cov_172",92.714,398,23,5,1,392,1580,1183,6.09e-162,569,391,397
"85545","Ntome_NODE_34521_length_394_cov_11","Nsylvestris_NODE_22064_length_952_cov_8",92.416,356,23,3,43,394,906,551,1.74e-142,505,351,355
"85546","Ntome_NODE_34526_length_394_cov_6","Nsylvestris_NODE_60_length_9257_cov_109",93.147,394,25,2,2,394,5281,4889,3.64e-164,577,392,392
"85547","Ntome_NODE_34528_length_394_cov_6","Nsylvestris_NODE_30065_length_521_cov_10",98.473,393,5,1,1,392,36,428,0,691,391,392
"85548","Ntome_NODE_34529_length_394_cov_5","Nsylvestris_NODE_24958_length_774_cov_6",91.758,182,12,3,169,350,84,262,9.01e-66,250,181,178
"85549","Ntome_NODE_34530_length_394_cov_5","Nsylvestris_NODE_1015_length_4928_cov_41",89.643,280,22,2,122,394,1033,1312,8.64e-96,350,272,279
"85553","Ntome_NODE_34537_length_393_cov_291","Nsylvestris_NODE_7230_length_2529_cov_205",95.116,389,19,0,3,391,1284,1672,2.77e-175,614,388,388
"85567","Ntome_NODE_34546_length_393_cov_7","Nsylvestris_NODE_1696_length_4257_cov_120",95.09,387,15,2,7,393,1846,1464,4.63e-173,606,386,382
"85568","Ntome_NODE_34547_length_393_cov_7","Nsylvestris_NODE_1983_length_4066_cov_70",89.474,57,3,2,336,392,607,660,2.7e-11,69.4,56,53
"85569","Ntome_NODE_34553_length_393_cov_5","Nsylvestris_NODE_2207_length_3934_cov_230",100,37,0,0,1,37,2646,2682,2.7e-11,69.4,36,36
"85570","Ntome_NODE_34559_length_393_cov_4","Nsylvestris_NODE_31920_length_398_cov_2",95.965,347,8,2,1,345,56,398,1.32e-158,558,344,342
"85571","Ntome_NODE_34561_length_393_cov_3","Nsylvestris_NODE_33232_length_345_cov_4",97.273,110,3,0,284,393,54,163,7.15e-47,187,109,109
"85572","Ntome_NODE_34565_length_392_cov_213","Nsylvestris_NODE_19461_length_1147_cov_174",92.81,306,17,4,1,306,437,137,1.78e-122,438,305,300
"85573","Ntome_NODE_34566_length_392_cov_191","Nsylvestris_NODE_22930_length_895_cov_143",98.05,359,6,1,1,358,359,1,4.59e-178,623,357,358
"85574","Ntome_NODE_34567_length_392_cov_154","Nsylvestris_NODE_34482_length_308_cov_63",84.32,338,22,11,52,388,1,308,2.44e-81,302,336,307
"85575","Ntome_NODE_34569_length_390_cov_11","Nsylvestris_NODE_25802_length_728_cov_34",85.714,371,25,3,15,385,116,458,8.49e-101,366,370,342
"85576","Ntome_NODE_34570_length_392_cov_9","Nsylvestris_NODE_27348_length_658_cov_38",88.406,414,24,5,1,390,532,119,3.78e-134,477,389,413
"85581","Ntome_NODE_34573_length_392_cov_7","Nsylvestris_NODE_30908_length_457_cov_14",96.507,229,8,0,98,326,390,162,1.1e-104,379,228,228
"85582","Ntome_NODE_34581_length_392_cov_4","Nsylvestris_NODE_3436_length_3426_cov_141",98.721,391,5,0,1,391,3056,2666,0,695,390,390
"85583","Ntome_NODE_34582_length_392_cov_4","Nsylvestris_NODE_24992_length_772_cov_14",92.228,386,19,3,8,392,604,229,6.15e-152,536,384,375
"85584","Ntome_NODE_34588_length_391_cov_243","Nsylvestris_NODE_5268_length_2911_cov_223",88.131,396,38,4,1,390,2247,1855,1.06e-129,462,389,392
"85588","Ntome_NODE_34590_length_391_cov_7","Nsylvestris_NODE_2535_length_3777_cov_83",88.806,402,30,5,1,390,2523,2921,1.05e-134,479,389,398
"85592","Ntome_NODE_34595_length_391_cov_5","Nsylvestris_NODE_36584_length_260_cov_4",95.367,259,11,1,2,260,3,260,3.88e-114,411,258,257
"85596","Ntome_NODE_34600_length_391_cov_4","Nsylvestris_NODE_34823_length_299_cov_6",95.638,298,13,0,90,387,299,2,1.05e-134,479,297,297
"85599","Ntome_NODE_34602_length_391_cov_4","Nsylvestris_NODE_15355_length_1517_cov_86",93.691,317,18,2,75,391,684,998,4.87e-133,473,316,314
"85600","Ntome_NODE_34607_length_390_cov_275","Nsylvestris_NODE_13967_length_1654_cov_214",96.154,390,15,0,1,390,1455,1066,0,638,389,389
"85603","Ntome_NODE_34609_length_390_cov_232","Nsylvestris_NODE_10030_length_2112_cov_212",98.047,256,4,1,1,256,1702,1956,3.81e-124,444,255,254
"85608","Ntome_NODE_34613_length_390_cov_168","Nsylvestris_NODE_3371_length_3448_cov_210",96.089,179,6,1,1,178,265,87,5.25e-78,291,177,178
"85612","Ntome_NODE_34617_length_390_cov_11","Nsylvestris_NODE_505_length_5948_cov_29",77.211,294,60,7,96,386,2683,2972,3.32e-40,165,290,289
"85616","Ntome_NODE_34619_length_390_cov_8","Nsylvestris_NODE_20995_length_1028_cov_36",90.49,347,24,5,39,383,280,619,8.19e-126,449,344,339
"85617","Ntome_NODE_34623_length_390_cov_5","Nsylvestris_NODE_17619_length_1301_cov_33",89.059,393,33,5,1,387,21,409,1.04e-134,479,386,388
"85618","Ntome_NODE_34624_length_390_cov_4","Nsylvestris_NODE_7461_length_2494_cov_107",86.041,394,32,11,1,390,2098,2472,2.33e-111,401,389,374
"85619","Ntome_NODE_34627_length_389_cov_311","Nsylvestris_NODE_12834_length_1782_cov_211",97.686,389,9,0,1,389,1042,1430,0,669,388,388
"85620","Ntome_NODE_34628_length_389_cov_299","Nsylvestris_NODE_1857_length_4145_cov_130",98.458,389,6,0,1,389,2342,1954,0,686,388,388
"85625","Ntome_NODE_34631_length_389_cov_218","Nsylvestris_NODE_24650_length_791_cov_205",85.556,360,20,22,1,340,375,722,3.07e-95,348,339,347
"85628","Ntome_NODE_34633_length_389_cov_10","Nsylvestris_NODE_8767_length_2285_cov_28",93.151,73,4,1,173,245,72,1,2.04e-22,106,72,71
"85629","Ntome_NODE_34634_length_389_cov_9","Nsylvestris_NODE_1124_length_4787_cov_79",95.573,384,16,1,1,383,1929,2312,2.74e-175,614,382,383
"85632","Ntome_NODE_34637_length_389_cov_9","Nsylvestris_NODE_30926_length_456_cov_16",87.349,332,33,5,1,325,127,456,1.82e-102,372,324,329
"85633","Ntome_NODE_34638_length_389_cov_5","Nsylvestris_NODE_1075_length_4848_cov_117",96.639,357,12,0,33,389,415,59,3.57e-169,593,356,356
"85634","Ntome_NODE_34642_length_389_cov_4","Nsylvestris_NODE_1613_length_4320_cov_178",91.536,319,17,3,1,309,973,655,2.96e-120,431,308,318
"85638","Ntome_NODE_34652_length_389_cov_2","Nsylvestris_NODE_15001_length_1550_cov_11",76.955,243,46,8,110,348,412,176,1.21e-29,130,238,236
"85644","Ntome_NODE_34655_length_390_cov_31","Nsylvestris_NODE_18573_length_1218_cov_223",83.5,200,19,6,65,263,948,762,5.52e-43,174,198,186
"85645","Ntome_NODE_34656_length_388_cov_13","Nsylvestris_NODE_31822_length_402_cov_8",91.239,331,28,1,20,349,402,72,8.15e-126,449,329,330
"85648","Ntome_NODE_34659_length_388_cov_7","Nsylvestris_NODE_5871_length_2789_cov_90",97.059,34,1,0,75,108,2588,2555,5.77e-08,58.4,33,33
"85649","Ntome_NODE_34660_length_388_cov_7","Nsylvestris_NODE_4110_length_3200_cov_122",90,50,5,0,1,50,2396,2347,3.45e-10,65.8,49,49
"85650","Ntome_NODE_34662_length_388_cov_6","Nsylvestris_NODE_9951_length_2122_cov_13",96.264,348,13,0,40,387,2119,1772,1.67e-162,571,347,347
"85651","Ntome_NODE_34663_length_388_cov_6","Nsylvestris_NODE_11060_length_1981_cov_10",94.845,388,20,0,1,388,689,1076,4.57e-173,606,387,387
"85652","Ntome_NODE_34665_length_388_cov_6","Nsylvestris_NODE_14672_length_1582_cov_24",100,383,0,0,6,388,354,736,0,708,382,382
"85656","Ntome_NODE_34672_length_387_cov_243","Nsylvestris_NODE_19497_length_1144_cov_17",94.792,384,20,0,4,387,817,434,7.62e-171,599,383,383
"85657","Ntome_NODE_34673_length_387_cov_242","Nsylvestris_NODE_7929_length_2415_cov_68",95.538,381,17,0,7,387,1192,812,3.52e-174,610,380,380
"85658","Ntome_NODE_34674_length_387_cov_235","Nsylvestris_NODE_14439_length_1606_cov_175",95.103,388,10,3,1,387,1526,1147,5.89e-172,603,386,379
"85661","Ntome_NODE_34680_length_387_cov_7","Nsylvestris_NODE_30140_length_514_cov_8",94.1,339,20,0,49,387,514,176,7.9e-146,516,338,338
"85662","Ntome_NODE_34682_length_387_cov_4","Nsylvestris_NODE_7757_length_2444_cov_63",92.332,313,20,4,76,385,505,194,1.36e-123,442,309,311
"85663","Ntome_NODE_34687_length_387_cov_3","Nsylvestris_NODE_3253_length_3488_cov_174",96.296,54,2,0,334,387,754,807,2.04e-17,89.8,53,53
"85664","Ntome_NODE_34689_length_387_cov_2","Nsylvestris_NODE_9677_length_2156_cov_24",97.416,387,10,0,1,387,755,1141,0,660,386,386
"85669","Ntome_NODE_34696_length_386_cov_246","Nsylvestris_NODE_7632_length_2465_cov_225",93.243,296,9,3,49,344,19,303,1.37e-118,425,295,284
"85678","Ntome_NODE_34700_length_386_cov_178","Nsylvestris_NODE_3020_length_3578_cov_120",94.712,208,10,1,52,259,3220,3426,1.84e-87,322,207,206
"85679","Ntome_NODE_34701_length_386_cov_174","Nsylvestris_NODE_22643_length_913_cov_198",92.722,371,20,4,20,386,913,546,1.01e-149,529,366,367
"85683","Ntome_NODE_34703_length_386_cov_166","Nsylvestris_NODE_9790_length_2141_cov_213",90.217,368,10,11,1,352,358,1,4.84e-128,457,351,357
"85684","Ntome_NODE_34706_length_386_cov_15","Nsylvestris_NODE_13561_length_1700_cov_16",94.385,374,18,2,1,374,274,644,1.66e-162,571,373,370
"85685","Ntome_NODE_34709_length_386_cov_7","Nsylvestris_NODE_28717_length_597_cov_4",83.607,366,39,11,25,386,232,580,5.12e-88,324,361,348
"85686","Ntome_NODE_34713_length_386_cov_5","Nsylvestris_NODE_750_length_5351_cov_204",100,41,0,0,1,41,4161,4201,1.58e-13,76.8,40,40
"85687","Ntome_NODE_34714_length_386_cov_5","Nsylvestris_NODE_15984_length_1451_cov_9",95.402,174,8,0,1,174,360,533,4.05e-74,278,173,173
"85690","Ntome_NODE_34720_length_386_cov_4","Nsylvestris_NODE_7169_length_2540_cov_213",90,140,9,1,177,311,1645,1506,1.52e-43,176,134,139
"85691","Ntome_NODE_34721_length_386_cov_4","Nsylvestris_NODE_24162_length_822_cov_25",90.769,390,19,10,1,386,416,40,1.7e-142,505,385,376
"85692","Ntome_NODE_34722_length_386_cov_4","Nsylvestris_NODE_4955_length_2985_cov_104",96.774,31,1,0,1,31,2558,2528,2.67e-06,52.8,30,30
"85693","Ntome_NODE_34724_length_386_cov_4","Nsylvestris_NODE_35800_length_277_cov_7",91.176,272,21,3,101,369,4,275,8.39e-101,366,268,271
"85694","Ntome_NODE_34725_length_386_cov_4","Nsylvestris_NODE_13867_length_1666_cov_208",87.687,268,29,4,5,269,541,275,1.43e-83,309,264,266
"85695","Ntome_NODE_34726_length_386_cov_3","Nsylvestris_NODE_19232_length_1165_cov_82",96.281,242,9,0,1,242,759,1000,2.98e-110,398,241,241
"85696","Ntome_NODE_34727_length_386_cov_3","Nsylvestris_NODE_5131_length_2942_cov_129",90.104,384,23,9,5,386,66,436,2.22e-136,484,381,370
"85697","Ntome_NODE_34731_length_386_cov_2","Nsylvestris_NODE_5163_length_2934_cov_212",96.97,33,1,0,354,386,1203,1235,2.06e-07,56.5,32,32
"85698","Ntome_NODE_34733_length_385_cov_203","Nsylvestris_NODE_610_length_5685_cov_144",89.404,302,19,6,75,375,2442,2731,2.33e-101,368,300,289
"85701","Ntome_NODE_34735_length_385_cov_185","Nsylvestris_NODE_29799_length_544_cov_229",97.619,168,4,0,1,168,333,500,1.86e-77,289,167,167
"85704","Ntome_NODE_34737_length_385_cov_15","Nsylvestris_NODE_36488_length_262_cov_5",84.685,222,13,6,185,385,1,222,2.5e-51,202,200,221
"85705","Ntome_NODE_34738_length_385_cov_6","Nsylvestris_NODE_24890_length_778_cov_10",85.714,112,12,3,138,248,322,214,3.35e-25,115,110,108
"85706","Ntome_NODE_34739_length_385_cov_4","Nsylvestris_NODE_14004_length_1648_cov_123",98.182,385,7,0,1,385,1073,689,0,673,384,384
"85712","Ntome_NODE_34744_length_384_cov_316","Nsylvestris_NODE_12711_length_1794_cov_209",98.177,384,6,1,1,384,1570,1188,0,669,383,382
"85713","Ntome_NODE_34745_length_384_cov_311","Nsylvestris_NODE_2084_length_4003_cov_207",97.396,384,10,0,1,384,1345,1728,0,654,383,383
"85720","Ntome_NODE_34748_length_384_cov_235","Nsylvestris_NODE_23979_length_833_cov_66",90.8,250,9,1,1,250,544,779,1.83e-87,322,249,235
"85724","Ntome_NODE_34752_length_384_cov_27","Nsylvestris_NODE_11400_length_1942_cov_18",86.667,135,13,5,5,138,1794,1924,4.26e-34,145,133,130
"85725","Ntome_NODE_34753_length_384_cov_23","Nsylvestris_NODE_32680_length_364_cov_13",92,350,21,6,11,357,19,364,2.21e-136,484,346,345
"85726","Ntome_NODE_34754_length_384_cov_19","Nsylvestris_NODE_30448_length_490_cov_84",95.058,344,14,1,36,379,442,102,1.67e-152,538,343,340
"85733","Ntome_NODE_34760_length_384_cov_7","Nsylvestris_NODE_16979_length_1359_cov_15",97.598,333,8,0,51,383,1329,997,1.65e-162,571,332,332
"85734","Ntome_NODE_34762_length_384_cov_5","Nsylvestris_NODE_6571_length_2648_cov_175",100,33,0,0,352,384,1314,1282,4.41e-09,62.1,32,32
"85741","Ntome_NODE_34767_length_384_cov_4","Nsylvestris_NODE_29915_length_535_cov_2",90.789,152,14,0,193,344,1,152,6.93e-52,204,151,151
"85742","Ntome_NODE_34769_length_384_cov_3","Nsylvestris_NODE_13092_length_1752_cov_58",97.479,357,6,1,31,384,1213,1569,4.52e-173,606,353,356
"85753","Ntome_NODE_34777_length_383_cov_228","Nsylvestris_NODE_4081_length_3209_cov_226",92.105,228,14,2,111,334,568,795,2.36e-86,318,223,227
"85756","Ntome_NODE_34781_length_383_cov_8","Nsylvestris_NODE_27811_length_637_cov_138",93.6,375,23,1,1,374,623,249,1.28e-158,558,373,374
"85763","Ntome_NODE_34793_length_383_cov_3","Nsylvestris_NODE_4004_length_3232_cov_132",93.973,365,15,1,25,382,2335,2699,9.96e-155,545,357,364
"85766","Ntome_NODE_34796_length_383_cov_2","Nsylvestris_NODE_10506_length_2050_cov_28",94.643,392,12,1,1,383,937,546,7.54e-171,599,382,391
"85772","Ntome_NODE_34800_length_382_cov_278","Nsylvestris_NODE_491_length_5983_cov_168",97.382,382,10,0,1,382,2936,2555,0,651,381,381
"85775","Ntome_NODE_34804_length_382_cov_179","Nsylvestris_NODE_26501_length_696_cov_9",84.615,104,16,0,1,104,680,577,7.19e-22,104,103,103
"85782","Ntome_NODE_34809_length_382_cov_9","Nsylvestris_NODE_29000_length_584_cov_7",87.442,215,24,2,1,215,373,584,4.06e-64,244,214,211
"85785","Ntome_NODE_34820_length_382_cov_4","Nsylvestris_NODE_4877_length_3001_cov_103",99.34,303,2,0,1,303,1940,1638,7.68e-156,549,302,302
"85786","Ntome_NODE_34824_length_382_cov_2","Nsylvestris_NODE_63_length_9186_cov_130",97.778,45,0,1,1,45,6093,6050,1.57e-13,76.8,44,43
"85789","Ntome_NODE_34826_length_381_cov_285","Nsylvestris_NODE_9104_length_2236_cov_106",96.744,215,7,0,167,381,2236,2022,1.39e-98,359,214,214
"85790","Ntome_NODE_34827_length_381_cov_277","Nsylvestris_NODE_5469_length_2869_cov_231",97.889,379,8,0,1,379,393,771,0,656,378,378
"85794","Ntome_NODE_34834_length_381_cov_5","Nsylvestris_NODE_26567_length_693_cov_18",88.221,416,10,9,1,381,3,414,3.69e-129,460,380,411
"85795","Ntome_NODE_34838_length_381_cov_3","Nsylvestris_NODE_17557_length_1308_cov_8",98.276,232,4,0,1,232,273,42,4.88e-113,407,231,231
"85802","Ntome_NODE_34844_length_380_cov_263","Nsylvestris_NODE_20814_length_1041_cov_229",95.468,331,13,2,51,380,903,574,3.58e-149,527,329,329
"85806","Ntome_NODE_34846_length_380_cov_219","Nsylvestris_NODE_19151_length_1171_cov_214",90.909,385,24,4,1,380,1063,685,4.66e-143,507,379,378
"85807","Ntome_NODE_34847_length_380_cov_206","Nsylvestris_NODE_8834_length_2274_cov_200",90,190,7,3,70,257,2196,2017,2.43e-61,235,187,179
"85810","Ntome_NODE_34849_length_379_cov_177","Nsylvestris_NODE_527_length_5882_cov_161",96.364,55,2,0,325,379,523,577,5.55e-18,91.6,54,54
"85813","Ntome_NODE_34853_length_380_cov_14","Nsylvestris_NODE_27700_length_642_cov_4",89.973,369,32,3,13,380,642,278,1.7e-132,472,367,364
"85814","Ntome_NODE_34855_length_380_cov_10","Nsylvestris_NODE_548_length_5829_cov_125",96.491,57,2,0,158,214,5773,5829,4.3e-19,95.3,56,56
"85818","Ntome_NODE_34864_length_380_cov_2","Nsylvestris_NODE_3158_length_3524_cov_94",91.99,387,21,6,1,380,582,965,2.14e-151,534,379,383
"85819","Ntome_NODE_34865_length_380_cov_2","Nsylvestris_NODE_10474_length_2053_cov_225",100,33,0,0,348,380,826,794,4.36e-09,62.1,32,32
"85820","Ntome_NODE_34866_length_379_cov_194","Nsylvestris_NODE_17487_length_1314_cov_217",89.091,385,17,10,12,379,26,402,1.71e-127,455,367,376
"85821","Ntome_NODE_34867_length_379_cov_176","Nsylvestris_NODE_145_length_7832_cov_124",100,29,0,0,77,105,6243,6215,7.28e-07,54.7,28,28
"85822","Ntome_NODE_34868_length_379_cov_161","Nsylvestris_NODE_3217_length_3501_cov_132",94.643,56,2,1,7,62,1813,1759,2.58e-16,86.1,55,54
"85831","Ntome_NODE_34874_length_379_cov_6","Nsylvestris_NODE_6614_length_2640_cov_75",95.733,375,12,2,3,377,1643,1273,2.07e-171,601,374,370
"85832","Ntome_NODE_34876_length_379_cov_6","Nsylvestris_NODE_16635_length_1388_cov_9",82.143,112,11,7,156,260,1122,1013,7.18e-17,87.9,104,109
"85833","Ntome_NODE_34877_length_379_cov_5","Nsylvestris_NODE_366_length_6419_cov_87",83.947,380,59,2,1,379,1730,2108,1.06e-99,363,378,378
"85834","Ntome_NODE_34881_length_379_cov_4","Nsylvestris_NODE_30152_length_513_cov_5",98.551,345,5,0,1,345,345,1,3.44e-174,610,344,344
"85835","Ntome_NODE_34883_length_379_cov_4","Nsylvestris_NODE_17689_length_1295_cov_46",94.156,308,15,2,1,305,996,689,7.89e-131,466,304,307
"85838","Ntome_NODE_34888_length_379_cov_3","Nsylvestris_NODE_3861_length_3280_cov_92",86.275,357,40,5,2,357,333,681,1.06e-104,379,355,348
"85839","Ntome_NODE_34891_length_379_cov_2","Nsylvestris_NODE_7354_length_2512_cov_26",97.889,379,8,0,1,379,378,756,0,656,378,378
"85840","Ntome_NODE_34892_length_378_cov_339","Nsylvestris_NODE_25794_length_728_cov_174",93.734,383,19,3,1,378,110,492,5.83e-162,569,377,382
"85844","Ntome_NODE_34894_length_378_cov_319","Nsylvestris_NODE_658_length_5531_cov_126",95.767,378,16,0,1,378,4680,4303,3.43e-174,610,377,377
"85855","Ntome_NODE_34899_length_378_cov_268","Nsylvestris_NODE_9404_length_2193_cov_24",89.583,384,27,3,5,378,1325,1705,1.31e-133,475,373,380
"85860","Ntome_NODE_34901_length_378_cov_193","Nsylvestris_NODE_3103_length_3542_cov_171",100,54,0,0,325,378,1235,1288,9.19e-21,100,53,53
"85861","Ntome_NODE_34903_length_378_cov_35","Nsylvestris_NODE_32520_length_371_cov_143",80.427,281,51,4,11,288,51,330,4.07e-54,211,277,279
"85862","Ntome_NODE_34905_length_378_cov_9","Nsylvestris_NODE_113_length_8253_cov_73",77.517,298,60,7,2,294,7139,7434,1.92e-42,172,292,295
"85863","Ntome_NODE_34906_length_377_cov_8","Nsylvestris_NODE_1360_length_4535_cov_71",95.491,377,17,0,1,377,280,656,5.73e-172,603,376,376
"85867","Ntome_NODE_34916_length_378_cov_4","Nsylvestris_NODE_2619_length_3733_cov_101",94.709,378,20,0,1,378,3095,3472,1.61e-167,588,377,377
"85877","Ntome_NODE_34926_length_377_cov_311","Nsylvestris_NODE_2341_length_3877_cov_216",96.552,377,13,0,1,377,2156,2532,1.22e-178,625,376,376
"85880","Ntome_NODE_34928_length_377_cov_34","Nsylvestris_NODE_13039_length_1759_cov_138",94.828,58,2,1,321,377,422,479,1.98e-17,89.8,56,57
"85881","Ntome_NODE_34930_length_377_cov_9","Nsylvestris_NODE_31548_length_417_cov_2",90.852,317,27,2,1,317,315,1,4.79e-118,424,316,314
"85882","Ntome_NODE_34932_length_377_cov_8","Nsylvestris_NODE_23450_length_863_cov_55",93.899,377,20,1,1,374,172,548,7.52e-161,566,373,376
"85885","Ntome_NODE_34936_length_377_cov_5","Nsylvestris_NODE_14327_length_1619_cov_15",96.021,377,15,0,1,377,1386,1010,2.65e-175,614,376,376
"85886","Ntome_NODE_34938_length_377_cov_4","Nsylvestris_NODE_487_length_5996_cov_35",89.916,119,11,1,161,278,5878,5996,2.5e-36,152,117,118
"85887","Ntome_NODE_34940_length_377_cov_4","Nsylvestris_NODE_11252_length_1957_cov_5",99.469,377,2,0,1,377,991,615,0,686,376,376
"85888","Ntome_NODE_34941_length_377_cov_3","Nsylvestris_NODE_22665_length_911_cov_187",100,33,0,0,1,33,345,377,4.33e-09,62.1,32,32
"85897","Ntome_NODE_34950_length_376_cov_12","Nsylvestris_NODE_27920_length_632_cov_13",93.611,360,20,2,17,376,164,520,2.11e-151,534,359,356
"85898","Ntome_NODE_34951_length_376_cov_9","Nsylvestris_NODE_23203_length_878_cov_42",92.308,351,24,3,27,376,421,73,9.98e-140,496,349,348
"85899","Ntome_NODE_34952_length_376_cov_5","Nsylvestris_NODE_16491_length_1401_cov_7",88.235,51,5,1,233,283,238,287,1.55e-08,60.2,50,49
"85900","Ntome_NODE_34953_length_376_cov_5","Nsylvestris_NODE_3607_length_3363_cov_32",91.228,342,30,0,4,345,1308,1649,7.82e-131,466,341,341
"85901","Ntome_NODE_34954_length_376_cov_5","Nsylvestris_NODE_62_length_9216_cov_60",95.266,338,16,0,39,376,3403,3740,5.88e-152,536,337,337
"85902","Ntome_NODE_34955_length_376_cov_5","Nsylvestris_NODE_36530_length_261_cov_7",95.618,251,3,4,40,283,11,260,1.04e-109,396,243,249
"85903","Ntome_NODE_34956_length_376_cov_5","Nsylvestris_NODE_8281_length_2358_cov_40",93.122,378,21,4,3,376,1897,1521,7.55e-156,549,373,376
"85906","Ntome_NODE_34962_length_376_cov_3","Nsylvestris_NODE_30586_length_480_cov_3",93.238,281,11,4,1,281,273,1,4.81e-113,407,280,272
"85907","Ntome_NODE_34963_length_376_cov_3","Nsylvestris_NODE_3704_length_3334_cov_62",91.755,376,21,1,1,376,1450,1085,2.75e-145,514,375,365
"85911","Ntome_NODE_34972_length_375_cov_219","Nsylvestris_NODE_7710_length_2451_cov_140",92.877,351,19,3,2,346,2034,2384,1.65e-142,505,344,350
"85912","Ntome_NODE_34973_length_375_cov_213","Nsylvestris_NODE_16250_length_1420_cov_231",87.113,388,9,10,1,353,382,1,2.23e-111,401,352,381
"85913","Ntome_NODE_34974_length_375_cov_198","Nsylvestris_NODE_15785_length_1471_cov_204",87.714,350,19,7,29,375,1415,1087,6.25e-107,387,346,328
"85914","Ntome_NODE_34975_length_375_cov_185","Nsylvestris_NODE_2009_length_4047_cov_207",94.62,316,12,2,7,322,31,341,2.15e-136,484,315,310
"85917","Ntome_NODE_34979_length_375_cov_10","Nsylvestris_NODE_36368_length_265_cov_4",88.312,154,13,4,3,152,5,157,1.14e-44,180,149,152
"85918","Ntome_NODE_34980_length_375_cov_8","Nsylvestris_NODE_32341_length_379_cov_12",90.377,239,17,3,1,236,144,379,1.39e-83,309,235,235
"85919","Ntome_NODE_34981_length_375_cov_6","Nsylvestris_NODE_16131_length_1435_cov_45",78.74,254,45,7,99,346,1073,1323,4.12e-39,161,247,250
"85925","Ntome_NODE_34992_length_375_cov_4","Nsylvestris_NODE_11970_length_1874_cov_22",95.652,345,15,0,31,375,114,458,1.62e-157,555,344,344
"85926","Ntome_NODE_34993_length_375_cov_4","Nsylvestris_NODE_6182_length_2720_cov_124",85.932,263,31,6,1,259,1350,1090,1.41e-73,276,258,260
"85930","Ntome_NODE_34997_length_375_cov_2","Nsylvestris_NODE_7816_length_2434_cov_171",95.833,48,2,0,1,48,490,537,4.27e-14,78.7,47,47
"85933","Ntome_NODE_34999_length_374_cov_223","Nsylvestris_NODE_8488_length_2326_cov_223",91.093,247,19,3,129,374,34,278,2.96e-90,331,245,244
"85936","Ntome_NODE_35006_length_374_cov_6","Nsylvestris_NODE_15206_length_1531_cov_9",94.783,345,11,3,19,357,524,867,2.72e-150,531,338,343
"85937","Ntome_NODE_35007_length_374_cov_6","Nsylvestris_NODE_24477_length_802_cov_46",96.45,169,5,1,166,333,313,481,3.91e-74,278,167,168
"85938","Ntome_NODE_35011_length_374_cov_4","Nsylvestris_NODE_1205_length_4701_cov_118",91.935,372,29,1,4,374,4297,3926,5.89e-147,520,370,371
"85944","Ntome_NODE_35018_length_374_cov_3","Nsylvestris_NODE_26368_length_702_cov_8",81.622,370,55,11,7,371,702,341,3.88e-79,294,364,361
"85945","Ntome_NODE_35021_length_373_cov_286","Nsylvestris_NODE_10491_length_2051_cov_179",94.37,373,18,1,1,373,738,1107,5.75e-162,569,372,369
"85963","Ntome_NODE_35027_length_373_cov_17","Nsylvestris_NODE_26309_length_705_cov_7",93.6,125,6,2,66,188,535,411,2.43e-46,185,122,124
"85967","Ntome_NODE_35029_length_373_cov_15","Nsylvestris_NODE_22873_length_899_cov_5",95.455,66,3,0,104,169,702,767,1.95e-22,106,65,65
"85968","Ntome_NODE_35033_length_373_cov_7","Nsylvestris_NODE_30411_length_493_cov_27",78.102,274,51,9,9,276,79,349,3.17e-40,165,267,270
"85969","Ntome_NODE_35036_length_373_cov_5","Nsylvestris_NODE_2588_length_3750_cov_164",89.796,196,16,2,179,373,3424,3616,3.06e-65,248,194,192
"85970","Ntome_NODE_35038_length_373_cov_4","Nsylvestris_NODE_2399_length_3840_cov_105",94.611,334,16,2,41,373,1689,2021,7.59e-146,516,332,332
"85976","Ntome_NODE_35043_length_373_cov_2","Nsylvestris_NODE_11252_length_1957_cov_5",95.979,373,15,0,1,373,474,102,4.38e-173,606,372,372
"85977","Ntome_NODE_35044_length_373_cov_2","Nsylvestris_NODE_6489_length_2663_cov_74",96.196,368,14,0,6,373,1575,1208,5.67e-172,603,367,367
"85978","Ntome_NODE_35045_length_372_cov_256","Nsylvestris_NODE_21881_length_963_cov_50",95.402,87,4,0,145,231,876,790,1.91e-32,139,86,86
"85984","Ntome_NODE_35051_length_372_cov_7","Nsylvestris_NODE_20495_length_1065_cov_22",97.659,299,7,0,74,372,1065,767,2.72e-145,514,298,298
"85985","Ntome_NODE_35052_length_372_cov_7","Nsylvestris_NODE_3704_length_3334_cov_62",95.43,372,13,2,1,372,2184,1817,4.4e-168,590,371,367
"85986","Ntome_NODE_35055_length_372_cov_6","Nsylvestris_NODE_736_length_5378_cov_103",92.506,387,11,4,1,372,2829,2446,1.62e-152,538,371,383
"85989","Ntome_NODE_35059_length_372_cov_4","Nsylvestris_NODE_19971_length_1105_cov_21",86.018,329,20,10,2,330,479,177,1.06e-89,329,328,302
"85990","Ntome_NODE_35060_length_372_cov_4","Nsylvestris_NODE_52_length_9427_cov_171",95.276,381,7,3,1,372,5208,5586,3.4e-169,593,371,378
"85991","Ntome_NODE_35067_length_372_cov_3","Nsylvestris_NODE_7222_length_2531_cov_14",87.879,231,20,7,147,372,40,267,3.03e-70,265,225,227
"85997","Ntome_NODE_35072_length_371_cov_50","Nsylvestris_NODE_19360_length_1154_cov_220",95.946,74,2,1,218,291,596,524,2.49e-26,119,73,72
"85998","Ntome_NODE_35073_length_371_cov_12","Nsylvestris_NODE_136_length_7944_cov_139",96.594,323,11,0,49,371,5620,5942,5.8e-152,536,322,322
"85999","Ntome_NODE_35074_length_371_cov_10","Nsylvestris_NODE_9793_length_2141_cov_203",100,33,0,0,1,33,1093,1061,4.25e-09,62.1,32,32
"86000","Ntome_NODE_35076_length_371_cov_9","Nsylvestris_NODE_2724_length_3695_cov_139",95.699,372,15,1,1,371,1008,1379,2.62e-170,597,370,371
"86001","Ntome_NODE_35081_length_371_cov_5","Nsylvestris_NODE_31073_length_447_cov_3",86.411,287,26,5,88,371,132,408,2.3e-81,302,283,276
"86002","Ntome_NODE_35082_length_371_cov_5","Nsylvestris_NODE_261_length_6934_cov_148",89.157,83,9,0,289,371,1751,1833,6.97e-22,104,82,82
"86003","Ntome_NODE_35083_length_371_cov_4","Nsylvestris_NODE_32855_length_358_cov_4",92.5,360,21,6,1,358,3,358,3.51e-144,510,357,355
"86020","Ntome_NODE_35096_length_370_cov_67","Nsylvestris_NODE_1796_length_4181_cov_221",92.969,128,8,1,2,129,1695,1569,2.41e-46,185,127,126
"86024","Ntome_NODE_35099_length_370_cov_11","Nsylvestris_NODE_31779_length_404_cov_21",90.775,271,22,3,18,286,15,284,1.34e-98,359,268,269
"86025","Ntome_NODE_35100_length_370_cov_6","Nsylvestris_NODE_5199_length_2926_cov_38",96.933,163,5,0,1,163,2709,2871,5e-73,274,162,162
"86028","Ntome_NODE_35107_length_370_cov_4","Nsylvestris_NODE_441_length_6140_cov_71",89.347,291,28,1,1,288,3925,4215,1.04e-99,363,287,290
"86029","Ntome_NODE_35113_length_369_cov_302","Nsylvestris_NODE_1528_length_4374_cov_222",92.5,320,10,2,50,369,1923,2228,9.99e-125,446,319,305
"86032","Ntome_NODE_35117_length_369_cov_13","Nsylvestris_NODE_26736_length_686_cov_9",92.697,178,12,1,2,179,126,302,1.81e-67,255,177,176
"86037","Ntome_NODE_35122_length_369_cov_7","Nsylvestris_NODE_34952_length_296_cov_6",83.399,253,14,10,44,268,44,296,1.43e-53,209,224,252
"86038","Ntome_NODE_35124_length_369_cov_5","Nsylvestris_NODE_559_length_5805_cov_107",93.6,250,16,0,1,250,2383,2134,4.78e-103,374,249,249
"86039","Ntome_NODE_35128_length_369_cov_4","Nsylvestris_NODE_3951_length_3250_cov_235",87.023,131,17,0,1,131,2008,2138,3.15e-35,148,130,130
"86054","Ntome_NODE_35139_length_367_cov_11","Nsylvestris_NODE_36157_length_270_cov_2",93.836,146,9,0,1,146,146,1,6.55e-57,220,145,145
"86055","Ntome_NODE_35144_length_368_cov_6","Nsylvestris_NODE_26196_length_710_cov_9",93.895,344,17,2,2,344,621,281,7.48e-146,516,342,340
"86059","Ntome_NODE_35146_length_368_cov_5","Nsylvestris_NODE_20881_length_1037_cov_7",94.309,369,15,5,4,368,689,323,3.41e-159,560,364,366
"86063","Ntome_NODE_35150_length_368_cov_4","Nsylvestris_NODE_19549_length_1140_cov_8",95.109,368,18,0,1,368,595,228,2.62e-165,580,367,367
"86066","Ntome_NODE_35156_length_368_cov_3","Nsylvestris_NODE_13761_length_1678_cov_15",94.005,367,14,4,1,367,1070,712,7.38e-156,549,366,358
"86075","Ntome_NODE_35165_length_367_cov_227","Nsylvestris_NODE_17452_length_1318_cov_142",94.278,367,18,1,1,367,209,572,1.22e-158,558,366,363
"86078","Ntome_NODE_35176_length_367_cov_3","Nsylvestris_NODE_645_length_5569_cov_176",93.094,362,20,4,8,366,5069,5428,1.24e-148,525,358,359
"86079","Ntome_NODE_35182_length_367_cov_1","Nsylvestris_NODE_2052_length_4025_cov_56",95.902,366,15,0,1,366,1008,1373,3.35e-169,593,365,365
"86080","Ntome_NODE_35184_length_366_cov_330","Nsylvestris_NODE_8857_length_2270_cov_237",98.361,366,6,0,1,366,607,242,0,643,365,365
"86081","Ntome_NODE_35185_length_366_cov_279","Nsylvestris_NODE_25459_length_746_cov_72",93.93,313,17,1,1,311,440,128,1.63e-132,472,310,312
"86082","Ntome_NODE_35186_length_366_cov_207","Nsylvestris_NODE_26259_length_707_cov_206",92.879,323,20,1,1,320,275,597,7.6e-131,466,319,322
"86085","Ntome_NODE_35190_length_366_cov_15","Nsylvestris_NODE_30674_length_473_cov_4",91.765,170,11,2,200,366,316,147,8.39e-61,233,166,169
"86086","Ntome_NODE_35194_length_366_cov_9","Nsylvestris_NODE_6743_length_2614_cov_114",83.051,118,6,5,1,104,1888,2005,4.13e-19,95.3,103,117
"86087","Ntome_NODE_35198_length_366_cov_6","Nsylvestris_NODE_1491_length_4405_cov_40",96.185,367,13,1,1,366,616,250,7.18e-171,599,365,366
"86093","Ntome_NODE_35201_length_366_cov_5","Nsylvestris_NODE_31222_length_437_cov_9",97.701,261,6,0,1,261,261,1,7.65e-126,449,260,260
"86094","Ntome_NODE_35203_length_366_cov_5","Nsylvestris_NODE_8320_length_2353_cov_31",88.503,374,23,6,13,366,2271,1898,2.14e-121,435,353,373
"86095","Ntome_NODE_35205_length_366_cov_4","Nsylvestris_NODE_2957_length_3601_cov_126",94.512,328,15,3,39,366,1293,969,5.79e-142,503,327,324
"86101","Ntome_NODE_35213_length_365_cov_201","Nsylvestris_NODE_146_length_7818_cov_26",94.393,107,6,0,62,168,1857,1963,3.1e-40,165,106,106
"86113","Ntome_NODE_35220_length_365_cov_7","Nsylvestris_NODE_2340_length_3878_cov_79",94.54,348,9,3,1,345,3430,3090,9.53e-150,529,344,340
"86118","Ntome_NODE_35239_length_364_cov_8","Nsylvestris_NODE_24965_length_773_cov_56",91.071,56,4,1,7,62,519,465,5.35e-13,75,55,54
"86122","Ntome_NODE_35243_length_364_cov_5","Nsylvestris_NODE_4867_length_3004_cov_27",92.098,367,20,7,1,362,2434,2796,1.24e-143,508,361,362
"86126","Ntome_NODE_35246_length_364_cov_5","Nsylvestris_NODE_3432_length_3427_cov_56",89.844,128,12,1,38,165,1415,1541,1.11e-39,163,127,126
"86127","Ntome_NODE_35248_length_364_cov_4","Nsylvestris_NODE_33525_length_336_cov_3",83.636,330,40,11,44,364,336,12,2.92e-80,298,320,324
"86133","Ntome_NODE_35260_length_364_cov_2","Nsylvestris_NODE_7222_length_2531_cov_14",96.978,364,11,0,1,364,1266,903,9.17e-175,612,363,363
"86134","Ntome_NODE_35262_length_363_cov_311","Nsylvestris_NODE_10369_length_2066_cov_213",96.97,363,11,0,1,363,329,691,3.29e-174,610,362,362
"86146","Ntome_NODE_35271_length_363_cov_4","Nsylvestris_NODE_17088_length_1350_cov_13",95.376,173,8,0,111,283,224,396,1.36e-73,276,172,172
"86155","Ntome_NODE_35276_length_363_cov_3","Nsylvestris_NODE_3678_length_3343_cov_61",91.736,363,22,2,1,363,3237,2883,2.67e-140,497,362,354
"86156","Ntome_NODE_35278_length_363_cov_3","Nsylvestris_NODE_16151_length_1435_cov_10",92.394,355,22,4,9,363,600,949,2.07e-141,501,354,349
"86159","Ntome_NODE_35282_length_363_cov_2","Nsylvestris_NODE_12787_length_1788_cov_17",93.056,360,16,1,4,363,1773,1423,2.05e-146,518,359,350
"86160","Ntome_NODE_35283_length_363_cov_2","Nsylvestris_NODE_2547_length_3770_cov_126",96.389,360,13,0,4,363,2797,2438,3.31e-169,593,359,359
"86161","Ntome_NODE_35286_length_362_cov_287","Nsylvestris_NODE_24195_length_819_cov_63",91.753,97,8,0,1,97,143,47,2.41e-31,135,96,96
"86166","Ntome_NODE_35289_length_362_cov_219","Nsylvestris_NODE_11913_length_1879_cov_44",98.684,152,2,0,1,152,1367,1518,6.32e-72,270,151,151
"86167","Ntome_NODE_35290_length_362_cov_193","Nsylvestris_NODE_7776_length_2441_cov_199",95.495,222,10,0,43,264,2220,2441,1.7e-97,355,221,221
"86168","Ntome_NODE_35291_length_362_cov_182","Nsylvestris_NODE_9484_length_2180_cov_133",93.82,356,15,2,7,362,2180,1832,9.45e-150,529,355,348
"86169","Ntome_NODE_35293_length_362_cov_116","Nsylvestris_NODE_34946_length_296_cov_19",89.764,127,6,2,1,126,80,200,1.85e-37,156,125,120
"86170","Ntome_NODE_35295_length_362_cov_7","Nsylvestris_NODE_28772_length_594_cov_8",93.939,363,21,1,1,362,404,42,2.61e-155,547,361,362
"86171","Ntome_NODE_35297_length_362_cov_7","Nsylvestris_NODE_5007_length_2971_cov_102",88.789,223,16,5,148,362,877,1098,2.94e-70,265,214,221
"86172","Ntome_NODE_35300_length_362_cov_6","Nsylvestris_NODE_27618_length_646_cov_14",89.583,48,1,4,165,211,132,176,5.36e-08,58.4,46,44
"86173","Ntome_NODE_35301_length_362_cov_5","Nsylvestris_NODE_1716_length_4239_cov_137",86.628,172,22,1,192,362,673,844,1.82e-47,189,170,171
"86174","Ntome_NODE_35304_length_362_cov_4","Nsylvestris_NODE_7081_length_2556_cov_194",97.872,47,1,0,1,47,376,422,3.18e-15,82.4,46,46
"86189","Ntome_NODE_35316_length_361_cov_153","Nsylvestris_NODE_22057_length_952_cov_177",89.552,67,3,1,1,63,182,248,3.17e-15,82.4,62,66
"86190","Ntome_NODE_35319_length_361_cov_5","Nsylvestris_NODE_2949_length_3591_cov_48",87.5,128,13,3,130,257,968,1092,3.99e-34,145,127,124
"86194","Ntome_NODE_35323_length_361_cov_4","Nsylvestris_NODE_32002_length_394_cov_4",97.541,122,3,0,1,122,124,3,1.39e-53,209,121,121
"86197","Ntome_NODE_35329_length_361_cov_3","Nsylvestris_NODE_19432_length_1150_cov_7",95.822,359,15,0,3,361,6,364,2.56e-165,580,358,358
"86198","Ntome_NODE_35332_length_360_cov_326","Nsylvestris_NODE_474_length_6026_cov_221",98.056,360,7,0,1,360,4418,4777,3.24e-179,627,359,359
"86201","Ntome_NODE_35335_length_360_cov_124","Nsylvestris_NODE_25362_length_751_cov_177",92.4,250,9,4,1,248,294,53,2.82e-95,348,247,241
"86202","Ntome_NODE_35336_length_360_cov_117","Nsylvestris_NODE_10791_length_2015_cov_34",92.771,83,6,0,57,139,612,530,6.7e-27,121,82,82
"86203","Ntome_NODE_35338_length_360_cov_16","Nsylvestris_NODE_32355_length_378_cov_12",83.473,357,25,13,25,355,9,357,2.23e-81,302,330,348
"86204","Ntome_NODE_35339_length_360_cov_8","Nsylvestris_NODE_22183_length_943_cov_12",97.382,191,5,0,1,191,753,943,1.32e-88,326,190,190
"86205","Ntome_NODE_35341_length_360_cov_7","Nsylvestris_NODE_13791_length_1674_cov_95",96.667,360,9,1,1,360,537,181,9.13e-170,595,359,356
"86206","Ntome_NODE_35343_length_360_cov_5","Nsylvestris_NODE_4840_length_3009_cov_235",77.101,345,59,16,20,355,2676,3009,3.03e-45,182,335,333
"86207","Ntome_NODE_35346_length_360_cov_5","Nsylvestris_NODE_2538_length_3776_cov_43",97.5,360,9,0,1,360,1659,1300,7.01e-176,616,359,359
"86213","Ntome_NODE_35358_length_360_cov_3","Nsylvestris_NODE_15860_length_1463_cov_26",96.21,343,13,0,13,355,601,259,9.26e-160,562,342,342
"86214","Ntome_NODE_35361_length_360_cov_2","Nsylvestris_NODE_18085_length_1261_cov_7",90.686,204,11,3,108,305,1005,1206,2.92e-70,265,197,201
"86219","Ntome_NODE_35364_length_359_cov_205","Nsylvestris_NODE_6231_length_2711_cov_70",88.235,323,7,11,49,356,1,307,4.68e-98,357,307,306
"86222","Ntome_NODE_35368_length_359_cov_23","Nsylvestris_NODE_6391_length_2681_cov_135",89.97,329,18,7,1,322,2343,2663,3.54e-114,411,321,320
"86223","Ntome_NODE_35375_length_359_cov_5","Nsylvestris_NODE_4685_length_3048_cov_162",100,359,0,0,1,359,2797,2439,0,664,358,358
"86224","Ntome_NODE_35377_length_359_cov_4","Nsylvestris_NODE_27338_length_659_cov_3",89.773,264,18,1,16,279,341,595,1.02e-89,329,263,254
"86225","Ntome_NODE_35379_length_359_cov_3","Nsylvestris_NODE_6768_length_2609_cov_100",98.05,359,7,0,1,359,1218,860,1.16e-178,625,358,358
"86226","Ntome_NODE_35380_length_359_cov_2","Nsylvestris_NODE_4290_length_3154_cov_88",77.626,219,42,5,145,358,639,855,1.44e-28,126,213,216
"86227","Ntome_NODE_35381_length_359_cov_2","Nsylvestris_NODE_9382_length_2196_cov_74",98.05,359,7,0,1,359,1567,1925,1.16e-178,625,358,358
"86228","Ntome_NODE_35384_length_359_cov_2","Nsylvestris_NODE_9798_length_2141_cov_103",86.592,358,24,6,2,359,585,252,4.64e-103,374,357,333
"86233","Ntome_NODE_35386_length_358_cov_251","Nsylvestris_NODE_30686_length_472_cov_5",87.264,212,24,3,53,262,37,247,1.76e-62,239,209,210
"86241","Ntome_NODE_35396_length_358_cov_5","Nsylvestris_NODE_29043_length_582_cov_6",97.5,240,6,0,16,255,240,1,3.53e-114,411,239,239
"86242","Ntome_NODE_35397_length_358_cov_5","Nsylvestris_NODE_6807_length_2602_cov_101",90.826,218,20,0,3,220,810,593,1.33e-78,292,217,217
"86243","Ntome_NODE_35400_length_358_cov_4","Nsylvestris_NODE_8124_length_2384_cov_44",76.077,209,37,11,156,358,584,383,1.12e-19,97.1,202,201
"86254","Ntome_NODE_35420_length_357_cov_6","Nsylvestris_NODE_16965_length_1360_cov_8",91.785,353,29,0,4,356,965,613,1.22e-138,492,352,352
"86257","Ntome_NODE_35441_length_356_cov_271","Nsylvestris_NODE_3648_length_3352_cov_32",83.569,353,49,6,1,351,1843,2188,1.69e-87,322,350,345
"86260","Ntome_NODE_35448_length_356_cov_9","Nsylvestris_NODE_3341_length_3459_cov_95",82.394,284,38,7,83,356,1704,1423,6.3e-62,237,273,281
"86261","Ntome_NODE_35451_length_356_cov_6","Nsylvestris_NODE_10543_length_2045_cov_14",92.017,238,8,5,124,356,73,304,4.7e-88,324,232,231
"86264","Ntome_NODE_35455_length_356_cov_5","Nsylvestris_NODE_971_length_4991_cov_57",90.155,193,12,2,171,356,1566,1758,3.76e-64,244,185,192
"86265","Ntome_NODE_35456_length_356_cov_5","Nsylvestris_NODE_16960_length_1360_cov_24",97.183,284,8,0,2,285,1077,1360,2.64e-135,481,283,283
"86266","Ntome_NODE_35457_length_356_cov_4","Nsylvestris_NODE_32293_length_382_cov_2",83.453,278,44,2,79,354,376,99,4.83e-68,257,275,277
"86267","Ntome_NODE_35461_length_356_cov_3","Nsylvestris_NODE_32216_length_385_cov_2",96.901,355,11,0,2,356,27,381,9.02e-170,595,354,354
"86268","Ntome_NODE_35464_length_356_cov_3","Nsylvestris_NODE_25635_length_738_cov_11",98.588,354,5,0,1,354,453,100,3.2e-179,627,353,353
"86269","Ntome_NODE_35465_length_356_cov_3","Nsylvestris_NODE_21626_length_984_cov_26",84.59,305,27,8,54,356,451,165,2.22e-76,285,302,286
"86270","Ntome_NODE_35469_length_356_cov_3","Nsylvestris_NODE_171_length_7558_cov_82",95.225,356,17,0,1,356,3581,3936,2.54e-160,564,355,355
"86278","Ntome_NODE_35478_length_355_cov_9","Nsylvestris_NODE_1845_length_4151_cov_80",90.84,131,11,1,135,265,1384,1513,4.99e-43,174,130,129
"86279","Ntome_NODE_35479_length_355_cov_8","Nsylvestris_NODE_33785_length_328_cov_7",77.593,241,41,13,18,251,89,323,8.47e-31,134,233,234
"86280","Ntome_NODE_35480_length_355_cov_6","Nsylvestris_NODE_7068_length_2559_cov_117",94.099,322,9,6,35,355,17,329,2.63e-135,481,320,312
"86283","Ntome_NODE_35486_length_355_cov_3","Nsylvestris_NODE_4867_length_3004_cov_27",91.69,361,23,4,1,355,1213,854,3.37e-139,494,354,359
"86284","Ntome_NODE_35491_length_355_cov_2","Nsylvestris_NODE_752_length_5347_cov_24",81.985,272,37,8,85,353,2042,1780,6.32e-57,220,268,262
"86285","Ntome_NODE_35492_length_355_cov_1","Nsylvestris_NODE_108_length_8357_cov_118",100,34,0,0,87,120,212,245,1.13e-09,63.9,33,33
"86286","Ntome_NODE_35493_length_354_cov_247","Nsylvestris_NODE_1316_length_4581_cov_207",98.305,354,6,0,1,354,2037,1684,1.48e-177,621,353,353
"86289","Ntome_NODE_35495_length_354_cov_217","Nsylvestris_NODE_19766_length_1121_cov_129",93.355,301,20,0,1,301,530,830,9.55e-125,446,300,300
"86293","Ntome_NODE_35499_length_354_cov_6","Nsylvestris_NODE_29063_length_581_cov_5",93.617,235,11,3,120,352,124,356,2.77e-95,348,232,232
"86294","Ntome_NODE_35503_length_354_cov_5","Nsylvestris_NODE_15694_length_1480_cov_225",100,29,0,0,326,354,1024,996,6.77e-07,54.7,28,28
"86295","Ntome_NODE_35504_length_354_cov_4","Nsylvestris_NODE_5363_length_2895_cov_27",94.915,354,17,1,1,354,184,536,5.47e-157,553,353,352
"86296","Ntome_NODE_35505_length_354_cov_4","Nsylvestris_NODE_7002_length_2569_cov_99",88.604,351,21,4,1,340,1448,1106,1.25e-113,409,339,342
"86297","Ntome_NODE_35507_length_354_cov_4","Nsylvestris_NODE_8369_length_2345_cov_196",97.674,43,1,0,25,67,125,167,5.19e-13,75,42,42
"86298","Ntome_NODE_35508_length_354_cov_4","Nsylvestris_NODE_12702_length_1795_cov_104",97.175,354,10,0,1,354,1211,1564,6.93e-171,599,353,353
"86299","Ntome_NODE_35509_length_354_cov_4","Nsylvestris_NODE_5326_length_2901_cov_101",94.068,354,15,3,1,354,1558,1211,7.13e-151,532,353,347
"86300","Ntome_NODE_35511_length_354_cov_3","Nsylvestris_NODE_8153_length_2380_cov_82",96.241,133,5,0,3,135,1323,1191,2.27e-56,219,132,132
"86301","Ntome_NODE_35512_length_354_cov_3","Nsylvestris_NODE_3576_length_3372_cov_210",94.444,72,2,1,1,70,877,806,1.42e-23,110,69,71
"86302","Ntome_NODE_35516_length_354_cov_2","Nsylvestris_NODE_2069_length_4011_cov_85",93.443,61,4,0,294,354,1895,1835,5.16e-18,91.6,60,60
"86307","Ntome_NODE_35522_length_353_cov_288","Nsylvestris_NODE_14312_length_1619_cov_212",91.789,341,25,2,1,338,388,48,1.57e-132,472,337,340
"86311","Ntome_NODE_35524_length_353_cov_105","Nsylvestris_NODE_16682_length_1382_cov_205",91.156,294,11,5,74,353,2,294,2.11e-106,385,279,292
"86314","Ntome_NODE_35527_length_353_cov_11","Nsylvestris_NODE_25745_length_731_cov_22",87.187,359,28,9,1,353,378,32,1.26e-108,392,352,346
"86318","Ntome_NODE_35532_length_353_cov_6","Nsylvestris_NODE_5089_length_2952_cov_100",80.189,318,24,14,61,351,1080,775,2.28e-51,202,290,305
"86319","Ntome_NODE_35534_length_353_cov_5","Nsylvestris_NODE_17103_length_1348_cov_134",84.906,53,6,1,68,118,451,503,2.43e-06,52.8,50,52
"86320","Ntome_NODE_35538_length_353_cov_4","Nsylvestris_NODE_31200_length_438_cov_12",94.571,350,16,1,1,350,69,415,1.53e-152,538,349,346
"86323","Ntome_NODE_35542_length_353_cov_4","Nsylvestris_NODE_31303_length_432_cov_4",100,29,0,0,325,353,162,190,6.75e-07,54.7,28,28
"86330","Ntome_NODE_35551_length_353_cov_2","Nsylvestris_NODE_2502_length_3793_cov_20",96.307,352,13,0,2,353,3393,3744,9e-165,579,351,351
"86331","Ntome_NODE_35553_length_353_cov_2","Nsylvestris_NODE_5714_length_2818_cov_31",95.751,353,13,1,1,353,2324,2674,1.95e-161,568,352,350
"86334","Ntome_NODE_35556_length_352_cov_329","Nsylvestris_NODE_6955_length_2576_cov_118",96.307,352,13,0,1,352,1616,1265,8.97e-165,579,351,351
"86335","Ntome_NODE_35557_length_352_cov_282","Nsylvestris_NODE_4391_length_3128_cov_211",95.726,351,15,0,2,352,1538,1188,6.99e-161,566,350,350
"86346","Ntome_NODE_35564_length_352_cov_17","Nsylvestris_NODE_7824_length_2433_cov_104",94.942,257,10,1,79,332,170,426,7.5e-111,399,253,256
"86350","Ntome_NODE_35573_length_352_cov_5","Nsylvestris_NODE_32264_length_383_cov_3",96.108,334,11,2,4,337,332,1,3.27e-154,544,333,331
"86351","Ntome_NODE_35574_length_352_cov_5","Nsylvestris_NODE_21273_length_1009_cov_10",93.143,350,17,5,1,350,534,192,4.29e-143,507,349,342
"86352","Ntome_NODE_35575_length_352_cov_5","Nsylvestris_NODE_1802_length_4173_cov_169",94.398,357,14,2,1,352,2146,1791,3.27e-154,544,351,355
"86358","Ntome_NODE_35595_length_351_cov_8","Nsylvestris_NODE_10054_length_2110_cov_120",96.866,351,11,0,1,351,849,1199,1.49e-167,588,350,350
"86365","Ntome_NODE_35607_length_351_cov_5","Nsylvestris_NODE_34225_length_315_cov_8",95.254,295,14,0,1,295,295,1,2.02e-131,468,294,294
"86366","Ntome_NODE_35610_length_351_cov_4","Nsylvestris_NODE_19460_length_1147_cov_197",85.593,118,17,0,25,142,791,674,5.04e-28,124,117,117
"86369","Ntome_NODE_35620_length_351_cov_2","Nsylvestris_NODE_8857_length_2270_cov_237",100,30,0,0,322,351,731,760,1.86e-07,56.5,29,29
"86370","Ntome_NODE_35623_length_351_cov_2","Nsylvestris_NODE_10603_length_2037_cov_14",97.093,344,9,1,1,343,1572,1915,8.95e-165,579,342,343
"86371","Ntome_NODE_35626_length_351_cov_2","Nsylvestris_NODE_29761_length_548_cov_147",86.027,365,37,4,1,351,436,72,9.74e-105,379,350,364
"86372","Ntome_NODE_35627_length_350_cov_258","Nsylvestris_NODE_569_length_5779_cov_180",96.97,33,0,1,28,59,5444,5476,6.68e-07,54.7,31,32
"86377","Ntome_NODE_35631_length_347_cov_11","Nsylvestris_NODE_16843_length_1368_cov_223",98.276,58,1,0,83,140,602,545,2.33e-21,102,57,57
"86378","Ntome_NODE_35640_length_350_cov_4","Nsylvestris_NODE_3987_length_3236_cov_94",82.903,310,41,8,44,345,1272,1577,2.19e-71,268,301,305
"86379","Ntome_NODE_35644_length_350_cov_4","Nsylvestris_NODE_3585_length_3370_cov_91",96.857,350,11,0,1,350,2346,2695,5.33e-167,586,349,349
"86380","Ntome_NODE_35646_length_350_cov_3","Nsylvestris_NODE_32071_length_391_cov_4",91.818,220,11,1,138,350,291,72,7.78e-81,300,212,219
"86381","Ntome_NODE_35648_length_350_cov_3","Nsylvestris_NODE_3231_length_3496_cov_150",94.872,351,17,1,1,350,1109,1459,2.52e-155,547,349,350
"86403","Ntome_NODE_35667_length_349_cov_4","Nsylvestris_NODE_6529_length_2656_cov_114",86.969,353,27,11,1,349,137,474,9.68e-105,379,348,337
"86404","Ntome_NODE_35673_length_349_cov_2","Nsylvestris_NODE_2994_length_3590_cov_122",92.903,155,9,1,192,346,45,197,4.8e-58,224,154,152
"86405","Ntome_NODE_35676_length_349_cov_2","Nsylvestris_NODE_1821_length_4162_cov_133",92.183,371,6,6,1,349,1594,1963,5.51e-142,503,348,369
"86410","Ntome_NODE_35679_length_348_cov_62","Nsylvestris_NODE_5641_length_2830_cov_32",97.708,349,7,1,1,348,1191,843,6.8e-171,599,347,348
"86411","Ntome_NODE_35683_length_348_cov_6","Nsylvestris_NODE_23989_length_833_cov_5",86.313,358,32,10,1,348,493,143,4.49e-103,374,347,350
"86412","Ntome_NODE_35684_length_348_cov_6","Nsylvestris_NODE_11952_length_1875_cov_123",77.397,146,21,8,11,153,1086,1222,1.42e-13,76.8,142,136
"86413","Ntome_NODE_35686_length_348_cov_5","Nsylvestris_NODE_20773_length_1045_cov_11",94.224,277,16,0,72,348,1043,767,4.4e-118,424,276,276
"86418","Ntome_NODE_35693_length_348_cov_3","Nsylvestris_NODE_27624_length_646_cov_5",94.842,349,14,2,1,348,371,26,1.16e-153,542,347,345
"86419","Ntome_NODE_35700_length_348_cov_1","Nsylvestris_NODE_3145_length_3529_cov_119",91.092,348,19,1,1,348,1526,1861,3.35e-129,460,347,335
"86423","Ntome_NODE_35702_length_347_cov_255","Nsylvestris_NODE_22005_length_955_cov_188",93.948,347,17,4,1,347,10,352,1.51e-147,521,346,342
"86429","Ntome_NODE_35705_length_347_cov_116","Nsylvestris_NODE_23248_length_876_cov_19",91.111,90,7,1,218,306,146,57,6.44e-27,121,88,89
"86430","Ntome_NODE_35706_length_347_cov_81","Nsylvestris_NODE_17847_length_1282_cov_96",92.157,153,8,3,172,322,992,842,1.03e-54,213,150,150
"86431","Ntome_NODE_35707_length_347_cov_19","Nsylvestris_NODE_3410_length_3434_cov_56",100,31,0,0,302,332,2250,2280,5.12e-08,58.4,30,30
"86438","Ntome_NODE_35720_length_347_cov_4","Nsylvestris_NODE_31581_length_415_cov_6",96.83,347,11,0,1,347,50,396,2.46e-165,580,346,346
"86444","Ntome_NODE_35725_length_347_cov_4","Nsylvestris_NODE_17730_length_1292_cov_8",94.509,346,19,0,2,347,1040,695,1.94e-151,534,345,345
"86447","Ntome_NODE_35727_length_347_cov_3","Nsylvestris_NODE_20800_length_1042_cov_75",86.93,329,18,7,39,345,468,143,9.76e-95,346,306,325
"86451","Ntome_NODE_35729_length_347_cov_3","Nsylvestris_NODE_7589_length_2472_cov_72",86.395,147,16,3,202,347,1469,1612,4.91e-38,158,145,143
"86454","Ntome_NODE_35733_length_347_cov_3","Nsylvestris_NODE_36945_length_253_cov_2",80.952,147,25,3,1,145,252,107,1.08e-24,113,144,145
"86455","Ntome_NODE_35740_length_346_cov_299","Nsylvestris_NODE_5295_length_2905_cov_239",96.821,346,11,0,1,346,1108,1453,8.81e-165,579,345,345
"86456","Ntome_NODE_35741_length_346_cov_265","Nsylvestris_NODE_21768_length_972_cov_184",94.19,327,17,2,20,346,117,441,2.54e-140,497,326,324
"86457","Ntome_NODE_35742_length_346_cov_264","Nsylvestris_NODE_22248_length_939_cov_154",85.124,121,15,3,217,334,226,106,6.42e-27,121,117,120
"86458","Ntome_NODE_35743_length_346_cov_216","Nsylvestris_NODE_19132_length_1173_cov_73",93.37,181,8,4,54,231,201,380,2.8e-70,265,177,179
"86462","Ntome_NODE_35748_length_346_cov_11","Nsylvestris_NODE_23877_length_839_cov_209",100,51,0,0,296,346,509,559,3.89e-19,95.3,50,50
"86463","Ntome_NODE_35751_length_346_cov_9","Nsylvestris_NODE_22580_length_917_cov_12",92.197,346,26,1,1,346,293,637,1.53e-137,488,345,344
"86464","Ntome_NODE_35754_length_346_cov_8","Nsylvestris_NODE_21807_length_969_cov_7",94.065,337,18,2,11,346,531,196,3.26e-144,510,335,335
"86467","Ntome_NODE_35757_length_346_cov_6","Nsylvestris_NODE_7525_length_2482_cov_20",96.016,251,10,0,2,252,2013,1763,1.22e-113,409,250,250
"86471","Ntome_NODE_35762_length_346_cov_5","Nsylvestris_NODE_12496_length_1816_cov_19",93.642,346,22,0,1,346,1320,975,1.95e-146,518,345,345
"86472","Ntome_NODE_35764_length_346_cov_5","Nsylvestris_NODE_5476_length_2867_cov_125",87.097,93,11,1,175,267,270,361,6.46e-22,104,92,91
"86473","Ntome_NODE_35765_length_346_cov_4","Nsylvestris_NODE_28082_length_625_cov_10",92.727,330,19,2,2,327,291,619,1.54e-132,472,325,328
"86474","Ntome_NODE_35770_length_346_cov_3","Nsylvestris_NODE_981_length_4979_cov_83",92.593,351,16,6,1,346,3299,2954,9.13e-140,496,345,345
"86475","Ntome_NODE_35773_length_346_cov_3","Nsylvestris_NODE_5967_length_2767_cov_17",88.131,337,39,1,11,346,1898,2234,7.36e-111,399,335,336
"86476","Ntome_NODE_35777_length_346_cov_2","Nsylvestris_NODE_32508_length_372_cov_3",95.376,346,16,0,1,346,357,12,1.92e-156,551,345,345
"86480","Ntome_NODE_35783_length_345_cov_9","Nsylvestris_NODE_2550_length_3770_cov_62",100,29,0,0,1,29,3286,3314,6.58e-07,54.7,28,28
"86481","Ntome_NODE_35785_length_345_cov_8","Nsylvestris_NODE_5707_length_2819_cov_116",91.743,327,24,3,1,327,2806,2483,2e-126,451,326,323
"86482","Ntome_NODE_35786_length_345_cov_8","Nsylvestris_NODE_1952_length_4084_cov_139",93.141,277,19,0,1,277,3584,3860,4.39e-113,407,276,276
"86483","Ntome_NODE_35787_length_345_cov_8","Nsylvestris_NODE_26236_length_708_cov_27",97.345,339,9,0,7,345,138,476,3.16e-164,577,338,338
"86484","Ntome_NODE_35788_length_345_cov_7","Nsylvestris_NODE_8111_length_2386_cov_62",95.362,345,16,0,1,345,2005,1661,6.89e-156,549,344,344
"86485","Ntome_NODE_35792_length_345_cov_6","Nsylvestris_NODE_171_length_7558_cov_82",93.333,345,23,0,1,345,2128,2472,3.25e-144,510,344,344
"86486","Ntome_NODE_35794_length_345_cov_6","Nsylvestris_NODE_16151_length_1435_cov_10",88.5,200,20,2,79,275,1236,1435,1.69e-62,239,196,199
"86490","Ntome_NODE_35798_length_345_cov_4","Nsylvestris_NODE_30944_length_455_cov_5",87.129,303,20,9,43,344,1,285,1.26e-88,326,301,284
"86491","Ntome_NODE_35805_length_345_cov_3","Nsylvestris_NODE_12915_length_1772_cov_230",95.115,348,14,1,1,345,1185,838,8.91e-155,545,344,347
"86494","Ntome_NODE_35808_length_345_cov_2","Nsylvestris_NODE_239_length_7063_cov_138",87.069,348,35,6,3,340,2333,1986,2.05e-106,385,337,347
"86499","Ntome_NODE_35811_length_344_cov_270","Nsylvestris_NODE_12497_length_1815_cov_218",94.771,306,9,5,41,344,62,362,5.5e-132,470,303,300
"86503","Ntome_NODE_35813_length_344_cov_256","Nsylvestris_NODE_1028_length_4900_cov_209",93.948,347,14,1,5,344,2030,1684,1.94e-146,518,339,346
"86504","Ntome_NODE_35814_length_344_cov_9","Nsylvestris_NODE_9399_length_2193_cov_168",100,34,0,0,311,344,1565,1532,1.09e-09,63.9,33,33
"86505","Ntome_NODE_35815_length_344_cov_7","Nsylvestris_NODE_1711_length_4243_cov_223",91.404,349,24,2,2,344,1946,2294,4.25e-133,473,342,348
"86506","Ntome_NODE_35816_length_344_cov_7","Nsylvestris_NODE_28454_length_608_cov_6",95.361,194,8,1,1,194,74,266,4.56e-83,307,193,192
"86510","Ntome_NODE_35819_length_344_cov_6","Nsylvestris_NODE_8111_length_2386_cov_62",97.059,340,8,2,4,342,1995,2333,1.47e-162,571,338,338
"86514","Ntome_NODE_35822_length_344_cov_5","Nsylvestris_NODE_30815_length_463_cov_6",96.835,316,10,0,4,319,324,9,8.94e-150,529,315,315
"86517","Ntome_NODE_35828_length_344_cov_4","Nsylvestris_NODE_19798_length_1118_cov_13",96.178,314,12,0,1,314,830,517,2.5e-145,514,313,313
"86518","Ntome_NODE_35831_length_344_cov_3","Nsylvestris_NODE_25912_length_723_cov_12",92.442,344,14,1,1,344,361,692,2.54e-135,481,343,331
"86519","Ntome_NODE_35833_length_344_cov_2","Nsylvestris_NODE_674_length_5502_cov_65",93.567,342,21,1,3,344,3793,3453,1.17e-143,508,341,340
"86522","Ntome_NODE_35836_length_344_cov_2","Nsylvestris_NODE_33556_length_335_cov_5",93.119,218,10,3,121,333,1,218,2.73e-85,315,212,217
"86526","Ntome_NODE_35840_length_343_cov_101","Nsylvestris_NODE_17189_length_1341_cov_156",86.577,149,18,2,196,343,1235,1088,1.04e-39,163,147,147
"86527","Ntome_NODE_35841_length_343_cov_33","Nsylvestris_NODE_942_length_5031_cov_93",86.777,121,16,0,181,301,4792,4912,2.27e-31,135,120,120
"86535","Ntome_NODE_35849_length_343_cov_7","Nsylvestris_NODE_35808_length_277_cov_4",100,28,0,0,229,256,249,222,2.35e-06,52.8,27,27
"86536","Ntome_NODE_35853_length_343_cov_6","Nsylvestris_NODE_19010_length_1183_cov_7",86.575,365,21,8,1,343,693,1051,3.42e-104,377,342,358
"86540","Ntome_NODE_35856_length_343_cov_5","Nsylvestris_NODE_21896_length_962_cov_24",92.169,332,18,5,14,343,962,637,9.17e-130,462,329,325
"86541","Ntome_NODE_35857_length_343_cov_5","Nsylvestris_NODE_7071_length_2559_cov_43",80.117,342,55,10,4,343,1077,1407,1.3e-63,243,339,330
"86542","Ntome_NODE_35858_length_343_cov_5","Nsylvestris_NODE_27376_length_657_cov_17",83.944,355,35,14,1,343,374,30,5.84e-87,320,342,344
"86545","Ntome_NODE_35860_length_343_cov_4","Nsylvestris_NODE_5612_length_2838_cov_91",91.837,343,28,0,1,343,2381,2723,9.11e-135,479,342,342
"86546","Ntome_NODE_35862_length_343_cov_4","Nsylvestris_NODE_3659_length_3348_cov_71",81.994,311,32,12,46,340,1586,1888,1.3e-63,243,294,302
"86547","Ntome_NODE_35867_length_343_cov_3","Nsylvestris_NODE_431_length_6172_cov_53",90.087,343,34,0,1,343,1471,1129,9.24e-125,446,342,342
"86550","Ntome_NODE_35870_length_343_cov_2","Nsylvestris_NODE_13856_length_1668_cov_15",85.43,302,20,12,61,343,1534,1238,1.27e-78,292,282,296
"86555","Ntome_NODE_35874_length_342_cov_323","Nsylvestris_NODE_7535_length_2479_cov_221",98.538,342,5,0,1,342,842,1183,1.44e-172,604,341,341
"86564","Ntome_NODE_35878_length_342_cov_272","Nsylvestris_NODE_2470_length_3807_cov_226",97.953,342,7,0,1,342,1790,2131,3.11e-169,593,341,341
"86569","Ntome_NODE_35881_length_342_cov_20","Nsylvestris_NODE_19097_length_1175_cov_50",92.857,42,1,2,218,258,77,37,1.4e-08,60.2,40,40
"86570","Ntome_NODE_35882_length_342_cov_18","Nsylvestris_NODE_1578_length_4345_cov_60",95.763,118,3,2,224,340,415,299,1.71e-47,189,116,116
"86571","Ntome_NODE_35892_length_342_cov_5","Nsylvestris_NODE_26755_length_685_cov_25",93.333,45,2,1,1,44,294,338,3.01e-10,65.8,43,44
"86577","Ntome_NODE_35902_length_342_cov_3","Nsylvestris_NODE_18234_length_1248_cov_94",97.087,103,3,0,191,293,138,240,4.8e-43,174,102,102
"86578","Ntome_NODE_35904_length_342_cov_3","Nsylvestris_NODE_8084_length_2390_cov_37",95.614,342,15,0,1,342,1520,1179,6.82e-156,549,341,341
"86579","Ntome_NODE_35908_length_342_cov_3","Nsylvestris_NODE_28921_length_587_cov_8",93.805,113,7,0,49,161,475,587,6.21e-42,171,112,112
"86584","Ntome_NODE_35912_length_341_cov_230","Nsylvestris_NODE_20833_length_1039_cov_192",97.906,191,4,0,1,191,794,984,2.68e-90,331,190,190
"86585","Ntome_NODE_35914_length_341_cov_78","Nsylvestris_NODE_10666_length_2030_cov_58",93.333,285,14,3,1,282,1704,1986,7.2e-116,416,281,282
"86586","Ntome_NODE_35915_length_341_cov_47","Nsylvestris_NODE_281_length_6805_cov_139",94.545,55,3,0,115,169,2712,2766,2.3e-16,86.1,54,54
"86587","Ntome_NODE_35918_length_341_cov_11","Nsylvestris_NODE_23083_length_886_cov_21",87.546,273,31,3,60,330,611,882,9.71e-85,313,270,271
"86593","Ntome_NODE_35933_length_341_cov_3","Nsylvestris_NODE_1868_length_4137_cov_64",95.894,341,14,0,1,341,3714,3374,5.26e-157,553,340,340
"86594","Ntome_NODE_35935_length_341_cov_2","Nsylvestris_NODE_27539_length_649_cov_72",95.455,132,6,0,2,133,112,243,3.64e-54,211,131,131
"86603","Ntome_NODE_35941_length_340_cov_195","Nsylvestris_NODE_20681_length_1051_cov_176",91.456,316,13,3,1,316,682,983,1.54e-117,422,315,301
"86604","Ntome_NODE_35942_length_340_cov_162","Nsylvestris_NODE_4898_length_2996_cov_57",92.105,76,6,0,1,76,481,406,4.9e-23,108,75,75
"86609","Ntome_NODE_35951_length_340_cov_6","Nsylvestris_NODE_5891_length_2786_cov_191",97.959,49,1,0,51,99,792,840,2.3e-16,86.1,48,48
"86610","Ntome_NODE_35955_length_340_cov_4","Nsylvestris_NODE_261_length_6934_cov_148",89.634,164,17,0,32,195,2099,2262,1.31e-53,209,163,163
"86611","Ntome_NODE_35956_length_340_cov_4","Nsylvestris_NODE_32180_length_386_cov_6",93.004,243,17,0,98,340,1,243,1.59e-97,355,242,242
"86612","Ntome_NODE_35961_length_340_cov_3","Nsylvestris_NODE_14464_length_1604_cov_20",96.755,339,11,0,2,340,739,401,6.73e-161,566,338,338
"86613","Ntome_NODE_35963_length_340_cov_3","Nsylvestris_NODE_4529_length_3092_cov_128",92.941,340,22,2,2,340,1386,1724,3.22e-139,494,338,338
"86616","Ntome_NODE_35965_length_340_cov_3","Nsylvestris_NODE_40_length_9683_cov_75",83.908,87,8,5,141,225,4869,4787,3.84e-14,78.7,84,82
"86617","Ntome_NODE_35967_length_340_cov_2","Nsylvestris_NODE_1224_length_4680_cov_172",88.983,354,22,9,3,340,1776,2128,1.54e-117,422,337,352
"86621","Ntome_NODE_35969_length_339_cov_181","Nsylvestris_NODE_1444_length_4452_cov_220",88.172,93,3,3,1,85,2397,2489,6.32e-22,104,84,92
"86622","Ntome_NODE_35974_length_339_cov_5","Nsylvestris_NODE_16311_length_1418_cov_129",95.575,339,15,0,1,339,935,597,3.14e-154,544,338,338
"86623","Ntome_NODE_35979_length_339_cov_4","Nsylvestris_NODE_683_length_5485_cov_47",78.857,175,30,7,124,294,3225,3396,3.78e-24,111,170,171
"86624","Ntome_NODE_35982_length_339_cov_3","Nsylvestris_NODE_1064_length_4863_cov_92",94.94,336,17,0,1,336,2600,2935,3.17e-149,527,335,335
"86625","Ntome_NODE_35983_length_339_cov_3","Nsylvestris_NODE_28925_length_587_cov_5",86.777,363,22,7,1,339,223,583,2.61e-105,381,338,360
"86626","Ntome_NODE_35986_length_339_cov_3","Nsylvestris_NODE_33195_length_346_cov_5",76.897,290,59,8,12,297,52,337,4.79e-38,158,285,285
"86627","Ntome_NODE_35992_length_339_cov_2","Nsylvestris_NODE_18948_length_1188_cov_20",89.547,287,28,2,54,339,882,597,9.45e-100,363,285,285
"86628","Ntome_NODE_35993_length_339_cov_2","Nsylvestris_NODE_35758_length_278_cov_5",95.21,167,6,1,175,339,278,112,9.86e-70,263,164,166
"86631","Ntome_NODE_35995_length_338_cov_214","Nsylvestris_NODE_18123_length_1256_cov_196",80.982,326,31,16,1,315,309,4,9.97e-60,230,314,305
"86644","Ntome_NODE_36004_length_338_cov_7","Nsylvestris_NODE_22639_length_913_cov_228",100,338,0,0,1,338,537,200,1.09e-178,625,337,337
"86645","Ntome_NODE_36006_length_338_cov_7","Nsylvestris_NODE_30116_length_516_cov_9",86.174,311,14,10,52,333,2,312,1.24e-83,309,281,310
"86646","Ntome_NODE_36007_length_338_cov_7","Nsylvestris_NODE_5263_length_2913_cov_52",92.035,339,26,1,1,338,1471,1133,1.16e-133,475,337,338
"86647","Ntome_NODE_36008_length_338_cov_6","Nsylvestris_NODE_28434_length_608_cov_88",91.15,339,20,2,1,338,216,545,1.95e-126,451,337,329
"86648","Ntome_NODE_36011_length_338_cov_5","Nsylvestris_NODE_339_length_6516_cov_121",94.72,322,16,1,2,323,3359,3679,6.88e-141,499,321,320
"86649","Ntome_NODE_36017_length_338_cov_4","Nsylvestris_NODE_33059_length_351_cov_4",89.524,105,11,0,233,337,265,161,8.04e-31,134,104,104
"86650","Ntome_NODE_36022_length_338_cov_3","Nsylvestris_NODE_33650_length_332_cov_6",86.905,84,9,2,65,148,161,242,1.36e-18,93.5,83,81
"86653","Ntome_NODE_36024_length_338_cov_3","Nsylvestris_NODE_17681_length_1296_cov_37",86.408,206,15,7,15,207,1078,1283,1e-54,213,192,205
"86663","Ntome_NODE_36033_length_337_cov_11","Nsylvestris_NODE_1969_length_4073_cov_46",95.455,286,12,1,1,286,3031,3315,1.51e-127,455,285,284
"86667","Ntome_NODE_36036_length_337_cov_4","Nsylvestris_NODE_10924_length_1997_cov_209",93.75,48,1,2,282,327,936,983,6.37e-12,71.3,45,47
"86668","Ntome_NODE_36039_length_337_cov_4","Nsylvestris_NODE_14118_length_1639_cov_75",97.626,337,8,0,1,337,1386,1050,8.56e-165,579,336,336
"86669","Ntome_NODE_36043_length_337_cov_3","Nsylvestris_NODE_67_length_9106_cov_194",90.149,335,32,1,1,334,364,698,1.96e-121,435,333,334
"86672","Ntome_NODE_36050_length_337_cov_3","Nsylvestris_NODE_30846_length_461_cov_1",95.87,339,10,3,1,337,42,378,8.69e-155,545,336,336
"86673","Ntome_NODE_36052_length_337_cov_3","Nsylvestris_NODE_436_length_6152_cov_57",84.024,338,34,8,2,320,1496,1832,4.46e-83,307,318,336
"86674","Ntome_NODE_36058_length_336_cov_246","Nsylvestris_NODE_2557_length_3766_cov_194",91.304,115,4,2,179,291,249,139,2.21e-36,152,112,110
"86675","Ntome_NODE_36059_length_336_cov_237","Nsylvestris_NODE_15312_length_1520_cov_166",98.276,58,1,0,279,336,1273,1330,2.25e-21,102,57,57
"86678","Ntome_NODE_36063_length_336_cov_201","Nsylvestris_NODE_6720_length_2618_cov_139",94.044,319,10,1,18,336,2446,2137,1.15e-133,475,318,309
"86679","Ntome_NODE_36065_length_336_cov_162","Nsylvestris_NODE_15870_length_1462_cov_205",91.857,307,11,4,1,293,1045,1351,7.08e-116,416,292,306
"86680","Ntome_NODE_36066_length_336_cov_161","Nsylvestris_NODE_7360_length_2511_cov_144",96.364,55,2,0,282,336,1879,1825,4.88e-18,91.6,54,54
"86683","Ntome_NODE_36070_length_336_cov_10","Nsylvestris_NODE_26715_length_686_cov_167",91.74,339,22,3,1,334,581,244,6.93e-131,466,333,337
"86684","Ntome_NODE_36071_length_336_cov_9","Nsylvestris_NODE_1744_length_4216_cov_107",92.708,192,13,1,145,336,1137,1327,1.25e-73,276,191,190
"86685","Ntome_NODE_36074_length_336_cov_7","Nsylvestris_NODE_7505_length_2485_cov_126",86.957,322,22,8,19,336,1297,992,3.39e-94,344,317,305
"86686","Ntome_NODE_36079_length_336_cov_5","Nsylvestris_NODE_1261_length_4629_cov_84",97.321,336,9,0,1,336,3804,4139,1.43e-162,571,335,335
"86687","Ntome_NODE_36080_length_336_cov_5","Nsylvestris_NODE_4379_length_3132_cov_12",93.452,336,22,0,1,336,1654,1319,6.84e-141,499,335,335
"86688","Ntome_NODE_36081_length_336_cov_5","Nsylvestris_NODE_553_length_5813_cov_96",83.929,336,53,1,1,336,1762,2096,5.71e-87,320,335,334
"86689","Ntome_NODE_36083_length_336_cov_4","Nsylvestris_NODE_15052_length_1546_cov_48",94.925,335,17,0,1,335,1205,871,1.13e-148,525,334,334
"86690","Ntome_NODE_36084_length_336_cov_4","Nsylvestris_NODE_2216_length_3931_cov_39",98.214,336,6,0,1,336,2381,2046,1.42e-167,588,335,335
"86691","Ntome_NODE_36086_length_336_cov_4","Nsylvestris_NODE_30509_length_485_cov_18",86.726,339,40,4,2,336,7,344,1.55e-102,372,334,337
"86692","Ntome_NODE_36087_length_336_cov_4","Nsylvestris_NODE_9735_length_2149_cov_95",97.297,37,1,0,224,260,1179,1215,1.06e-09,63.9,36,36
"86693","Ntome_NODE_36091_length_337_cov_3","Nsylvestris_NODE_14044_length_1645_cov_171",89.032,155,13,3,2,155,1246,1397,1.69e-47,189,153,151
"86694","Ntome_NODE_36094_length_336_cov_3","Nsylvestris_NODE_31768_length_405_cov_3",95.431,197,6,2,143,336,405,209,3.44e-84,311,193,196
"86697","Ntome_NODE_36098_length_336_cov_3","Nsylvestris_NODE_11451_length_1936_cov_99",86.798,356,20,7,3,331,1602,1247,1.55e-102,372,328,355
"86700","Ntome_NODE_36101_length_336_cov_2","Nsylvestris_NODE_4379_length_3132_cov_12",94.345,336,19,0,1,336,204,539,6.79e-146,516,335,335
"86701","Ntome_NODE_36107_length_335_cov_327","Nsylvestris_NODE_4720_length_3040_cov_107",96.697,333,11,0,3,335,1569,1901,1.43e-157,555,332,332
"86702","Ntome_NODE_36108_length_335_cov_297","Nsylvestris_NODE_12462_length_1820_cov_215",97.313,335,9,0,1,335,1270,936,5.12e-162,569,334,334
"86712","Ntome_NODE_36113_length_335_cov_213","Nsylvestris_NODE_9821_length_2137_cov_72",90.476,168,16,0,1,168,616,783,1.65e-57,222,167,167
"86713","Ntome_NODE_36117_length_335_cov_7","Nsylvestris_NODE_441_length_6140_cov_71",92.216,334,25,1,1,333,4491,4824,1.49e-132,472,332,333
"86717","Ntome_NODE_36121_length_335_cov_6","Nsylvestris_NODE_18504_length_1224_cov_38",87.425,334,21,5,2,335,1024,712,2.59e-100,364,333,312
"86720","Ntome_NODE_36133_length_335_cov_4","Nsylvestris_NODE_14325_length_1619_cov_18",95.509,334,15,0,2,335,669,1002,1.87e-151,534,333,333
"86721","Ntome_NODE_36136_length_335_cov_3","Nsylvestris_NODE_35507_length_284_cov_3",96.089,179,7,0,157,335,284,106,1.24e-78,292,178,178
"86726","Ntome_NODE_36141_length_335_cov_3","Nsylvestris_NODE_285_length_6786_cov_51",97.612,335,8,0,1,335,3333,3667,1.1e-163,575,334,334
"86733","Ntome_NODE_36155_length_334_cov_7","Nsylvestris_NODE_11408_length_1941_cov_60",88.026,309,32,3,1,305,1169,1476,3.34e-99,361,304,307
"86734","Ntome_NODE_36157_length_334_cov_6","Nsylvestris_NODE_22282_length_937_cov_22",89.773,352,17,7,1,334,901,551,6.99e-121,433,333,350
"86735","Ntome_NODE_36160_length_334_cov_5","Nsylvestris_NODE_24411_length_806_cov_41",90.882,340,16,3,1,334,680,350,1.16e-123,442,333,330
"86754","Ntome_NODE_36179_length_333_cov_187","Nsylvestris_NODE_2605_length_3743_cov_122",94.545,55,3,0,1,55,1395,1449,2.25e-16,86.1,54,54
"86755","Ntome_NODE_36180_length_333_cov_161","Nsylvestris_NODE_6420_length_2675_cov_170",97.561,123,3,0,1,123,2099,1977,3.55e-54,211,122,122
"86758","Ntome_NODE_36184_length_333_cov_11","Nsylvestris_NODE_24538_length_799_cov_11",79.381,291,40,12,47,329,328,50,5.99e-47,187,282,278
"86759","Ntome_NODE_36190_length_333_cov_6","Nsylvestris_NODE_1747_length_4216_cov_80",93.471,291,17,2,36,325,2342,2631,2.51e-120,431,289,289
"86760","Ntome_NODE_36194_length_333_cov_5","Nsylvestris_NODE_4586_length_3077_cov_81",94.083,338,15,4,1,333,681,1018,1.12e-143,508,332,337
"86761","Ntome_NODE_36198_length_333_cov_4","Nsylvestris_NODE_33025_length_352_cov_7",96.988,332,10,0,1,332,351,20,1.1e-158,558,331,331
"86762","Ntome_NODE_36204_length_333_cov_4","Nsylvestris_NODE_637_length_5593_cov_130",97.674,43,1,0,1,43,1778,1820,4.86e-13,75,42,42
"86763","Ntome_NODE_36207_length_333_cov_3","Nsylvestris_NODE_8327_length_2351_cov_151",93.75,336,15,3,1,333,876,1208,6.77e-141,499,332,332
"86766","Ntome_NODE_36211_length_333_cov_3","Nsylvestris_NODE_16491_length_1401_cov_7",85.714,63,9,0,265,327,399,337,8.14e-11,67.6,62,62
"86767","Ntome_NODE_36214_length_333_cov_3","Nsylvestris_NODE_13295_length_1729_cov_102",87.984,258,25,2,3,255,1472,1728,7.37e-81,300,252,256
"86768","Ntome_NODE_36217_length_333_cov_2","Nsylvestris_NODE_36410_length_264_cov_3",99.621,264,1,0,64,327,264,1,6.82e-136,483,263,263
"86777","Ntome_NODE_36224_length_332_cov_9","Nsylvestris_NODE_28367_length_611_cov_98",80.851,188,27,5,26,204,228,415,1.69e-32,139,178,187
"86787","Ntome_NODE_36236_length_332_cov_4","Nsylvestris_NODE_15875_length_1462_cov_68",94.203,69,4,0,18,86,1185,1253,1.72e-22,106,68,68
"86797","Ntome_NODE_36247_length_331_cov_240","Nsylvestris_NODE_7721_length_2449_cov_218",90.878,296,10,5,1,281,1938,2231,2.54e-105,381,280,293
"86798","Ntome_NODE_36248_length_331_cov_223","Nsylvestris_NODE_27661_length_643_cov_177",100,56,0,0,276,331,53,108,6.16e-22,104,55,55
"86802","Ntome_NODE_36250_length_331_cov_202","Nsylvestris_NODE_4405_length_3124_cov_164",95.139,144,5,2,163,305,11,153,1.26e-58,226,142,142
"86805","Ntome_NODE_36252_length_331_cov_177","Nsylvestris_NODE_4718_length_3041_cov_13",93.407,182,12,0,150,331,514,333,5.74e-72,270,181,181
"86806","Ntome_NODE_36254_length_331_cov_11","Nsylvestris_NODE_6506_length_2660_cov_38",92.771,166,6,2,167,331,1620,1460,2.09e-61,235,164,160
"86812","Ntome_NODE_36258_length_331_cov_6","Nsylvestris_NODE_2308_length_3890_cov_68",95.77,331,14,0,1,331,2121,1791,1.84e-151,534,330,330
"86813","Ntome_NODE_36267_length_331_cov_5","Nsylvestris_NODE_33163_length_347_cov_4",86.25,80,5,1,252,331,341,268,2.89e-15,82.4,79,73
"86814","Ntome_NODE_36269_length_331_cov_4","Nsylvestris_NODE_26482_length_697_cov_6",95.779,308,11,2,8,315,401,96,8.7e-140,496,307,305
"86818","Ntome_NODE_36282_length_330_cov_318","Nsylvestris_NODE_4720_length_3040_cov_107",94.512,328,18,0,1,328,2327,2654,4.01e-143,507,327,327
"86821","Ntome_NODE_36284_length_330_cov_276","Nsylvestris_NODE_388_length_6343_cov_161",99.091,330,3,0,1,330,2554,2225,2.99e-169,593,329,329
"86822","Ntome_NODE_36285_length_330_cov_261","Nsylvestris_NODE_1316_length_4581_cov_207",98.182,330,6,0,1,330,1983,2312,3.01e-164,577,329,329
"86823","Ntome_NODE_36287_length_330_cov_169","Nsylvestris_NODE_1635_length_4305_cov_165",94.561,239,7,2,92,329,45,278,2.55e-100,364,237,233
"86824","Ntome_NODE_36289_length_330_cov_136","Nsylvestris_NODE_5967_length_2767_cov_17",92.105,76,4,2,251,325,992,1066,1.71e-22,106,74,74
"86825","Ntome_NODE_36291_length_330_cov_54","Nsylvestris_NODE_3808_length_3298_cov_31",86.364,88,10,2,147,232,113,26,3.7e-19,95.3,85,87
"86826","Ntome_NODE_36293_length_330_cov_25","Nsylvestris_NODE_29940_length_533_cov_7",85.816,141,13,5,192,330,41,176,1.3e-33,143,138,135
"86827","Ntome_NODE_36296_length_330_cov_8","Nsylvestris_NODE_19044_length_1180_cov_13",89.058,329,19,6,1,327,383,696,1.17e-108,392,326,313
"86831","Ntome_NODE_36298_length_330_cov_6","Nsylvestris_NODE_8132_length_2383_cov_14",96.916,227,6,1,60,286,1182,1407,9.11e-105,379,226,225
"86832","Ntome_NODE_36300_length_330_cov_6","Nsylvestris_NODE_4066_length_3215_cov_76",90,60,4,2,226,283,625,566,1.34e-13,76.8,57,59
"86833","Ntome_NODE_36306_length_330_cov_5","Nsylvestris_NODE_12877_length_1777_cov_215",87.654,324,33,5,10,330,116,435,5.49e-102,370,320,319
"86837","Ntome_NODE_36308_length_330_cov_4","Nsylvestris_NODE_15107_length_1540_cov_144",95.652,46,1,1,282,327,265,309,1.73e-12,73.1,45,44
"86838","Ntome_NODE_36313_length_330_cov_4","Nsylvestris_NODE_30407_length_494_cov_5",89.407,236,24,1,1,236,259,493,9.44e-80,296,235,234
"86843","Ntome_NODE_36320_length_330_cov_2","Nsylvestris_NODE_18975_length_1186_cov_15",93.393,333,18,3,1,330,74,405,4.04e-138,490,329,331
"86844","Ntome_NODE_36323_length_330_cov_2","Nsylvestris_NODE_22351_length_932_cov_44",96.732,306,9,1,26,330,561,256,1.11e-143,508,304,305
"86845","Ntome_NODE_36324_length_329_cov_283","Nsylvestris_NODE_21921_length_960_cov_183",96.127,284,9,2,1,283,543,825,8.77e-130,462,282,282
"86849","Ntome_NODE_36334_length_329_cov_4","Nsylvestris_NODE_28713_length_596_cov_8",86.29,124,14,2,1,124,353,473,2.81e-30,132,123,120
"86850","Ntome_NODE_36337_length_329_cov_3","Nsylvestris_NODE_27814_length_637_cov_53",96.241,133,5,0,197,329,55,187,2.1e-56,219,132,132
"86857","Ntome_NODE_36346_length_328_cov_328","Nsylvestris_NODE_4077_length_3210_cov_199",96.979,331,7,1,1,328,2313,1983,5.04e-157,553,327,330
"86865","Ntome_NODE_36351_length_328_cov_77","Nsylvestris_NODE_30276_length_505_cov_8",91.473,129,5,4,205,328,461,334,1.65e-42,172,123,127
"86866","Ntome_NODE_36352_length_328_cov_29","Nsylvestris_NODE_2758_length_3680_cov_219",91.071,56,2,2,1,56,2062,2010,1.72e-12,73.1,55,52
"86867","Ntome_NODE_36353_length_328_cov_15","Nsylvestris_NODE_7748_length_2445_cov_89",90.164,305,19,3,1,297,364,63,5.41e-107,387,296,301
"86868","Ntome_NODE_36363_length_328_cov_6","Nsylvestris_NODE_26711_length_687_cov_5",92.073,328,26,0,1,328,31,358,8.74e-130,462,327,327
"86869","Ntome_NODE_36364_length_328_cov_6","Nsylvestris_NODE_36866_length_254_cov_5",92,50,4,0,1,50,66,115,6.19e-12,71.3,49,49
"86870","Ntome_NODE_36365_length_328_cov_5","Nsylvestris_NODE_19576_length_1137_cov_14",84.806,283,34,4,7,289,659,932,1.22e-73,276,282,273
"86871","Ntome_NODE_36368_length_328_cov_5","Nsylvestris_NODE_25810_length_728_cov_9",83.571,140,19,3,188,324,352,490,3.62e-29,128,136,138
"86872","Ntome_NODE_36376_length_328_cov_3","Nsylvestris_NODE_185_length_7475_cov_83",92.698,315,23,0,14,328,4644,4330,1.46e-127,455,314,314
"86876","Ntome_NODE_36379_length_328_cov_3","Nsylvestris_NODE_29840_length_542_cov_4",95,180,8,1,1,180,179,1,2.63e-75,281,179,178
"86879","Ntome_NODE_36386_length_328_cov_2","Nsylvestris_NODE_1471_length_4425_cov_109",84.848,99,12,3,116,212,4197,4100,1.02e-19,97.1,96,97
"86880","Ntome_NODE_36388_length_328_cov_1","Nsylvestris_NODE_32113_length_389_cov_5",92.284,324,24,1,1,324,356,34,1.13e-128,459,323,322
"86881","Ntome_NODE_36389_length_327_cov_324","Nsylvestris_NODE_1560_length_4354_cov_201",97.554,327,8,0,1,327,2123,2449,3e-159,560,326,326
"86885","Ntome_NODE_36392_length_327_cov_141","Nsylvestris_NODE_3263_length_3485_cov_128",89.818,275,13,6,1,260,2558,2284,1.53e-92,339,259,274
"86886","Ntome_NODE_36393_length_327_cov_112","Nsylvestris_NODE_3127_length_3535_cov_111",90.441,272,19,3,61,326,3478,3208,1.97e-96,351,265,270
"86887","Ntome_NODE_36395_length_327_cov_17","Nsylvestris_NODE_18760_length_1205_cov_170",84.874,119,12,5,205,321,1204,1090,2.81e-25,115,116,114
"86891","Ntome_NODE_36397_length_327_cov_14","Nsylvestris_NODE_6770_length_2609_cov_211",91.716,169,6,7,153,321,161,1,3.46e-59,228,168,160
"86892","Ntome_NODE_36400_length_327_cov_9","Nsylvestris_NODE_7065_length_2560_cov_21",97.368,38,1,0,132,169,590,627,2.87e-10,65.8,37,37
"86899","Ntome_NODE_36409_length_327_cov_4","Nsylvestris_NODE_8130_length_2383_cov_80",100,28,0,0,197,224,2291,2264,2.23e-06,52.8,27,27
"86902","Ntome_NODE_36415_length_327_cov_3","Nsylvestris_NODE_12778_length_1789_cov_49",94.637,317,17,0,11,327,540,224,1.11e-138,492,316,316
"86903","Ntome_NODE_36416_length_327_cov_3","Nsylvestris_NODE_7705_length_2452_cov_114",96.33,327,12,0,1,327,1631,1957,1.41e-152,538,326,326
"86904","Ntome_NODE_36421_length_327_cov_3","Nsylvestris_NODE_5085_length_2953_cov_74",96.308,325,12,0,3,327,2479,2155,1.82e-151,534,324,324
"86905","Ntome_NODE_36424_length_326_cov_272","Nsylvestris_NODE_7230_length_2529_cov_205",92.638,326,24,0,1,326,726,401,5.19e-132,470,325,325
"86920","Ntome_NODE_36438_length_326_cov_4","Nsylvestris_NODE_11585_length_1921_cov_36",95.918,294,12,0,17,310,434,727,3.1e-134,477,293,293
"86921","Ntome_NODE_36440_length_326_cov_4","Nsylvestris_NODE_22565_length_918_cov_7",97.403,154,1,2,173,326,882,732,1.22e-68,259,153,150
"86922","Ntome_NODE_36442_length_326_cov_4","Nsylvestris_NODE_32139_length_388_cov_4",88.889,189,20,1,134,322,1,188,2.67e-60,231,188,187
"86923","Ntome_NODE_36443_length_326_cov_4","Nsylvestris_NODE_11952_length_1875_cov_123",96.667,300,10,0,1,300,1692,1393,6.62e-141,499,299,299
"86924","Ntome_NODE_36444_length_326_cov_4","Nsylvestris_NODE_3442_length_3423_cov_57",97.853,326,7,0,1,326,1959,1634,2.31e-160,564,325,325
"86925","Ntome_NODE_36453_length_326_cov_1","Nsylvestris_NODE_32540_length_371_cov_2",95.392,217,6,3,1,216,214,1,1.18e-93,342,215,213
"86926","Ntome_NODE_36454_length_325_cov_321","Nsylvestris_NODE_4667_length_3054_cov_49",97.846,325,7,0,1,325,765,1089,8.29e-160,562,324,324
"86934","Ntome_NODE_36457_length_325_cov_148","Nsylvestris_NODE_16434_length_1406_cov_212",88.71,186,12,7,1,182,1222,1402,2.07e-56,219,181,180
"86935","Ntome_NODE_36458_length_325_cov_118","Nsylvestris_NODE_6057_length_2747_cov_110",95.385,325,13,1,1,325,1123,1445,6.55e-146,516,324,322
"86936","Ntome_NODE_36460_length_325_cov_11","Nsylvestris_NODE_13003_length_1763_cov_156",100,33,0,0,1,33,497,529,3.69e-09,62.1,32,32
"86944","Ntome_NODE_36476_length_325_cov_3","Nsylvestris_NODE_3471_length_3410_cov_158",95.988,324,13,0,1,324,2485,2808,3.03e-149,527,323,323
"86945","Ntome_NODE_36480_length_325_cov_3","Nsylvestris_NODE_4236_length_3166_cov_98",96.615,325,11,0,1,325,1318,994,3.89e-153,540,324,324
"86950","Ntome_NODE_36486_length_325_cov_2","Nsylvestris_NODE_11487_length_1932_cov_58",92.424,330,16,6,1,325,1278,953,8.65e-130,462,324,325
"86951","Ntome_NODE_36490_length_324_cov_323","Nsylvestris_NODE_11357_length_1946_cov_88",94.881,293,9,4,32,324,224,510,5.19e-127,453,292,286
"86952","Ntome_NODE_36491_length_324_cov_278","Nsylvestris_NODE_560_length_5800_cov_182",95.37,324,15,0,1,324,1459,1782,6.53e-146,516,323,323
"86956","Ntome_NODE_36493_length_324_cov_192","Nsylvestris_NODE_9364_length_2198_cov_218",92.042,289,14,2,2,281,1734,2022,2.47e-110,398,279,288
"86964","Ntome_NODE_36499_length_324_cov_8","Nsylvestris_NODE_20147_length_1090_cov_212",100,324,0,0,1,324,421,98,6.3e-171,599,323,323
"86965","Ntome_NODE_36500_length_324_cov_7","Nsylvestris_NODE_237_length_7070_cov_115",95.625,320,14,0,4,323,2725,3044,2.35e-145,514,319,319
"86966","Ntome_NODE_36502_length_324_cov_6","Nsylvestris_NODE_59_length_9263_cov_64",92.284,324,25,0,1,324,5128,5451,3.1e-129,460,323,323
"86967","Ntome_NODE_36505_length_324_cov_5","Nsylvestris_NODE_25132_length_764_cov_78",85.127,316,39,7,13,324,532,221,7.11e-86,316,311,311
"86970","Ntome_NODE_36512_length_324_cov_4","Nsylvestris_NODE_11868_length_1884_cov_11",93.214,280,19,0,1,280,1876,1597,8.81e-115,412,279,279
"86973","Ntome_NODE_36520_length_324_cov_3","Nsylvestris_NODE_6641_length_2635_cov_38",92.453,53,2,2,1,52,1591,1642,4.72e-13,75,51,51
"86974","Ntome_NODE_36521_length_324_cov_2","Nsylvestris_NODE_8824_length_2276_cov_16",97.368,228,6,0,86,313,2276,2049,1.48e-107,388,227,227
"86975","Ntome_NODE_36524_length_324_cov_2","Nsylvestris_NODE_1981_length_4066_cov_103",93.808,323,19,1,3,324,932,610,1.84e-136,484,321,322
"86982","Ntome_NODE_36529_length_323_cov_39","Nsylvestris_NODE_6592_length_2644_cov_144",89.804,255,26,0,31,285,8,262,3.27e-89,327,254,254
"86983","Ntome_NODE_36531_length_323_cov_12","Nsylvestris_NODE_27818_length_637_cov_16",82.587,201,32,3,6,203,1,201,4.51e-43,174,197,200
"86987","Ntome_NODE_36533_length_323_cov_9","Nsylvestris_NODE_13761_length_1678_cov_15",95.342,322,14,1,1,322,1402,1082,3.03e-144,510,321,320
"86988","Ntome_NODE_36535_length_323_cov_7","Nsylvestris_NODE_923_length_5059_cov_127",82.648,219,31,7,5,220,1296,1082,5.79e-47,187,215,214
"86997","Ntome_NODE_36541_length_323_cov_5","Nsylvestris_NODE_31546_length_417_cov_3",97.426,272,7,0,51,322,416,145,2.39e-130,464,271,271
"86998","Ntome_NODE_36542_length_323_cov_5","Nsylvestris_NODE_3845_length_3287_cov_16",97.833,323,7,0,1,323,468,790,1.07e-158,558,322,322
"86999","Ntome_NODE_36543_length_322_cov_5","Nsylvestris_NODE_27580_length_647_cov_157",87.037,54,7,0,269,322,329,276,3.65e-09,62.1,53,53
"87000","Ntome_NODE_36544_length_323_cov_5","Nsylvestris_NODE_30891_length_458_cov_7",90.476,273,22,1,39,311,458,190,4.17e-98,357,272,268
"87001","Ntome_NODE_36546_length_323_cov_4","Nsylvestris_NODE_22063_length_952_cov_13",94.805,154,5,2,170,323,307,157,5.67e-62,237,153,150
"87002","Ntome_NODE_36548_length_323_cov_3","Nsylvestris_NODE_11933_length_1877_cov_104",97.561,82,2,0,44,125,868,787,4.57e-33,141,81,81
"87003","Ntome_NODE_36550_length_323_cov_3","Nsylvestris_NODE_6357_length_2687_cov_15",91.139,79,5,2,239,316,399,322,1.67e-22,106,77,77
"87004","Ntome_NODE_36551_length_323_cov_3","Nsylvestris_NODE_33058_length_351_cov_4",81.928,249,26,10,49,281,246,1,1.25e-48,193,232,245
"87011","Ntome_NODE_36564_length_322_cov_6","Nsylvestris_NODE_2535_length_3777_cov_83",94.576,295,13,1,1,295,1097,1388,5.16e-127,453,294,291
"87015","Ntome_NODE_36567_length_322_cov_5","Nsylvestris_NODE_31047_length_448_cov_7",95.062,324,13,3,1,322,3,325,3.9e-143,507,321,322
"87016","Ntome_NODE_36569_length_322_cov_4","Nsylvestris_NODE_1124_length_4787_cov_79",97.396,192,5,0,131,322,1555,1364,3.26e-89,327,191,191
"87017","Ntome_NODE_36570_length_322_cov_4","Nsylvestris_NODE_10611_length_2036_cov_26",95.886,316,13,0,7,322,856,541,8.39e-145,512,315,315
"87018","Ntome_NODE_36572_length_321_cov_4","Nsylvestris_NODE_16523_length_1398_cov_15",91.489,329,16,3,2,321,432,757,1.11e-123,442,319,325
"87021","Ntome_NODE_36575_length_322_cov_3","Nsylvestris_NODE_8281_length_2358_cov_40",94.081,321,10,4,2,322,1509,1198,8.51e-135,479,320,311
"87026","Ntome_NODE_36586_length_321_cov_221","Nsylvestris_NODE_22022_length_953_cov_181",95.324,278,12,1,1,277,310,33,4e-123,440,276,277
"87027","Ntome_NODE_36590_length_321_cov_11","Nsylvestris_NODE_25276_length_756_cov_7",97.17,106,3,0,216,321,481,586,9.63e-45,180,105,105
"87030","Ntome_NODE_36595_length_321_cov_6","Nsylvestris_NODE_18823_length_1200_cov_20",81.855,248,29,9,74,321,934,703,3.44e-49,195,247,231
"87031","Ntome_NODE_36599_length_321_cov_4","Nsylvestris_NODE_13423_length_1715_cov_69",94.671,319,17,0,3,321,1238,1556,8.42e-140,496,318,318
"87032","Ntome_NODE_36600_length_321_cov_4","Nsylvestris_NODE_16236_length_1426_cov_91",97.196,321,9,0,1,321,809,1129,2.96e-154,544,320,320
"87033","Ntome_NODE_36604_length_321_cov_3","Nsylvestris_NODE_22094_length_950_cov_13",83.09,343,26,13,1,320,692,359,7.13e-76,283,319,333
"87034","Ntome_NODE_36609_length_321_cov_3","Nsylvestris_NODE_15930_length_1457_cov_75",84.277,318,50,0,1,318,217,534,3.27e-84,311,317,317
"87040","Ntome_NODE_36613_length_321_cov_2","Nsylvestris_NODE_6853_length_2594_cov_14",88.889,297,33,0,1,297,595,299,6.89e-101,366,296,296
"87041","Ntome_NODE_36614_length_321_cov_2","Nsylvestris_NODE_28009_length_629_cov_3",90.909,275,16,4,50,321,395,127,3.2e-99,361,271,268
"87051","Ntome_NODE_36622_length_320_cov_14","Nsylvestris_NODE_2349_length_3871_cov_104",86.667,165,17,4,112,274,327,166,3.45e-44,178,162,161
"87056","Ntome_NODE_36627_length_320_cov_5","Nsylvestris_NODE_8014_length_2401_cov_134",93.125,320,22,0,1,320,297,616,5.09e-132,470,319,319
"87062","Ntome_NODE_36633_length_320_cov_4","Nsylvestris_NODE_23294_length_873_cov_11",91.563,320,13,3,1,320,457,762,8.63e-120,429,319,305
"87063","Ntome_NODE_36634_length_320_cov_4","Nsylvestris_NODE_30444_length_491_cov_9",90.78,282,19,3,41,320,175,451,5.31e-102,370,279,276
"87064","Ntome_NODE_36635_length_320_cov_4","Nsylvestris_NODE_8852_length_2272_cov_65",91.566,332,16,1,1,320,962,1293,2.38e-125,448,319,331
"87065","Ntome_NODE_36636_length_320_cov_4","Nsylvestris_NODE_33802_length_328_cov_3",93.262,282,19,0,1,282,47,328,6.72e-116,416,281,281
"87066","Ntome_NODE_36641_length_320_cov_3","Nsylvestris_NODE_24748_length_786_cov_20",95.37,324,5,3,1,320,197,514,3.88e-143,507,319,317
"87067","Ntome_NODE_36642_length_320_cov_3","Nsylvestris_NODE_16816_length_1371_cov_97",90.526,285,9,4,39,320,911,1180,3.19e-99,361,281,269
"87072","Ntome_NODE_36645_length_320_cov_3","Nsylvestris_NODE_29529_length_562_cov_10",95.833,120,5,0,73,192,5,124,3.43e-49,195,119,119
"87073","Ntome_NODE_36649_length_320_cov_3","Nsylvestris_NODE_67_length_9106_cov_194",88.474,321,36,1,1,320,961,1281,5.27e-107,387,319,320
"87074","Ntome_NODE_36651_length_320_cov_3","Nsylvestris_NODE_23782_length_844_cov_13",100,70,0,0,251,320,1,70,9.8e-30,130,69,69
"87077","Ntome_NODE_36658_length_319_cov_268","Nsylvestris_NODE_7848_length_2423_cov_130",98.119,319,6,0,1,319,1197,1515,3.78e-158,556,318,318
"87078","Ntome_NODE_36659_length_319_cov_239","Nsylvestris_NODE_917_length_5066_cov_179",98.99,99,0,1,221,319,2539,2442,1.24e-43,176,98,97
"87082","Ntome_NODE_36661_length_319_cov_217","Nsylvestris_NODE_6861_length_2592_cov_147",97.179,319,9,0,1,319,1153,835,3.81e-153,540,318,318
"87088","Ntome_NODE_36670_length_319_cov_6","Nsylvestris_NODE_26687_length_688_cov_6",92.053,151,7,3,4,154,479,334,4.39e-53,207,150,145
"87092","Ntome_NODE_36674_length_319_cov_5","Nsylvestris_NODE_10345_length_2070_cov_19",92.163,319,25,0,1,319,464,146,1.84e-126,451,318,318
"87095","Ntome_NODE_36676_length_319_cov_5","Nsylvestris_NODE_34013_length_321_cov_7",96.386,166,6,0,154,319,321,156,4.27e-73,274,165,165
"87096","Ntome_NODE_36677_length_319_cov_5","Nsylvestris_NODE_52_length_9427_cov_171",92.145,331,12,6,1,317,6023,5693,1.42e-127,455,316,330
"87097","Ntome_NODE_36685_length_319_cov_3","Nsylvestris_NODE_3079_length_3550_cov_95",93.103,319,16,3,1,318,3123,2810,8.48e-130,462,317,313
"87098","Ntome_NODE_36689_length_319_cov_3","Nsylvestris_NODE_30141_length_514_cov_8",85.656,244,30,5,1,242,89,329,2e-66,252,241,240
"87101","Ntome_NODE_36699_length_318_cov_340","Nsylvestris_NODE_6610_length_2640_cov_226",91.541,331,13,10,2,318,186,515,1.1e-123,442,316,329
"87105","Ntome_NODE_36702_length_318_cov_267","Nsylvestris_NODE_5219_length_2923_cov_47",92.647,272,10,1,47,318,2550,2289,6.77e-106,383,271,261
"87108","Ntome_NODE_36704_length_318_cov_199","Nsylvestris_NODE_6932_length_2580_cov_97",98.113,318,6,0,1,318,1626,1309,1.36e-157,555,317,317
"87113","Ntome_NODE_36711_length_318_cov_8","Nsylvestris_NODE_12965_length_1767_cov_113",92.744,317,23,0,1,317,873,1189,1.09e-128,459,316,316
"87114","Ntome_NODE_36718_length_318_cov_6","Nsylvestris_NODE_9495_length_2179_cov_21",95.283,318,14,1,1,318,1965,1649,4.98e-142,503,317,316
"87115","Ntome_NODE_36719_length_318_cov_6","Nsylvestris_NODE_31348_length_429_cov_8",97.59,83,1,1,1,83,348,429,4.5e-33,141,82,81
"87116","Ntome_NODE_36726_length_318_cov_4","Nsylvestris_NODE_5435_length_2877_cov_39",93.711,318,20,0,1,318,2367,2050,3.02e-134,477,317,317
"87117","Ntome_NODE_36729_length_318_cov_4","Nsylvestris_NODE_8941_length_2258_cov_158",83.962,318,25,10,1,318,1288,1579,2.54e-75,281,317,291
"87118","Ntome_NODE_36730_length_318_cov_3","Nsylvestris_NODE_14352_length_1615_cov_11",94.025,318,17,1,1,318,1556,1241,2.33e-135,481,317,315
"87119","Ntome_NODE_36733_length_318_cov_3","Nsylvestris_NODE_12006_length_1867_cov_52",95.767,189,8,0,1,189,722,910,1.51e-82,305,188,188
"87120","Ntome_NODE_36736_length_318_cov_3","Nsylvestris_NODE_10945_length_1995_cov_9",95.098,306,14,1,1,306,1276,1580,2.33e-135,481,305,304
"87123","Ntome_NODE_36738_length_317_cov_263","Nsylvestris_NODE_8959_length_2256_cov_219",96.744,215,7,0,51,265,2145,1931,1.14e-98,359,214,214
"87129","Ntome_NODE_36741_length_316_cov_25","Nsylvestris_NODE_8709_length_2292_cov_184",92.147,191,14,1,27,216,177,367,1.96e-71,268,189,190
"87132","Ntome_NODE_36744_length_317_cov_6","Nsylvestris_NODE_3751_length_3318_cov_174",91.781,292,20,2,26,317,2135,2422,5.18e-112,403,291,287
"87133","Ntome_NODE_36747_length_317_cov_6","Nsylvestris_NODE_2352_length_3869_cov_60",88.636,176,13,1,111,279,2358,2533,4.36e-53,207,168,175
"87137","Ntome_NODE_36756_length_317_cov_4","Nsylvestris_NODE_28243_length_617_cov_214",83.945,218,33,2,50,266,217,1,4.36e-53,207,216,216
"87138","Ntome_NODE_36757_length_317_cov_3","Nsylvestris_NODE_4710_length_3042_cov_201",76.923,208,33,14,57,252,379,583,5.88e-22,104,195,204
"87139","Ntome_NODE_36764_length_317_cov_3","Nsylvestris_NODE_19348_length_1156_cov_8",85.938,128,2,1,1,112,128,1,1.62e-27,122,111,127
"87140","Ntome_NODE_36766_length_317_cov_1","Nsylvestris_NODE_3845_length_3287_cov_16",95.268,317,15,0,1,317,356,40,4.96e-142,503,316,316
"87141","Ntome_NODE_36767_length_316_cov_256","Nsylvestris_NODE_12397_length_1826_cov_205",91.892,111,8,1,1,110,409,299,5.74e-37,154,109,110
"87142","Ntome_NODE_36768_length_316_cov_254","Nsylvestris_NODE_15241_length_1527_cov_169",96.519,316,11,0,1,316,827,1142,3.8e-148,523,315,315
"87143","Ntome_NODE_36770_length_316_cov_231","Nsylvestris_NODE_4328_length_3143_cov_155",93.987,316,16,2,1,316,1338,1026,1.08e-133,475,315,312
"87146","Ntome_NODE_36772_length_316_cov_133","Nsylvestris_NODE_241_length_7050_cov_29",98.101,316,6,0,1,316,2526,2841,1.74e-156,551,315,315
"87147","Ntome_NODE_36775_length_316_cov_11","Nsylvestris_NODE_24989_length_772_cov_17",91.367,278,23,1,2,279,753,477,8.7e-105,379,277,276
"87148","Ntome_NODE_36778_length_316_cov_8","Nsylvestris_NODE_34781_length_300_cov_7",96.656,299,6,3,1,298,296,1,2.98e-139,494,297,295
"87154","Ntome_NODE_36785_length_316_cov_5","Nsylvestris_NODE_11529_length_1927_cov_29",89.905,317,27,3,1,313,64,379,5.16e-112,403,312,315
"87155","Ntome_NODE_36786_length_316_cov_5","Nsylvestris_NODE_641_length_5582_cov_124",92.727,110,7,1,1,109,1354,1245,4.44e-38,158,108,109
"87156","Ntome_NODE_36790_length_316_cov_4","Nsylvestris_NODE_30510_length_485_cov_12",82.734,139,23,1,51,189,348,485,1.62e-27,122,138,137
"87162","Ntome_NODE_36796_length_316_cov_4","Nsylvestris_NODE_16397_length_1410_cov_22",92.434,304,17,2,1,301,849,1149,8.51e-120,429,300,300
"87166","Ntome_NODE_36803_length_316_cov_3","Nsylvestris_NODE_3548_length_3387_cov_13",89.939,328,20,6,1,316,2763,3089,3.08e-114,411,315,326
"87167","Ntome_NODE_36807_length_315_cov_303","Nsylvestris_NODE_6248_length_2707_cov_211",97.46,315,8,0,1,315,1283,969,1.35e-152,538,314,314
"87171","Ntome_NODE_36809_length_315_cov_254","Nsylvestris_NODE_36381_length_264_cov_120",96.491,57,2,0,1,57,138,82,3.52e-19,95.3,56,56
"87177","Ntome_NODE_36812_length_315_cov_219","Nsylvestris_NODE_20079_length_1095_cov_203",95.169,207,7,1,1,207,259,56,4.12e-88,324,206,203
"87185","Ntome_NODE_36816_length_315_cov_15","Nsylvestris_NODE_34451_length_309_cov_7",96.117,309,11,1,1,308,1,309,4.93e-142,503,307,308
"87186","Ntome_NODE_36817_length_315_cov_8","Nsylvestris_NODE_27090_length_670_cov_4",79.649,285,41,14,39,315,291,566,1.57e-47,189,276,275
"87187","Ntome_NODE_36819_length_315_cov_7","Nsylvestris_NODE_3395_length_3440_cov_84",81.5,200,26,8,8,200,753,948,5.72e-37,154,192,195
"87190","Ntome_NODE_36823_length_315_cov_6","Nsylvestris_NODE_24485_length_801_cov_205",86.547,223,8,8,1,218,25,230,1.19e-58,226,217,205
"87193","Ntome_NODE_36828_length_315_cov_5","Nsylvestris_NODE_11038_length_1983_cov_32",86.239,109,13,2,207,313,871,979,7.5e-26,117,106,108
"87194","Ntome_NODE_36829_length_314_cov_4","Nsylvestris_NODE_18526_length_1222_cov_32",86.667,240,19,7,6,236,981,1216,5.46e-67,254,230,235
"87195","Ntome_NODE_36830_length_315_cov_4","Nsylvestris_NODE_25735_length_732_cov_6",95.238,315,14,1,1,315,650,337,2.29e-140,497,314,313
"87196","Ntome_NODE_36833_length_315_cov_3","Nsylvestris_NODE_277_length_6827_cov_72",92.405,316,22,2,1,315,4254,4568,6.51e-126,449,314,314
"87200","Ntome_NODE_36839_length_315_cov_3","Nsylvestris_NODE_7828_length_2432_cov_163",94.603,315,17,0,1,315,597,911,1.38e-137,488,314,314
"87201","Ntome_NODE_36842_length_315_cov_3","Nsylvestris_NODE_4820_length_3015_cov_75",97.778,315,7,0,1,315,1064,1378,2.9e-154,544,314,314
"87202","Ntome_NODE_36845_length_315_cov_2","Nsylvestris_NODE_3581_length_3371_cov_225",100,37,0,0,279,315,1395,1359,2.13e-11,69.4,36,36
"87203","Ntome_NODE_36847_length_314_cov_329","Nsylvestris_NODE_7535_length_2479_cov_221",97.134,314,9,0,1,314,896,583,2.25e-150,531,313,313
"87204","Ntome_NODE_36848_length_314_cov_323","Nsylvestris_NODE_2084_length_4003_cov_207",95.541,314,14,0,1,314,2850,2537,4.91e-142,503,313,313
"87208","Ntome_NODE_36850_length_314_cov_253","Nsylvestris_NODE_3507_length_3398_cov_138",98.089,314,6,0,1,314,2100,2413,2.24e-155,547,313,313
"87209","Ntome_NODE_36851_length_314_cov_177","Nsylvestris_NODE_20451_length_1068_cov_134",85.204,196,16,7,54,243,835,1023,1.56e-47,189,189,188
"87212","Ntome_NODE_36862_length_314_cov_4","Nsylvestris_NODE_25273_length_756_cov_20",90.705,312,27,2,3,314,337,646,2.37e-115,414,311,309
"87218","Ntome_NODE_36871_length_314_cov_3","Nsylvestris_NODE_2069_length_4011_cov_85",88.372,215,18,3,101,314,954,746,1.96e-66,252,213,208
"87219","Ntome_NODE_36875_length_314_cov_3","Nsylvestris_NODE_1533_length_4373_cov_30",85.185,270,36,2,1,270,2831,3096,4.19e-73,274,269,265
"87220","Ntome_NODE_36882_length_314_cov_2","Nsylvestris_NODE_12778_length_1789_cov_49",95.86,314,10,1,1,314,776,1086,1.37e-142,505,313,310
"87224","Ntome_NODE_36884_length_313_cov_251","Nsylvestris_NODE_4354_length_3138_cov_227",90.385,208,7,5,1,196,2900,3106,3.25e-69,261,195,206
"87227","Ntome_NODE_36886_length_313_cov_130","Nsylvestris_NODE_22076_length_951_cov_8",94.937,237,12,0,22,258,65,301,1.44e-102,372,236,236
"87232","Ntome_NODE_36899_length_313_cov_4","Nsylvestris_NODE_21569_length_987_cov_15",81.992,261,41,6,3,260,317,60,7.14e-56,217,257,257
"87233","Ntome_NODE_36910_length_313_cov_3","Nsylvestris_NODE_7935_length_2414_cov_105",93.311,299,19,1,16,313,407,109,3.89e-123,440,297,298
"87234","Ntome_NODE_36911_length_313_cov_3","Nsylvestris_NODE_9750_length_2147_cov_74",76.046,263,42,16,48,304,6,253,7.45e-26,117,256,247
"87237","Ntome_NODE_36914_length_313_cov_3","Nsylvestris_NODE_5085_length_2953_cov_74",98.403,313,5,0,1,313,900,1212,1.72e-156,551,312,312
"87238","Ntome_NODE_36917_length_313_cov_2","Nsylvestris_NODE_36468_length_263_cov_3",92.045,264,20,1,3,266,263,1,5.18e-102,370,263,262
"87239","Ntome_NODE_36918_length_313_cov_2","Nsylvestris_NODE_21237_length_1012_cov_7",88.818,313,34,1,1,313,943,632,6.65e-106,383,312,311
"87242","Ntome_NODE_36921_length_312_cov_241","Nsylvestris_NODE_1546_length_4361_cov_224",98.182,55,1,0,1,55,2540,2594,9.67e-20,97.1,54,54
"87249","Ntome_NODE_36928_length_312_cov_7","Nsylvestris_NODE_18704_length_1209_cov_20",96.19,315,9,1,1,312,510,824,8.11e-145,512,311,314
"87253","Ntome_NODE_36932_length_312_cov_5","Nsylvestris_NODE_36444_length_263_cov_5",95.42,262,9,3,1,260,3,263,2.35e-115,414,259,260
"87254","Ntome_NODE_36933_length_312_cov_4","Nsylvestris_NODE_6338_length_2692_cov_86",92.013,313,18,4,1,312,1793,2099,6.49e-121,433,311,306
"87259","Ntome_NODE_36951_length_312_cov_3","Nsylvestris_NODE_12769_length_1790_cov_13",96.795,312,10,0,1,312,1716,1405,1.35e-147,521,311,311
"87260","Ntome_NODE_36953_length_312_cov_2","Nsylvestris_NODE_32282_length_382_cov_4",84.656,189,13,4,137,309,344,156,4.34e-43,174,172,188
"87261","Ntome_NODE_36955_length_311_cov_274","Nsylvestris_NODE_7516_length_2483_cov_203",96.785,311,10,0,1,311,1924,1614,4.83e-147,520,310,310
"87262","Ntome_NODE_36956_length_311_cov_210","Nsylvestris_NODE_23427_length_864_cov_179",85.145,276,26,10,40,311,59,323,1.93e-71,268,271,264
"87265","Ntome_NODE_36959_length_311_cov_152","Nsylvestris_NODE_8702_length_2294_cov_128",94.483,290,13,2,22,311,16,302,2.99e-124,444,289,286
"87268","Ntome_NODE_36964_length_311_cov_12","Nsylvestris_NODE_36666_length_258_cov_25",94.922,256,7,3,1,255,8,258,8.49e-110,396,254,250
"87269","Ntome_NODE_36965_length_311_cov_11","Nsylvestris_NODE_10625_length_2034_cov_134",90,50,1,3,2,49,163,210,3.52e-09,62.1,47,47
"87272","Ntome_NODE_36968_length_311_cov_7","Nsylvestris_NODE_12286_length_1838_cov_233",100,38,0,0,274,311,657,620,5.84e-12,71.3,37,37
"87277","Ntome_NODE_36972_length_311_cov_5","Nsylvestris_NODE_381_length_6388_cov_93",80.488,164,9,9,148,311,6122,6262,5.76e-22,104,163,140
"87278","Ntome_NODE_36974_length_311_cov_5","Nsylvestris_NODE_5357_length_2896_cov_78",100,28,0,0,17,44,2845,2818,2.12e-06,52.8,27,27
"87281","Ntome_NODE_36978_length_311_cov_5","Nsylvestris_NODE_5743_length_2811_cov_118",91.961,311,16,3,1,311,2547,2246,3.01e-119,427,310,301
"87285","Ntome_NODE_36984_length_311_cov_4","Nsylvestris_NODE_25222_length_759_cov_23",83.987,306,35,6,3,306,137,430,2.48e-75,281,303,293
"87286","Ntome_NODE_36986_length_311_cov_4","Nsylvestris_NODE_24752_length_786_cov_10",91.011,89,6,1,223,311,483,569,2.06e-26,119,88,86
"87287","Ntome_NODE_36987_length_311_cov_4","Nsylvestris_NODE_3579_length_3372_cov_28",96.785,311,10,0,1,311,3316,3006,4.83e-147,520,310,310
"87288","Ntome_NODE_36989_length_311_cov_4","Nsylvestris_NODE_26420_length_700_cov_5",87.651,332,19,12,1,311,644,314,6.65e-101,366,310,330
"87289","Ntome_NODE_36992_length_311_cov_4","Nsylvestris_NODE_9873_length_2131_cov_17",97.428,311,8,0,1,311,863,1173,2.23e-150,531,310,310
"87290","Ntome_NODE_36994_length_311_cov_3","Nsylvestris_NODE_35777_length_278_cov_3",92.529,174,11,2,140,311,278,105,2.52e-65,248,171,173
"87291","Ntome_NODE_36996_length_311_cov_3","Nsylvestris_NODE_14798_length_1569_cov_189",85.217,115,16,1,4,118,1345,1232,7.4e-26,117,114,113
"87295","Ntome_NODE_37005_length_311_cov_2","Nsylvestris_NODE_3030_length_3576_cov_31",94.839,310,16,0,2,311,3146,2837,1.76e-136,484,309,309
"87296","Ntome_NODE_37006_length_311_cov_2","Nsylvestris_NODE_15733_length_1477_cov_28",83.951,162,19,5,1,158,1239,1081,2.62e-35,148,157,158
"87297","Ntome_NODE_37010_length_310_cov_294","Nsylvestris_NODE_388_length_6343_cov_161",99.355,310,2,0,1,310,2279,1970,7.88e-160,562,309,309
"87305","Ntome_NODE_37016_length_310_cov_140","Nsylvestris_NODE_2178_length_3949_cov_216",93.75,176,7,3,135,310,1403,1232,3.22e-69,261,175,171
"87306","Ntome_NODE_37017_length_310_cov_103","Nsylvestris_NODE_16557_length_1395_cov_72",98.039,51,1,0,255,305,873,923,1.61e-17,89.8,50,50
"87310","Ntome_NODE_37021_length_310_cov_6","Nsylvestris_NODE_5678_length_2825_cov_1",89.583,192,12,5,1,192,897,1080,5.43e-62,237,191,183
"87311","Ntome_NODE_37023_length_310_cov_6","Nsylvestris_NODE_25820_length_727_cov_103",89.198,324,21,2,1,310,587,264,1.09e-108,392,309,323
"87312","Ntome_NODE_37024_length_310_cov_6","Nsylvestris_NODE_15929_length_1457_cov_82",92.881,295,15,3,3,297,1073,1361,3.88e-118,424,294,288
"87313","Ntome_NODE_37027_length_310_cov_5","Nsylvestris_NODE_18904_length_1192_cov_57",86.018,329,21,10,1,310,533,211,8.7e-90,329,309,322
"87314","Ntome_NODE_37030_length_310_cov_5","Nsylvestris_NODE_17119_length_1347_cov_25",93.16,307,16,3,1,306,906,604,8.28e-125,446,305,302
"87315","Ntome_NODE_37032_length_310_cov_4","Nsylvestris_NODE_2088_length_4002_cov_97",95.806,310,9,1,1,310,163,468,2.25e-140,497,309,305
"87316","Ntome_NODE_37034_length_310_cov_4","Nsylvestris_NODE_16149_length_1435_cov_62",94.483,290,7,3,30,310,432,143,1.39e-122,438,280,289
"87317","Ntome_NODE_37035_length_310_cov_4","Nsylvestris_NODE_2043_length_4028_cov_17",97.5,280,6,1,31,310,1030,1308,2.94e-134,477,279,278
"87318","Ntome_NODE_37036_length_310_cov_4","Nsylvestris_NODE_28012_length_628_cov_185",88.571,70,3,4,96,162,525,592,9.67e-15,80.5,66,67
"87319","Ntome_NODE_37038_length_310_cov_3","Nsylvestris_NODE_33859_length_326_cov_5",93.092,304,14,3,14,310,6,309,1.39e-122,438,296,303
"87320","Ntome_NODE_37040_length_310_cov_3","Nsylvestris_NODE_2238_length_3919_cov_148",91.379,58,5,0,223,280,1731,1788,9.67e-15,80.5,57,57
"87321","Ntome_NODE_37041_length_310_cov_3","Nsylvestris_NODE_28112_length_624_cov_10",94.056,286,15,1,27,310,598,313,6.45e-121,433,283,285
"87327","Ntome_NODE_37051_length_310_cov_2","Nsylvestris_NODE_13710_length_1684_cov_18",94.839,310,16,0,1,310,375,66,1.75e-136,484,309,309
"87328","Ntome_NODE_37053_length_309_cov_243","Nsylvestris_NODE_14783_length_1571_cov_170",93.59,312,7,2,1,309,1566,1265,4.93e-127,453,308,301
"87329","Ntome_NODE_37054_length_309_cov_226","Nsylvestris_NODE_20912_length_1034_cov_190",81.538,130,13,4,181,309,877,758,9.57e-20,97.1,128,119
"87342","Ntome_NODE_37071_length_309_cov_4","Nsylvestris_NODE_726_length_5395_cov_45",90.566,318,20,6,1,309,3649,3333,8.37e-115,412,308,316
"87343","Ntome_NODE_37088_length_309_cov_3","Nsylvestris_NODE_12499_length_1815_cov_137",75.776,161,32,7,41,197,600,443,4.49e-13,75,156,157
"87346","Ntome_NODE_37095_length_309_cov_2","Nsylvestris_NODE_29678_length_555_cov_23",84.141,227,21,10,1,223,218,3,1.52e-52,206,222,215
"87347","Ntome_NODE_37096_length_309_cov_2","Nsylvestris_NODE_27907_length_633_cov_3",89.796,245,24,1,65,309,622,379,8.73e-85,313,244,243
"87348","Ntome_NODE_37097_length_309_cov_2","Nsylvestris_NODE_2571_length_3761_cov_14",93.831,308,14,2,6,309,646,952,1.06e-128,459,303,306
"87349","Ntome_NODE_37098_length_309_cov_1","Nsylvestris_NODE_29004_length_584_cov_4",93.226,310,20,1,1,309,498,189,1.37e-127,455,308,309
"87359","Ntome_NODE_37103_length_308_cov_235","Nsylvestris_NODE_1582_length_4340_cov_190",95.349,301,14,0,1,301,1561,1261,8.11e-135,479,300,300
"87371","Ntome_NODE_37111_length_308_cov_7","Nsylvestris_NODE_17556_length_1308_cov_14",89.137,313,27,2,1,306,930,618,6.54e-106,383,305,312
"87372","Ntome_NODE_37112_length_308_cov_6","Nsylvestris_NODE_14031_length_1646_cov_74",89.61,308,30,2,1,307,925,619,3.91e-108,390,306,306
"87373","Ntome_NODE_37114_length_308_cov_6","Nsylvestris_NODE_23673_length_850_cov_58",93.399,303,17,1,6,308,624,325,8.22e-125,446,302,299
"87374","Ntome_NODE_37116_length_308_cov_6","Nsylvestris_NODE_13632_length_1692_cov_121",96.393,305,11,0,1,305,610,914,4.81e-142,503,304,304
"87375","Ntome_NODE_37117_length_308_cov_5","Nsylvestris_NODE_301_length_6718_cov_180",97.516,161,4,0,144,304,3648,3808,1.14e-73,276,160,160
"87376","Ntome_NODE_37124_length_308_cov_5","Nsylvestris_NODE_6534_length_2654_cov_96",88.291,316,16,9,1,301,1308,1617,1.1e-98,359,300,309
"87377","Ntome_NODE_37126_length_308_cov_5","Nsylvestris_NODE_35712_length_279_cov_5",92.578,256,10,5,1,253,30,279,1.1e-98,359,252,249
"87378","Ntome_NODE_37134_length_308_cov_4","Nsylvestris_NODE_28528_length_605_cov_8",98.377,308,5,0,1,308,256,563,1.02e-153,542,307,307
"87379","Ntome_NODE_37141_length_308_cov_3","Nsylvestris_NODE_20498_length_1065_cov_8",94.643,56,2,1,1,56,372,426,2.06e-16,86.1,55,54
"87380","Ntome_NODE_37144_length_308_cov_3","Nsylvestris_NODE_9349_length_2201_cov_103",94.498,309,15,2,1,308,931,1238,1.05e-133,475,307,307
"87381","Ntome_NODE_37145_length_308_cov_3","Nsylvestris_NODE_4236_length_3166_cov_98",97.078,308,9,0,1,308,1629,1936,4.78e-147,520,307,307
"87382","Ntome_NODE_37148_length_308_cov_3","Nsylvestris_NODE_970_length_4991_cov_159",94.118,306,17,1,3,308,1070,1374,2.27e-130,464,305,304
"87385","Ntome_NODE_37152_length_308_cov_2","Nsylvestris_NODE_10813_length_2012_cov_143",96.104,308,12,0,1,308,577,884,4.81e-142,503,307,307
"87386","Ntome_NODE_37153_length_307_cov_316","Nsylvestris_NODE_10806_length_2013_cov_135",99.023,307,3,0,1,307,1419,1113,1.69e-156,551,306,306
"87390","Ntome_NODE_37155_length_307_cov_216","Nsylvestris_NODE_35247_length_289_cov_7",98.45,129,2,0,179,307,265,137,3.23e-59,228,128,128
"87398","Ntome_NODE_37159_length_307_cov_11","Nsylvestris_NODE_10986_length_1989_cov_230",95.833,48,1,1,261,307,1301,1254,1.24e-13,76.8,46,47
"87401","Ntome_NODE_37165_length_307_cov_5","Nsylvestris_NODE_5271_length_2911_cov_157",88.506,87,10,0,146,232,212,298,1.58e-22,106,86,86
"87405","Ntome_NODE_37170_length_307_cov_4","Nsylvestris_NODE_23295_length_873_cov_7",87.736,318,22,9,1,307,353,664,1.42e-97,355,306,311
"87406","Ntome_NODE_37171_length_307_cov_4","Nsylvestris_NODE_25875_length_725_cov_8",92.982,285,17,2,24,305,604,320,8.31e-115,412,281,284
"87407","Ntome_NODE_37172_length_307_cov_4","Nsylvestris_NODE_36316_length_266_cov_4",93.82,178,11,0,129,306,61,238,1.9e-71,268,177,177
"87408","Ntome_NODE_37173_length_307_cov_3","Nsylvestris_NODE_16659_length_1385_cov_24",90.645,310,8,5,1,307,656,947,1.08e-108,392,306,291
"87412","Ntome_NODE_37175_length_307_cov_3","Nsylvestris_NODE_25_length_11258_cov_108",82.295,305,36,7,4,307,9733,10020,2.48e-65,248,303,287
"87413","Ntome_NODE_37182_length_307_cov_2","Nsylvestris_NODE_20874_length_1037_cov_31",83.224,304,31,3,1,304,523,806,3.19e-69,261,303,283
"87423","Ntome_NODE_37189_length_306_cov_243","Nsylvestris_NODE_5519_length_2858_cov_122",96.429,224,8,0,83,306,2660,2437,5.05e-102,370,223,223
"87432","Ntome_NODE_37197_length_306_cov_6","Nsylvestris_NODE_12727_length_1793_cov_31",96.405,306,11,0,1,306,584,279,1.33e-142,505,305,305
"87435","Ntome_NODE_37200_length_306_cov_5","Nsylvestris_NODE_30387_length_495_cov_11",88.98,245,25,2,62,305,276,33,1.87e-81,302,243,243
"87436","Ntome_NODE_37202_length_306_cov_5","Nsylvestris_NODE_17120_length_1347_cov_20",86.644,292,22,3,29,306,999,1287,4.02e-83,307,277,288
"87437","Ntome_NODE_37209_length_306_cov_4","Nsylvestris_NODE_22779_length_904_cov_160",95.395,304,13,1,1,304,216,518,6.22e-136,483,303,302
"87438","Ntome_NODE_37212_length_306_cov_4","Nsylvestris_NODE_5856_length_2791_cov_50",92.982,285,20,0,4,288,1892,2176,6.4e-116,416,284,284
"87439","Ntome_NODE_37215_length_306_cov_3","Nsylvestris_NODE_8988_length_2253_cov_11",94.578,166,9,0,1,166,259,94,4.11e-68,257,165,165
"87442","Ntome_NODE_37219_length_306_cov_3","Nsylvestris_NODE_12081_length_1860_cov_149",92.222,90,6,1,216,305,919,831,1.21e-28,126,89,88
"87443","Ntome_NODE_37221_length_306_cov_3","Nsylvestris_NODE_26892_length_678_cov_52",83.333,66,11,0,237,302,273,208,3.46e-09,62.1,65,65
"87446","Ntome_NODE_37226_length_306_cov_2","Nsylvestris_NODE_11399_length_1942_cov_20",94.983,299,15,0,1,299,1614,1912,4.84e-132,470,298,298
"87449","Ntome_NODE_37229_length_305_cov_334","Nsylvestris_NODE_7883_length_2423_cov_177",94.531,256,12,1,50,305,419,672,2.99e-109,394,255,253
"87450","Ntome_NODE_37230_length_305_cov_305","Nsylvestris_NODE_9496_length_2178_cov_201",96.721,305,10,0,1,305,94,398,1.02e-143,508,304,304
"87451","Ntome_NODE_37232_length_305_cov_27","Nsylvestris_NODE_26231_length_708_cov_52",99.636,275,1,0,1,275,275,1,4.76e-142,503,274,274
"87452","Ntome_NODE_37233_length_305_cov_9","Nsylvestris_NODE_26691_length_687_cov_201",91.883,308,13,2,1,305,270,568,4.93e-117,420,304,298
"87460","Ntome_NODE_37246_length_305_cov_4","Nsylvestris_NODE_139_length_7902_cov_57",85.614,285,36,4,24,303,2686,2402,3.12e-79,294,279,284
"87461","Ntome_NODE_37250_length_305_cov_3","Nsylvestris_NODE_25228_length_759_cov_5",91.148,305,10,7,1,305,239,526,2.31e-110,398,304,287
"87462","Ntome_NODE_37252_length_305_cov_3","Nsylvestris_NODE_8133_length_2383_cov_11",89.508,305,20,4,2,305,254,547,1.08e-103,375,303,293
"87465","Ntome_NODE_37260_length_305_cov_2","Nsylvestris_NODE_26782_length_684_cov_10",97.917,48,1,0,10,57,637,684,7.35e-16,84.2,47,47
"87466","Ntome_NODE_37262_length_305_cov_1","Nsylvestris_NODE_25774_length_730_cov_9",96.405,306,10,1,1,305,320,15,4.76e-142,503,304,305
"87467","Ntome_NODE_37263_length_304_cov_298","Nsylvestris_NODE_7535_length_2479_cov_221",99.342,304,2,0,1,304,1129,1432,1.67e-156,551,303,303
"87470","Ntome_NODE_37265_length_304_cov_227","Nsylvestris_NODE_4111_length_3199_cov_196",87.407,270,18,10,48,304,2830,2564,8.64e-80,296,256,266
"87474","Ntome_NODE_37267_length_303_cov_198","Nsylvestris_NODE_3469_length_3412_cov_96",87.843,255,8,7,1,254,280,48,3.12e-74,278,253,232
"87482","Ntome_NODE_37281_length_304_cov_6","Nsylvestris_NODE_17138_length_1345_cov_27",79.139,302,54,9,1,300,435,729,6.97e-51,200,299,294
"87483","Ntome_NODE_37283_length_304_cov_5","Nsylvestris_NODE_1968_length_4073_cov_83",92.434,304,18,1,1,304,33,331,8.16e-120,429,303,298
"87487","Ntome_NODE_37285_length_304_cov_4","Nsylvestris_NODE_11504_length_1930_cov_85",92.827,237,14,2,69,304,1311,1077,3.94e-93,340,235,234
"87488","Ntome_NODE_37286_length_304_cov_4","Nsylvestris_NODE_15721_length_1478_cov_18",91.667,180,14,1,1,179,380,201,2.45e-65,248,178,179
"87489","Ntome_NODE_37287_length_304_cov_3","Nsylvestris_NODE_5565_length_2850_cov_21",98.689,305,3,1,1,304,909,605,3.61e-153,540,303,304
"87493","Ntome_NODE_37291_length_304_cov_3","Nsylvestris_NODE_5754_length_2810_cov_24",91.915,235,15,3,73,304,2529,2762,1.1e-88,326,231,233
"87494","Ntome_NODE_37292_length_304_cov_3","Nsylvestris_NODE_11627_length_1916_cov_106",96.067,178,7,0,127,304,1916,1739,4.02e-78,291,177,177
"87495","Ntome_NODE_37293_length_304_cov_3","Nsylvestris_NODE_22118_length_948_cov_15",87.869,305,26,7,1,304,402,108,2.35e-95,348,303,294
"87496","Ntome_NODE_37294_length_304_cov_3","Nsylvestris_NODE_5360_length_2895_cov_159",91.398,279,16,3,3,280,2182,2453,1.08e-103,375,277,271
"87497","Ntome_NODE_37301_length_304_cov_2","Nsylvestris_NODE_34527_length_307_cov_3",93.534,232,12,2,74,304,1,230,1.09e-93,342,230,229
"87498","Ntome_NODE_37302_length_304_cov_2","Nsylvestris_NODE_436_length_6152_cov_57",92.434,304,23,0,1,304,1413,1110,1.75e-121,435,303,303
"87499","Ntome_NODE_37303_length_304_cov_2","Nsylvestris_NODE_13257_length_1731_cov_116",92.763,304,20,2,1,303,437,739,1.36e-122,438,302,302
"87513","Ntome_NODE_37315_length_303_cov_5","Nsylvestris_NODE_5078_length_2954_cov_99",89.251,307,25,7,1,303,842,540,2.99e-104,377,302,302
"87519","Ntome_NODE_37323_length_303_cov_4","Nsylvestris_NODE_3436_length_3426_cov_141",96.949,295,9,0,9,303,1346,1640,7.91e-140,496,294,294
"87520","Ntome_NODE_37326_length_303_cov_4","Nsylvestris_NODE_18997_length_1184_cov_53",83.513,279,34,7,1,278,1085,818,6.8e-66,250,277,267
"87524","Ntome_NODE_37345_length_303_cov_2","Nsylvestris_NODE_2361_length_3867_cov_20",82.667,225,36,3,81,303,3228,3451,8.98e-50,196,222,223
"87525","Ntome_NODE_37346_length_303_cov_2","Nsylvestris_NODE_31723_length_407_cov_4",95.05,303,15,0,1,303,9,311,2.86e-134,477,302,302
"87532","Ntome_NODE_37349_length_302_cov_298","Nsylvestris_NODE_2791_length_3666_cov_87",90.909,55,5,0,1,55,566,512,4.38e-13,75,54,54
"87533","Ntome_NODE_37350_length_302_cov_245","Nsylvestris_NODE_2541_length_3773_cov_203",97.682,302,7,0,1,302,518,819,4.68e-147,520,301,301
"87541","Ntome_NODE_37354_length_302_cov_71","Nsylvestris_NODE_12403_length_1826_cov_98",98.148,54,1,0,1,54,326,273,3.36e-19,95.3,53,53
"87552","Ntome_NODE_37361_length_302_cov_6","Nsylvestris_NODE_16358_length_1414_cov_75",85.354,198,17,6,1,196,1056,1243,3.22e-49,195,195,187
"87558","Ntome_NODE_37369_length_302_cov_5","Nsylvestris_NODE_84_length_8749_cov_18",91.456,316,12,2,1,302,4360,4674,4.88e-117,420,301,314
"87559","Ntome_NODE_37371_length_302_cov_5","Nsylvestris_NODE_28567_length_603_cov_6",97.701,261,6,0,42,302,603,343,6.22e-126,449,260,260
"87560","Ntome_NODE_37375_length_302_cov_5","Nsylvestris_NODE_28235_length_618_cov_15",95.918,98,4,0,1,98,388,485,1.17e-38,159,97,97
"87561","Ntome_NODE_37376_length_302_cov_4","Nsylvestris_NODE_15768_length_1473_cov_54",91.06,302,27,0,1,302,580,881,1.06e-113,409,301,301
"87562","Ntome_NODE_37380_length_302_cov_4","Nsylvestris_NODE_7355_length_2511_cov_233",97.368,38,1,0,1,38,1514,1477,2.63e-10,65.8,37,37
"87563","Ntome_NODE_37382_length_302_cov_4","Nsylvestris_NODE_11252_length_1957_cov_5",97.682,302,7,0,1,302,1259,1560,4.68e-147,520,301,301
"87564","Ntome_NODE_37383_length_302_cov_3","Nsylvestris_NODE_36735_length_257_cov_3",96.241,133,5,0,170,302,256,124,1.91e-56,219,132,132
"87565","Ntome_NODE_37392_length_302_cov_1","Nsylvestris_NODE_7_length_13493_cov_101",90.759,303,27,1,1,302,12734,13036,4.91e-112,403,301,302
"87566","Ntome_NODE_37393_length_302_cov_1","Nsylvestris_NODE_8767_length_2285_cov_28",95.374,281,13,0,22,302,57,337,2.24e-125,448,280,280
"87567","Ntome_NODE_37394_length_302_cov_1","Nsylvestris_NODE_10817_length_2012_cov_11",95.695,302,13,0,1,302,1075,774,4.74e-137,486,301,301
"87568","Ntome_NODE_37395_length_301_cov_305","Nsylvestris_NODE_1067_length_4859_cov_230",99.003,301,3,0,1,301,2859,3159,3.58e-153,540,300,300
"87572","Ntome_NODE_37397_length_301_cov_289","Nsylvestris_NODE_1448_length_4449_cov_196",99.003,301,3,0,1,301,1545,1245,3.58e-153,540,300,300
"87573","Ntome_NODE_37398_length_301_cov_259","Nsylvestris_NODE_4032_length_3223_cov_132",96.013,301,12,0,1,301,576,876,3.65e-138,490,300,300
"87583","Ntome_NODE_37410_length_300_cov_6","Nsylvestris_NODE_36846_length_255_cov_3",88.492,252,26,3,26,275,3,253,1.83e-81,302,249,250
"87584","Ntome_NODE_37416_length_301_cov_4","Nsylvestris_NODE_6253_length_2706_cov_214",95.987,299,8,3,3,301,361,67,6.11e-136,483,298,294
"87585","Ntome_NODE_37417_length_301_cov_4","Nsylvestris_NODE_6124_length_2732_cov_131",94.276,297,14,1,6,299,2283,2579,1.72e-126,451,293,296
"87586","Ntome_NODE_37419_length_301_cov_4","Nsylvestris_NODE_1851_length_4149_cov_39",97.01,301,8,1,1,301,1782,1483,1.3e-142,505,300,299
"87587","Ntome_NODE_37429_length_301_cov_3","Nsylvestris_NODE_51_length_9473_cov_96",95.017,301,15,0,1,301,4144,4444,3.68e-133,473,300,300
"87588","Ntome_NODE_37431_length_301_cov_3","Nsylvestris_NODE_23450_length_863_cov_55",95.017,301,15,0,1,301,848,548,3.68e-133,473,300,300
"87589","Ntome_NODE_37432_length_301_cov_3","Nsylvestris_NODE_6913_length_2583_cov_141",97.619,42,1,0,97,138,2275,2234,1.57e-12,73.1,41,41
"87593","Ntome_NODE_37436_length_301_cov_3","Nsylvestris_NODE_4353_length_3139_cov_67",81.364,220,26,6,80,299,2071,1867,2.51e-40,165,219,204
"87594","Ntome_NODE_37446_length_301_cov_2","Nsylvestris_NODE_5830_length_2796_cov_14",92.691,301,11,4,1,301,1126,837,3.76e-118,424,300,289
"87607","Ntome_NODE_37453_length_300_cov_185","Nsylvestris_NODE_13195_length_1739_cov_199",92.34,235,12,3,7,236,132,365,8.4e-90,329,229,233
"87608","Ntome_NODE_37455_length_300_cov_107","Nsylvestris_NODE_10544_length_2044_cov_204",95.455,44,2,0,257,300,1928,1885,5.62e-12,71.3,43,43
"87609","Ntome_NODE_37456_length_300_cov_9","Nsylvestris_NODE_22488_length_920_cov_46",81.991,211,17,15,10,212,551,748,1.17e-38,159,202,197
"87610","Ntome_NODE_37462_length_300_cov_5","Nsylvestris_NODE_5146_length_2938_cov_39",97.333,300,8,0,1,300,1645,1944,2.79e-144,510,299,299
"87613","Ntome_NODE_37473_length_300_cov_4","Nsylvestris_NODE_13989_length_1651_cov_21",79.798,297,35,13,2,295,1190,1464,1.15e-48,193,293,274
"87616","Ntome_NODE_37480_length_300_cov_3","Nsylvestris_NODE_9743_length_2147_cov_189",95.802,262,6,5,40,299,642,900,1.74e-116,418,259,258
"87621","Ntome_NODE_37488_length_299_cov_331","Nsylvestris_NODE_23589_length_854_cov_199",95.6,250,10,1,51,299,751,502,6.29e-111,399,248,249
"87630","Ntome_NODE_37496_length_299_cov_6","Nsylvestris_NODE_10304_length_2075_cov_7",88.255,298,27,5,1,296,1052,1343,6.42e-96,350,295,291
"87633","Ntome_NODE_37501_length_299_cov_5","Nsylvestris_NODE_12615_length_1804_cov_14",88.153,287,28,5,6,288,1332,1616,5e-92,337,282,284
"87634","Ntome_NODE_37503_length_299_cov_5","Nsylvestris_NODE_1985_length_4064_cov_22",93.878,49,1,2,251,299,917,963,1.56e-12,73.1,48,46
"87635","Ntome_NODE_37508_length_299_cov_4","Nsylvestris_NODE_30030_length_525_cov_26",93.617,282,6,1,28,297,93,374,2.9e-114,411,269,281
"87636","Ntome_NODE_37509_length_299_cov_4","Nsylvestris_NODE_27279_length_661_cov_13",86.496,274,13,5,1,274,358,607,8.55e-75,279,273,249
"87637","Ntome_NODE_37510_length_299_cov_4","Nsylvestris_NODE_485_length_6003_cov_42",86,300,38,3,1,296,4229,4528,1.81e-86,318,295,299
"87638","Ntome_NODE_37514_length_299_cov_3","Nsylvestris_NODE_11767_length_1897_cov_198",81.308,214,39,1,1,213,838,625,1.49e-42,172,212,213
"87642","Ntome_NODE_37517_length_299_cov_3","Nsylvestris_NODE_1107_length_4817_cov_198",98.113,53,1,0,1,53,1339,1391,1.19e-18,93.5,52,52
"87643","Ntome_NODE_37522_length_299_cov_3","Nsylvestris_NODE_2696_length_3706_cov_98",96.358,302,8,1,1,299,2182,2483,2.8e-139,494,298,301
"87644","Ntome_NODE_37523_length_299_cov_3","Nsylvestris_NODE_19938_length_1107_cov_143",95.333,300,12,2,2,299,551,252,1.02e-133,475,297,299
"87650","Ntome_NODE_37535_length_298_cov_329","Nsylvestris_NODE_1122_length_4788_cov_207",96.98,298,9,0,1,298,3565,3862,1.67e-141,501,297,297
"87655","Ntome_NODE_37537_length_298_cov_241","Nsylvestris_NODE_2621_length_3731_cov_233",96.296,54,2,0,244,297,2070,2123,1.54e-17,89.8,53,53
"87656","Ntome_NODE_37538_length_298_cov_217","Nsylvestris_NODE_4032_length_3223_cov_132",90.336,238,10,5,63,296,4,232,6.54e-81,300,233,228
"87661","Ntome_NODE_37540_length_298_cov_88","Nsylvestris_NODE_19700_length_1127_cov_143",85.211,284,19,13,1,271,29,302,5.12e-72,270,270,273
"87666","Ntome_NODE_37545_length_298_cov_8","Nsylvestris_NODE_9495_length_2179_cov_21",95.638,298,13,0,1,298,222,519,7.82e-135,479,297,297
"87667","Ntome_NODE_37552_length_298_cov_5","Nsylvestris_NODE_2043_length_4028_cov_17",98.322,298,5,0,1,298,3013,3310,3.56e-148,523,297,297
"87670","Ntome_NODE_37554_length_298_cov_4","Nsylvestris_NODE_11059_length_1981_cov_16",94.257,296,17,0,3,298,1639,1934,4.74e-127,453,295,295
"87674","Ntome_NODE_37557_length_298_cov_4","Nsylvestris_NODE_825_length_5205_cov_125",97.778,45,1,0,254,298,4179,4223,3.33e-14,78.7,44,44
"87679","Ntome_NODE_37560_length_299_cov_4","Nsylvestris_NODE_113_length_8253_cov_73",86.096,187,16,6,113,298,7916,7739,1.15e-48,193,185,177
"87680","Ntome_NODE_37567_length_298_cov_3","Nsylvestris_NODE_13598_length_1696_cov_169",100,31,0,0,1,31,586,616,4.34e-08,58.4,30,30
"87684","Ntome_NODE_37571_length_298_cov_3","Nsylvestris_NODE_22421_length_927_cov_14",92.017,238,16,2,61,298,395,161,2.32e-90,331,237,234
"87685","Ntome_NODE_37578_length_298_cov_2","Nsylvestris_NODE_13369_length_1721_cov_9",90.123,81,8,0,150,230,894,974,1.53e-22,106,80,80
"87686","Ntome_NODE_37580_length_298_cov_2","Nsylvestris_NODE_1544_length_4363_cov_62",94.333,300,14,2,1,298,661,959,3.66e-128,457,297,298
"87687","Ntome_NODE_37582_length_297_cov_317","Nsylvestris_NODE_11253_length_1956_cov_223",92.23,296,15,4,2,297,1189,902,8.02e-115,412,295,287
"87699","Ntome_NODE_37587_length_296_cov_176","Nsylvestris_NODE_18264_length_1244_cov_185",94.483,290,11,2,3,288,344,56,1.02e-123,442,285,288
"87706","Ntome_NODE_37593_length_297_cov_8","Nsylvestris_NODE_12163_length_1852_cov_11",81.974,233,37,4,67,294,991,1223,1.14e-48,193,227,232
"87707","Ntome_NODE_37599_length_297_cov_7","Nsylvestris_NODE_11635_length_1915_cov_17",96.183,131,5,0,1,131,482,352,2.43e-55,215,130,130
"87708","Ntome_NODE_37605_length_297_cov_6","Nsylvestris_NODE_20249_length_1083_cov_7",84.513,226,34,1,1,226,242,18,1.45e-57,222,225,224
"87709","Ntome_NODE_37608_length_297_cov_5","Nsylvestris_NODE_9220_length_2220_cov_162",96.633,297,8,1,1,297,464,170,1e-138,492,296,294
"87712","Ntome_NODE_37620_length_281_cov_3","Nsylvestris_NODE_32821_length_359_cov_18",97.826,46,1,0,223,268,224,269,8.69e-15,80.5,45,45
"87713","Ntome_NODE_37624_length_297_cov_2","Nsylvestris_NODE_2107_length_3991_cov_37",81.743,241,33,2,1,240,224,454,4.09e-48,191,239,230
"87714","Ntome_NODE_37626_length_297_cov_2","Nsylvestris_NODE_3656_length_3349_cov_127",89.597,298,27,4,1,296,2426,2131,1.05e-103,375,295,295
"87715","Ntome_NODE_37628_length_297_cov_2","Nsylvestris_NODE_3881_length_3273_cov_184",86.395,294,36,3,6,297,598,307,1.8e-86,318,291,291
"87718","Ntome_NODE_37631_length_296_cov_270","Nsylvestris_NODE_14783_length_1571_cov_170",98.986,296,3,0,1,296,1120,825,2.11e-150,531,295,295
"87722","Ntome_NODE_37633_length_296_cov_246","Nsylvestris_NODE_14234_length_1625_cov_218",96.296,54,2,0,1,54,1431,1484,1.53e-17,89.8,53,53
"87723","Ntome_NODE_37634_length_296_cov_226","Nsylvestris_NODE_4804_length_3021_cov_114",95.436,241,11,0,56,296,2884,2644,1.74e-106,385,240,240
"87733","Ntome_NODE_37640_length_296_cov_7","Nsylvestris_NODE_10927_length_1997_cov_48",91.321,265,23,0,1,265,367,631,8.16e-100,363,264,264
"87734","Ntome_NODE_37641_length_296_cov_6","Nsylvestris_NODE_31142_length_442_cov_10",97.865,281,6,0,1,281,281,1,1.29e-137,488,280,280
"87735","Ntome_NODE_37642_length_296_cov_6","Nsylvestris_NODE_8792_length_2281_cov_18",91.639,299,22,1,1,296,1713,1415,2.87e-114,411,295,298
"87736","Ntome_NODE_37647_length_296_cov_5","Nsylvestris_NODE_33508_length_336_cov_6",94.366,213,12,0,84,296,246,34,2.98e-89,327,212,212
"87737","Ntome_NODE_37648_length_296_cov_5","Nsylvestris_NODE_17668_length_1297_cov_87",89.455,275,23,1,1,269,728,454,1.06e-93,342,268,274
"87738","Ntome_NODE_37650_length_296_cov_4","Nsylvestris_NODE_11208_length_1962_cov_13",97.297,296,8,0,1,296,1294,999,4.61e-142,503,295,295
"87739","Ntome_NODE_37653_length_296_cov_4","Nsylvestris_NODE_31867_length_400_cov_5",89.562,297,14,2,1,296,88,368,2.93e-99,361,295,280
"87740","Ntome_NODE_37656_length_296_cov_4","Nsylvestris_NODE_8190_length_2373_cov_40",84.797,296,45,0,1,296,2104,1809,2.33e-80,298,295,295
"87741","Ntome_NODE_37657_length_296_cov_4","Nsylvestris_NODE_6256_length_2706_cov_34",95.798,119,5,0,39,157,1270,1152,1.13e-48,193,118,118
"87744","Ntome_NODE_37660_length_296_cov_3","Nsylvestris_NODE_4185_length_3180_cov_37",95.27,296,14,0,1,296,1428,1133,4.67e-132,470,295,295
"87752","Ntome_NODE_37668_length_295_cov_355","Nsylvestris_NODE_2859_length_3635_cov_226",92.105,266,12,1,39,295,3580,3315,6.28e-101,366,256,265
"87755","Ntome_NODE_37670_length_295_cov_206","Nsylvestris_NODE_17452_length_1318_cov_142",86.111,252,17,7,47,295,24,260,1.42e-67,255,248,236
"87756","Ntome_NODE_37671_length_295_cov_11","Nsylvestris_NODE_7044_length_2562_cov_206",89.868,227,21,1,21,247,1370,1594,3.89e-78,291,226,224
"87760","Ntome_NODE_37674_length_295_cov_9","Nsylvestris_NODE_5972_length_2766_cov_108",93.452,168,8,2,1,167,500,335,8.54e-65,246,166,165
"87766","Ntome_NODE_37688_length_295_cov_4","Nsylvestris_NODE_16131_length_1435_cov_45",88.028,142,16,1,65,205,261,402,6.84e-41,167,140,141
"87767","Ntome_NODE_37689_length_295_cov_4","Nsylvestris_NODE_20976_length_1030_cov_9",88.39,267,20,3,11,270,325,587,2.99e-84,311,259,262
"87768","Ntome_NODE_37693_length_295_cov_4","Nsylvestris_NODE_16616_length_1390_cov_92",97.966,295,6,0,1,295,743,449,7.63e-145,512,294,294
"87769","Ntome_NODE_37694_length_295_cov_3","Nsylvestris_NODE_25565_length_741_cov_8",90.268,298,22,5,1,295,382,675,6.24e-106,383,294,293
"87770","Ntome_NODE_37699_length_295_cov_3","Nsylvestris_NODE_25871_length_725_cov_12",96.61,295,10,0,1,295,209,503,3.57e-138,490,294,294
"87771","Ntome_NODE_37701_length_295_cov_3","Nsylvestris_NODE_979_length_4980_cov_201",87.458,295,31,3,6,295,2300,2593,1.77e-91,335,289,293
"87772","Ntome_NODE_37702_length_295_cov_3","Nsylvestris_NODE_29547_length_561_cov_52",91.892,296,15,6,1,295,83,370,1.33e-112,405,294,287
"87773","Ntome_NODE_37703_length_295_cov_3","Nsylvestris_NODE_2632_length_3729_cov_34",98.276,58,1,0,238,295,884,941,1.96e-21,102,57,57
"87774","Ntome_NODE_37704_length_295_cov_3","Nsylvestris_NODE_962_length_5000_cov_62",96.271,295,11,0,1,295,3059,2765,1.66e-136,484,294,294
"87775","Ntome_NODE_37706_length_295_cov_2","Nsylvestris_NODE_5465_length_2870_cov_174",86.038,265,19,13,40,295,1024,1279,1.82e-71,268,255,255
"87781","Ntome_NODE_37714_length_294_cov_344","Nsylvestris_NODE_854_length_5156_cov_216",88.525,305,20,7,1,293,2999,3300,1.36e-97,355,292,301
"87793","Ntome_NODE_37719_length_294_cov_204","Nsylvestris_NODE_13448_length_1712_cov_184",88.197,305,13,10,1,294,1667,1375,1.06e-93,342,293,292
"87796","Ntome_NODE_37723_length_294_cov_86","Nsylvestris_NODE_15286_length_1522_cov_185",86.885,122,5,5,6,126,1308,1419,1.16e-28,126,120,111
"87797","Ntome_NODE_37724_length_294_cov_9","Nsylvestris_NODE_36579_length_260_cov_6",93.75,256,16,0,38,293,257,2,1.73e-106,385,255,255
"87798","Ntome_NODE_37728_length_294_cov_7","Nsylvestris_NODE_14740_length_1575_cov_216",83.036,112,15,4,131,240,267,158,2.52e-20,99,109,109
"87799","Ntome_NODE_37731_length_294_cov_5","Nsylvestris_NODE_9469_length_2182_cov_207",78.113,265,58,0,12,276,1951,1687,1.89e-41,169,264,264
"87808","Ntome_NODE_37742_length_294_cov_4","Nsylvestris_NODE_10153_length_2095_cov_56",95.876,291,8,1,1,291,1710,1996,1.67e-131,468,290,286
"87809","Ntome_NODE_37747_length_294_cov_3","Nsylvestris_NODE_1261_length_4629_cov_84",98.98,294,3,0,1,294,2813,2520,2.71e-149,527,293,293
"87810","Ntome_NODE_37751_length_294_cov_3","Nsylvestris_NODE_1011_length_4932_cov_20",88.406,276,30,2,1,274,1450,1175,2.28e-90,331,273,275
"87813","Ntome_NODE_37755_length_294_cov_3","Nsylvestris_NODE_9380_length_2196_cov_222",88.496,113,10,3,1,113,1262,1371,6.91e-31,134,112,109
"87817","Ntome_NODE_37764_length_293_cov_248","Nsylvestris_NODE_22377_length_931_cov_10",90.514,253,17,1,41,293,931,686,2.94e-89,327,252,245
"87818","Ntome_NODE_37765_length_293_cov_120","Nsylvestris_NODE_9735_length_2149_cov_95",88.837,215,19,3,83,293,2029,1816,1.09e-68,259,210,213
"87819","Ntome_NODE_37766_length_293_cov_45","Nsylvestris_NODE_10321_length_2072_cov_207",89.565,230,17,6,7,232,1768,1994,1.8e-76,285,225,226
"87820","Ntome_NODE_37774_length_293_cov_5","Nsylvestris_NODE_15864_length_1463_cov_10",98.635,293,4,0,1,293,1160,1452,4.52e-147,520,292,292
"87821","Ntome_NODE_37776_length_293_cov_5","Nsylvestris_NODE_14060_length_1644_cov_83",87.931,290,35,0,1,290,676,387,1.05e-93,342,289,289
"87822","Ntome_NODE_37782_length_293_cov_4","Nsylvestris_NODE_27105_length_669_cov_5",95.489,266,11,1,28,292,311,46,3.65e-118,424,264,265
"87823","Ntome_NODE_37788_length_293_cov_4","Nsylvestris_NODE_4552_length_3085_cov_205",91.489,47,3,1,247,293,2259,2304,9.16e-10,63.9,46,45
"87824","Ntome_NODE_37789_length_293_cov_4","Nsylvestris_NODE_2146_length_3966_cov_119",85.959,292,33,4,8,291,1786,1495,1.38e-82,305,283,291
"87827","Ntome_NODE_37795_length_293_cov_3","Nsylvestris_NODE_16477_length_1402_cov_9",95.563,293,10,2,4,293,223,515,5.98e-131,466,289,292
"87828","Ntome_NODE_37799_length_293_cov_3","Nsylvestris_NODE_3490_length_3404_cov_91",88.312,231,19,5,52,281,2499,2722,5.03e-72,270,229,223
"87829","Ntome_NODE_37806_length_293_cov_3","Nsylvestris_NODE_13697_length_1685_cov_128",86.525,282,33,3,4,284,56,333,1.38e-82,305,280,277
"87830","Ntome_NODE_37807_length_293_cov_3","Nsylvestris_NODE_10656_length_2031_cov_99",92.308,299,17,3,1,293,1978,1680,4.72e-117,420,292,298
"87833","Ntome_NODE_37814_length_292_cov_27","Nsylvestris_NODE_34375_length_311_cov_5",88.406,69,7,1,220,288,234,167,2.52e-15,82.4,68,67
"87841","Ntome_NODE_37830_length_292_cov_4","Nsylvestris_NODE_17557_length_1308_cov_8",95.804,286,11,1,7,292,1110,826,2.77e-129,460,285,284
"87844","Ntome_NODE_37834_length_292_cov_4","Nsylvestris_NODE_33428_length_338_cov_10",93.893,262,9,1,28,289,3,257,1.33e-107,388,261,254
"87847","Ntome_NODE_37841_length_292_cov_4","Nsylvestris_NODE_32912_length_356_cov_4",92.466,292,15,1,1,292,18,302,2.83e-114,411,291,284
"87848","Ntome_NODE_37842_length_292_cov_3","Nsylvestris_NODE_14299_length_1621_cov_75",95.89,292,12,0,1,292,1123,1414,3.56e-133,473,291,291
"87849","Ntome_NODE_37846_length_296_cov_3","Nsylvestris_NODE_17460_length_1316_cov_130",90.909,154,9,3,125,278,149,1,1.88e-51,202,153,148
"87850","Ntome_NODE_37848_length_292_cov_3","Nsylvestris_NODE_1124_length_4787_cov_79",96.319,163,6,0,130,292,109,271,1.8e-71,268,162,162
"87856","Ntome_NODE_37857_length_291_cov_283","Nsylvestris_NODE_12056_length_1863_cov_179",94.502,291,16,0,1,291,1741,1451,5.98e-126,449,290,290
"87875","Ntome_NODE_37864_length_291_cov_8","Nsylvestris_NODE_30595_length_479_cov_8",93.559,295,14,4,1,291,186,479,1.67e-121,435,290,293
"87879","Ntome_NODE_37869_length_291_cov_6","Nsylvestris_NODE_21480_length_993_cov_16",90.123,162,8,1,1,154,797,958,5.14e-52,204,153,161
"87880","Ntome_NODE_37870_length_291_cov_6","Nsylvestris_NODE_20315_length_1076_cov_205",100,291,0,0,1,291,676,966,1.24e-152,538,290,290
"87881","Ntome_NODE_37881_length_291_cov_4","Nsylvestris_NODE_11524_length_1927_cov_120",92.784,291,15,3,1,285,1433,1723,6.06e-116,416,284,290
"87884","Ntome_NODE_37884_length_291_cov_3","Nsylvestris_NODE_1009_length_4937_cov_50",77.376,221,46,4,66,284,3161,3379,3.18e-29,128,218,218
"87888","Ntome_NODE_37892_length_291_cov_2","Nsylvestris_NODE_1726_length_4230_cov_53",92.5,80,6,0,28,107,2214,2293,2.48e-25,115,79,79
"87889","Ntome_NODE_37893_length_290_cov_300","Nsylvestris_NODE_4885_length_2999_cov_182",92.568,148,8,1,143,290,123,267,1.1e-53,209,147,144
"87890","Ntome_NODE_37894_length_290_cov_239","Nsylvestris_NODE_10176_length_2091_cov_225",90.58,276,14,6,1,268,1820,2091,1.34e-97,355,267,271
"87891","Ntome_NODE_37895_length_290_cov_221","Nsylvestris_NODE_10843_length_2008_cov_213",93.023,172,11,1,67,238,1863,1693,6.48e-66,250,171,170
"87898","Ntome_NODE_37900_length_290_cov_65","Nsylvestris_NODE_18953_length_1187_cov_144",86,300,21,10,10,290,298,1,1.76e-81,302,280,297
"87899","Ntome_NODE_37903_length_290_cov_8","Nsylvestris_NODE_17636_length_1299_cov_208",100,40,0,0,251,290,871,910,4.19e-13,75,39,39
"87900","Ntome_NODE_37905_length_290_cov_7","Nsylvestris_NODE_24008_length_832_cov_7",93.284,268,18,0,1,268,351,84,7.87e-110,396,267,267
"87901","Ntome_NODE_37907_length_290_cov_6","Nsylvestris_NODE_20010_length_1102_cov_68",96.552,290,10,0,1,290,208,497,2.11e-135,481,289,289
"87905","Ntome_NODE_37909_length_290_cov_6","Nsylvestris_NODE_35291_length_285_cov_17",93.357,286,16,1,5,290,285,3,4.67e-117,420,285,282
"87906","Ntome_NODE_37910_length_290_cov_5","Nsylvestris_NODE_237_length_7070_cov_115",95.96,297,4,2,1,290,2718,2423,9.82e-134,475,289,295
"87909","Ntome_NODE_37917_length_290_cov_4","Nsylvestris_NODE_32080_length_390_cov_165",96.587,293,7,2,1,290,70,362,5.87e-136,483,289,292
"87910","Ntome_NODE_37918_length_290_cov_4","Nsylvestris_NODE_9430_length_2189_cov_23",95.862,290,12,0,1,290,1780,1491,4.57e-132,470,289,289
"87911","Ntome_NODE_37919_length_290_cov_4","Nsylvestris_NODE_441_length_6140_cov_71",91.753,291,23,1,1,290,3964,3674,4.7e-112,403,289,290
"87914","Ntome_NODE_37928_length_290_cov_3","Nsylvestris_NODE_15768_length_1473_cov_54",95.122,287,14,0,1,287,362,76,4.6e-127,453,286,286
"87915","Ntome_NODE_37931_length_290_cov_3","Nsylvestris_NODE_14602_length_1588_cov_19",89.865,296,22,3,1,288,896,601,3.69e-103,374,287,295
"87916","Ntome_NODE_37937_length_289_cov_2","Nsylvestris_NODE_26402_length_700_cov_61",76.404,178,28,12,18,187,463,634,6.93e-16,84.2,169,171
"87921","Ntome_NODE_37941_length_289_cov_43","Nsylvestris_NODE_32895_length_356_cov_51",92.347,196,13,2,36,230,25,219,2.96e-74,278,194,194
"87926","Ntome_NODE_37944_length_289_cov_12","Nsylvestris_NODE_25423_length_748_cov_12",89.153,295,18,6,1,289,509,223,1.33e-97,355,288,286
"87927","Ntome_NODE_37945_length_289_cov_9","Nsylvestris_NODE_29957_length_532_cov_2",91.63,227,13,3,65,289,532,310,1.05e-83,309,224,222
"87928","Ntome_NODE_37951_length_289_cov_5","Nsylvestris_NODE_18697_length_1209_cov_175",91.781,292,18,5,3,289,1153,863,1.68e-111,401,286,290
"87929","Ntome_NODE_37953_length_289_cov_5","Nsylvestris_NODE_3200_length_3506_cov_27",96.194,289,11,0,1,289,1330,1042,3.52e-133,473,288,288
"87930","Ntome_NODE_37959_length_289_cov_4","Nsylvestris_NODE_1603_length_4326_cov_45",97.232,289,8,0,1,289,3544,3256,3.49e-138,490,288,288
"87933","Ntome_NODE_37963_length_289_cov_4","Nsylvestris_NODE_21275_length_1009_cov_5",91.623,191,5,2,1,187,764,947,4.99e-67,254,186,183
"87934","Ntome_NODE_37964_length_289_cov_4","Nsylvestris_NODE_1087_length_4831_cov_201",97.826,46,1,0,1,46,1289,1244,2.49e-15,82.4,45,45
"87935","Ntome_NODE_37966_length_289_cov_3","Nsylvestris_NODE_3207_length_3505_cov_86",92.143,280,17,3,2,278,1485,1762,3.65e-108,390,276,277
"87936","Ntome_NODE_37967_length_289_cov_3","Nsylvestris_NODE_1043_length_4887_cov_110",91.45,269,20,2,24,289,3966,4234,6.14e-101,366,265,268
"87937","Ntome_NODE_37972_length_289_cov_3","Nsylvestris_NODE_11891_length_1881_cov_84",92.653,245,7,3,32,275,801,567,1.04e-93,342,243,234
"87938","Ntome_NODE_37975_length_289_cov_3","Nsylvestris_NODE_19517_length_1142_cov_11",94.118,289,10,1,1,289,135,416,5.97e-121,433,288,281
"87939","Ntome_NODE_37976_length_289_cov_2","Nsylvestris_NODE_34626_length_304_cov_7",88.889,135,13,2,1,133,135,1,2.41e-40,165,132,134
"87947","Ntome_NODE_37982_length_288_cov_330","Nsylvestris_NODE_74_length_8919_cov_185",99.653,288,1,0,1,288,3678,3965,2.65e-149,527,287,287
"87980","Ntome_NODE_38002_length_288_cov_5","Nsylvestris_NODE_32349_length_379_cov_3",97.569,288,7,0,1,288,363,76,2.69e-139,494,287,287
"87981","Ntome_NODE_38003_length_288_cov_5","Nsylvestris_NODE_26849_length_681_cov_5",88.591,298,21,5,1,288,329,623,6.16e-96,350,287,294
"87982","Ntome_NODE_38004_length_288_cov_5","Nsylvestris_NODE_363_length_6429_cov_141",89.937,159,13,2,129,286,5007,5163,1.83e-51,202,157,156
"87986","Ntome_NODE_38011_length_288_cov_4","Nsylvestris_NODE_27637_length_645_cov_5",96.596,235,8,0,7,241,1,235,3.63e-108,390,234,234
"87987","Ntome_NODE_38012_length_288_cov_4","Nsylvestris_NODE_35730_length_279_cov_3",97.512,201,5,0,1,201,71,271,2.87e-94,344,200,200
"87988","Ntome_NODE_38015_length_288_cov_4","Nsylvestris_NODE_31170_length_440_cov_37",95.918,196,5,2,91,283,440,245,2.25e-85,315,192,195
"87989","Ntome_NODE_38021_length_288_cov_3","Nsylvestris_NODE_28321_length_613_cov_22",100,288,0,0,1,288,26,313,5.7e-151,532,287,287
"87994","Ntome_NODE_38029_length_288_cov_3","Nsylvestris_NODE_2869_length_3632_cov_116",87.5,288,25,4,2,288,2397,2120,1.34e-87,322,286,277
"87995","Ntome_NODE_38030_length_288_cov_3","Nsylvestris_NODE_25433_length_747_cov_56",94.595,222,11,1,63,283,727,506,1.03e-93,342,220,221
"87996","Ntome_NODE_38033_length_288_cov_2","Nsylvestris_NODE_30991_length_452_cov_9",87.762,286,35,0,1,286,8,293,1.73e-91,335,285,285
"87997","Ntome_NODE_38035_length_288_cov_2","Nsylvestris_NODE_4185_length_3180_cov_37",96.528,288,10,0,1,288,811,524,2.71e-134,477,287,287
"88005","Ntome_NODE_38039_length_287_cov_76","Nsylvestris_NODE_14441_length_1606_cov_150",89.381,226,17,4,62,287,974,1192,2.94e-74,278,225,218
"88008","Ntome_NODE_38041_length_287_cov_8","Nsylvestris_NODE_30240_length_505_cov_3",94.017,234,7,1,1,234,279,505,2.21e-95,348,233,226
"88016","Ntome_NODE_38053_length_287_cov_4","Nsylvestris_NODE_33530_length_336_cov_3",76.071,280,29,19,26,282,314,50,3.15e-24,111,256,264
"88019","Ntome_NODE_38069_length_287_cov_3","Nsylvestris_NODE_51_length_9473_cov_96",99.303,287,2,0,1,287,7154,6868,4.42e-147,520,286,286
"88023","Ntome_NODE_38077_length_287_cov_1","Nsylvestris_NODE_20003_length_1102_cov_217",94.656,262,14,0,1,262,357,618,3.59e-113,407,261,261
"88024","Ntome_NODE_38078_length_287_cov_1","Nsylvestris_NODE_7354_length_2512_cov_26",98.258,287,5,0,1,287,1542,1828,4.45e-142,503,286,286
"88028","Ntome_NODE_38080_length_286_cov_205","Nsylvestris_NODE_9952_length_2120_cov_230",96.853,286,9,0,1,286,566,281,7.48e-135,479,285,285
"88031","Ntome_NODE_38082_length_286_cov_35","Nsylvestris_NODE_14740_length_1575_cov_216",76.754,228,43,8,21,244,195,416,1.88e-26,119,223,221
"88032","Ntome_NODE_38083_length_288_cov_19","Nsylvestris_NODE_3195_length_3508_cov_113",100,288,0,0,1,288,554,267,5.7e-151,532,287,287
"88033","Ntome_NODE_38084_length_286_cov_10","Nsylvestris_NODE_279_length_6819_cov_155",81.818,132,17,3,116,242,299,170,5.26e-22,104,126,129
"88039","Ntome_NODE_38091_length_287_cov_6","Nsylvestris_NODE_8132_length_2383_cov_14",89.967,299,16,6,1,287,1159,863,3.64e-103,374,286,296
"88040","Ntome_NODE_38093_length_286_cov_6","Nsylvestris_NODE_235_length_7074_cov_155",98.182,55,1,0,232,286,3155,3101,8.8e-20,97.1,54,54
"88041","Ntome_NODE_38095_length_286_cov_5","Nsylvestris_NODE_17523_length_1311_cov_53",93.471,291,11,3,1,286,1102,815,9.88e-119,425,285,287
"88047","Ntome_NODE_38101_length_286_cov_4","Nsylvestris_NODE_5891_length_2786_cov_191",95.652,207,9,0,77,283,2291,2497,6.16e-91,333,206,206
"88051","Ntome_NODE_38106_length_286_cov_4","Nsylvestris_NODE_1870_length_4136_cov_184",88.112,286,32,2,1,286,30,313,1.32e-92,339,285,283
"88054","Ntome_NODE_38111_length_286_cov_4","Nsylvestris_NODE_451_length_6105_cov_57",85.366,123,17,1,128,250,1731,1610,1.12e-28,126,122,121
"88055","Ntome_NODE_38112_length_286_cov_4","Nsylvestris_NODE_7119_length_2550_cov_83",88.755,249,10,7,1,243,420,184,1.35e-77,289,242,236
"88059","Ntome_NODE_38120_length_286_cov_3","Nsylvestris_NODE_923_length_5059_cov_127",87.097,93,10,1,126,216,1484,1576,5.26e-22,104,90,92
"88060","Ntome_NODE_38122_length_286_cov_3","Nsylvestris_NODE_36285_length_267_cov_2",97.872,47,1,0,164,210,49,3,2.46e-15,82.4,46,46
"88061","Ntome_NODE_38123_length_286_cov_3","Nsylvestris_NODE_18014_length_1267_cov_8",94.715,246,11,2,1,245,306,550,2.17e-105,381,244,244
"88065","Ntome_NODE_38133_length_285_cov_323","Nsylvestris_NODE_3624_length_3357_cov_173",92.982,285,20,0,1,285,842,558,5.92e-116,416,284,284
"88066","Ntome_NODE_38134_length_285_cov_318","Nsylvestris_NODE_8181_length_2374_cov_77",93.21,162,11,0,124,285,1693,1532,1.38e-62,239,161,161
"88067","Ntome_NODE_38135_length_285_cov_296","Nsylvestris_NODE_14234_length_1625_cov_218",97.203,286,7,1,1,285,370,655,5.76e-136,483,284,285
"88068","Ntome_NODE_38136_length_285_cov_285","Nsylvestris_NODE_21286_length_1007_cov_229",91.93,285,5,1,1,285,686,952,6.01e-106,383,284,266
"88073","Ntome_NODE_38139_length_285_cov_192","Nsylvestris_NODE_4021_length_3227_cov_68",96.491,285,10,0,1,285,2167,1883,1.25e-132,472,284,284
"88074","Ntome_NODE_38140_length_285_cov_177","Nsylvestris_NODE_20798_length_1043_cov_183",97.656,128,3,0,1,128,174,47,4.99e-57,220,127,127
"88075","Ntome_NODE_38141_length_285_cov_175","Nsylvestris_NODE_9955_length_2121_cov_172",89.634,164,13,4,109,271,1883,2043,1.4e-52,206,162,160
"88076","Ntome_NODE_38142_length_285_cov_134","Nsylvestris_NODE_11547_length_1924_cov_221",92.708,288,13,4,1,281,287,1,9.91e-114,409,280,286
"88077","Ntome_NODE_38144_length_285_cov_19","Nsylvestris_NODE_2152_length_3963_cov_52",94.521,219,12,0,1,219,410,192,1.32e-92,339,218,218
"88078","Ntome_NODE_38147_length_285_cov_7","Nsylvestris_NODE_3638_length_3354_cov_41",99.298,285,2,0,1,285,1001,1285,5.68e-146,516,284,284
"88079","Ntome_NODE_38150_length_285_cov_6","Nsylvestris_NODE_26983_length_674_cov_8",89.697,165,12,2,40,201,163,1,1.4e-52,206,161,162
"88080","Ntome_NODE_38153_length_285_cov_5","Nsylvestris_NODE_3852_length_3284_cov_31",89.695,262,26,1,1,262,1715,1975,6.14e-91,333,261,260
"88083","Ntome_NODE_38157_length_285_cov_4","Nsylvestris_NODE_13423_length_1715_cov_69",96.853,286,8,1,1,285,322,607,2.68e-134,477,284,285
"88084","Ntome_NODE_38159_length_285_cov_4","Nsylvestris_NODE_23785_length_844_cov_7",89.597,298,12,10,1,279,440,737,2.82e-99,361,278,297
"88087","Ntome_NODE_38173_length_285_cov_3","Nsylvestris_NODE_4220_length_3171_cov_154",90,290,15,2,1,285,1533,1253,7.83e-100,363,284,280
"88088","Ntome_NODE_38175_length_285_cov_3","Nsylvestris_NODE_825_length_5205_cov_125",96.853,286,8,1,1,285,1963,1678,2.68e-134,477,284,285
"88091","Ntome_NODE_38184_length_285_cov_3","Nsylvestris_NODE_18665_length_1212_cov_43",96.491,285,10,0,1,285,287,571,1.25e-132,472,284,284
"88092","Ntome_NODE_38193_length_285_cov_2","Nsylvestris_NODE_4295_length_3152_cov_16",86.806,288,33,5,1,285,773,1058,6.18e-86,316,284,285
"88093","Ntome_NODE_38195_length_284_cov_278","Nsylvestris_NODE_881_length_5109_cov_127",94.828,290,9,1,1,284,2092,1803,2.09e-125,448,283,289
"88104","Ntome_NODE_38201_length_284_cov_174","Nsylvestris_NODE_6739_length_2615_cov_226",93.13,131,8,1,155,284,52,182,3.89e-48,191,129,130
"88107","Ntome_NODE_38203_length_284_cov_102","Nsylvestris_NODE_5914_length_2779_cov_116",88.104,269,8,8,1,267,2501,2747,2.23e-80,298,266,246
"88108","Ntome_NODE_38205_length_284_cov_10","Nsylvestris_NODE_29606_length_559_cov_9",89.091,55,5,1,94,148,268,321,6.85e-11,67.6,54,53
"88109","Ntome_NODE_38208_length_284_cov_7","Nsylvestris_NODE_8375_length_2343_cov_163",95.437,263,12,0,22,284,1429,1691,4.56e-117,420,262,262
"88113","Ntome_NODE_38221_length_284_cov_4","Nsylvestris_NODE_27900_length_633_cov_7",91.544,272,20,1,1,269,1,272,1.3e-102,372,268,271
"88114","Ntome_NODE_38224_length_284_cov_4","Nsylvestris_NODE_1902_length_4114_cov_132",97.917,48,1,0,222,269,3280,3327,6.8e-16,84.2,47,47
"88115","Ntome_NODE_38225_length_284_cov_4","Nsylvestris_NODE_15049_length_1546_cov_180",93.208,265,15,1,23,284,624,360,4.63e-107,387,261,264
"88116","Ntome_NODE_38233_length_284_cov_3","Nsylvestris_NODE_4311_length_3147_cov_148",88.849,278,28,1,5,282,2870,3144,1.31e-92,339,277,274
"88117","Ntome_NODE_38234_length_284_cov_3","Nsylvestris_NODE_19020_length_1182_cov_128",94.737,38,2,0,25,62,889,926,1.15e-08,60.2,37,37
"88118","Ntome_NODE_38237_length_284_cov_3","Nsylvestris_NODE_32051_length_392_cov_3",87.814,279,11,11,12,284,32,293,1.33e-82,305,272,261
"88119","Ntome_NODE_38238_length_284_cov_3","Nsylvestris_NODE_10297_length_2075_cov_194",100,284,0,0,1,284,1303,1586,9.4e-149,525,283,283
"88120","Ntome_NODE_38239_length_284_cov_3","Nsylvestris_NODE_14012_length_1648_cov_10",92.166,217,8,1,64,280,1575,1368,2.23e-80,298,216,207
"88121","Ntome_NODE_38245_length_284_cov_2","Nsylvestris_NODE_15512_length_1501_cov_13",91.235,251,16,2,40,284,1234,1484,4.73e-92,337,244,250
"88125","Ntome_NODE_38247_length_283_cov_162","Nsylvestris_NODE_4519_length_3095_cov_199",89.216,204,11,4,81,283,3043,2850,2.94e-64,244,202,193
"88126","Ntome_NODE_38250_length_283_cov_5","Nsylvestris_NODE_2143_length_3968_cov_78",97.535,284,6,1,1,283,1797,1514,1.59e-136,484,282,283
"88127","Ntome_NODE_38251_length_283_cov_5","Nsylvestris_NODE_4598_length_3074_cov_56",96.82,283,9,0,1,283,1876,1594,3.44e-133,473,282,282
"88130","Ntome_NODE_38256_length_283_cov_4","Nsylvestris_NODE_8626_length_2306_cov_35",97.509,281,7,0,3,283,1238,958,2.06e-135,481,280,280
"88131","Ntome_NODE_38257_length_284_cov_4","Nsylvestris_NODE_20235_length_1083_cov_197",92.982,57,4,0,144,200,620,676,6.8e-16,84.2,56,56
"88132","Ntome_NODE_38265_length_283_cov_3","Nsylvestris_NODE_31997_length_394_cov_5",93.902,246,14,1,1,246,265,21,4.64e-102,370,245,244
"88133","Ntome_NODE_38267_length_283_cov_3","Nsylvestris_NODE_12504_length_1811_cov_8",89.119,193,14,3,95,283,619,430,6.36e-61,233,188,189
"88142","Ntome_NODE_38282_length_282_cov_317","Nsylvestris_NODE_19381_length_1153_cov_149",98.936,282,3,0,1,282,892,611,1.22e-142,505,281,281
"88143","Ntome_NODE_38283_length_282_cov_312","Nsylvestris_NODE_2470_length_3807_cov_226",96.809,282,9,0,1,282,2675,2394,1.23e-132,472,281,281
"88155","Ntome_NODE_38288_length_282_cov_174","Nsylvestris_NODE_23219_length_877_cov_207",95.902,244,10,0,1,244,611,854,7.63e-110,396,243,243
"88158","Ntome_NODE_38291_length_282_cov_30","Nsylvestris_NODE_599_length_5708_cov_168",89.615,260,17,5,27,279,3039,3295,1.31e-87,322,252,256
"88159","Ntome_NODE_38293_length_282_cov_7","Nsylvestris_NODE_10106_length_2102_cov_125",100,43,0,0,240,282,898,856,8.73e-15,80.5,42,42
"88160","Ntome_NODE_38298_length_282_cov_5","Nsylvestris_NODE_32255_length_383_cov_6",93.19,279,16,2,1,279,87,362,3.52e-113,407,278,275
"88161","Ntome_NODE_38304_length_282_cov_4","Nsylvestris_NODE_28348_length_612_cov_13",92.334,287,17,2,1,282,142,428,4.56e-112,403,281,286
"88162","Ntome_NODE_38306_length_282_cov_4","Nsylvestris_NODE_23355_length_869_cov_44",96.774,279,9,0,1,279,229,507,5.73e-131,466,278,278
"88163","Ntome_NODE_38310_length_282_cov_4","Nsylvestris_NODE_2555_length_3767_cov_116",90.625,256,16,5,1,250,655,908,6.07e-91,333,249,253
"88164","Ntome_NODE_38313_length_282_cov_3","Nsylvestris_NODE_8316_length_2353_cov_172",98.81,168,1,1,115,282,956,790,2.21e-80,298,167,166
"88165","Ntome_NODE_38314_length_282_cov_3","Nsylvestris_NODE_17595_length_1304_cov_37",92.908,282,11,3,4,282,452,177,1.64e-111,401,278,275
"88166","Ntome_NODE_38316_length_282_cov_3","Nsylvestris_NODE_2679_length_3713_cov_170",83.333,264,41,1,10,273,821,1081,3.78e-63,241,263,260
"88167","Ntome_NODE_38322_length_282_cov_3","Nsylvestris_NODE_25590_length_740_cov_4",100,31,0,0,222,252,49,19,4.09e-08,58.4,30,30
"88168","Ntome_NODE_38323_length_282_cov_3","Nsylvestris_NODE_2187_length_3941_cov_33",94.34,265,15,0,16,280,2663,2399,3.52e-113,407,264,264
"88169","Ntome_NODE_38324_length_282_cov_3","Nsylvestris_NODE_9075_length_2242_cov_22",87.454,271,34,0,12,282,302,572,7.9e-85,313,270,270
"88170","Ntome_NODE_38327_length_282_cov_3","Nsylvestris_NODE_23068_length_887_cov_14",91.429,280,24,0,3,282,434,713,1.65e-106,385,279,279
"88178","Ntome_NODE_38332_length_281_cov_285","Nsylvestris_NODE_15086_length_1542_cov_233",98.577,281,1,1,1,281,647,370,2.62e-139,494,280,277
"88179","Ntome_NODE_38334_length_281_cov_223","Nsylvestris_NODE_1424_length_4474_cov_146",97.024,168,5,0,112,279,939,772,6.17e-76,283,167,167
"88189","Ntome_NODE_38339_length_281_cov_16","Nsylvestris_NODE_30027_length_525_cov_82",94.224,277,16,0,1,277,186,462,3.49e-118,424,276,276
"88193","Ntome_NODE_38343_length_281_cov_9","Nsylvestris_NODE_1869_length_4137_cov_56",96.085,281,11,0,1,281,3812,3532,9.56e-129,459,280,280
"88194","Ntome_NODE_38344_length_281_cov_7","Nsylvestris_NODE_23204_length_878_cov_34",95.683,278,12,0,1,278,247,524,2.07e-125,448,277,277
"88195","Ntome_NODE_38345_length_281_cov_6","Nsylvestris_NODE_2599_length_3745_cov_227",90.833,120,11,0,162,281,1055,936,3.02e-39,161,119,119
"88196","Ntome_NODE_38346_length_281_cov_6","Nsylvestris_NODE_41_length_9657_cov_190",92.857,56,3,1,27,82,2945,2891,8.69e-15,80.5,55,54
"88197","Ntome_NODE_38347_length_281_cov_6","Nsylvestris_NODE_26678_length_688_cov_11",92,200,4,2,1,194,204,397,4.81e-72,270,193,193
"88198","Ntome_NODE_38350_length_281_cov_5","Nsylvestris_NODE_1532_length_4373_cov_108",98.221,281,5,0,1,281,3457,3737,9.42e-139,492,280,280
"88199","Ntome_NODE_38351_length_279_cov_5","Nsylvestris_NODE_5261_length_2913_cov_56",85.235,149,20,2,100,246,2761,2909,1.8e-36,152,146,148
"88200","Ntome_NODE_38352_length_281_cov_5","Nsylvestris_NODE_13768_length_1677_cov_45",80.702,285,31,12,1,281,134,398,6.4e-51,200,280,264
"88201","Ntome_NODE_38357_length_281_cov_4","Nsylvestris_NODE_15234_length_1528_cov_82",95,280,14,0,1,280,1142,1421,3.46e-123,440,279,279
"88202","Ntome_NODE_38358_length_281_cov_4","Nsylvestris_NODE_19758_length_1122_cov_18",93.502,277,9,2,6,281,349,617,4.54e-112,403,275,268
"88203","Ntome_NODE_38367_length_281_cov_3","Nsylvestris_NODE_32955_length_355_cov_2",84.653,202,31,0,42,243,355,154,1.78e-51,202,201,201
"88204","Ntome_NODE_38371_length_281_cov_2","Nsylvestris_NODE_1227_length_4677_cov_68",88.06,134,11,2,134,267,3432,3304,5.05e-37,154,133,128
"88205","Ntome_NODE_38374_length_281_cov_2","Nsylvestris_NODE_13783_length_1675_cov_29",86.992,246,28,2,1,243,884,1128,3.72e-73,274,242,244
"88208","Ntome_NODE_38377_length_280_cov_249","Nsylvestris_NODE_4021_length_3227_cov_68",97.865,281,5,1,1,280,2393,2113,1.57e-136,484,279,280
"88212","Ntome_NODE_38379_length_280_cov_215","Nsylvestris_NODE_8261_length_2361_cov_157",92.982,228,13,3,1,227,260,35,7.79e-90,329,226,225
"88213","Ntome_NODE_38380_length_280_cov_65","Nsylvestris_NODE_35291_length_285_cov_17",92.825,223,15,1,27,249,35,256,1.3e-87,322,222,221
"88214","Ntome_NODE_38381_length_280_cov_34","Nsylvestris_NODE_2849_length_3638_cov_61",90.496,242,15,6,16,257,3638,3405,7.84e-85,313,241,233
"88218","Ntome_NODE_38386_length_280_cov_7","Nsylvestris_NODE_19601_length_1135_cov_35",95.714,280,6,3,1,280,91,364,7.41e-125,446,279,273
"88219","Ntome_NODE_38389_length_280_cov_5","Nsylvestris_NODE_25294_length_755_cov_16",92.908,282,15,5,1,280,477,755,1.26e-112,405,279,278
"88220","Ntome_NODE_38392_length_280_cov_5","Nsylvestris_NODE_24788_length_784_cov_11",88.776,294,16,6,3,280,739,447,2.78e-94,344,277,292
"88221","Ntome_NODE_38394_length_280_cov_4","Nsylvestris_NODE_21361_length_1004_cov_6",80.074,271,41,9,7,275,853,594,1.38e-47,189,268,259
"88222","Ntome_NODE_38397_length_280_cov_4","Nsylvestris_NODE_22095_length_950_cov_8",98.214,280,5,0,1,280,319,40,3.38e-138,490,279,279
"88223","Ntome_NODE_38401_length_280_cov_4","Nsylvestris_NODE_20358_length_1074_cov_37",93.972,282,12,3,1,280,763,485,1.25e-117,422,279,278
"88227","Ntome_NODE_38403_length_280_cov_4","Nsylvestris_NODE_1836_length_4155_cov_80",97.5,280,7,0,1,280,1825,2104,7.31e-135,479,279,279
"88228","Ntome_NODE_38407_length_280_cov_3","Nsylvestris_NODE_19111_length_1175_cov_11",93.214,280,19,0,1,280,438,159,7.52e-115,412,279,279
"88229","Ntome_NODE_38411_length_280_cov_3","Nsylvestris_NODE_36474_length_263_cov_3",89.726,146,14,1,136,280,262,117,1.78e-46,185,144,145
"88238","Ntome_NODE_38422_length_279_cov_257","Nsylvestris_NODE_2470_length_3807_cov_226",98.925,279,3,0,1,279,206,484,5.59e-141,499,278,278
"88243","Ntome_NODE_38425_length_279_cov_175","Nsylvestris_NODE_974_length_4986_cov_218",98.182,55,1,0,1,55,970,1024,8.57e-20,97.1,54,54
"88244","Ntome_NODE_38429_length_279_cov_13","Nsylvestris_NODE_7160_length_2542_cov_102",95.07,284,8,4,1,279,287,5,9.55e-124,442,278,282
"88245","Ntome_NODE_38430_length_279_cov_10","Nsylvestris_NODE_6982_length_2572_cov_107",94.03,67,4,0,1,67,67,1,1.84e-21,102,66,66
"88249","Ntome_NODE_38433_length_279_cov_6","Nsylvestris_NODE_13213_length_1738_cov_72",94.118,187,8,3,26,211,777,593,2.2e-75,281,185,184
"88253","Ntome_NODE_38441_length_279_cov_4","Nsylvestris_NODE_3635_length_3354_cov_224",94.444,36,2,0,1,36,2523,2488,1.45e-07,56.5,35,35
"88260","Ntome_NODE_38449_length_279_cov_4","Nsylvestris_NODE_14031_length_1646_cov_74",88.439,173,20,0,107,279,1283,1111,1.05e-53,209,172,172
"88261","Ntome_NODE_38452_length_279_cov_3","Nsylvestris_NODE_18465_length_1227_cov_98",79.016,305,25,18,1,279,1159,868,1.38e-42,172,278,291
"88265","Ntome_NODE_38457_length_279_cov_3","Nsylvestris_NODE_23532_length_858_cov_5",90.253,277,24,2,1,276,505,779,9.89e-99,359,275,274
"88266","Ntome_NODE_38464_length_279_cov_2","Nsylvestris_NODE_454_length_6090_cov_147",88.153,287,15,8,6,279,1437,1157,3.61e-88,324,273,280
"88267","Ntome_NODE_38466_length_278_cov_176","Nsylvestris_NODE_7061_length_2560_cov_217",83.42,193,8,4,110,278,97,289,3.86e-38,158,168,192
"88276","Ntome_NODE_38470_length_278_cov_7","Nsylvestris_NODE_25815_length_728_cov_4",86.364,88,6,6,188,273,171,88,3.97e-18,91.6,85,83
"88277","Ntome_NODE_38472_length_278_cov_6","Nsylvestris_NODE_23948_length_835_cov_193",100,278,0,0,1,278,397,674,1.99e-145,514,277,277
"88278","Ntome_NODE_38475_length_278_cov_5","Nsylvestris_NODE_923_length_5059_cov_127",76.569,239,47,9,24,261,1105,1335,1.41e-27,122,237,230
"88282","Ntome_NODE_38483_length_278_cov_4","Nsylvestris_NODE_11022_length_1984_cov_211",81.227,277,52,0,1,277,820,1096,3.75e-58,224,276,276
"88286","Ntome_NODE_38487_length_278_cov_4","Nsylvestris_NODE_8899_length_2264_cov_13",89.015,264,28,1,1,263,637,900,1e-88,326,262,263
"88287","Ntome_NODE_38491_length_278_cov_4","Nsylvestris_NODE_33122_length_348_cov_22",95.683,278,12,0,1,278,13,290,2.04e-125,448,277,277
"88288","Ntome_NODE_38494_length_278_cov_4","Nsylvestris_NODE_32369_length_378_cov_3",82.969,229,38,1,48,276,378,151,1.36e-52,206,228,227
"88292","Ntome_NODE_38503_length_278_cov_3","Nsylvestris_NODE_25310_length_754_cov_49",97.143,280,5,1,1,277,409,130,4.36e-132,470,276,279
"88293","Ntome_NODE_38505_length_278_cov_3","Nsylvestris_NODE_717_length_5403_cov_52",88.087,277,33,0,1,277,2864,3140,7.73e-90,329,276,276
"88294","Ntome_NODE_38508_length_278_cov_3","Nsylvestris_NODE_4568_length_3081_cov_117",86.093,151,15,4,130,278,1063,1209,3.86e-38,158,148,146
"88298","Ntome_NODE_38513_length_278_cov_1","Nsylvestris_NODE_25373_length_751_cov_8",95.858,169,7,0,109,277,392,224,3.67e-73,274,168,168
"88299","Ntome_NODE_38514_length_277_cov_333","Nsylvestris_NODE_1028_length_4900_cov_209",97.285,221,6,0,57,277,1518,1738,9.75e-104,375,220,220
"88300","Ntome_NODE_38515_length_277_cov_290","Nsylvestris_NODE_2488_length_3800_cov_191",90.217,276,14,6,10,277,3749,3479,2.12e-95,348,267,270
"88305","Ntome_NODE_38518_length_277_cov_174","Nsylvestris_NODE_14036_length_1646_cov_24",91.743,109,9,0,167,275,1410,1518,1.79e-36,152,108,108
"88306","Ntome_NODE_38519_length_277_cov_173","Nsylvestris_NODE_2456_length_3811_cov_153",100,37,0,0,58,94,1764,1800,1.85e-11,69.4,36,36
"88307","Ntome_NODE_38521_length_277_cov_165","Nsylvestris_NODE_2214_length_3931_cov_223",100,54,0,0,224,277,2891,2944,6.57e-21,100,53,53
"88310","Ntome_NODE_38523_length_277_cov_122","Nsylvestris_NODE_4401_length_3125_cov_218",88.298,282,24,6,3,277,53,332,7.7e-90,329,274,279
"88311","Ntome_NODE_38525_length_277_cov_18","Nsylvestris_NODE_10481_length_2053_cov_21",87.755,98,9,3,119,215,1332,1237,3.03e-24,111,96,95
"88312","Ntome_NODE_38526_length_277_cov_10","Nsylvestris_NODE_5256_length_2915_cov_50",91.398,279,21,3,1,277,429,152,7.54e-105,379,276,277
"88313","Ntome_NODE_38527_length_277_cov_9","Nsylvestris_NODE_13469_length_1710_cov_60",89.952,209,11,6,79,277,699,491,2.85e-69,261,198,208
"88316","Ntome_NODE_38540_length_277_cov_4","Nsylvestris_NODE_2565_length_3762_cov_117",92.334,287,10,7,1,277,2328,2612,2.08e-110,398,276,284
"88317","Ntome_NODE_38542_length_277_cov_4","Nsylvestris_NODE_10589_length_2039_cov_52",97.473,277,7,0,1,277,366,642,3.36e-133,473,276,276
"88318","Ntome_NODE_38550_length_277_cov_3","Nsylvestris_NODE_30758_length_468_cov_4",80,100,16,4,13,109,212,114,5.15e-12,71.3,96,98
"88321","Ntome_NODE_38553_length_277_cov_3","Nsylvestris_NODE_2146_length_3966_cov_119",89.928,278,27,1,1,277,1942,2219,3.53e-98,357,276,277
"88322","Ntome_NODE_38555_length_277_cov_2","Nsylvestris_NODE_30701_length_471_cov_7",98.917,277,3,0,1,277,298,22,7.17e-140,496,276,276
"88326","Ntome_NODE_38558_length_276_cov_383","Nsylvestris_NODE_10544_length_2044_cov_204",95.849,265,11,0,12,276,1928,1664,7.35e-120,429,264,264
"88327","Ntome_NODE_38560_length_276_cov_302","Nsylvestris_NODE_16472_length_1402_cov_115",96.014,276,8,1,1,276,995,723,7.3e-125,446,275,272
"88328","Ntome_NODE_38561_length_276_cov_267","Nsylvestris_NODE_15101_length_1540_cov_214",97.826,276,6,0,1,276,427,702,2.59e-134,477,275,275
"88329","Ntome_NODE_38562_length_276_cov_260","Nsylvestris_NODE_5832_length_2795_cov_214",94.545,55,3,0,222,276,2078,2024,1.83e-16,86.1,54,54
"88335","Ntome_NODE_38566_length_276_cov_224","Nsylvestris_NODE_17021_length_1355_cov_219",96.444,225,8,0,50,274,60,284,1.26e-102,372,224,224
"88339","Ntome_NODE_38568_length_276_cov_42","Nsylvestris_NODE_14492_length_1601_cov_82",91.837,196,12,2,13,208,1410,1601,4.71e-72,270,195,191
"88342","Ntome_NODE_38584_length_276_cov_4","Nsylvestris_NODE_6671_length_2628_cov_105",91.473,258,13,4,1,258,1832,2080,7.61e-95,346,257,248
"88343","Ntome_NODE_38587_length_276_cov_4","Nsylvestris_NODE_18018_length_1266_cov_192",90.132,152,11,4,1,149,1189,1039,2.92e-49,195,148,150
"88350","Ntome_NODE_38604_length_275_cov_23","Nsylvestris_NODE_17796_length_1286_cov_202",89.883,257,19,4,22,272,932,1187,3.55e-88,324,250,255
"88351","Ntome_NODE_38605_length_275_cov_10","Nsylvestris_NODE_237_length_7070_cov_115",97.368,266,7,0,1,266,1197,1462,4.34e-127,453,265,265
"88352","Ntome_NODE_38615_length_275_cov_4","Nsylvestris_NODE_19044_length_1180_cov_13",94.203,276,12,2,1,275,1034,762,1.58e-116,418,274,272
"88357","Ntome_NODE_38623_length_275_cov_3","Nsylvestris_NODE_33347_length_341_cov_3",91.866,209,7,3,1,209,143,341,6.03e-76,283,208,198
"88358","Ntome_NODE_38626_length_275_cov_3","Nsylvestris_NODE_3405_length_3435_cov_81",98.905,274,3,0,1,274,894,621,3.31e-138,490,273,273
"88359","Ntome_NODE_38630_length_275_cov_3","Nsylvestris_NODE_25031_length_770_cov_7",88.406,138,14,1,136,273,1,136,2.28e-40,165,137,135
"88365","Ntome_NODE_38634_length_275_cov_3","Nsylvestris_NODE_8424_length_2336_cov_138",95.683,278,7,3,1,275,646,921,9.4e-124,442,274,275
"88375","Ntome_NODE_38642_length_274_cov_304","Nsylvestris_NODE_24195_length_819_cov_63",94.834,271,14,0,2,272,90,360,3.39e-118,424,270,270
"88376","Ntome_NODE_38643_length_274_cov_296","Nsylvestris_NODE_8802_length_2279_cov_76",98.54,274,4,0,1,274,1930,1657,1.53e-136,484,273,273
"88377","Ntome_NODE_38644_length_274_cov_269","Nsylvestris_NODE_3602_length_3364_cov_211",90.813,283,14,3,4,274,809,527,1.61e-101,368,270,282
"88380","Ntome_NODE_38646_length_274_cov_248","Nsylvestris_NODE_2456_length_3811_cov_153",84.615,208,24,5,4,209,33,234,6.22e-51,200,205,201
"88389","Ntome_NODE_38655_length_274_cov_6","Nsylvestris_NODE_6475_length_2665_cov_86",100,34,0,0,1,34,1676,1709,8.52e-10,63.9,33,33
"88390","Ntome_NODE_38656_length_274_cov_6","Nsylvestris_NODE_33992_length_322_cov_4",93.81,210,13,0,2,211,214,5,5.92e-86,316,209,209
"88391","Ntome_NODE_38659_length_274_cov_6","Nsylvestris_NODE_18925_length_1190_cov_186",98.175,274,5,0,1,274,710,983,7.14e-135,479,273,273
"88394","Ntome_NODE_38669_length_274_cov_4","Nsylvestris_NODE_1603_length_4326_cov_45",89.855,276,26,2,1,274,3811,3536,4.51e-97,353,273,275
"88395","Ntome_NODE_38672_length_274_cov_4","Nsylvestris_NODE_8272_length_2359_cov_181",87.676,284,25,6,1,274,1520,1803,1.27e-87,322,273,283
"88396","Ntome_NODE_38674_length_274_cov_3","Nsylvestris_NODE_363_length_6429_cov_141",91.078,269,17,4,10,274,4037,4302,3.49e-98,357,264,265
"88397","Ntome_NODE_38675_length_274_cov_3","Nsylvestris_NODE_10044_length_2111_cov_8",94.578,166,8,1,1,165,628,463,1.31e-67,255,164,165
"88398","Ntome_NODE_38678_length_274_cov_3","Nsylvestris_NODE_31310_length_431_cov_7",87.826,115,14,0,5,119,249,363,1.78e-31,135,114,114
"88399","Ntome_NODE_38685_length_274_cov_3","Nsylvestris_NODE_1990_length_4062_cov_125",98.168,273,5,0,2,274,717,445,2.57e-134,477,272,272
"88400","Ntome_NODE_38686_length_274_cov_3","Nsylvestris_NODE_7930_length_2415_cov_55",95.604,273,12,0,1,273,1002,730,1.21e-122,438,272,272
"88403","Ntome_NODE_38692_length_274_cov_2","Nsylvestris_NODE_14876_length_1563_cov_7",87.313,134,17,0,1,134,530,397,4.91e-37,154,133,133
"88404","Ntome_NODE_38693_length_274_cov_1","Nsylvestris_NODE_15749_length_1475_cov_113",92.336,274,18,2,1,274,466,196,4.45e-107,387,273,270
"88410","Ntome_NODE_38696_length_273_cov_200","Nsylvestris_NODE_525_length_5886_cov_217",96.703,273,9,0,1,273,1502,1774,1.2e-127,455,272,272
"88416","Ntome_NODE_38700_length_273_cov_94","Nsylvestris_NODE_1244_length_4655_cov_124",90.213,235,13,5,1,228,4424,4655,2.14e-80,298,227,231
"88422","Ntome_NODE_38714_length_273_cov_4","Nsylvestris_NODE_19683_length_1128_cov_181",84.247,146,11,3,1,143,982,1118,2.29e-30,132,142,136
"88423","Ntome_NODE_38716_length_273_cov_4","Nsylvestris_NODE_15662_length_1484_cov_11",80.556,144,19,6,121,257,983,842,1.8e-21,102,136,141
"88424","Ntome_NODE_38718_length_273_cov_4","Nsylvestris_NODE_35911_length_275_cov_3",97.209,215,6,0,1,215,215,1,2.08e-100,364,214,214
"88425","Ntome_NODE_38719_length_273_cov_3","Nsylvestris_NODE_28739_length_596_cov_11",96.691,272,7,2,4,273,220,491,1.55e-126,451,269,271
"88429","Ntome_NODE_38724_length_273_cov_3","Nsylvestris_NODE_22906_length_897_cov_13",95.604,273,12,0,1,273,748,476,1.21e-122,438,272,272
"88441","Ntome_NODE_38733_length_272_cov_258","Nsylvestris_NODE_2959_length_3600_cov_173",100,92,0,0,52,143,945,854,4.84e-42,171,91,91
"88442","Ntome_NODE_38734_length_272_cov_249","Nsylvestris_NODE_4596_length_3075_cov_216",96.364,55,2,0,218,272,2468,2414,3.88e-18,91.6,54,54
"88443","Ntome_NODE_38735_length_272_cov_249","Nsylvestris_NODE_18892_length_1192_cov_208",93.796,274,11,3,1,272,923,1192,3.39e-113,407,271,269
"88444","Ntome_NODE_38736_length_272_cov_219","Nsylvestris_NODE_27067_length_670_cov_172",98.182,55,1,0,218,272,300,354,8.33e-20,97.1,54,54
"88447","Ntome_NODE_38739_length_272_cov_174","Nsylvestris_NODE_4055_length_3216_cov_189",83.088,272,33,10,1,272,153,411,1.69e-61,235,271,258
"88453","Ntome_NODE_38745_length_272_cov_9","Nsylvestris_NODE_2521_length_3783_cov_181",96.85,127,4,0,78,204,1653,1779,7.93e-55,213,126,126
"88454","Ntome_NODE_38747_length_272_cov_6","Nsylvestris_NODE_3435_length_3426_cov_162",86.726,113,15,0,127,239,2940,3052,1.06e-28,126,112,112
"88455","Ntome_NODE_38749_length_272_cov_6","Nsylvestris_NODE_29617_length_558_cov_139",93.846,65,3,1,75,138,313,249,8.33e-20,97.1,63,64
"88456","Ntome_NODE_38754_length_272_cov_5","Nsylvestris_NODE_2010_length_4046_cov_28",81.25,272,46,4,2,269,1359,1629,2.2e-55,215,267,270
"88457","Ntome_NODE_38755_length_272_cov_5","Nsylvestris_NODE_5260_length_2913_cov_183",94.643,56,3,0,1,56,2348,2403,5.01e-17,87.9,55,55
"88458","Ntome_NODE_38757_length_272_cov_5","Nsylvestris_NODE_26247_length_708_cov_8",88.983,236,21,4,41,272,656,422,4.61e-77,287,231,234
"88459","Ntome_NODE_38760_length_272_cov_4","Nsylvestris_NODE_34871_length_298_cov_6",88.421,95,10,1,138,231,100,6,8.27e-25,113,93,94
"88463","Ntome_NODE_38771_length_272_cov_3","Nsylvestris_NODE_607_length_5688_cov_181",88.462,52,4,2,62,111,2636,2585,3.04e-09,62.1,49,51
"88464","Ntome_NODE_38773_length_272_cov_3","Nsylvestris_NODE_12266_length_1841_cov_39",84,275,26,10,1,272,411,152,2.17e-65,248,271,259
"88465","Ntome_NODE_38774_length_272_cov_3","Nsylvestris_NODE_6285_length_2700_cov_129",93.066,274,9,7,1,272,80,345,9.49e-109,392,271,265
"88466","Ntome_NODE_38775_length_272_cov_3","Nsylvestris_NODE_2848_length_3638_cov_135",94.853,272,14,0,1,272,1837,1566,9.35e-119,425,271,271
"88473","Ntome_NODE_38786_length_272_cov_2","Nsylvestris_NODE_4409_length_3122_cov_20",98.162,272,5,0,1,272,2483,2212,9.16e-134,475,271,271
"88478","Ntome_NODE_38791_length_271_cov_11","Nsylvestris_NODE_25179_length_762_cov_4",86.667,60,6,2,55,113,525,467,2.34e-10,65.8,58,58
"88479","Ntome_NODE_38795_length_271_cov_6","Nsylvestris_NODE_1876_length_4133_cov_175",89.655,116,8,4,7,122,1537,1648,2.92e-34,145,115,111
"88480","Ntome_NODE_38798_length_271_cov_5","Nsylvestris_NODE_15187_length_1532_cov_25",95.572,271,12,0,1,271,644,374,1.55e-121,435,270,270
"88481","Ntome_NODE_38799_length_271_cov_5","Nsylvestris_NODE_4652_length_3057_cov_101",97.417,271,7,0,1,271,1477,1207,7.1e-130,462,270,270
"88482","Ntome_NODE_38803_length_271_cov_5","Nsylvestris_NODE_211_length_7288_cov_38",85.437,103,15,0,169,271,7024,7126,3.83e-23,108,102,102
"88483","Ntome_NODE_38805_length_271_cov_5","Nsylvestris_NODE_14118_length_1639_cov_75",87.543,289,14,8,1,271,287,3,2.1e-85,315,270,284
"88484","Ntome_NODE_38812_length_271_cov_4","Nsylvestris_NODE_1619_length_4317_cov_76",96.226,159,5,1,1,159,2993,3150,1e-68,259,158,157
"88485","Ntome_NODE_38814_length_271_cov_4","Nsylvestris_NODE_30754_length_468_cov_9",94.872,273,12,1,1,271,60,332,9.32e-119,425,270,272
"88489","Ntome_NODE_38822_length_271_cov_3","Nsylvestris_NODE_10951_length_1994_cov_72",93.609,266,12,1,6,271,67,327,9.45e-109,392,265,260
"88493","Ntome_NODE_38831_length_271_cov_2","Nsylvestris_NODE_5913_length_2778_cov_175",91.7,253,20,1,19,271,2427,2176,5.77e-96,350,252,251
"88496","Ntome_NODE_38834_length_271_cov_2","Nsylvestris_NODE_26100_length_714_cov_13",91.513,271,23,0,1,271,344,614,3.42e-103,374,270,270
"88497","Ntome_NODE_38835_length_270_cov_283","Nsylvestris_NODE_793_length_5250_cov_202",98.182,55,1,0,216,270,1389,1443,8.26e-20,97.1,54,54
"88500","Ntome_NODE_38838_length_270_cov_14","Nsylvestris_NODE_36078_length_271_cov_23",92.969,256,15,2,15,267,13,268,4.41e-102,370,252,255
"88501","Ntome_NODE_38839_length_270_cov_10","Nsylvestris_NODE_30818_length_461_cov_4",97.619,84,2,0,1,84,32,115,2.91e-34,145,83,83
"88502","Ntome_NODE_38842_length_270_cov_7","Nsylvestris_NODE_10951_length_1994_cov_72",93.382,272,15,2,1,270,590,320,5.62e-111,399,269,270
"88503","Ntome_NODE_38843_length_270_cov_6","Nsylvestris_NODE_15531_length_1499_cov_22",89.412,255,18,6,24,270,555,302,7.54e-85,313,246,253
"88511","Ntome_NODE_38862_length_270_cov_4","Nsylvestris_NODE_35398_length_286_cov_5",89.655,232,18,5,35,260,285,54,3.53e-78,291,225,231
"88512","Ntome_NODE_38868_length_270_cov_4","Nsylvestris_NODE_24230_length_817_cov_13",96.667,270,8,1,2,270,311,42,1.98e-125,448,268,269
"88513","Ntome_NODE_38869_length_270_cov_4","Nsylvestris_NODE_23119_length_884_cov_16",91.791,268,19,2,4,270,826,561,4.41e-102,370,266,265
"88514","Ntome_NODE_38884_length_270_cov_3","Nsylvestris_NODE_4572_length_3080_cov_106",94.096,271,15,1,1,270,2610,2340,2.6e-114,411,269,270
"88515","Ntome_NODE_38889_length_270_cov_3","Nsylvestris_NODE_2176_length_3951_cov_137",87.963,108,12,1,3,110,1064,1170,1.05e-28,126,107,106
"88516","Ntome_NODE_38891_length_270_cov_3","Nsylvestris_NODE_4052_length_3217_cov_19",94.862,253,13,0,18,270,2895,3147,7.28e-110,396,252,252
"88517","Ntome_NODE_38892_length_270_cov_3","Nsylvestris_NODE_21018_length_1027_cov_14",95.911,269,11,0,2,270,376,108,4.29e-122,436,268,268
"88520","Ntome_NODE_38894_length_270_cov_2","Nsylvestris_NODE_20421_length_1070_cov_52",98.864,88,1,0,76,163,367,280,3.74e-38,158,87,87
"88529","Ntome_NODE_38898_length_269_cov_78","Nsylvestris_NODE_33576_length_334_cov_28",93.939,231,11,1,2,229,100,330,7.4e-95,346,227,230
"88534","Ntome_NODE_38906_length_269_cov_6","Nsylvestris_NODE_5191_length_2928_cov_222",100,269,0,0,1,269,2580,2848,1.93e-140,497,268,268
"88535","Ntome_NODE_38907_length_269_cov_5","Nsylvestris_NODE_3867_length_3279_cov_220",100,268,0,0,2,269,182,449,6.94e-140,496,267,267
"88539","Ntome_NODE_38915_length_269_cov_4","Nsylvestris_NODE_19481_length_1145_cov_37",88.889,207,20,2,1,206,790,586,1.66e-66,252,205,204
"88540","Ntome_NODE_38916_length_269_cov_4","Nsylvestris_NODE_106_length_8362_cov_114",94.465,271,8,3,1,269,5691,5956,2.59e-114,411,268,265
"88541","Ntome_NODE_38922_length_269_cov_3","Nsylvestris_NODE_34128_length_318_cov_4",95.597,159,6,1,112,269,1,159,4.61e-67,254,157,158
"88542","Ntome_NODE_38923_length_269_cov_3","Nsylvestris_NODE_9632_length_2161_cov_8",97.297,148,4,0,122,269,1,148,1.66e-66,252,147,147
"88543","Ntome_NODE_38925_length_269_cov_3","Nsylvestris_NODE_33333_length_341_cov_5",96.911,259,7,1,10,268,297,40,5.52e-121,433,258,257
"88544","Ntome_NODE_38926_length_269_cov_3","Nsylvestris_NODE_22196_length_942_cov_68",90.076,262,26,0,8,269,656,395,3.44e-93,340,261,261
"88545","Ntome_NODE_38927_length_269_cov_3","Nsylvestris_NODE_2070_length_4011_cov_26",97.77,269,6,0,1,269,2874,2606,1.96e-130,464,268,268
"88546","Ntome_NODE_38930_length_269_cov_3","Nsylvestris_NODE_21480_length_993_cov_16",94.403,268,15,0,1,268,305,572,7.19e-115,412,267,267
"88547","Ntome_NODE_38933_length_268_cov_315","Nsylvestris_NODE_18755_length_1205_cov_206",90.775,271,22,2,1,268,490,220,9.47e-99,359,267,270
"88552","Ntome_NODE_38942_length_268_cov_8","Nsylvestris_NODE_31157_length_441_cov_5",96.988,166,5,0,1,166,276,441,7.58e-75,279,165,165
"88553","Ntome_NODE_38943_length_268_cov_7","Nsylvestris_NODE_7707_length_2452_cov_42",92.222,270,18,3,1,268,1998,1730,7.27e-105,379,267,268
"88554","Ntome_NODE_38945_length_268_cov_6","Nsylvestris_NODE_46_length_9533_cov_130",93.156,263,18,0,6,268,6918,7180,4.34e-107,387,262,262
"88558","Ntome_NODE_38951_length_268_cov_5","Nsylvestris_NODE_6020_length_2757_cov_35",88.433,268,26,2,1,268,1201,1463,1.61e-86,318,267,262
"88559","Ntome_NODE_38952_length_268_cov_5","Nsylvestris_NODE_7630_length_2466_cov_110",96.283,269,9,1,1,268,1770,2038,3.29e-123,440,267,268
"88564","Ntome_NODE_38963_length_268_cov_4","Nsylvestris_NODE_6540_length_2654_cov_113",80,165,9,9,72,232,1670,1526,6.34e-21,100,160,144
"88565","Ntome_NODE_38966_length_268_cov_4","Nsylvestris_NODE_31987_length_394_cov_10",94.697,264,13,1,3,265,10,273,9.27e-114,409,262,263
"88566","Ntome_NODE_38967_length_268_cov_4","Nsylvestris_NODE_9255_length_2214_cov_29",88.525,61,3,4,30,88,1088,1030,4.97e-12,71.3,58,58
"88570","Ntome_NODE_38969_length_268_cov_4","Nsylvestris_NODE_29880_length_538_cov_7",98.039,204,4,0,65,268,538,335,1.22e-97,355,203,203
"88571","Ntome_NODE_38970_length_270_cov_4","Nsylvestris_NODE_3931_length_3258_cov_114",90.667,75,7,0,26,100,1071,1145,6.39e-21,100,74,74
"88572","Ntome_NODE_38977_length_268_cov_3","Nsylvestris_NODE_2569_length_3762_cov_29",88.889,117,12,1,1,116,2464,2580,1.04e-33,143,115,116
"88589","Ntome_NODE_38992_length_267_cov_10","Nsylvestris_NODE_4133_length_3193_cov_60",86.752,234,30,1,11,243,673,440,9.84e-69,259,232,233
"88590","Ntome_NODE_38994_length_267_cov_9","Nsylvestris_NODE_19438_length_1149_cov_62",83.439,157,21,4,66,220,64,217,3.72e-33,141,154,153
"88593","Ntome_NODE_39000_length_267_cov_5","Nsylvestris_NODE_20862_length_1038_cov_24",89.256,121,11,2,87,206,576,457,6.18e-36,150,119,119
"88594","Ntome_NODE_39002_length_267_cov_5","Nsylvestris_NODE_5263_length_2913_cov_52",82.772,267,27,6,2,267,605,853,4.64e-57,220,265,248
"88595","Ntome_NODE_39004_length_267_cov_5","Nsylvestris_NODE_27754_length_640_cov_5",85,220,19,10,42,258,375,167,2.79e-54,211,216,208
"88603","Ntome_NODE_39007_length_267_cov_4","Nsylvestris_NODE_21517_length_991_cov_26",94.382,267,15,0,1,267,520,786,2.57e-114,411,266,266
"88604","Ntome_NODE_39009_length_267_cov_4","Nsylvestris_NODE_470_length_6031_cov_12",80.165,242,46,2,27,267,5448,5208,7.88e-45,180,240,240
"88609","Ntome_NODE_39015_length_267_cov_4","Nsylvestris_NODE_2268_length_3906_cov_174",79.268,164,34,0,3,166,1594,1757,2.25e-25,115,163,163
"88610","Ntome_NODE_39022_length_267_cov_2","Nsylvestris_NODE_13502_length_1706_cov_57",98.127,267,5,0,1,267,1050,784,5.4e-131,466,266,266
"88611","Ntome_NODE_39027_length_266_cov_432","Nsylvestris_NODE_2341_length_3877_cov_216",96.617,266,9,0,1,266,1808,1543,9.06e-124,442,265,265
"88624","Ntome_NODE_39037_length_266_cov_6","Nsylvestris_NODE_24646_length_792_cov_12",88.462,78,9,0,1,78,236,159,2.92e-19,95.3,77,77
"88625","Ntome_NODE_39043_length_266_cov_5","Nsylvestris_NODE_425_length_6184_cov_55",90.805,174,9,2,1,174,3595,3761,9.94e-59,226,173,166
"88626","Ntome_NODE_39044_length_266_cov_5","Nsylvestris_NODE_6696_length_2623_cov_218",100,266,0,0,1,266,407,672,8.87e-139,492,265,265
"88632","Ntome_NODE_39053_length_266_cov_4","Nsylvestris_NODE_8537_length_2320_cov_53",90.909,264,23,1,4,266,40,303,4.37e-97,353,262,263
"88633","Ntome_NODE_39058_length_266_cov_4","Nsylvestris_NODE_33297_length_343_cov_3",93.962,265,15,1,1,265,61,324,5.53e-111,399,264,263
"88634","Ntome_NODE_39062_length_266_cov_3","Nsylvestris_NODE_8524_length_2322_cov_80",93.103,58,4,0,11,68,325,268,1.76e-16,86.1,57,57
"88637","Ntome_NODE_39068_length_266_cov_3","Nsylvestris_NODE_29179_length_576_cov_6",86.94,268,22,4,1,260,263,525,1.25e-77,289,259,262
"88638","Ntome_NODE_39069_length_266_cov_3","Nsylvestris_NODE_9104_length_2236_cov_106",97.744,266,6,0,1,266,1160,1425,9e-129,459,265,265
"88639","Ntome_NODE_39070_length_266_cov_3","Nsylvestris_NODE_28814_length_592_cov_8",98.12,266,5,0,1,266,399,134,1.93e-130,464,265,265
"88640","Ntome_NODE_39072_length_266_cov_2","Nsylvestris_NODE_17243_length_1337_cov_22",98.496,266,4,0,1,266,893,628,4.16e-132,470,265,265
"88643","Ntome_NODE_39077_length_266_cov_2","Nsylvestris_NODE_15933_length_1456_cov_10",100,28,0,0,111,138,660,633,1.78e-06,52.8,27,27
"88648","Ntome_NODE_39083_length_265_cov_270","Nsylvestris_NODE_4599_length_3073_cov_171",88.043,276,21,5,1,265,2494,2220,5.71e-86,316,264,274
"88653","Ntome_NODE_39086_length_265_cov_253","Nsylvestris_NODE_22775_length_904_cov_207",92.075,265,18,3,1,265,821,560,4.32e-102,370,264,261
"88658","Ntome_NODE_39089_length_265_cov_205","Nsylvestris_NODE_848_length_5160_cov_92",98.039,51,1,0,213,263,844,894,1.35e-17,89.8,50,50
"88659","Ntome_NODE_39090_length_265_cov_181","Nsylvestris_NODE_1512_length_4390_cov_53",100,55,0,0,211,265,517,571,1.74e-21,102,54,54
"88663","Ntome_NODE_39102_length_265_cov_5","Nsylvestris_NODE_3288_length_3480_cov_27",94.052,269,12,1,1,265,875,1143,1.18e-112,405,264,268
"88664","Ntome_NODE_39105_length_265_cov_5","Nsylvestris_NODE_16560_length_1395_cov_18",91.903,247,13,1,5,244,255,501,1.22e-92,339,239,246
"88668","Ntome_NODE_39109_length_265_cov_4","Nsylvestris_NODE_260_length_6939_cov_229",87.755,49,3,2,33,79,6484,6437,4.94e-07,54.7,46,47
"88669","Ntome_NODE_39111_length_265_cov_4","Nsylvestris_NODE_34961_length_296_cov_4",95.055,182,8,1,9,189,114,295,1.61e-76,285,180,181
"88676","Ntome_NODE_39124_length_265_cov_3","Nsylvestris_NODE_9196_length_2224_cov_134",98.387,248,4,0,2,249,1235,1482,4.2e-122,436,247,247
"88683","Ntome_NODE_39131_length_265_cov_3","Nsylvestris_NODE_7553_length_2477_cov_162",89.27,233,15,7,1,233,1880,2102,5.79e-76,283,232,222
"88692","Ntome_NODE_39139_length_264_cov_272","Nsylvestris_NODE_439_length_6140_cov_164",93.511,262,14,3,4,264,3623,3364,4.27e-107,387,260,259
"88693","Ntome_NODE_39141_length_264_cov_249","Nsylvestris_NODE_36502_length_262_cov_4",86.01,193,21,5,78,264,1,193,1.66e-51,202,186,192
"88696","Ntome_NODE_39143_length_264_cov_223","Nsylvestris_NODE_5474_length_2868_cov_175",96.364,55,2,0,1,55,2050,2104,3.75e-18,91.6,54,54
"88704","Ntome_NODE_39148_length_264_cov_164","Nsylvestris_NODE_24687_length_789_cov_224",95.683,139,6,0,126,264,50,188,3.54e-58,224,138,138
"88705","Ntome_NODE_39150_length_264_cov_128","Nsylvestris_NODE_8365_length_2346_cov_73",88.048,251,18,5,16,258,6,252,4.46e-77,287,242,246
"88712","Ntome_NODE_39158_length_264_cov_7","Nsylvestris_NODE_10787_length_2015_cov_118",95.51,245,10,1,20,264,2015,1772,3.3e-108,390,244,243
"88713","Ntome_NODE_39166_length_264_cov_5","Nsylvestris_NODE_62_length_9216_cov_60",93.182,264,18,0,1,264,4205,4468,1.19e-107,388,263,263
"88714","Ntome_NODE_39177_length_264_cov_4","Nsylvestris_NODE_24683_length_790_cov_8",92.803,264,13,3,1,264,580,323,2.57e-104,377,263,257
"88715","Ntome_NODE_39181_length_264_cov_3","Nsylvestris_NODE_15429_length_1510_cov_49",94.071,253,15,0,12,264,452,704,1.54e-106,385,252,252
"88716","Ntome_NODE_39185_length_264_cov_3","Nsylvestris_NODE_7314_length_2518_cov_17",87.132,272,23,9,1,263,1774,1506,2.06e-80,298,262,268
"88717","Ntome_NODE_39189_length_264_cov_3","Nsylvestris_NODE_3263_length_3485_cov_128",82.237,152,25,2,7,157,462,312,7.95e-30,130,150,150
"88718","Ntome_NODE_39191_length_264_cov_3","Nsylvestris_NODE_13662_length_1689_cov_214",100,32,0,0,1,32,206,237,1.06e-08,60.2,31,31
"88719","Ntome_NODE_39195_length_264_cov_2","Nsylvestris_NODE_16900_length_1365_cov_69",92.893,197,14,0,1,197,1121,1317,4.46e-77,287,196,196
"88725","Ntome_NODE_39199_length_263_cov_323","Nsylvestris_NODE_6429_length_2672_cov_232",94.677,263,14,0,1,263,1476,1214,9.08e-114,409,262,262
"88728","Ntome_NODE_39201_length_263_cov_282","Nsylvestris_NODE_139_length_7902_cov_57",94.361,266,12,1,1,263,1840,2105,1.17e-112,405,262,265
"88729","Ntome_NODE_39202_length_263_cov_281","Nsylvestris_NODE_16205_length_1429_cov_141",92.437,238,18,0,1,238,1126,1363,3.36e-93,340,237,237
"88730","Ntome_NODE_39203_length_263_cov_275","Nsylvestris_NODE_2304_length_3891_cov_119",95.522,134,4,1,11,142,3444,3577,7.64e-55,213,131,133
"88731","Ntome_NODE_39204_length_263_cov_268","Nsylvestris_NODE_2541_length_3773_cov_203",97.719,263,6,0,1,263,2632,2894,4.14e-127,453,262,262
"88734","Ntome_NODE_39207_length_263_cov_137","Nsylvestris_NODE_29723_length_552_cov_184",96.552,261,5,1,3,263,280,536,6.97e-120,429,260,256
"88735","Ntome_NODE_39209_length_263_cov_18","Nsylvestris_NODE_1830_length_4159_cov_34",82.083,240,39,4,5,242,3546,3309,1.65e-51,202,237,237
"88743","Ntome_NODE_39228_length_263_cov_4","Nsylvestris_NODE_23883_length_839_cov_98",96.774,62,2,0,97,158,778,839,4.8e-22,104,61,61
"88744","Ntome_NODE_39233_length_263_cov_4","Nsylvestris_NODE_28594_length_602_cov_10",96.923,130,4,0,18,147,2,131,1.64e-56,219,129,129
"88745","Ntome_NODE_39238_length_263_cov_4","Nsylvestris_NODE_15213_length_1530_cov_181",100,263,0,0,1,263,895,633,4.08e-137,486,262,262
"88752","Ntome_NODE_39245_length_263_cov_3","Nsylvestris_NODE_27507_length_651_cov_9",95.42,262,12,0,1,262,250,511,1.51e-116,418,261,261
"88753","Ntome_NODE_39246_length_263_cov_3","Nsylvestris_NODE_34504_length_308_cov_2",98.361,122,2,0,1,122,122,1,2.12e-55,215,121,121
"88754","Ntome_NODE_39249_length_263_cov_3","Nsylvestris_NODE_11022_length_1984_cov_211",83.012,259,44,0,1,259,1261,1519,1.63e-61,235,258,258
"88755","Ntome_NODE_39250_length_263_cov_3","Nsylvestris_NODE_26498_length_696_cov_14",79.643,280,35,15,1,263,335,61,2.15e-45,182,262,274
"88756","Ntome_NODE_39251_length_263_cov_3","Nsylvestris_NODE_30704_length_471_cov_5",93.633,267,11,4,1,263,417,153,2.54e-109,394,262,264
"88757","Ntome_NODE_39255_length_263_cov_3","Nsylvestris_NODE_1289_length_4604_cov_93",95.802,262,8,1,1,262,3840,4098,4.19e-117,420,261,258
"88758","Ntome_NODE_39262_length_263_cov_2","Nsylvestris_NODE_8792_length_2281_cov_18",90.875,263,24,0,1,263,2238,1976,4.31e-97,353,262,262
"88759","Ntome_NODE_39263_length_263_cov_2","Nsylvestris_NODE_33517_length_336_cov_4",89.151,212,23,0,1,212,218,7,2.08e-70,265,211,211
"88760","Ntome_NODE_39266_length_262_cov_324","Nsylvestris_NODE_7953_length_2412_cov_143",96.947,262,8,0,1,262,1651,1390,3.21e-123,440,261,261
"88766","Ntome_NODE_39269_length_262_cov_280","Nsylvestris_NODE_20515_length_1063_cov_200",91.985,262,21,0,1,262,263,524,1.53e-101,368,261,261
"88779","Ntome_NODE_39274_length_262_cov_162","Nsylvestris_NODE_24927_length_775_cov_41",94.828,58,3,0,1,58,288,231,3.72e-18,91.6,57,57
"88788","Ntome_NODE_39283_length_262_cov_6","Nsylvestris_NODE_32013_length_393_cov_7",88.991,109,10,2,2,109,196,89,6.09e-31,134,107,107
"88789","Ntome_NODE_39284_length_262_cov_6","Nsylvestris_NODE_374_length_6403_cov_158",94.275,262,15,0,1,262,5971,6232,1.51e-111,401,261,261
"88790","Ntome_NODE_39285_length_262_cov_6","Nsylvestris_NODE_2320_length_3885_cov_82",86.973,261,13,10,1,260,1874,1634,3.44e-73,274,259,240
"88791","Ntome_NODE_39286_length_262_cov_5","Nsylvestris_NODE_15206_length_1531_cov_9",92.095,253,10,3,19,261,1115,863,2e-95,348,242,252
"88794","Ntome_NODE_39290_length_262_cov_5","Nsylvestris_NODE_4281_length_3156_cov_124",93.704,270,9,3,1,262,231,500,1.96e-110,398,261,269
"88797","Ntome_NODE_39292_length_262_cov_4","Nsylvestris_NODE_12128_length_1855_cov_22",96.565,262,9,0,1,262,1130,869,1.49e-121,435,261,261
"88798","Ntome_NODE_39293_length_262_cov_4","Nsylvestris_NODE_19432_length_1150_cov_7",95.42,262,12,0,1,262,883,622,1.5e-116,418,261,261
"88799","Ntome_NODE_39295_length_262_cov_4","Nsylvestris_NODE_932_length_5045_cov_32",93.05,259,17,1,4,262,2759,2502,2.55e-104,377,258,257
"88803","Ntome_NODE_39297_length_262_cov_4","Nsylvestris_NODE_18906_length_1192_cov_52",91.327,196,14,2,70,262,267,462,2.07e-70,265,192,195
"88804","Ntome_NODE_39298_length_262_cov_4","Nsylvestris_NODE_26150_length_712_cov_15",88.123,261,16,12,2,262,288,43,7.34e-80,296,260,245
"88805","Ntome_NODE_39299_length_262_cov_4","Nsylvestris_NODE_29529_length_562_cov_10",95.42,262,11,1,1,262,161,421,5.4e-116,416,261,260
"88806","Ntome_NODE_39303_length_262_cov_3","Nsylvestris_NODE_22158_length_945_cov_17",82.117,274,34,7,3,261,624,897,4.55e-57,220,258,273
"88807","Ntome_NODE_39312_length_262_cov_2","Nsylvestris_NODE_5312_length_2903_cov_111",87.452,263,28,3,1,259,1170,909,2.04e-80,298,258,261
"88811","Ntome_NODE_39314_length_261_cov_290","Nsylvestris_NODE_19537_length_1140_cov_123",98.084,261,5,0,1,261,736,476,1.14e-127,455,260,260
"88812","Ntome_NODE_39315_length_261_cov_230","Nsylvestris_NODE_25919_length_723_cov_6",96.169,261,10,0,1,261,84,344,2.49e-119,427,260,260
"88813","Ntome_NODE_39316_length_261_cov_212","Nsylvestris_NODE_26288_length_706_cov_22",94.964,139,7,0,97,235,199,337,1.63e-56,219,138,138
"88819","Ntome_NODE_39322_length_261_cov_7","Nsylvestris_NODE_842_length_5165_cov_212",100,235,0,0,1,235,667,901,1.49e-121,435,234,234
"88820","Ntome_NODE_39328_length_261_cov_5","Nsylvestris_NODE_1764_length_4205_cov_87",95.402,261,12,0,1,261,3411,3151,5.38e-116,416,260,260
"88823","Ntome_NODE_39332_length_261_cov_4","Nsylvestris_NODE_6529_length_2656_cov_114",100,34,0,0,131,164,1089,1056,8.07e-10,63.9,33,33
"88824","Ntome_NODE_39333_length_261_cov_4","Nsylvestris_NODE_28511_length_606_cov_4",87.879,264,19,7,1,261,268,521,2.03e-80,298,260,253
"88825","Ntome_NODE_39336_length_260_cov_4","Nsylvestris_NODE_31398_length_425_cov_16",95.094,265,6,4,3,260,10,274,2.49e-114,411,257,264
"88826","Ntome_NODE_39341_length_261_cov_4","Nsylvestris_NODE_3508_length_3398_cov_87",92.969,256,18,0,6,261,1186,931,3.28e-103,374,255,255
"88827","Ntome_NODE_39344_length_261_cov_3","Nsylvestris_NODE_16357_length_1414_cov_113",95.263,190,9,0,72,261,1299,1110,1.57e-81,302,189,189
"88830","Ntome_NODE_39354_length_260_cov_3","Nsylvestris_NODE_35073_length_293_cov_4",91.463,164,13,1,97,260,293,131,3.49e-58,224,163,162
"88836","Ntome_NODE_39374_length_260_cov_6","Nsylvestris_NODE_11515_length_1928_cov_227",84.231,260,29,6,1,260,763,516,9.62e-64,243,259,247
"88837","Ntome_NODE_39375_length_260_cov_6","Nsylvestris_NODE_35111_length_292_cov_6",90.909,143,11,2,118,259,62,203,3.53e-48,191,141,141
"88840","Ntome_NODE_39380_length_260_cov_5","Nsylvestris_NODE_20989_length_1028_cov_190",94.118,51,3,0,2,52,998,948,2.87e-14,78.7,50,50
"88841","Ntome_NODE_39381_length_260_cov_5","Nsylvestris_NODE_21804_length_969_cov_22",92.149,242,16,3,22,260,586,345,1.19e-92,339,238,241
"88842","Ntome_NODE_39385_length_260_cov_4","Nsylvestris_NODE_25142_length_764_cov_6",90.037,271,15,1,2,260,21,291,3.32e-93,340,258,270
"88845","Ntome_NODE_39391_length_260_cov_4","Nsylvestris_NODE_22567_length_918_cov_5",90.476,210,19,1,1,210,693,485,9.49e-74,276,209,208
"88853","Ntome_NODE_39408_length_259_cov_294","Nsylvestris_NODE_14752_length_1574_cov_191",94.595,259,13,1,1,259,1269,1012,5.37e-111,399,258,257
"88856","Ntome_NODE_39410_length_259_cov_219","Nsylvestris_NODE_16225_length_1427_cov_197",98.444,257,4,0,1,257,980,724,4.07e-127,453,256,256
"88875","Ntome_NODE_39432_length_259_cov_4","Nsylvestris_NODE_1353_length_4544_cov_135",87.778,270,18,7,1,255,3227,3496,1.56e-81,302,254,269
"88876","Ntome_NODE_39434_length_259_cov_4","Nsylvestris_NODE_9020_length_2248_cov_17",84.615,260,36,3,1,259,1484,1228,1.23e-67,255,258,256
"88877","Ntome_NODE_39436_length_259_cov_4","Nsylvestris_NODE_10438_length_2058_cov_67",96.887,257,8,0,1,257,1017,1273,1.91e-120,431,256,256
"88878","Ntome_NODE_39445_length_259_cov_3","Nsylvestris_NODE_6178_length_2721_cov_69",96.791,187,6,0,6,192,651,837,7.2e-85,313,186,186
"88883","Ntome_NODE_39448_length_259_cov_3","Nsylvestris_NODE_8566_length_2314_cov_168",98.069,259,4,1,2,259,396,138,5.26e-126,449,257,258
"88884","Ntome_NODE_39450_length_259_cov_3","Nsylvestris_NODE_26515_length_695_cov_24",89.706,68,6,1,190,256,302,369,1.71e-16,86.1,66,67
"88885","Ntome_NODE_39452_length_259_cov_3","Nsylvestris_NODE_736_length_5378_cov_103",97.683,259,6,0,1,259,2054,2312,6.8e-125,446,258,258
"88886","Ntome_NODE_39454_length_259_cov_3","Nsylvestris_NODE_9411_length_2192_cov_60",97.683,259,6,0,1,259,2017,1759,6.8e-125,446,258,258
"88890","Ntome_NODE_39457_length_259_cov_2","Nsylvestris_NODE_20242_length_1083_cov_62",96.109,257,10,0,1,257,588,332,4.12e-117,420,256,256
"88893","Ntome_NODE_39462_length_258_cov_210","Nsylvestris_NODE_29778_length_547_cov_9",93.506,231,14,1,1,230,246,16,9.14e-94,342,229,230
"88894","Ntome_NODE_39463_length_258_cov_184","Nsylvestris_NODE_3564_length_3378_cov_168",90.547,201,16,1,56,256,1409,1212,7.32e-70,263,200,197
"88902","Ntome_NODE_39470_length_258_cov_5","Nsylvestris_NODE_12702_length_1795_cov_104",94.553,257,14,0,1,257,1047,791,1.92e-110,398,256,256
"88905","Ntome_NODE_39479_length_258_cov_5","Nsylvestris_NODE_26945_length_676_cov_6",96.774,248,8,0,1,248,248,1,1.91e-115,414,247,247
"88908","Ntome_NODE_39487_length_258_cov_4","Nsylvestris_NODE_4737_length_3036_cov_143",87.027,185,23,1,51,234,499,315,3.48e-53,207,183,184
"88909","Ntome_NODE_39488_length_258_cov_4","Nsylvestris_NODE_13656_length_1690_cov_76",85.714,259,13,10,1,258,1044,1279,1.59e-66,252,257,235
"88910","Ntome_NODE_39489_length_258_cov_4","Nsylvestris_NODE_12293_length_1838_cov_23",86.066,244,32,2,4,247,1052,1293,2.63e-69,261,243,241
"88917","Ntome_NODE_39494_length_258_cov_3","Nsylvestris_NODE_30473_length_488_cov_8",94.8,250,13,0,3,252,228,477,3.22e-108,390,249,249
"88921","Ntome_NODE_39501_length_258_cov_2","Nsylvestris_NODE_6178_length_2721_cov_69",92.218,257,20,0,2,258,627,371,1.95e-100,364,256,256
"88925","Ntome_NODE_39507_length_257_cov_299","Nsylvestris_NODE_3241_length_3492_cov_230",96.887,257,8,0,1,257,1463,1719,1.89e-120,431,256,256
"88929","Ntome_NODE_39509_length_257_cov_289","Nsylvestris_NODE_6005_length_2759_cov_214",100,257,0,0,1,257,2249,1993,8.6e-134,475,256,256
"88934","Ntome_NODE_39512_length_257_cov_196","Nsylvestris_NODE_4728_length_3038_cov_126",98.182,55,1,0,203,257,571,625,7.83e-20,97.1,54,54
"88941","Ntome_NODE_39521_length_257_cov_9","Nsylvestris_NODE_7765_length_2443_cov_69",91.903,247,9,3,21,256,105,351,1.52e-91,335,235,246
"88942","Ntome_NODE_39525_length_257_cov_6","Nsylvestris_NODE_16413_length_1409_cov_12",77.132,258,53,4,5,257,762,506,2.76e-34,145,252,256
"88943","Ntome_NODE_39529_length_257_cov_5","Nsylvestris_NODE_3978_length_3239_cov_19",93.385,257,17,0,1,257,346,90,1.93e-105,381,256,256
"88949","Ntome_NODE_39537_length_257_cov_4","Nsylvestris_NODE_36635_length_259_cov_4",97.98,198,2,1,60,257,259,64,9.1e-94,342,197,195
"88950","Ntome_NODE_39541_length_257_cov_4","Nsylvestris_NODE_6850_length_2594_cov_83",94.922,256,11,1,4,257,1705,1450,5.33e-111,399,253,255
"88951","Ntome_NODE_39543_length_257_cov_4","Nsylvestris_NODE_32229_length_384_cov_6",92.692,260,16,1,1,257,370,111,1.16e-102,372,256,259
"88952","Ntome_NODE_39549_length_257_cov_4","Nsylvestris_NODE_17221_length_1339_cov_7",96.457,254,7,1,4,257,1081,830,1.47e-116,418,253,251
"88958","Ntome_NODE_39562_length_257_cov_3","Nsylvestris_NODE_111_length_8299_cov_158",100,28,0,0,230,257,5257,5230,1.72e-06,52.8,27,27
"88959","Ntome_NODE_39566_length_257_cov_2","Nsylvestris_NODE_33938_length_324_cov_3",88.976,127,13,1,113,239,199,324,1.27e-37,156,126,125
"88960","Ntome_NODE_39567_length_257_cov_2","Nsylvestris_NODE_1595_length_4334_cov_104",97.487,199,4,1,1,199,224,421,1.18e-92,339,198,197
"88964","Ntome_NODE_39572_length_256_cov_323","Nsylvestris_NODE_4077_length_3210_cov_199",96.484,256,9,0,1,256,2568,2313,3.15e-118,424,255,255
"88965","Ntome_NODE_39573_length_256_cov_315","Nsylvestris_NODE_9598_length_2164_cov_227",99.219,256,2,0,1,256,1385,1130,6.67e-130,462,255,255
"88971","Ntome_NODE_39576_length_256_cov_181","Nsylvestris_NODE_17663_length_1297_cov_182",96.602,206,7,0,1,206,1029,1234,9.07e-94,342,205,205
"88972","Ntome_NODE_39577_length_256_cov_32","Nsylvestris_NODE_1990_length_4062_cov_125",86.179,246,20,11,1,245,2221,2453,4.37e-67,254,244,232
"88973","Ntome_NODE_39582_length_256_cov_6","Nsylvestris_NODE_1057_length_4871_cov_222",100,28,0,0,1,28,1203,1176,1.71e-06,52.8,27,27
"88977","Ntome_NODE_39588_length_256_cov_5","Nsylvestris_NODE_7373_length_2509_cov_26",92.462,199,15,0,44,242,91,289,1.55e-76,285,198,198
"88978","Ntome_NODE_39590_length_256_cov_5","Nsylvestris_NODE_25433_length_747_cov_56",95.703,256,11,0,1,256,133,388,6.81e-115,412,255,255
"88982","Ntome_NODE_39595_length_256_cov_4","Nsylvestris_NODE_35268_length_289_cov_3",95.862,145,5,1,113,256,59,203,5.69e-61,233,143,144
"88985","Ntome_NODE_39599_length_256_cov_4","Nsylvestris_NODE_4248_length_3163_cov_95",96.667,240,5,3,19,256,1078,1316,6.86e-110,396,237,238
"88989","Ntome_NODE_39609_length_256_cov_4","Nsylvestris_NODE_6035_length_2754_cov_17",87.234,47,6,0,102,148,297,343,4.76e-07,54.7,46,46
"88993","Ntome_NODE_39619_length_256_cov_3","Nsylvestris_NODE_13560_length_1700_cov_22",96.85,254,8,0,3,256,1058,805,8.75e-119,425,253,253
"88994","Ntome_NODE_39620_length_256_cov_2","Nsylvestris_NODE_899_length_5087_cov_92",82.192,146,17,6,8,149,3972,3832,5.98e-26,117,141,140
"88999","Ntome_NODE_39625_length_255_cov_317","Nsylvestris_NODE_12314_length_1835_cov_261",97.222,252,7,0,4,255,838,587,2.42e-119,427,251,251
"89002","Ntome_NODE_39628_length_255_cov_310","Nsylvestris_NODE_14569_length_1592_cov_192",98.431,255,4,0,1,255,873,619,5.17e-126,449,254,254
"89006","Ntome_NODE_39630_length_255_cov_277","Nsylvestris_NODE_18613_length_1216_cov_165",97.647,255,6,0,1,255,569,823,1.12e-122,438,254,254
"89011","Ntome_NODE_39633_length_255_cov_206","Nsylvestris_NODE_24078_length_827_cov_32",93.651,252,16,0,1,252,345,596,2.47e-104,377,251,251
"89012","Ntome_NODE_39635_length_255_cov_8","Nsylvestris_NODE_31368_length_428_cov_2",96.599,147,5,0,3,149,282,428,2.62e-64,244,146,146
"89013","Ntome_NODE_39641_length_255_cov_5","Nsylvestris_NODE_28530_length_605_cov_6",88.679,53,2,1,174,222,298,350,2.83e-09,62.1,48,52
"89014","Ntome_NODE_39642_length_255_cov_5","Nsylvestris_NODE_4856_length_3006_cov_107",95.294,170,6,1,85,254,2726,2893,1.55e-71,268,169,167
"89015","Ntome_NODE_39644_length_255_cov_5","Nsylvestris_NODE_27582_length_647_cov_40",90.909,253,22,1,1,253,317,568,1.17e-92,339,252,251
"89016","Ntome_NODE_39649_length_255_cov_4","Nsylvestris_NODE_31227_length_437_cov_5",90.09,111,10,1,1,111,110,1,9.83e-34,143,110,109
"89017","Ntome_NODE_39655_length_255_cov_4","Nsylvestris_NODE_35906_length_275_cov_4",97.17,106,3,0,1,106,106,1,7.49e-45,180,105,105
"89018","Ntome_NODE_39657_length_255_cov_4","Nsylvestris_NODE_18017_length_1266_cov_197",100,255,0,0,1,255,711,965,1.1e-132,472,254,254
"89019","Ntome_NODE_39662_length_255_cov_3","Nsylvestris_NODE_4028_length_3225_cov_86",90.083,121,7,3,2,121,2049,1933,1.63e-36,152,119,116
"89020","Ntome_NODE_39664_length_255_cov_3","Nsylvestris_NODE_11_length_12805_cov_33",91.275,149,13,0,3,151,2146,1998,4.44e-52,204,148,148
"89021","Ntome_NODE_39665_length_255_cov_3","Nsylvestris_NODE_19432_length_1150_cov_7",95.946,222,8,1,1,221,427,648,8.96e-99,359,220,221
"89022","Ntome_NODE_39666_length_255_cov_3","Nsylvestris_NODE_2116_length_3981_cov_100",96.838,253,8,0,1,253,3257,3005,3.13e-118,424,252,252
"89029","Ntome_NODE_39682_length_254_cov_348","Nsylvestris_NODE_22709_length_894_cov_142",98.819,254,3,0,1,254,480,227,3.98e-127,453,253,253
"89030","Ntome_NODE_39683_length_254_cov_337","Nsylvestris_NODE_14783_length_1571_cov_170",99.606,254,1,0,1,254,1319,1066,1.84e-130,464,253,253
"89041","Ntome_NODE_39689_length_254_cov_189","Nsylvestris_NODE_639_length_5586_cov_181",95.035,141,7,0,102,242,2026,2166,1.22e-57,222,140,140
"89044","Ntome_NODE_39691_length_254_cov_160","Nsylvestris_NODE_594_length_5718_cov_222",93.725,255,14,2,1,254,273,20,1.9e-105,381,253,253
"89045","Ntome_NODE_39696_length_254_cov_6","Nsylvestris_NODE_3238_length_3495_cov_110",96.97,33,0,1,1,32,1856,1888,4.72e-07,54.7,31,32
"89049","Ntome_NODE_39703_length_254_cov_4","Nsylvestris_NODE_12136_length_1854_cov_101",94.882,254,10,1,1,254,1494,1244,2.45e-109,394,253,250
"89050","Ntome_NODE_39704_length_254_cov_4","Nsylvestris_NODE_7081_length_2556_cov_194",91.266,229,15,5,29,254,803,1029,3.28e-83,307,225,226
"89051","Ntome_NODE_39708_length_254_cov_4","Nsylvestris_NODE_16669_length_1384_cov_71",93.678,174,11,0,4,177,191,18,2.59e-69,261,173,173
"89055","Ntome_NODE_39715_length_254_cov_3","Nsylvestris_NODE_6629_length_2637_cov_55",91.632,239,20,0,1,239,2487,2249,1.95e-90,331,238,238
"89061","Ntome_NODE_39718_length_254_cov_3","Nsylvestris_NODE_20570_length_1059_cov_106",94.366,71,3,1,71,141,397,466,3.57e-23,108,70,69
"89062","Ntome_NODE_39719_length_254_cov_3","Nsylvestris_NODE_25867_length_725_cov_45",91.623,191,11,3,3,191,393,206,9.31e-69,259,188,187
"89063","Ntome_NODE_39724_length_254_cov_3","Nsylvestris_NODE_11211_length_1961_cov_220",86.364,154,13,3,3,154,407,260,2.7e-39,161,151,147
"89064","Ntome_NODE_39726_length_254_cov_3","Nsylvestris_NODE_3788_length_3304_cov_184",96.85,254,8,0,1,254,1603,1350,8.68e-119,425,253,253
"89065","Ntome_NODE_39727_length_254_cov_2","Nsylvestris_NODE_31366_length_428_cov_4",90.65,246,17,4,1,243,186,428,1.17e-87,322,242,242
"89068","Ntome_NODE_39731_length_254_cov_1","Nsylvestris_NODE_14405_length_1610_cov_15",95.669,254,11,0,1,254,1218,965,8.74e-114,409,253,253
"89075","Ntome_NODE_39736_length_253_cov_285","Nsylvestris_NODE_10126_length_2100_cov_77",99.209,253,2,0,1,253,719,467,3.06e-128,457,252,252
"89079","Ntome_NODE_39738_length_253_cov_247","Nsylvestris_NODE_212_length_7274_cov_199",89.883,257,22,2,1,253,331,75,2.51e-89,327,252,256
"89080","Ntome_NODE_39739_length_253_cov_235","Nsylvestris_NODE_4596_length_3075_cov_216",98.182,55,1,0,199,253,1571,1625,7.69e-20,97.1,54,54
"89083","Ntome_NODE_39743_length_253_cov_42","Nsylvestris_NODE_2375_length_3855_cov_86",93.953,215,9,4,1,215,1095,1305,1.17e-87,322,214,210
"89087","Ntome_NODE_39749_length_253_cov_6","Nsylvestris_NODE_22421_length_927_cov_14",96.875,160,5,0,1,160,160,1,1.54e-71,268,159,159
"89092","Ntome_NODE_39759_length_253_cov_4","Nsylvestris_NODE_13710_length_1684_cov_18",97.189,249,7,0,5,253,1478,1230,1.12e-117,422,248,248
"89093","Ntome_NODE_39760_length_253_cov_4","Nsylvestris_NODE_8486_length_2327_cov_19",95.745,47,1,1,10,56,2154,2109,3.6e-13,75,46,45
"89094","Ntome_NODE_39762_length_253_cov_4","Nsylvestris_NODE_2171_length_3953_cov_116",88.333,240,25,1,6,242,733,494,1.53e-76,285,236,239
"89098","Ntome_NODE_39774_length_253_cov_3","Nsylvestris_NODE_20959_length_1031_cov_30",87.671,146,15,3,108,252,203,60,5.78e-41,167,144,143
"89107","Ntome_NODE_39780_length_253_cov_2","Nsylvestris_NODE_36104_length_271_cov_4",96.444,225,8,0,27,251,1,225,1.14e-102,372,224,224
"89108","Ntome_NODE_39783_length_252_cov_319","Nsylvestris_NODE_19129_length_1173_cov_162",92.857,252,18,0,1,252,350,601,5.29e-101,366,251,251
"89111","Ntome_NODE_39785_length_252_cov_265","Nsylvestris_NODE_25991_length_718_cov_44",96.063,254,8,1,1,252,341,594,6.7e-115,412,251,253
"89114","Ntome_NODE_39789_length_252_cov_219","Nsylvestris_NODE_3059_length_3562_cov_193",98.024,253,3,2,1,252,469,720,1.1e-122,438,251,251
"89117","Ntome_NODE_39791_length_252_cov_173","Nsylvestris_NODE_13799_length_1673_cov_71",96.825,252,8,0,1,252,756,505,1.11e-117,422,251,251
"89118","Ntome_NODE_39792_length_252_cov_46","Nsylvestris_NODE_178_length_7523_cov_18",83.036,112,17,2,143,252,49,160,5.92e-21,100,109,111
"89119","Ntome_NODE_39795_length_252_cov_6","Nsylvestris_NODE_11208_length_1962_cov_13",98.413,252,4,0,1,252,662,913,2.37e-124,444,251,251
"89127","Ntome_NODE_39805_length_252_cov_5","Nsylvestris_NODE_7360_length_2511_cov_144",96.047,253,8,2,1,252,326,75,2.41e-114,411,251,251
"89128","Ntome_NODE_39806_length_252_cov_5","Nsylvestris_NODE_810_length_5230_cov_73",95.238,252,12,0,1,252,4474,4725,5.21e-111,399,251,251
"89129","Ntome_NODE_39811_length_252_cov_4","Nsylvestris_NODE_28791_length_593_cov_7",89.952,209,15,6,1,207,532,328,1.98e-70,265,206,204
"89130","Ntome_NODE_39812_length_252_cov_4","Nsylvestris_NODE_24948_length_774_cov_33",94.8,250,13,0,3,252,400,649,3.14e-108,390,249,249
"89131","Ntome_NODE_39815_length_252_cov_4","Nsylvestris_NODE_13812_length_1672_cov_108",89.72,214,10,6,51,252,547,760,7.14e-70,263,201,213
"89132","Ntome_NODE_39817_length_251_cov_4","Nsylvestris_NODE_8861_length_2270_cov_67",90.98,255,17,3,2,250,914,1168,1.15e-92,339,248,254
"89133","Ntome_NODE_39824_length_252_cov_3","Nsylvestris_NODE_8084_length_2390_cov_37",95.294,85,4,0,168,252,55,139,1.62e-31,135,84,84
"89134","Ntome_NODE_39826_length_252_cov_3","Nsylvestris_NODE_8776_length_2284_cov_23",96.429,252,9,0,1,252,1959,2210,5.18e-116,416,251,251
"89137","Ntome_NODE_39829_length_252_cov_3","Nsylvestris_NODE_825_length_5205_cov_125",97.571,247,6,0,6,252,2083,2329,3.09e-118,424,246,246
"89141","Ntome_NODE_39836_length_252_cov_2","Nsylvestris_NODE_1386_length_4504_cov_49",82.927,123,20,1,69,190,3874,3996,9.84e-24,110,121,122
"89142","Ntome_NODE_39837_length_252_cov_2","Nsylvestris_NODE_12068_length_1861_cov_200",95.686,255,8,2,1,252,362,616,3.11e-113,407,251,254
"89149","Ntome_NODE_39842_length_251_cov_379","Nsylvestris_NODE_3109_length_3540_cov_201",99.602,251,1,0,1,251,1794,1544,8.44e-129,459,250,250
"89152","Ntome_NODE_39844_length_251_cov_270","Nsylvestris_NODE_4885_length_2999_cov_182",97.211,251,7,0,1,251,2076,2326,8.56e-119,425,250,250
"89153","Ntome_NODE_39845_length_251_cov_255","Nsylvestris_NODE_18778_length_1204_cov_27",84.496,258,27,9,2,251,955,703,9.25e-64,243,249,252
"89154","Ntome_NODE_39846_length_251_cov_252","Nsylvestris_NODE_18437_length_1229_cov_114",88.158,228,26,1,1,227,374,147,4.25e-72,270,226,227
"89157","Ntome_NODE_39849_length_251_cov_209","Nsylvestris_NODE_5986_length_2763_cov_198",96.063,254,4,3,1,251,2201,1951,8.62e-114,409,250,250
"89158","Ntome_NODE_39850_length_251_cov_164","Nsylvestris_NODE_2813_length_3657_cov_65",96.813,251,7,1,1,251,1830,2079,1.43e-116,418,250,249
"89159","Ntome_NODE_39851_length_251_cov_110","Nsylvestris_NODE_28016_length_628_cov_51",84.615,104,14,1,83,186,326,427,1.64e-21,102,103,101
"89163","Ntome_NODE_39854_length_251_cov_26","Nsylvestris_NODE_14859_length_1564_cov_139",91.228,114,2,1,10,123,1416,1521,2.08e-35,148,113,105
"89172","Ntome_NODE_39858_length_251_cov_9","Nsylvestris_NODE_32708_length_363_cov_51",91.02,245,22,0,7,251,260,16,1.92e-90,331,244,244
"89173","Ntome_NODE_39865_length_251_cov_5","Nsylvestris_NODE_8723_length_2291_cov_203",93.75,240,12,1,15,251,322,83,3.17e-98,357,236,239
"89177","Ntome_NODE_39869_length_251_cov_5","Nsylvestris_NODE_13243_length_1735_cov_20",97.674,86,2,0,90,175,1241,1156,2.08e-35,148,85,85
"89178","Ntome_NODE_39870_length_251_cov_4","Nsylvestris_NODE_22_length_11544_cov_169",88.889,72,7,1,30,101,5431,5501,4.59e-17,87.9,71,70
"89179","Ntome_NODE_39871_length_251_cov_4","Nsylvestris_NODE_255_length_6967_cov_81",100,39,0,0,1,39,1145,1107,1.28e-12,73.1,38,38
"89180","Ntome_NODE_39872_length_251_cov_4","Nsylvestris_NODE_35967_length_274_cov_2",96.216,185,7,0,67,251,4,188,4.19e-82,303,184,184
"89181","Ntome_NODE_39878_length_251_cov_4","Nsylvestris_NODE_6529_length_2656_cov_114",95.652,69,3,0,162,230,852,920,2.72e-24,111,68,68
"89182","Ntome_NODE_39879_length_251_cov_4","Nsylvestris_NODE_19299_length_1161_cov_26",85.088,228,32,2,25,251,860,1086,2e-60,231,226,226
"89183","Ntome_NODE_39882_length_251_cov_4","Nsylvestris_NODE_19095_length_1176_cov_88",83.019,159,12,5,26,177,721,871,7.52e-30,130,151,150
"89184","Ntome_NODE_39883_length_251_cov_3","Nsylvestris_NODE_30767_length_467_cov_10",95.652,161,7,0,1,161,307,467,9.19e-69,259,160,160
"89185","Ntome_NODE_39885_length_251_cov_3","Nsylvestris_NODE_24822_length_782_cov_18",92.593,216,16,0,1,216,206,421,2.5e-84,311,215,215
"89190","Ntome_NODE_39890_length_251_cov_3","Nsylvestris_NODE_1026_length_4902_cov_190",92.913,254,15,2,1,251,3870,3617,5.26e-101,366,250,253
"89191","Ntome_NODE_39892_length_251_cov_3","Nsylvestris_NODE_20709_length_1049_cov_23",96.443,253,7,1,1,251,954,702,5.15e-116,416,250,252
"89192","Ntome_NODE_39899_length_251_cov_2","Nsylvestris_NODE_5830_length_2796_cov_14",93.651,252,15,1,1,251,1456,1707,8.75e-104,375,250,251
"89193","Ntome_NODE_39900_length_251_cov_2","Nsylvestris_NODE_7150_length_2544_cov_80",81.081,148,23,5,2,147,457,601,7.57e-25,113,145,144
"89198","Ntome_NODE_39905_length_250_cov_203","Nsylvestris_NODE_16796_length_1372_cov_234",95.337,193,9,0,1,193,1143,1335,3.22e-83,307,192,192
"89199","Ntome_NODE_39908_length_250_cov_13","Nsylvestris_NODE_9971_length_2119_cov_213",93.277,119,6,2,117,235,2065,1949,3.41e-43,174,118,116
"89207","Ntome_NODE_39918_length_250_cov_5","Nsylvestris_NODE_11384_length_1944_cov_37",91.165,249,22,0,2,250,292,44,1.14e-92,339,248,248
"89208","Ntome_NODE_39921_length_250_cov_4","Nsylvestris_NODE_1868_length_4137_cov_64",95.6,250,11,0,1,250,3179,2930,1.44e-111,401,249,249
"89209","Ntome_NODE_39923_length_250_cov_4","Nsylvestris_NODE_36522_length_262_cov_2",92.105,190,12,2,56,245,261,75,1.97e-70,265,189,186
"89210","Ntome_NODE_39927_length_250_cov_4","Nsylvestris_NODE_1752_length_4213_cov_121",88.288,222,12,5,1,221,103,311,4.26e-67,254,220,208
"89216","Ntome_NODE_39949_length_250_cov_3","Nsylvestris_NODE_31889_length_399_cov_3",92.035,113,6,1,1,110,115,3,1.23e-37,156,109,112
"89217","Ntome_NODE_39950_length_250_cov_3","Nsylvestris_NODE_6613_length_2639_cov_148",94.231,52,2,1,93,144,2504,2454,2.75e-14,78.7,51,50
