"","Query.seq.ID","Subject.seq.ID","X.ID","Alignment.length","X..mismatches","X..gap.openings","start.in.query","end.in.query","start.in.subject","end.in.subject","evalue","bitscore","match.length.query","match.length.subject"
"183","Nsylvestris_NODE_31_length_10192_cov_149","Ntome_NODE_41_length_10213_cov_186",97.736,10157,195,8,40,10175,71,10213,0,17450,10135,10142
"433","Nsylvestris_NODE_81_length_8791_cov_210","Ntome_NODE_77_length_8856_cov_268",97.295,8723,208,14,74,8791,25,8724,0,14776,8717,8699
"434","Nsylvestris_NODE_82_length_8789_cov_19","Ntome_NODE_51_length_9742_cov_60",78.893,3956,776,47,4702,8627,5578,1652,0,2625,3925,3926
"640","Nsylvestris_NODE_122_length_8122_cov_92","Ntome_NODE_138_length_7978_cov_141",97.722,7989,141,13,62,8022,1,7976,0,13706,7960,7975
"649","Nsylvestris_NODE_124_length_8100_cov_69","Ntome_NODE_2522_length_3898_cov_200",86.614,127,16,1,70,196,571,696,4.75e-31,139,126,125
"834","Nsylvestris_NODE_160_length_7658_cov_230","Ntome_NODE_162_length_7696_cov_302",97.652,7667,163,7,1,7658,31,7689,0,13145,7657,7658
"905","Nsylvestris_NODE_175_length_7533_cov_28","Ntome_NODE_1290_length_4743_cov_26",85.092,1516,191,21,3778,5262,4157,2646,0,1515,1484,1511
"1049","Nsylvestris_NODE_205_length_7311_cov_116","Ntome_NODE_109_length_8334_cov_78",97.06,7142,192,7,35,7162,8334,1197,0,12009,7127,7137
"1109","Nsylvestris_NODE_219_length_7205_cov_36","Ntome_NODE_4576_length_3187_cov_50",94.103,2781,131,14,4423,7191,2787,28,0,4196,2768,2759
"1303","Nsylvestris_NODE_263_length_6934_cov_93","Ntome_NODE_311_length_6659_cov_97",95.917,6612,208,18,194,6799,55,6610,0,10658,6605,6555
"1320","Nsylvestris_NODE_268_length_6861_cov_46","Ntome_NODE_146_length_7881_cov_69",97.273,5831,150,3,165,5992,2057,7881,0,9878,5827,5824
"1512","Nsylvestris_NODE_315_length_6651_cov_86","Ntome_NODE_21373_length_1090_cov_65",88.406,69,5,3,491,557,1016,949,2.4e-13,80.5,66,67
"1692","Nsylvestris_NODE_348_length_6485_cov_17","Ntome_NODE_16218_length_1519_cov_285",96.61,59,2,0,6155,6213,467,409,6.45e-19,99,58,58
"1736","Nsylvestris_NODE_359_length_6446_cov_171","Ntome_NODE_351_length_6498_cov_169",97.08,6405,159,12,33,6427,36,6422,0,10767,6394,6386
"1766","Nsylvestris_NODE_367_length_6417_cov_133","Ntome_NODE_364_length_6448_cov_107",98.133,6053,108,3,344,6392,381,6432,0,10547,6048,6051
"2018","Nsylvestris_NODE_417_length_6227_cov_125","Ntome_NODE_24255_length_909_cov_43",81.197,117,22,0,5665,5781,332,216,8.01e-18,95.3,116,116
"2074","Nsylvestris_NODE_429_length_6174_cov_233","Ntome_NODE_454_length_6143_cov_308",97.895,5892,103,7,244,6120,5888,3,0,10174,5876,5885
"2217","Nsylvestris_NODE_463_length_6057_cov_159","Ntome_NODE_391_length_6343_cov_169",97.28,5808,149,3,259,6057,6297,490,0,9841,5798,5807
"2290","Nsylvestris_NODE_481_length_6006_cov_227","Ntome_NODE_442_length_6185_cov_261",98.062,5986,83,9,7,5981,88,6051,0,10381,5974,5963
"2321","Nsylvestris_NODE_489_length_5990_cov_82","Ntome_NODE_50_length_9746_cov_61",96.968,5672,139,7,325,5990,4071,9715,0,9491,5665,5644
"2348","Nsylvestris_NODE_496_length_5976_cov_196","Ntome_NODE_381_length_6392_cov_208",97.989,5966,108,5,1,5960,6059,100,0,10342,5959,5959
"2525","Nsylvestris_NODE_536_length_5858_cov_27","Ntome_NODE_207_length_7386_cov_127",75.37,540,113,14,5052,5581,3249,2720,2.54e-62,243,529,529
"2708","Nsylvestris_NODE_573_length_5765_cov_181","Ntome_NODE_821_length_5351_cov_301",96.641,5031,158,4,743,5765,231,5258,0,8344,5022,5027
"2836","Nsylvestris_NODE_600_length_5707_cov_34","Ntome_NODE_9819_length_2222_cov_239",92.469,239,12,2,5036,5273,1614,1381,1.1e-90,337,237,233
"2947","Nsylvestris_NODE_623_length_5646_cov_160","Ntome_NODE_868_length_5269_cov_120",95.506,89,4,0,254,342,1922,1834,2.56e-32,143,88,88
"2962","Nsylvestris_NODE_628_length_5634_cov_44","Ntome_NODE_9421_length_2278_cov_63",88.034,234,24,4,5219,5451,404,174,8.67e-72,274,232,230
"2972","Nsylvestris_NODE_632_length_5617_cov_228","Ntome_NODE_569_length_5831_cov_290",96.078,5635,161,27,20,5612,169,5785,0,9127,5592,5616
"3049","Nsylvestris_NODE_648_length_5555_cov_57","Ntome_NODE_9821_length_2222_cov_188",85.631,515,68,4,876,1384,1627,2141,9.87e-151,536,508,514
"3169","Nsylvestris_NODE_678_length_5498_cov_103","Ntome_NODE_5868_length_2880_cov_74",92.584,418,19,5,49,466,456,51,7.39e-167,590,417,405
"3299","Nsylvestris_NODE_710_length_5408_cov_215","Ntome_NODE_796_length_5390_cov_268",96.411,5377,135,16,19,5375,43,5381,0,8807,5356,5338
"3335","Nsylvestris_NODE_718_length_5403_cov_61","Ntome_NODE_2641_length_3843_cov_37",79.781,821,160,6,4528,5344,2853,3671,2.02e-167,592,816,818
"3367","Nsylvestris_NODE_726_length_5395_cov_45","Ntome_NODE_37071_length_309_cov_4",90.566,318,20,6,3333,3649,309,1,1.69e-113,412,316,308
"3438","Nsylvestris_NODE_745_length_5355_cov_151","Ntome_NODE_15_length_12070_cov_222",81.765,170,23,5,2232,2397,7058,6893,4.05e-30,135,165,165
"3453","Nsylvestris_NODE_749_length_5353_cov_163","Ntome_NODE_875_length_5260_cov_302",80,105,16,5,2784,2886,3211,3312,3.22e-11,73.1,102,101
"3502","Nsylvestris_NODE_762_length_5315_cov_152","Ntome_NODE_56_length_9642_cov_224",97.356,5333,123,3,1,5315,1743,7075,0,9051,5314,5332
"3673","Nsylvestris_NODE_802_length_5245_cov_54","Ntome_NODE_7697_length_2541_cov_81",88.506,87,10,0,254,340,522,608,3.11e-21,106,86,86
"3674","Nsylvestris_NODE_803_length_5241_cov_24","Ntome_NODE_5351_length_2997_cov_15",100,45,0,0,1,45,1532,1576,1.46e-14,84.2,44,44
"3853","Nsylvestris_NODE_845_length_5164_cov_145","Ntome_NODE_2778_length_3777_cov_226",95.896,3338,135,1,106,3443,92,3427,0,5404,3337,3335
"3859","Nsylvestris_NODE_847_length_5160_cov_187","Ntome_NODE_849_length_5308_cov_224",96.309,5175,158,13,1,5160,30,5186,0,8468,5159,5156
"3966","Nsylvestris_NODE_872_length_5122_cov_205","Ntome_NODE_866_length_5276_cov_251",95.885,5128,155,27,4,5088,29,5143,0,8250,5084,5114
"3972","Nsylvestris_NODE_874_length_5121_cov_65","Ntome_NODE_1142_length_4905_cov_21",77.032,1206,229,29,375,1549,3368,4556,0,649,1174,1188
"4089","Nsylvestris_NODE_895_length_5095_cov_203","Ntome_NODE_1750_length_4343_cov_290",97.964,4175,75,4,306,4478,34,4200,0,7230,4172,4166
"4105","Nsylvestris_NODE_901_length_5088_cov_125","Ntome_NODE_943_length_5172_cov_240",95.638,5043,191,12,18,5048,5172,147,0,8067,5030,5025
"4199","Nsylvestris_NODE_912_length_5073_cov_236","Ntome_NODE_954_length_5159_cov_303",97.953,4983,91,4,52,5032,5012,39,0,8626,4980,4973
"4237","Nsylvestris_NODE_919_length_5061_cov_109","Ntome_NODE_1288_length_4745_cov_155",97.517,4470,102,5,39,4504,4601,137,0,7631,4465,4464
"4257","Nsylvestris_NODE_925_length_5053_cov_43","Ntome_NODE_1132_length_4916_cov_30",96.469,4899,158,7,1,4898,4885,1,0,8074,4897,4884
"4278","Nsylvestris_NODE_933_length_5044_cov_195","Ntome_NODE_1158_length_4886_cov_229",96.774,31,1,0,3786,3816,3004,2974,3.96e-05,52.8,30,30
"4429","Nsylvestris_NODE_975_length_4986_cov_44","Ntome_NODE_1222_length_4811_cov_114",94.961,3235,157,4,1624,4852,1,3235,0,5066,3228,3234
"4482","Nsylvestris_NODE_989_length_4970_cov_182","Ntome_NODE_1143_length_4904_cov_140",96.394,4908,121,27,109,4970,4902,5,0,8032,4861,4897
"4546","Nsylvestris_NODE_1003_length_4950_cov_183","Ntome_NODE_62_length_9425_cov_190",94.729,4420,167,13,246,4663,9083,4728,0,6811,4417,4355
"4569","Nsylvestris_NODE_1010_length_4933_cov_58","Ntome_NODE_13001_length_1842_cov_220",93.263,950,37,10,3993,4931,894,1827,0,1375,938,933
"4753","Nsylvestris_NODE_1054_length_4875_cov_139","Ntome_NODE_1183_length_4859_cov_78",94.595,37,2,0,2680,2716,3897,3861,8.21e-07,58.4,36,36
"4836","Nsylvestris_NODE_1077_length_4842_cov_82","Ntome_NODE_390_length_6347_cov_174",76.159,151,30,5,3410,3557,1684,1537,8.1e-12,75,147,147
"4878","Nsylvestris_NODE_1080_length_4839_cov_38","Ntome_NODE_1637_length_4430_cov_36",97.032,4380,123,5,459,4831,4380,1,0,7361,4372,4379
"5025","Nsylvestris_NODE_1115_length_4807_cov_235","Ntome_NODE_30796_length_596_cov_13",90.461,304,22,4,2973,3276,403,107,5.44e-108,394,303,296
"5100","Nsylvestris_NODE_1134_length_4772_cov_171","Ntome_NODE_2961_length_3715_cov_196",92.765,3193,162,20,110,3241,3665,481,0,4553,3131,3184
"5201","Nsylvestris_NODE_1158_length_4748_cov_123","Ntome_NODE_1099_length_4946_cov_245",96.375,4662,149,7,52,4698,81,4737,0,7655,4646,4656
"5234","Nsylvestris_NODE_1169_length_4730_cov_53","Ntome_NODE_374_length_6421_cov_111",96.553,4526,111,18,135,4649,55,4546,0,7452,4514,4491
"5340","Nsylvestris_NODE_1191_length_4709_cov_224","Ntome_NODE_1139_length_4908_cov_252",97.342,4627,92,13,2,4625,4599,1,0,7834,4623,4598
"5393","Nsylvestris_NODE_1205_length_4701_cov_118","Ntome_NODE_35011_length_374_cov_4",91.733,375,30,1,3926,4300,374,1,8.4e-146,520,374,373
"5472","Nsylvestris_NODE_1227_length_4677_cov_68","Ntome_NODE_38371_length_281_cov_2",88.06,134,11,2,3304,3432,267,134,9.77e-36,154,128,133
"5754","Nsylvestris_NODE_1292_length_4603_cov_182","Ntome_NODE_1650_length_4421_cov_190",96.349,4245,134,9,229,4462,46,4280,0,6961,4233,4234
"5857","Nsylvestris_NODE_1314_length_4584_cov_117","Ntome_NODE_1298_length_4731_cov_94",95.724,4537,143,23,74,4578,141,4658,0,7256,4504,4517
"6035","Nsylvestris_NODE_1348_length_4553_cov_158","Ntome_NODE_228_length_7228_cov_122",95.491,3903,175,1,373,4275,4568,667,0,6231,3902,3901
"6042","Nsylvestris_NODE_1351_length_4547_cov_227","Ntome_NODE_1541_length_4502_cov_287",95.308,4454,172,12,6,4440,4502,67,0,7033,4434,4435
"6099","Nsylvestris_NODE_1366_length_4530_cov_27","Ntome_NODE_16744_length_1472_cov_10",90.692,1214,107,5,5,1213,1213,1,0,1611,1208,1212
"6167","Nsylvestris_NODE_1385_length_4505_cov_56","Ntome_NODE_23376_length_961_cov_183",80.546,586,91,17,3908,4478,608,31,1.4e-118,429,570,577
"6245","Nsylvestris_NODE_1403_length_4492_cov_25","Ntome_NODE_4088_length_3323_cov_153",93.75,64,4,0,4429,4492,412,475,1.6e-18,97.1,63,63
"6254","Nsylvestris_NODE_1406_length_4487_cov_100","Ntome_NODE_2344_length_3987_cov_221",83.333,96,14,2,3694,3788,1447,1353,9.65e-16,87.9,94,94
"6447","Nsylvestris_NODE_1454_length_4445_cov_170","Ntome_NODE_1752_length_4341_cov_22",96.204,4347,140,13,73,4403,4,4341,0,7090,4330,4337
"6448","Nsylvestris_NODE_1455_length_4440_cov_22","Ntome_NODE_12046_length_1952_cov_142",98.077,52,1,0,4388,4439,697,646,7.38e-17,91.6,51,51
"6458","Nsylvestris_NODE_1458_length_4436_cov_125","Ntome_NODE_2041_length_4147_cov_275",96.59,3079,80,13,1320,4381,918,3988,0,5081,3061,3070
"6497","Nsylvestris_NODE_1468_length_4429_cov_69","Ntome_NODE_247_length_7111_cov_91",97.81,137,3,0,1,137,2661,2797,8.93e-61,237,136,136
"6527","Nsylvestris_NODE_1475_length_4421_cov_114","Ntome_NODE_2286_length_4014_cov_121",95.832,3959,122,12,447,4378,42,3984,0,6357,3931,3942
"6555","Nsylvestris_NODE_1483_length_4412_cov_12","Ntome_NODE_1417_length_4614_cov_68",93.462,4451,233,14,1,4412,4578,147,0,6554,4411,4431
"6578","Nsylvestris_NODE_1489_length_4405_cov_231","Ntome_NODE_405_length_6296_cov_301",97.995,4339,68,4,1,4339,1922,6241,0,7513,4338,4319
"6607","Nsylvestris_NODE_1496_length_4403_cov_97","Ntome_NODE_1676_length_4407_cov_65",95.602,4184,151,7,52,4216,238,4407,0,6676,4164,4169
"6630","Nsylvestris_NODE_1502_length_4395_cov_193","Ntome_NODE_2523_length_3897_cov_215",96.717,3868,91,14,371,4217,45,3897,0,6407,3846,3852
"6719","Nsylvestris_NODE_1520_length_4382_cov_224","Ntome_NODE_1365_length_4662_cov_273",96.856,4358,121,8,1,4345,133,4487,0,7275,4344,4354
"6738","Nsylvestris_NODE_1525_length_4376_cov_205","Ntome_NODE_1555_length_4491_cov_264",97.62,4328,89,10,61,4376,4462,137,0,7409,4315,4325
"6783","Nsylvestris_NODE_1536_length_4371_cov_182","Ntome_NODE_2791_length_3774_cov_273",94.692,3674,145,21,733,4367,3664,2,0,5659,3634,3662
"6936","Nsylvestris_NODE_1575_length_4347_cov_74","Ntome_NODE_2175_length_4074_cov_162",95.112,2046,91,8,2306,4347,3939,1899,0,3216,2041,2040
"6956","Nsylvestris_NODE_1581_length_4344_cov_140","Ntome_NODE_155_length_7801_cov_223",96.277,3922,118,6,307,4204,3832,7749,0,6408,3897,3917
"7030","Nsylvestris_NODE_1599_length_4330_cov_231","Ntome_NODE_114_length_8248_cov_183",96.613,4163,122,13,143,4293,4079,8234,0,6889,4150,4155
"7097","Nsylvestris_NODE_1617_length_4318_cov_34","Ntome_NODE_5020_length_3075_cov_95",83.75,80,12,1,101,180,3058,2980,7.23e-12,75,79,78
"7122","Nsylvestris_NODE_1624_length_4314_cov_47","Ntome_NODE_32858_length_488_cov_4",87.309,457,50,8,3819,4271,488,36,9.98e-145,516,452,452
"7132","Nsylvestris_NODE_1626_length_4313_cov_129","Ntome_NODE_1900_length_4235_cov_126",97.548,4241,83,7,58,4294,1,4224,0,7236,4236,4223
"7184","Nsylvestris_NODE_1642_length_4298_cov_28","Ntome_NODE_995_length_5098_cov_42",80.714,2857,514,26,1257,4099,2891,58,0,2189,2842,2833
"7343","Nsylvestris_NODE_1680_length_4269_cov_80","Ntome_NODE_948_length_5168_cov_80",96.804,4099,125,4,94,4190,4108,14,0,6839,4096,4094
"7365","Nsylvestris_NODE_1687_length_4265_cov_167","Ntome_NODE_1428_length_4602_cov_80",94.729,3567,153,13,291,3839,907,4456,0,5513,3548,3549
"7533","Nsylvestris_NODE_1728_length_4229_cov_226","Ntome_NODE_1020_length_5064_cov_272",95.155,4169,190,6,68,4229,5017,854,0,6569,4161,4163
"7661","Nsylvestris_NODE_1755_length_4212_cov_222","Ntome_NODE_897_length_5233_cov_251",97.186,4193,113,4,1,4189,999,5190,0,7084,4188,4191
"7687","Nsylvestris_NODE_1761_length_4207_cov_231","Ntome_NODE_1685_length_4397_cov_288",96.799,4218,110,12,1,4206,59,4263,0,7018,4205,4204
"7743","Nsylvestris_NODE_1774_length_4193_cov_175","Ntome_NODE_2615_length_3852_cov_263",96.987,3585,94,3,3,3573,94,3678,0,6010,3570,3584
"7788","Nsylvestris_NODE_1784_length_4187_cov_161","Ntome_NODE_5398_length_2985_cov_273",96.873,2686,62,8,1403,4068,2778,95,0,4475,2665,2683
"7833","Nsylvestris_NODE_1795_length_4182_cov_77","Ntome_NODE_13580_length_1778_cov_214",88.811,143,14,2,2840,2980,247,105,6.71e-42,174,140,142
"7842","Nsylvestris_NODE_1798_length_4179_cov_146","Ntome_NODE_2072_length_4128_cov_235",95.311,4073,131,28,58,4107,42,4077,0,6408,4049,4035
"7874","Nsylvestris_NODE_1806_length_4170_cov_141","Ntome_NODE_2016_length_4161_cov_219",95.711,4057,117,23,37,4043,112,4161,0,6475,4006,4049
"7883","Nsylvestris_NODE_1809_length_4167_cov_113","Ntome_NODE_2559_length_3879_cov_300",97.95,3658,72,3,239,3894,183,3839,0,6336,3655,3656
"8081","Nsylvestris_NODE_1853_length_4147_cov_145","Ntome_NODE_1653_length_4420_cov_228",97.283,4086,102,7,69,4147,4294,211,0,6922,4078,4083
"8102","Nsylvestris_NODE_1858_length_4145_cov_59","Ntome_NODE_458_length_6137_cov_152",95.496,4152,154,19,1,4130,1962,6102,0,6601,4129,4140
"8271","Nsylvestris_NODE_1896_length_4120_cov_101","Ntome_NODE_2060_length_4135_cov_74",94.483,4133,149,46,32,4120,4135,38,0,6296,4088,4097
"8317","Nsylvestris_NODE_1907_length_4109_cov_237","Ntome_NODE_22_length_11398_cov_308",98.145,3990,73,1,121,4109,1,3990,0,6957,3988,3989
"8335","Nsylvestris_NODE_1913_length_4104_cov_108","Ntome_NODE_2121_length_4098_cov_51",96.76,3920,120,4,95,4013,4047,134,0,6529,3918,3913
"8381","Nsylvestris_NODE_1927_length_4097_cov_54","Ntome_NODE_19451_length_1236_cov_13",98.182,55,1,0,1,55,1015,961,1.46e-18,97.1,54,54
"8409","Nsylvestris_NODE_1938_length_4092_cov_229","Ntome_NODE_2216_length_4051_cov_265",97.194,3599,72,9,264,3861,3842,272,0,6059,3597,3570
"8508","Nsylvestris_NODE_1959_length_4078_cov_136","Ntome_NODE_1374_length_4655_cov_176",95.699,3511,120,19,580,4078,3597,106,0,5618,3498,3491
"8570","Nsylvestris_NODE_1975_length_4069_cov_213","Ntome_NODE_328_length_6607_cov_250",96.877,3907,96,9,99,3993,2645,6537,0,6516,3894,3892
"8632","Nsylvestris_NODE_1988_length_4063_cov_181","Ntome_NODE_1913_length_4227_cov_203",95.864,4038,127,18,1,4017,166,4184,0,6495,4016,4018
"8694","Nsylvestris_NODE_2005_length_4049_cov_223","Ntome_NODE_222_length_7262_cov_259",96.706,4068,114,5,2,4049,1,4068,0,6752,4047,4067
"8743","Nsylvestris_NODE_2019_length_4042_cov_69","Ntome_NODE_1005_length_5084_cov_186",92.933,566,29,8,2620,3183,4354,4910,0,813,563,556
"8771","Nsylvestris_NODE_2026_length_4037_cov_106","Ntome_NODE_18128_length_1348_cov_210",97.059,34,0,1,9,41,34,1,2.45e-06,56.5,32,33
"8807","Nsylvestris_NODE_2035_length_4032_cov_82","Ntome_NODE_1819_length_4295_cov_49",95.907,3982,118,7,3,3982,18,3956,0,6408,3979,3938
"8825","Nsylvestris_NODE_2041_length_4029_cov_71","Ntome_NODE_16176_length_1524_cov_85",95.802,810,33,1,2495,3304,842,34,0,1306,809,808
"8942","Nsylvestris_NODE_2070_length_4011_cov_26","Ntome_NODE_38927_length_269_cov_3",97.77,269,6,0,2606,2874,269,1,3.41e-129,464,268,268
"8959","Nsylvestris_NODE_2075_length_4009_cov_91","Ntome_NODE_3014_length_3694_cov_119",97.626,3581,77,3,436,4009,96,3675,0,6135,3573,3579
"8978","Nsylvestris_NODE_2082_length_4005_cov_28","Ntome_NODE_3512_length_3513_cov_193",83.333,234,35,4,2583,2814,546,777,1.36e-53,213,231,231
"9012","Nsylvestris_NODE_2092_length_4000_cov_35","Ntome_NODE_2786_length_3775_cov_278",96.364,55,2,0,3946,4000,808,754,6.64e-17,91.6,54,54
"9013","Nsylvestris_NODE_2093_length_3999_cov_136","Ntome_NODE_2457_length_3927_cov_57",95.732,3889,122,19,1,3869,3923,59,0,6222,3868,3864
"9031","Nsylvestris_NODE_2097_length_3995_cov_89","Ntome_NODE_31960_length_553_cov_6",94.595,37,1,1,713,749,174,139,2.42e-06,56.5,36,35
"9032","Nsylvestris_NODE_2098_length_3995_cov_15","Ntome_NODE_25451_length_836_cov_4",89.58,691,71,1,1,691,146,835,0,876,690,689
"9161","Nsylvestris_NODE_2123_length_3979_cov_62","Ntome_NODE_23395_length_960_cov_264",96.117,103,4,0,2,104,313,211,2.97e-40,169,102,102
"9196","Nsylvestris_NODE_2130_length_3974_cov_62","Ntome_NODE_18259_length_1337_cov_108",78.761,791,144,12,2908,3678,81,867,1.54e-142,508,770,786
"9259","Nsylvestris_NODE_2148_length_3965_cov_56","Ntome_NODE_2253_length_4032_cov_53",94.908,3947,191,5,1,3946,95,4032,0,6167,3945,3937
"9281","Nsylvestris_NODE_2153_length_3963_cov_11","Ntome_NODE_7270_length_2610_cov_164",90.873,252,20,2,3713,3963,15,264,2.75e-90,335,250,249
"9442","Nsylvestris_NODE_2190_length_3940_cov_200","Ntome_NODE_3875_length_3395_cov_278",96.163,3362,94,7,71,3408,1,3351,0,5461,3337,3350
"9518","Nsylvestris_NODE_2209_length_3933_cov_132","Ntome_NODE_377_length_6408_cov_117",97.954,3275,55,10,1,3270,3054,6321,0,5666,3269,3267
"9600","Nsylvestris_NODE_2228_length_3923_cov_144","Ntome_NODE_2329_length_3994_cov_164",95.841,3823,127,14,75,3872,89,3904,0,6150,3797,3815
"9686","Nsylvestris_NODE_2253_length_3913_cov_88","Ntome_NODE_1332_length_4699_cov_92",98.827,3581,42,0,273,3853,3583,3,0,6381,3580,3580
"9712","Nsylvestris_NODE_2260_length_3910_cov_75","Ntome_NODE_10517_length_2130_cov_196",96.979,1920,56,2,1908,3826,1,1919,0,3223,1918,1918
"9795","Nsylvestris_NODE_2280_length_3902_cov_113","Ntome_NODE_2688_length_3820_cov_60",95.492,3394,111,23,288,3644,58,3446,0,5382,3356,3388
"9800","Nsylvestris_NODE_2282_length_3900_cov_224","Ntome_NODE_2243_length_4038_cov_279",96.577,3856,79,13,46,3897,175,3981,0,6340,3851,3806
"9812","Nsylvestris_NODE_2286_length_3899_cov_160","Ntome_NODE_988_length_5108_cov_217",94.582,2916,120,14,185,3089,5049,2161,0,4475,2904,2888
"9831","Nsylvestris_NODE_2290_length_3898_cov_70","Ntome_NODE_2425_length_3946_cov_63",95.56,3671,136,6,251,3898,3671,5,0,5851,3647,3666
"9855","Nsylvestris_NODE_2296_length_3895_cov_161","Ntome_NODE_2503_length_3905_cov_212",97.743,3899,53,8,1,3881,3882,1,0,6680,3880,3881
"9869","Nsylvestris_NODE_2299_length_3893_cov_228","Ntome_NODE_2884_length_3745_cov_160",96.839,3543,108,3,273,3811,3665,123,0,5919,3538,3542
"9937","Nsylvestris_NODE_2321_length_3884_cov_213","Ntome_NODE_1739_length_4353_cov_236",96.164,3858,112,14,1,3834,4187,342,0,6272,3833,3845
"9968","Nsylvestris_NODE_2329_length_3881_cov_160","Ntome_NODE_3138_length_3643_cov_49",95.339,3669,119,20,41,3683,3643,1,0,5781,3642,3642
"9980","Nsylvestris_NODE_2333_length_3881_cov_52","Ntome_NODE_2102_length_4109_cov_77",94.986,3829,187,3,53,3881,4060,237,0,6002,3828,3823
"10018","Nsylvestris_NODE_2343_length_3874_cov_88","Ntome_NODE_371_length_6431_cov_247",98.214,56,0,1,3820,3874,5708,5763,1.38e-18,97.1,54,55
"10048","Nsylvestris_NODE_2351_length_3869_cov_169","Ntome_NODE_211_length_7361_cov_225",98.182,55,1,0,3815,3869,862,808,1.38e-18,97.1,54,54
"10076","Nsylvestris_NODE_2360_length_3867_cov_34","Ntome_NODE_13165_length_1824_cov_17",94.577,1807,86,4,2023,3826,1,1798,0,2784,1803,1797
"10084","Nsylvestris_NODE_2363_length_3861_cov_220","Ntome_NODE_255_length_7035_cov_303",99.013,3445,34,0,417,3861,6688,3244,0,6174,3444,3444
"10148","Nsylvestris_NODE_2376_length_3855_cov_23","Ntome_NODE_6779_length_2698_cov_48",83.404,2350,365,19,214,2555,227,2559,0,2156,2341,2332
"10154","Nsylvestris_NODE_2379_length_3854_cov_25","Ntome_NODE_3174_length_3629_cov_221",94.688,753,26,4,2997,3748,1165,1904,0,1157,751,739
"10209","Nsylvestris_NODE_2394_length_3844_cov_20","Ntome_NODE_14087_length_1729_cov_7",82.836,134,19,3,128,258,1728,1596,1.05e-24,117,130,132
"10210","Nsylvestris_NODE_2395_length_3842_cov_210","Ntome_NODE_2550_length_3884_cov_245",97.416,3792,82,7,1,3780,56,3843,0,6445,3779,3787
"10240","Nsylvestris_NODE_2403_length_3839_cov_75","Ntome_NODE_309_length_6664_cov_209",96.747,3658,116,2,182,3839,6487,2833,0,6093,3657,3654
"10260","Nsylvestris_NODE_2408_length_3837_cov_140","Ntome_NODE_6684_length_2715_cov_285",84.844,1887,272,8,1454,3339,433,2306,0,1888,1885,1873
"10331","Nsylvestris_NODE_2424_length_3829_cov_166","Ntome_NODE_2921_length_3728_cov_42",95.975,3627,86,18,49,3620,107,3728,0,5834,3571,3621
"10355","Nsylvestris_NODE_2431_length_3825_cov_140","Ntome_NODE_2085_length_4115_cov_260",94.453,3714,119,31,4,3680,128,3791,0,5637,3676,3663
"10480","Nsylvestris_NODE_2460_length_3809_cov_226","Ntome_NODE_3025_length_3689_cov_260",96.499,3656,88,12,159,3788,46,3687,0,6006,3629,3641
"10607","Nsylvestris_NODE_2492_length_3798_cov_189","Ntome_NODE_998_length_5095_cov_262",95.549,3640,109,22,142,3750,1347,4964,0,5775,3608,3617
"10619","Nsylvestris_NODE_2495_length_3797_cov_205","Ntome_NODE_1276_length_4754_cov_105",95.909,3691,124,13,6,3695,4754,1090,0,5954,3689,3664
"10649","Nsylvestris_NODE_2500_length_3794_cov_97","Ntome_NODE_5630_length_2932_cov_38",95.595,2656,111,2,161,2810,54,2709,0,4252,2649,2655
"10760","Nsylvestris_NODE_2526_length_3780_cov_208","Ntome_NODE_2870_length_3749_cov_250",95.389,3687,109,21,109,3770,50,3700,0,5810,3661,3650
"10825","Nsylvestris_NODE_2544_length_3771_cov_82","Ntome_NODE_2653_length_3836_cov_138",95.084,3702,171,4,18,3710,3788,89,0,5818,3692,3699
"10826","Nsylvestris_NODE_2545_length_3771_cov_51","Ntome_NODE_2485_length_3915_cov_93",94.118,51,3,0,3640,3690,1027,977,4.87e-13,78.7,50,50
"10945","Nsylvestris_NODE_2572_length_3759_cov_230","Ntome_NODE_2623_length_3849_cov_293",96.704,3732,101,9,13,3729,3794,70,0,6191,3716,3724
"10946","Nsylvestris_NODE_2573_length_3759_cov_153","Ntome_NODE_4832_length_3126_cov_18",97.618,3148,51,4,212,3357,1,3126,0,5376,3145,3125
"11031","Nsylvestris_NODE_2594_length_3748_cov_74","Ntome_NODE_4604_length_3179_cov_19",88.201,3119,338,16,151,3260,82,3179,0,3694,3109,3097
"11036","Nsylvestris_NODE_2596_length_3746_cov_219","Ntome_NODE_3597_length_3485_cov_223",94.342,3429,127,26,40,3424,26,3431,0,5195,3384,3405
"11073","Nsylvestris_NODE_2604_length_3744_cov_34","Ntome_NODE_2543_length_3888_cov_80",95.828,3691,136,5,61,3744,77,3756,0,5947,3683,3679
"11161","Nsylvestris_NODE_2625_length_3730_cov_103","Ntome_NODE_33358_length_454_cov_4",96.744,430,14,0,813,1242,1,430,0,717,429,429
"11214","Nsylvestris_NODE_2640_length_3725_cov_144","Ntome_NODE_944_length_5170_cov_235",97.258,3720,93,4,1,3717,3762,49,0,6296,3716,3713
"11274","Nsylvestris_NODE_2651_length_3722_cov_83","Ntome_NODE_3716_length_3445_cov_78",97.667,3300,72,3,236,3533,50,3346,0,5662,3297,3296
"11285","Nsylvestris_NODE_2654_length_3721_cov_230","Ntome_NODE_3093_length_3660_cov_296",97.765,3624,68,4,1,3622,3660,48,0,6231,3621,3612
"11289","Nsylvestris_NODE_2656_length_3720_cov_231","Ntome_NODE_385_length_6379_cov_149",97.549,3713,76,7,1,3712,2680,6378,0,6338,3711,3698
"11333","Nsylvestris_NODE_2667_length_3717_cov_37","Ntome_NODE_417_length_6246_cov_50",73.381,834,140,62,1592,2379,3895,4692,2.69e-60,235,787,797
"11352","Nsylvestris_NODE_2673_length_3714_cov_138","Ntome_NODE_2911_length_3732_cov_164",90.729,3689,218,57,77,3706,47,3670,0,4804,3629,3623
"11411","Nsylvestris_NODE_2688_length_3710_cov_68","Ntome_NODE_3009_length_3696_cov_35",96.145,3709,118,7,1,3701,4,3695,0,6034,3700,3691
"11426","Nsylvestris_NODE_2694_length_3707_cov_28","Ntome_NODE_26289_length_793_cov_10",75.777,772,168,15,2751,3517,760,3,1.96e-101,372,766,757
"11480","Nsylvestris_NODE_2708_length_3701_cov_37","Ntome_NODE_2853_length_3755_cov_60",96.643,3724,81,11,1,3701,3751,49,0,6144,3700,3702
"11485","Nsylvestris_NODE_2710_length_3700_cov_109","Ntome_NODE_2737_length_3798_cov_115",95.12,3627,136,14,24,3616,3697,78,0,5679,3592,3619
"11490","Nsylvestris_NODE_2712_length_3699_cov_151","Ntome_NODE_4962_length_3094_cov_202",96.506,2805,73,3,599,3401,138,2919,0,4614,2802,2781
"11509","Nsylvestris_NODE_2718_length_3697_cov_88","Ntome_NODE_3360_length_3566_cov_65",97.51,3494,80,3,36,3526,3566,77,0,5963,3490,3489
"11542","Nsylvestris_NODE_2726_length_3693_cov_58","Ntome_NODE_1440_length_4587_cov_168",94.904,3709,141,30,1,3689,4558,878,0,5758,3688,3680
"11759","Nsylvestris_NODE_2783_length_3671_cov_183","Ntome_NODE_2469_length_3921_cov_71",95.424,3584,150,6,49,3621,341,3921,0,5698,3572,3580
"11782","Nsylvestris_NODE_2790_length_3666_cov_158","Ntome_NODE_3662_length_3466_cov_240",97.349,3470,85,3,113,3579,3466,1,0,5891,3466,3465
"11857","Nsylvestris_NODE_2809_length_3658_cov_122","Ntome_NODE_2892_length_3740_cov_246",95.233,3587,129,15,78,3658,113,3663,0,5638,3580,3550
"11890","Nsylvestris_NODE_2819_length_3654_cov_52","Ntome_NODE_4346_length_3251_cov_16",97.919,3219,65,2,49,3267,3251,35,0,5572,3218,3216
"12005","Nsylvestris_NODE_2845_length_3639_cov_205","Ntome_NODE_2971_length_3711_cov_283",96.415,3654,82,17,19,3639,54,3691,0,5976,3620,3637
"12105","Nsylvestris_NODE_2871_length_3630_cov_158","Ntome_NODE_8547_length_2406_cov_262",96.964,2141,61,1,1468,3608,2139,3,0,3591,2140,2136
"12109","Nsylvestris_NODE_2873_length_3630_cov_44","Ntome_NODE_3458_length_3528_cov_36",96.273,3488,106,11,3,3480,3523,50,0,5699,3477,3473
"12140","Nsylvestris_NODE_2880_length_3628_cov_202","Ntome_NODE_1492_length_4538_cov_94",97.597,2746,54,2,277,3010,2787,42,0,4695,2733,2745
"12245","Nsylvestris_NODE_2910_length_3616_cov_225","Ntome_NODE_3130_length_3646_cov_196",95.783,3581,124,10,37,3615,1,3556,0,5751,3578,3555
"12306","Nsylvestris_NODE_2929_length_3610_cov_54","Ntome_NODE_3160_length_3634_cov_51",95.116,3563,166,7,33,3588,3632,71,0,5609,3555,3561
"12320","Nsylvestris_NODE_2934_length_3609_cov_15","Ntome_NODE_6553_length_2738_cov_13",95.642,2685,113,4,304,2985,2684,1,0,4307,2681,2683
"12367","Nsylvestris_NODE_2947_length_3604_cov_232","Ntome_NODE_3609_length_3482_cov_290",95.231,3418,135,12,50,3458,35,3433,0,5384,3408,3398
"12373","Nsylvestris_NODE_2950_length_3603_cov_214","Ntome_NODE_3527_length_3507_cov_85",93.462,3472,202,12,56,3519,1,3455,0,5131,3463,3454
"12392","Nsylvestris_NODE_2955_length_3601_cov_205","Ntome_NODE_3089_length_3662_cov_174",96.731,3487,86,11,62,3529,115,3592,0,5782,3467,3477
"12400","Nsylvestris_NODE_2958_length_3600_cov_174","Ntome_NODE_2670_length_3827_cov_258",95.581,3417,114,11,143,3544,3441,47,0,5439,3401,3394
"12450","Nsylvestris_NODE_2971_length_3598_cov_88","Ntome_NODE_27223_length_747_cov_24",91.279,172,9,4,2423,2589,1,171,1.21e-58,230,166,170
"12469","Nsylvestris_NODE_2978_length_3596_cov_167","Ntome_NODE_4760_length_3144_cov_194",96.229,1591,55,1,1685,3270,3086,1496,0,2601,1585,1590
"12486","Nsylvestris_NODE_2983_length_3593_cov_147","Ntome_NODE_4114_length_3316_cov_231",96.778,1769,46,3,1,1769,1998,241,0,2940,1768,1757
"12527","Nsylvestris_NODE_2993_length_3590_cov_230","Ntome_NODE_2686_length_3820_cov_178",96.913,3498,100,5,1,3493,263,3757,0,5854,3492,3494
"12548","Nsylvestris_NODE_2999_length_3588_cov_69","Ntome_NODE_3065_length_3672_cov_96",98.134,3484,64,1,1,3484,3533,51,0,6072,3483,3482
"12549","Nsylvestris_NODE_3000_length_3587_cov_204","Ntome_NODE_3075_length_3667_cov_264",95.817,3251,80,20,288,3500,1,3233,0,5199,3212,3232
"12676","Nsylvestris_NODE_3031_length_3574_cov_218","Ntome_NODE_426_length_6232_cov_192",95.517,3569,134,18,8,3572,2685,6231,0,5681,3564,3546
"12679","Nsylvestris_NODE_3033_length_3574_cov_154","Ntome_NODE_3406_length_3545_cov_180",97.629,3501,67,8,54,3543,3496,1,0,5991,3489,3495
"12689","Nsylvestris_NODE_3036_length_3573_cov_128","Ntome_NODE_2925_length_3726_cov_166",94.643,3491,126,27,1,3466,232,3686,0,5354,3465,3454
"12716","Nsylvestris_NODE_3045_length_3570_cov_228","Ntome_NODE_1687_length_4391_cov_260",98.694,3446,45,0,125,3570,4323,878,0,6115,3445,3445
"12766","Nsylvestris_NODE_3058_length_3559_cov_57","Ntome_NODE_992_length_5103_cov_41",82.416,1945,234,46,450,2352,2011,3889,0,1598,1902,1878
"12795","Nsylvestris_NODE_3065_length_3557_cov_23","Ntome_NODE_1084_length_4975_cov_213",81.638,1209,205,16,1219,2418,2167,3367,0,987,1199,1200
"12811","Nsylvestris_NODE_3070_length_3555_cov_66","Ntome_NODE_2640_length_3844_cov_44",94.847,3474,155,5,56,3508,90,3560,0,5402,3452,3470
"12840","Nsylvestris_NODE_3078_length_3551_cov_82","Ntome_NODE_3715_length_3445_cov_105",95.989,3416,114,15,54,3450,5,3416,0,5528,3396,3411
"12851","Nsylvestris_NODE_3081_length_3549_cov_195","Ntome_NODE_3211_length_3618_cov_191",96.544,3443,102,5,57,3486,3475,37,0,5683,3429,3438
"12880","Nsylvestris_NODE_3088_length_3548_cov_61","Ntome_NODE_10160_length_2176_cov_74",94.737,57,2,1,1713,1768,28,84,7.62e-16,87.9,55,56
"12927","Nsylvestris_NODE_3100_length_3543_cov_210","Ntome_NODE_2769_length_3782_cov_178",97.333,3187,80,2,280,3466,552,3733,0,5409,3186,3181
"12938","Nsylvestris_NODE_3104_length_3541_cov_193","Ntome_NODE_3814_length_3415_cov_206",95.643,3282,88,16,46,3295,21,3279,0,5217,3249,3258
"12958","Nsylvestris_NODE_3111_length_3539_cov_191","Ntome_NODE_3502_length_3516_cov_177",96.365,3466,98,8,6,3443,1,3466,0,5677,3437,3465
"12984","Nsylvestris_NODE_3118_length_3538_cov_11","Ntome_NODE_738_length_5482_cov_20",75.946,2062,412,59,1501,3538,4715,2714,0,983,2037,2001
"13035","Nsylvestris_NODE_3129_length_3534_cov_114","Ntome_NODE_3940_length_3375_cov_76",94.92,3366,129,23,186,3525,3352,3,0,5230,3339,3349
"13168","Nsylvestris_NODE_3166_length_3520_cov_72","Ntome_NODE_2865_length_3751_cov_73",93.399,3257,155,27,40,3282,3695,485,0,4769,3242,3210
"13175","Nsylvestris_NODE_3169_length_3518_cov_171","Ntome_NODE_3135_length_3645_cov_11",96.346,3476,116,6,24,3498,1,3466,0,5705,3474,3465
"13192","Nsylvestris_NODE_3172_length_3518_cov_78","Ntome_NODE_22982_length_984_cov_258",85.542,166,24,0,1202,1367,24,189,5.63e-42,174,165,165
"13308","Nsylvestris_NODE_3199_length_3507_cov_64","Ntome_NODE_15240_length_1610_cov_164",98.182,55,1,0,1,55,303,357,1.25e-18,97.1,54,54
"13491","Nsylvestris_NODE_3242_length_3492_cov_216","Ntome_NODE_10911_length_2083_cov_261",96.507,1689,51,4,1794,3479,197,1880,0,2785,1685,1683
"13519","Nsylvestris_NODE_3249_length_3490_cov_19","Ntome_NODE_11595_length_2003_cov_261",100,30,0,0,3433,3462,56,27,2.11e-06,56.5,29,29
"13540","Nsylvestris_NODE_3256_length_3487_cov_203","Ntome_NODE_4587_length_3185_cov_86",96.321,3044,101,4,316,3349,47,3089,0,4990,3033,3042
"13544","Nsylvestris_NODE_3258_length_3487_cov_43","Ntome_NODE_3195_length_3623_cov_69",95.931,3441,120,7,4,3438,19,3445,0,5561,3434,3426
"13613","Nsylvestris_NODE_3276_length_3482_cov_80","Ntome_NODE_2823_length_3765_cov_67",94.592,3513,131,19,1,3469,267,3764,0,5380,3468,3497
"13624","Nsylvestris_NODE_3280_length_3481_cov_185","Ntome_NODE_3293_length_3590_cov_84",97.466,3433,63,10,23,3447,3466,50,0,5836,3424,3416
"13673","Nsylvestris_NODE_3293_length_3477_cov_196","Ntome_NODE_3647_length_3471_cov_279",97.338,3456,69,3,1,3456,3433,1,0,5851,3455,3432
"13686","Nsylvestris_NODE_3298_length_3474_cov_212","Ntome_NODE_3107_length_3655_cov_275",98.385,3405,54,1,70,3474,3607,204,0,5982,3404,3403
"13699","Nsylvestris_NODE_3302_length_3472_cov_151","Ntome_NODE_2182_length_4069_cov_219",97.062,3472,86,6,1,3469,3459,1,0,5832,3468,3458
"13766","Nsylvestris_NODE_3321_length_3468_cov_119","Ntome_NODE_4415_length_3234_cov_105",95.369,3153,134,12,33,3180,3197,52,0,5003,3147,3145
"13783","Nsylvestris_NODE_3326_length_3466_cov_146","Ntome_NODE_1253_length_4780_cov_210",93.617,141,9,0,1,141,2932,2792,4.23e-53,211,140,140
"13852","Nsylvestris_NODE_3339_length_3460_cov_221","Ntome_NODE_4449_length_3222_cov_105",97.17,3145,71,10,105,3241,1,3135,0,5299,3136,3134
"13853","Nsylvestris_NODE_3340_length_3459_cov_184","Ntome_NODE_734_length_5490_cov_289",95.035,3182,97,24,1,3139,2211,5374,0,4944,3138,3163
"13982","Nsylvestris_NODE_3374_length_3446_cov_229","Ntome_NODE_1125_length_4925_cov_301",98.182,3300,56,1,1,3300,1538,4833,0,5758,3299,3295
"14052","Nsylvestris_NODE_3393_length_3442_cov_204","Ntome_NODE_3730_length_3440_cov_260",94.71,3346,136,13,35,3351,56,3389,0,5160,3316,3333
"14119","Nsylvestris_NODE_3409_length_3434_cov_42","Ntome_NODE_3061_length_3674_cov_66",92.982,3420,171,26,13,3396,3499,113,0,4922,3383,3386
"14142","Nsylvestris_NODE_3415_length_3431_cov_233","Ntome_NODE_2674_length_3825_cov_305",97.211,3334,79,9,99,3431,4,3324,0,5629,3332,3320
"14167","Nsylvestris_NODE_3423_length_3428_cov_231","Ntome_NODE_3745_length_3436_cov_222",97.816,3389,68,4,40,3427,49,3432,0,5843,3387,3383
"14294","Nsylvestris_NODE_3455_length_3417_cov_63","Ntome_NODE_2492_length_3913_cov_75",95.977,3356,133,2,6,3361,3913,560,0,5448,3355,3353
"14388","Nsylvestris_NODE_3480_length_3408_cov_17","Ntome_NODE_3736_length_3439_cov_26",95.602,3320,138,7,90,3407,124,3437,0,5315,3317,3313
"14399","Nsylvestris_NODE_3483_length_3406_cov_194","Ntome_NODE_4160_length_3305_cov_210",95.984,3237,115,13,38,3261,3288,54,0,5243,3223,3234
"14414","Nsylvestris_NODE_3487_length_3404_cov_186","Ntome_NODE_1361_length_4667_cov_150",94.535,3239,158,6,146,3378,1421,4646,0,4983,3232,3225
"14457","Nsylvestris_NODE_3498_length_3402_cov_221","Ntome_NODE_3813_length_3415_cov_241",96.505,3376,91,16,39,3400,1,3363,0,5555,3361,3362
"14514","Nsylvestris_NODE_3512_length_3394_cov_209","Ntome_NODE_6746_length_2704_cov_244",95.545,2222,70,19,99,2302,2251,41,0,3528,2203,2210
"14630","Nsylvestris_NODE_3536_length_3387_cov_181","Ntome_NODE_3864_length_3400_cov_92",94.847,3377,148,8,1,3369,38,3396,0,5249,3368,3358
"14631","Nsylvestris_NODE_3537_length_3387_cov_111","Ntome_NODE_4811_length_3131_cov_82",74.965,723,124,26,1590,2286,1444,2135,1.12e-73,279,696,691
"14646","Nsylvestris_NODE_3541_length_3386_cov_26","Ntome_NODE_136_length_7983_cov_105",95.623,3267,109,13,135,3386,2957,6204,0,5210,3251,3247
"14650","Nsylvestris_NODE_3543_length_3385_cov_227","Ntome_NODE_2817_length_3766_cov_251",95.788,3015,106,12,41,3049,257,3256,0,4844,3008,2999
"14654","Nsylvestris_NODE_3545_length_3385_cov_168","Ntome_NODE_3356_length_3566_cov_181",97.408,3318,79,4,1,3316,73,3385,0,5644,3315,3312
"14710","Nsylvestris_NODE_3561_length_3380_cov_21","Ntome_NODE_5099_length_3054_cov_219",96.875,64,2,0,3,66,165,228,5.57e-22,108,63,63
"14716","Nsylvestris_NODE_3563_length_3378_cov_233","Ntome_NODE_1028_length_5054_cov_302",96.61,3363,85,7,1,3336,1694,5054,0,5552,3335,3360
"14720","Nsylvestris_NODE_3565_length_3378_cov_116","Ntome_NODE_3780_length_3427_cov_29",94.321,3381,135,15,1,3333,3423,52,0,5127,3332,3371
"14839","Nsylvestris_NODE_3596_length_3366_cov_89","Ntome_NODE_5217_length_3025_cov_45",95.954,2892,97,6,198,3085,95,2970,0,4674,2887,2875
"14840","Nsylvestris_NODE_3597_length_3365_cov_222","Ntome_NODE_1051_length_5019_cov_231",96.575,3241,100,3,78,3314,4970,1737,0,5360,3236,3233
"14880","Nsylvestris_NODE_3609_length_3361_cov_218","Ntome_NODE_4260_length_3274_cov_215",95.626,3269,131,6,89,3354,7,3266,0,5234,3265,3259
"14908","Nsylvestris_NODE_3616_length_3360_cov_171","Ntome_NODE_3856_length_3402_cov_309",94.778,3313,160,1,25,3324,28,3340,0,5147,3299,3312
"14956","Nsylvestris_NODE_3629_length_3356_cov_34","Ntome_NODE_20040_length_1188_cov_283",97.959,49,1,0,1,49,284,332,2.59e-15,86.1,48,48
"15034","Nsylvestris_NODE_3650_length_3351_cov_29","Ntome_NODE_5535_length_2954_cov_110",83.836,2122,305,25,632,2744,2257,165,0,1984,2112,2092
"15047","Nsylvestris_NODE_3655_length_3349_cov_178","Ntome_NODE_4221_length_3286_cov_235",93.746,3134,146,29,109,3225,3127,27,0,4656,3116,3100
"15051","Nsylvestris_NODE_3657_length_3349_cov_65","Ntome_NODE_599_length_5773_cov_100",97.545,3300,81,0,50,3349,5394,2095,0,5646,3299,3299
"15100","Nsylvestris_NODE_3667_length_3345_cov_129","Ntome_NODE_1066_length_5003_cov_68",97.264,3289,90,0,57,3345,4980,1692,0,5576,3288,3288
"15113","Nsylvestris_NODE_3670_length_3344_cov_147","Ntome_NODE_3426_length_3539_cov_176",97.4,3269,71,7,28,3282,3356,88,0,5553,3254,3268
"15126","Nsylvestris_NODE_3674_length_3343_cov_184","Ntome_NODE_723_length_5522_cov_61",98.534,3001,44,0,1,3001,3111,111,0,5299,3000,3000
"15203","Nsylvestris_NODE_3695_length_3336_cov_98","Ntome_NODE_4345_length_3251_cov_20",94.327,3261,151,15,65,3301,1,3251,0,4966,3236,3250
"15256","Nsylvestris_NODE_3709_length_3333_cov_64","Ntome_NODE_248_length_7107_cov_98",94.874,3336,141,14,3,3333,5858,2548,0,5186,3330,3310
"15282","Nsylvestris_NODE_3717_length_3330_cov_187","Ntome_NODE_4009_length_3349_cov_48",96.267,3295,91,9,33,3315,3345,71,0,5374,3282,3274
"15283","Nsylvestris_NODE_3718_length_3330_cov_160","Ntome_NODE_35086_length_371_cov_3",88.136,59,6,1,682,740,309,366,2.59e-10,69.4,58,57
"15326","Nsylvestris_NODE_3731_length_3326_cov_51","Ntome_NODE_4611_length_3181_cov_76",95.467,2934,124,9,397,3326,2971,43,0,4673,2929,2928
"15364","Nsylvestris_NODE_3742_length_3321_cov_213","Ntome_NODE_4167_length_3304_cov_288",95.957,3240,115,11,84,3320,3252,26,0,5243,3236,3226
"15374","Nsylvestris_NODE_3747_length_3320_cov_209","Ntome_NODE_3249_length_3605_cov_269",97.121,3230,69,9,97,3320,1,3212,0,5428,3223,3211
"15391","Nsylvestris_NODE_3752_length_3318_cov_153","Ntome_NODE_3638_length_3471_cov_110",97.088,3056,77,3,1,3049,3104,54,0,5140,3048,3050
"15426","Nsylvestris_NODE_3763_length_3314_cov_100","Ntome_NODE_2195_length_4064_cov_31",96.147,3166,119,2,87,3249,3166,1,0,5168,3162,3165
"15461","Nsylvestris_NODE_3772_length_3312_cov_63","Ntome_NODE_4318_length_3256_cov_87",92.885,3289,165,15,3,3265,3246,1,0,4713,3262,3245
"15613","Nsylvestris_NODE_3815_length_3296_cov_72","Ntome_NODE_14069_length_1731_cov_27",83.684,190,23,6,1949,2136,1270,1087,1.9e-41,172,187,183
"15645","Nsylvestris_NODE_3822_length_3293_cov_72","Ntome_NODE_3748_length_3436_cov_92",96.305,2977,107,2,1,2974,3023,47,0,4885,2973,2976
"15651","Nsylvestris_NODE_3825_length_3293_cov_51","Ntome_NODE_3311_length_3582_cov_69",86.133,375,52,0,833,1207,2376,2002,1.72e-111,405,374,374
"15655","Nsylvestris_NODE_3827_length_3292_cov_204","Ntome_NODE_7435_length_2580_cov_55",95.428,2537,97,4,708,3238,57,2580,0,4024,2530,2523
"15673","Nsylvestris_NODE_3834_length_3290_cov_243","Ntome_NODE_1628_length_4435_cov_264",98.541,3290,48,0,1,3290,334,3623,0,5810,3289,3289
"15789","Nsylvestris_NODE_3864_length_3280_cov_151","Ntome_NODE_1593_length_4459_cov_160",97.212,3192,82,3,95,3279,4410,1219,0,5395,3184,3191
"15793","Nsylvestris_NODE_3866_length_3280_cov_32","Ntome_NODE_4265_length_3272_cov_151",80.86,1139,188,14,1725,2839,1890,3022,0,869,1114,1132
"15934","Nsylvestris_NODE_3900_length_3268_cov_175","Ntome_NODE_8211_length_2458_cov_236",96.574,2306,51,11,255,2556,6,2287,0,3795,2301,2281
"15940","Nsylvestris_NODE_3902_length_3266_cov_141","Ntome_NODE_34491_length_396_cov_2",84.487,419,29,16,1587,1993,396,2,2.87e-104,381,406,394
"15996","Nsylvestris_NODE_3916_length_3264_cov_79","Ntome_NODE_7410_length_2584_cov_141",92.825,1784,68,21,1510,3264,782,2534,0,2531,1754,1752
"16019","Nsylvestris_NODE_3924_length_3262_cov_54","Ntome_NODE_543_length_5905_cov_125",91.309,2589,198,13,32,2601,5,2585,0,3509,2569,2580
"16063","Nsylvestris_NODE_3936_length_3256_cov_141","Ntome_NODE_3883_length_3393_cov_141",96.956,3022,77,4,190,3211,3189,183,0,5057,3021,3006
"16140","Nsylvestris_NODE_3959_length_3246_cov_183","Ntome_NODE_4186_length_3300_cov_252",95.278,3198,137,7,1,3195,35,3221,0,5057,3194,3186
"16145","Nsylvestris_NODE_3961_length_3245_cov_186","Ntome_NODE_660_length_5637_cov_213",95.741,3029,108,10,47,3063,211,3230,0,4859,3016,3019
"16210","Nsylvestris_NODE_3978_length_3239_cov_19","Ntome_NODE_39529_length_257_cov_5",93.385,257,17,0,90,346,257,1,2.85e-104,381,256,256
"16222","Nsylvestris_NODE_3982_length_3237_cov_228","Ntome_NODE_4179_length_3301_cov_244",95.965,2974,108,7,83,3050,3262,295,0,4817,2967,2967
"16245","Nsylvestris_NODE_3988_length_3236_cov_33","Ntome_NODE_33702_length_434_cov_44",85.821,134,19,0,7,140,31,164,1.46e-32,143,133,133
"16278","Nsylvestris_NODE_3995_length_3234_cov_25","Ntome_NODE_11146_length_2055_cov_260",83.099,71,8,3,525,595,837,903,4.2e-08,62.1,70,66
"16339","Nsylvestris_NODE_4012_length_3230_cov_144","Ntome_NODE_3131_length_3646_cov_181",94.798,2653,130,5,284,2934,3232,586,0,4128,2650,2646
"16433","Nsylvestris_NODE_4038_length_3221_cov_154","Ntome_NODE_4202_length_3294_cov_237",94.938,3161,107,18,61,3209,149,3268,0,4902,3148,3119
"16447","Nsylvestris_NODE_4043_length_3219_cov_223","Ntome_NODE_3765_length_3431_cov_153",90.741,54,5,0,2497,2550,1050,997,1.93e-11,73.1,53,53
"16486","Nsylvestris_NODE_4054_length_3216_cov_205","Ntome_NODE_1793_length_4317_cov_274",98.138,3223,53,2,1,3216,64,3286,0,5613,3215,3222
"16498","Nsylvestris_NODE_4057_length_3216_cov_79","Ntome_NODE_2407_length_3957_cov_96",96.08,3214,96,8,7,3216,3957,770,0,5210,3209,3187
"16512","Nsylvestris_NODE_4061_length_3215_cov_89","Ntome_NODE_13220_length_1817_cov_188",95.926,1129,36,7,55,1180,1811,690,0,1821,1125,1121
"16517","Nsylvestris_NODE_4063_length_3215_cov_33","Ntome_NODE_10862_length_2089_cov_186",93.741,703,42,2,1,702,52,753,0,1053,701,701
"16529","Nsylvestris_NODE_4066_length_3215_cov_76","Ntome_NODE_36300_length_330_cov_6",90,60,4,2,566,625,283,226,1.49e-12,76.8,59,57
"16593","Nsylvestris_NODE_4083_length_3209_cov_107","Ntome_NODE_2898_length_3737_cov_129",94.073,3138,131,23,49,3173,3160,65,0,4713,3124,3095
"16594","Nsylvestris_NODE_4084_length_3208_cov_128","Ntome_NODE_5432_length_2978_cov_35",95.534,2978,115,7,203,3165,2975,1,0,4747,2962,2974
"16632","Nsylvestris_NODE_4095_length_3204_cov_107","Ntome_NODE_4181_length_3301_cov_161",95.251,3201,120,19,1,3196,3288,115,0,5040,3195,3173
"16646","Nsylvestris_NODE_4099_length_3203_cov_50","Ntome_NODE_13106_length_1831_cov_25",94.194,1843,86,3,95,1934,1825,1,0,2791,1839,1824
"16654","Nsylvestris_NODE_4102_length_3202_cov_19","Ntome_NODE_2486_length_3915_cov_46",96.186,2858,103,3,203,3057,183,3037,0,4669,2854,2854
"16676","Nsylvestris_NODE_4108_length_3200_cov_149","Ntome_NODE_2271_length_4020_cov_73",96.963,1712,51,1,1490,3200,34,1745,0,2872,1710,1711
"16708","Nsylvestris_NODE_4118_length_3198_cov_53","Ntome_NODE_21047_length_1109_cov_30",92,50,2,2,547,595,1002,1050,2.48e-10,69.4,48,48
"16812","Nsylvestris_NODE_4145_length_3190_cov_135","Ntome_NODE_4399_length_3239_cov_104",96.305,3004,99,6,55,3046,3059,56,0,4922,2991,3003
"16837","Nsylvestris_NODE_4152_length_3189_cov_135","Ntome_NODE_10564_length_2124_cov_237",91.061,179,15,1,2488,2666,1854,1677,4.96e-62,241,178,177
"16936","Nsylvestris_NODE_4180_length_3181_cov_174","Ntome_NODE_4414_length_3234_cov_164",97.585,3106,66,7,53,3154,132,3232,0,5312,3101,3100
"16963","Nsylvestris_NODE_4188_length_3179_cov_43","Ntome_NODE_4990_length_3085_cov_33",96.036,3078,110,6,60,3133,16,3085,0,4998,3073,3069
"17000","Nsylvestris_NODE_4199_length_3176_cov_199","Ntome_NODE_3262_length_3601_cov_213",97.603,3004,52,8,55,3055,3599,613,0,5131,3000,2986
"17220","Nsylvestris_NODE_4255_length_3161_cov_217","Ntome_NODE_5614_length_2936_cov_69",96.376,2897,96,6,55,2948,7,2897,0,4759,2893,2890
"17236","Nsylvestris_NODE_4259_length_3159_cov_237","Ntome_NODE_3519_length_3509_cov_302",97.738,3139,62,5,1,3137,3201,70,0,5395,3136,3131
"17279","Nsylvestris_NODE_4272_length_3157_cov_155","Ntome_NODE_4744_length_3148_cov_183",94.296,2612,109,15,142,2751,3148,575,0,3962,2609,2573
"17296","Nsylvestris_NODE_4277_length_3156_cov_211","Ntome_NODE_5535_length_2954_cov_110",94.899,2862,105,12,280,3135,6,2832,0,4438,2855,2826
"17383","Nsylvestris_NODE_4302_length_3149_cov_166","Ntome_NODE_4348_length_3250_cov_188",93.403,3153,118,32,1,3091,126,3250,0,4588,3090,3124
"17418","Nsylvestris_NODE_4312_length_3147_cov_26","Ntome_NODE_7084_length_2642_cov_14",92.768,2641,188,3,434,3074,5,2642,0,3816,2640,2637
"17419","Nsylvestris_NODE_4313_length_3146_cov_236","Ntome_NODE_4534_length_3201_cov_155",93.763,2966,135,21,202,3146,49,2985,0,4407,2944,2936
"17471","Nsylvestris_NODE_4326_length_3144_cov_170","Ntome_NODE_2166_length_4078_cov_219",97.415,2863,65,3,238,3100,4025,1172,0,4868,2862,2853
"17472","Nsylvestris_NODE_4327_length_3144_cov_158","Ntome_NODE_5107_length_3053_cov_49",95.437,3068,119,5,37,3098,1,3053,0,4870,3061,3052
"17568","Nsylvestris_NODE_4353_length_3139_cov_67","Ntome_NODE_37436_length_301_cov_3",81.776,214,24,6,1873,2071,293,80,3.02e-39,165,198,213
"17609","Nsylvestris_NODE_4366_length_3135_cov_207","Ntome_NODE_23198_length_977_cov_28",93.487,783,45,5,15,794,136,915,0,1158,779,779
"17635","Nsylvestris_NODE_4374_length_3133_cov_196","Ntome_NODE_4947_length_3098_cov_246",96.36,2967,79,13,174,3133,2966,22,0,4854,2959,2944
"17657","Nsylvestris_NODE_4381_length_3131_cov_111","Ntome_NODE_9647_length_2246_cov_70",100,30,0,0,735,764,943,972,1.89e-06,56.5,29,29
"17698","Nsylvestris_NODE_4393_length_3128_cov_96","Ntome_NODE_17568_length_1396_cov_92",84.483,116,14,3,1026,1139,1057,1170,3.98e-23,111,113,113
"17798","Nsylvestris_NODE_4422_length_3115_cov_206","Ntome_NODE_5663_length_2924_cov_134",94.86,2899,92,15,196,3068,57,2924,0,4475,2872,2867
"17807","Nsylvestris_NODE_4425_length_3115_cov_121","Ntome_NODE_938_length_5179_cov_200",95.018,2770,111,4,370,3115,2774,8,0,4325,2745,2766
"17808","Nsylvestris_NODE_4426_length_3115_cov_108","Ntome_NODE_4136_length_3311_cov_161",75.488,1024,223,25,1578,2587,2732,1723,1.22e-132,475,1009,1009
"17821","Nsylvestris_NODE_4430_length_3114_cov_175","Ntome_NODE_7667_length_2545_cov_304",98.44,2179,30,4,103,2278,50,2227,0,3832,2175,2177
"17870","Nsylvestris_NODE_4443_length_3111_cov_80","Ntome_NODE_7536_length_2565_cov_33",90.25,1159,94,13,37,1185,2154,1005,0,1496,1148,1149
"17928","Nsylvestris_NODE_4458_length_3108_cov_33","Ntome_NODE_4796_length_3134_cov_87",96.34,3060,101,7,55,3108,8,3062,0,5020,3053,3054
"17949","Nsylvestris_NODE_4463_length_3107_cov_124","Ntome_NODE_469_length_6104_cov_173",97.397,2843,48,9,1,2826,1127,3960,0,4817,2825,2833
"17996","Nsylvestris_NODE_4477_length_3105_cov_21","Ntome_NODE_3218_length_3615_cov_10",94.515,3081,127,18,11,3062,3544,477,0,4715,3051,3067
"18004","Nsylvestris_NODE_4480_length_3103_cov_226","Ntome_NODE_4531_length_3201_cov_292",97.348,3054,56,15,3,3044,3192,152,0,5168,3041,3040
"18009","Nsylvestris_NODE_4482_length_3103_cov_205","Ntome_NODE_5282_length_3011_cov_289",94.249,3008,98,25,22,3008,2998,45,0,4527,2986,2953
"18043","Nsylvestris_NODE_4491_length_3102_cov_15","Ntome_NODE_15794_length_1558_cov_310",73.373,1183,263,44,773,1917,1549,381,1.26e-107,392,1144,1168
"18052","Nsylvestris_NODE_4494_length_3101_cov_145","Ntome_NODE_15741_length_1564_cov_18",94.426,1525,74,5,93,1617,1563,50,0,2335,1524,1513
"18055","Nsylvestris_NODE_4496_length_3101_cov_109","Ntome_NODE_4562_length_3194_cov_88",96.892,3089,73,8,27,3101,114,3193,0,5151,3074,3079
"18082","Nsylvestris_NODE_4504_length_3099_cov_17","Ntome_NODE_6317_length_2784_cov_281",100,55,0,0,3045,3099,359,305,2.37e-20,102,54,54
"18105","Nsylvestris_NODE_4511_length_3096_cov_123","Ntome_NODE_1592_length_4461_cov_293",95.89,3041,107,10,57,3082,4360,1323,0,4907,3025,3037
"18120","Nsylvestris_NODE_4516_length_3095_cov_224","Ntome_NODE_2866_length_3750_cov_242",97.131,3032,59,10,81,3094,3693,672,0,5092,3013,3021
"18256","Nsylvestris_NODE_4550_length_3086_cov_120","Ntome_NODE_5335_length_3000_cov_37",95.056,3014,129,10,20,3029,2998,1,0,4723,3009,2997
"18269","Nsylvestris_NODE_4555_length_3084_cov_230","Ntome_NODE_4678_length_3163_cov_294",95.711,3031,77,14,29,3043,39,3032,0,4828,3014,2993
"18279","Nsylvestris_NODE_4558_length_3083_cov_185","Ntome_NODE_4262_length_3273_cov_206",96.511,3038,76,12,1,3011,3086,52,0,4996,3010,3034
"18298","Nsylvestris_NODE_4564_length_3082_cov_104","Ntome_NODE_3415_length_3543_cov_139",97.233,2819,75,3,143,2959,458,3275,0,4771,2816,2817
"18441","Nsylvestris_NODE_4603_length_3072_cov_226","Ntome_NODE_4061_length_3331_cov_262",96.409,2701,78,7,162,2850,2757,64,0,4433,2688,2693
"18442","Nsylvestris_NODE_4604_length_3072_cov_118","Ntome_NODE_4430_length_3227_cov_156",96.721,3019,95,3,1,3015,160,3178,0,5024,3014,3018
"18451","Nsylvestris_NODE_4607_length_3071_cov_8","Ntome_NODE_3487_length_3522_cov_112",94.545,55,3,0,1,55,1126,1180,2.37e-15,86.1,54,54
"18499","Nsylvestris_NODE_4620_length_3067_cov_197","Ntome_NODE_5041_length_3067_cov_178",95.4,3022,93,16,1,2994,61,3064,0,4769,2993,3003
"18524","Nsylvestris_NODE_4627_length_3066_cov_109","Ntome_NODE_4715_length_3156_cov_204",96.323,2801,61,7,101,2901,3040,282,0,4564,2800,2758
"18572","Nsylvestris_NODE_4639_length_3060_cov_168","Ntome_NODE_5205_length_3030_cov_136",95.551,3057,93,12,15,3055,3030,1,0,4852,3040,3029
"18603","Nsylvestris_NODE_4646_length_3058_cov_227","Ntome_NODE_255_length_7035_cov_303",98.678,2950,39,0,109,3058,296,3245,0,5232,2949,2949
"18608","Nsylvestris_NODE_4648_length_3055_cov_144","Ntome_NODE_20815_length_1131_cov_24",77.551,147,24,8,1116,1255,146,2,1.1e-13,80.5,139,144
"18625","Nsylvestris_NODE_4655_length_3055_cov_192","Ntome_NODE_5934_length_2865_cov_140",93.993,2697,119,11,141,2812,72,2750,0,4043,2671,2678
"18742","Nsylvestris_NODE_4689_length_3047_cov_190","Ntome_NODE_5670_length_2923_cov_171",94.39,2959,85,23,4,2920,3,2922,0,4470,2916,2919
"18748","Nsylvestris_NODE_4692_length_3046_cov_79","Ntome_NODE_3056_length_3677_cov_158",93.733,2649,134,11,2,2640,3675,1049,0,3943,2638,2626
"18749","Nsylvestris_NODE_4693_length_3045_cov_230","Ntome_NODE_4889_length_3113_cov_211",74.384,1745,395,46,1,1723,1390,3104,0,699,1722,1714
"18756","Nsylvestris_NODE_4696_length_3045_cov_203","Ntome_NODE_2090_length_4113_cov_293",97.671,3049,65,3,1,3045,4087,1041,0,5232,3044,3046
"18792","Nsylvestris_NODE_4707_length_3043_cov_123","Ntome_NODE_5524_length_2956_cov_71",95.52,2723,109,4,43,2753,83,2804,0,4340,2710,2721
"18810","Nsylvestris_NODE_4713_length_3042_cov_55","Ntome_NODE_32933_length_483_cov_4",95.807,477,17,1,1561,2034,482,6,0,767,473,476
"18846","Nsylvestris_NODE_4722_length_3040_cov_10","Ntome_NODE_674_length_5607_cov_111",77.09,1292,249,28,1585,2863,3908,2651,0,702,1278,1257
"18862","Nsylvestris_NODE_4727_length_3038_cov_185","Ntome_NODE_3237_length_3608_cov_236",97.942,2818,49,5,221,3038,3438,630,0,4874,2817,2808
"18938","Nsylvestris_NODE_4753_length_3033_cov_126","Ntome_NODE_6383_length_2770_cov_221",93.897,2507,145,5,42,2544,2718,216,0,3775,2502,2502
"18963","Nsylvestris_NODE_4760_length_3031_cov_150","Ntome_NODE_4319_length_3255_cov_289",96.701,2971,79,3,28,2979,33,3003,0,4926,2951,2970
"18992","Nsylvestris_NODE_4770_length_3029_cov_199","Ntome_NODE_5767_length_2904_cov_226",98.561,2502,34,2,1,2500,36,2537,0,4420,2499,2501
"19015","Nsylvestris_NODE_4777_length_3027_cov_229","Ntome_NODE_3603_length_3484_cov_168",94.908,3005,123,14,1,2978,398,3399,0,4674,2977,3001
"19049","Nsylvestris_NODE_4787_length_3025_cov_96","Ntome_NODE_5086_length_3056_cov_251",95.16,2913,123,8,114,3023,3009,112,0,4582,2909,2897
"19073","Nsylvestris_NODE_4794_length_3023_cov_155","Ntome_NODE_30347_length_615_cov_3",90.076,524,37,8,2437,2957,3,514,0,665,520,511
"19076","Nsylvestris_NODE_4796_length_3022_cov_225","Ntome_NODE_5033_length_3068_cov_299",94.34,2915,149,11,95,3005,2929,27,0,4455,2910,2902
"19140","Nsylvestris_NODE_4813_length_3018_cov_101","Ntome_NODE_3224_length_3612_cov_114",95.478,2366,79,13,81,2446,3605,1268,0,3751,2365,2337
"19209","Nsylvestris_NODE_4832_length_3011_cov_226","Ntome_NODE_5312_length_3004_cov_299",94.219,3010,126,15,2,2970,3004,2,0,4551,2968,3002
"19235","Nsylvestris_NODE_4842_length_3009_cov_212","Ntome_NODE_2475_length_3918_cov_227",95.731,2881,110,6,136,3009,3918,1044,0,4626,2873,2874
"19261","Nsylvestris_NODE_4849_length_3007_cov_197","Ntome_NODE_3088_length_3662_cov_215",97.971,2662,41,5,359,3007,2712,51,0,4604,2648,2661
"19291","Nsylvestris_NODE_4858_length_3006_cov_16","Ntome_NODE_4300_length_3261_cov_38",95.148,2906,128,12,45,2947,364,3259,0,4573,2902,2895
"19358","Nsylvestris_NODE_4875_length_3001_cov_195","Ntome_NODE_4205_length_3292_cov_228",96.082,2884,75,12,1,2854,395,3270,0,4665,2853,2875
"19366","Nsylvestris_NODE_4878_length_3001_cov_44","Ntome_NODE_5386_length_2989_cov_35",93.298,3014,127,20,13,2987,6,2983,0,4377,2974,2977
"19511","Nsylvestris_NODE_4917_length_2993_cov_86","Ntome_NODE_29202_length_660_cov_16",87.922,563,66,2,2229,2790,6,567,0,662,561,561
"19521","Nsylvestris_NODE_4920_length_2992_cov_134","Ntome_NODE_20757_length_1134_cov_120",97.467,1066,24,3,293,1356,42,1106,0,1816,1063,1064
"19522","Nsylvestris_NODE_4921_length_2991_cov_228","Ntome_NODE_5948_length_2861_cov_275",94.244,2797,132,19,51,2842,2819,47,0,4246,2791,2772
"19541","Nsylvestris_NODE_4926_length_2994_cov_76","Ntome_NODE_6537_length_2741_cov_50",93.869,2740,129,20,268,2975,2733,1,0,4093,2707,2732
"19607","Nsylvestris_NODE_4944_length_2987_cov_202","Ntome_NODE_5227_length_3023_cov_133",95.055,2831,100,12,82,2903,64,2863,0,4416,2821,2799
"19615","Nsylvestris_NODE_4947_length_2987_cov_37","Ntome_NODE_3664_length_3466_cov_92",89.48,2386,182,27,4,2361,48,2392,0,2952,2357,2344
"19689","Nsylvestris_NODE_4971_length_2980_cov_211","Ntome_NODE_6173_length_2817_cov_242",96.796,2778,52,12,165,2912,47,2817,0,4602,2747,2770
"19696","Nsylvestris_NODE_4974_length_2980_cov_99","Ntome_NODE_8602_length_2398_cov_279",83.963,2064,303,21,484,2533,12,2061,0,1953,2049,2049
"19697","Nsylvestris_NODE_4975_length_2979_cov_232","Ntome_NODE_3392_length_3549_cov_303",97.686,2982,45,11,1,2979,3536,576,0,5103,2978,2960
"19757","Nsylvestris_NODE_4994_length_2974_cov_114","Ntome_NODE_5471_length_2970_cov_38",94.597,2980,107,13,21,2957,2969,1,0,4562,2936,2968
"19785","Nsylvestris_NODE_5002_length_2973_cov_9","Ntome_NODE_18140_length_1347_cov_232",96.364,55,2,0,1,55,466,520,4.93e-17,91.6,54,54
"19791","Nsylvestris_NODE_5005_length_2972_cov_195","Ntome_NODE_1507_length_4529_cov_202",97.636,2919,68,1,1,2918,1519,4437,0,5007,2917,2918
"19810","Nsylvestris_NODE_5010_length_2969_cov_237","Ntome_NODE_4152_length_3306_cov_303",97.073,2938,70,5,45,2969,3054,120,0,4935,2924,2934
"19972","Nsylvestris_NODE_5056_length_2959_cov_61","Ntome_NODE_6375_length_2772_cov_182",84.336,2094,303,20,60,2133,2514,426,0,2026,2073,2088
"19982","Nsylvestris_NODE_5060_length_2958_cov_70","Ntome_NODE_3119_length_3650_cov_176",95.914,2692,97,7,5,2692,65,2747,0,4349,2687,2682
"19983","Nsylvestris_NODE_5061_length_2957_cov_226","Ntome_NODE_5456_length_2972_cov_214",94.749,2952,134,7,7,2956,2933,1,0,4573,2949,2932
"20000","Nsylvestris_NODE_5066_length_2956_cov_176","Ntome_NODE_5458_length_2972_cov_207",97.431,2958,69,4,1,2956,2958,6,0,5035,2955,2952
"20082","Nsylvestris_NODE_5090_length_2952_cov_73","Ntome_NODE_7416_length_2583_cov_246",91.99,799,47,4,2164,2947,1746,2542,0,1105,783,796
"20191","Nsylvestris_NODE_5117_length_2945_cov_212","Ntome_NODE_5698_length_2918_cov_144",96.189,2834,72,16,36,2866,80,2880,0,4602,2830,2800
"20192","Nsylvestris_NODE_5118_length_2945_cov_182","Ntome_NODE_6059_length_2837_cov_225",94.395,2462,103,9,484,2945,301,2727,0,3749,2461,2426
"20265","Nsylvestris_NODE_5141_length_2939_cov_200","Ntome_NODE_6910_length_2672_cov_292",96.922,2112,51,4,731,2828,2112,1,0,3528,2097,2111
"20283","Nsylvestris_NODE_5147_length_2936_cov_213","Ntome_NODE_5226_length_3023_cov_264",95.611,2825,77,14,87,2888,125,2925,0,4486,2801,2800
"20412","Nsylvestris_NODE_5180_length_2930_cov_155","Ntome_NODE_8452_length_2420_cov_27",95.82,2416,88,5,504,2910,2420,9,0,3890,2406,2411
"20473","Nsylvestris_NODE_5197_length_2926_cov_203","Ntome_NODE_5676_length_2922_cov_280",94.852,2875,106,15,16,2856,56,2922,0,4451,2840,2866
"20532","Nsylvestris_NODE_5212_length_2923_cov_227","Ntome_NODE_5606_length_2937_cov_163",94.609,2912,144,4,15,2918,2907,1,0,4495,2903,2906
"20635","Nsylvestris_NODE_5242_length_2917_cov_95","Ntome_NODE_1846_length_4275_cov_178",93.405,1304,68,8,1613,2914,2894,4181,0,1916,1301,1287
"20636","Nsylvestris_NODE_5243_length_2917_cov_91","Ntome_NODE_20400_length_1161_cov_193",92.262,840,29,8,2078,2915,72,877,0,1158,837,805
"20649","Nsylvestris_NODE_5247_length_2916_cov_201","Ntome_NODE_971_length_5124_cov_281",96.07,2875,91,11,48,2909,2908,43,0,4663,2861,2865
"20806","Nsylvestris_NODE_5284_length_2908_cov_188","Ntome_NODE_283_length_6844_cov_290",96.267,2893,79,6,1,2892,3877,6741,0,4717,2891,2864
"20814","Nsylvestris_NODE_5287_length_2908_cov_54","Ntome_NODE_2109_length_4104_cov_88",86.692,804,87,9,269,1067,4104,3316,0,874,798,788
"20818","Nsylvestris_NODE_5289_length_2908_cov_43","Ntome_NODE_4930_length_3103_cov_34",91.432,2661,199,14,6,2657,95,2735,0,3624,2651,2640
"20824","Nsylvestris_NODE_5292_length_2907_cov_184","Ntome_NODE_6295_length_2789_cov_59",95.294,2805,84,19,84,2859,2789,4,0,4405,2775,2785
"20830","Nsylvestris_NODE_5294_length_2907_cov_100","Ntome_NODE_6857_length_2684_cov_77",96.286,2639,79,8,261,2885,47,2680,0,4313,2624,2633
"20880","Nsylvestris_NODE_5308_length_2904_cov_234","Ntome_NODE_2950_length_3719_cov_298",97.401,2847,71,2,1,2844,2853,7,0,4844,2843,2846
"20954","Nsylvestris_NODE_5330_length_2900_cov_172","Ntome_NODE_5642_length_2929_cov_288",96.113,2624,76,12,104,2704,309,2929,0,4257,2600,2620
"21009","Nsylvestris_NODE_5347_length_2897_cov_181","Ntome_NODE_1190_length_4849_cov_237",97.07,2696,67,7,78,2764,2944,252,0,4530,2686,2692
"21021","Nsylvestris_NODE_5351_length_2896_cov_211","Ntome_NODE_1694_length_4385_cov_96",96.218,2803,83,9,115,2896,1,2801,0,4567,2781,2800
"21066","Nsylvestris_NODE_5367_length_2893_cov_70","Ntome_NODE_25964_length_807_cov_205",87.034,725,39,20,2146,2831,759,51,0,767,685,708
"21101","Nsylvestris_NODE_5377_length_2891_cov_64","Ntome_NODE_4984_length_3087_cov_42",94.06,2761,118,19,119,2859,330,3064,0,4148,2740,2734
"21107","Nsylvestris_NODE_5379_length_2891_cov_20","Ntome_NODE_3547_length_3502_cov_35",95.127,2832,128,7,3,2831,3219,395,0,4457,2828,2824
"21111","Nsylvestris_NODE_5381_length_2890_cov_196","Ntome_NODE_148_length_7871_cov_262",95.183,2761,104,12,94,2830,7871,5116,0,4335,2736,2755
"21135","Nsylvestris_NODE_5385_length_2889_cov_223","Ntome_NODE_983_length_5116_cov_187",97.118,2811,64,6,28,2828,5079,2276,0,4726,2800,2803
"21189","Nsylvestris_NODE_5402_length_2885_cov_198","Ntome_NODE_1688_length_4387_cov_234",94.848,2795,108,9,8,2770,4387,1597,0,4331,2762,2790
"21305","Nsylvestris_NODE_5436_length_2877_cov_27","Ntome_NODE_5010_length_3077_cov_13",95.901,2635,69,7,279,2874,1,2635,0,4231,2595,2634
"21323","Nsylvestris_NODE_5442_length_2875_cov_206","Ntome_NODE_4799_length_3133_cov_210",96.1,2692,77,13,45,2734,148,2813,0,4364,2689,2665
"21354","Nsylvestris_NODE_5451_length_2873_cov_45","Ntome_NODE_4573_length_3189_cov_33",96.741,2792,90,1,1,2791,381,3172,0,4650,2790,2791
"21357","Nsylvestris_NODE_5453_length_2873_cov_23","Ntome_NODE_7509_length_2570_cov_45",95.932,2286,92,1,586,2870,2366,81,0,3705,2284,2285
"21403","Nsylvestris_NODE_5466_length_2870_cov_142","Ntome_NODE_5678_length_2922_cov_249",95.062,2754,91,17,91,2820,2787,55,0,4290,2729,2732
"21408","Nsylvestris_NODE_5468_length_2870_cov_13","Ntome_NODE_28744_length_678_cov_241",94.231,52,3,0,2819,2870,287,236,1.03e-13,80.5,51,51
"21413","Nsylvestris_NODE_5470_length_2869_cov_224","Ntome_NODE_5731_length_2910_cov_270",95.041,2823,88,20,1,2807,83,2869,0,4390,2806,2786
"21443","Nsylvestris_NODE_5478_length_2867_cov_46","Ntome_NODE_28565_length_686_cov_5",94.737,684,36,0,840,1523,686,3,0,1064,683,683
"21485","Nsylvestris_NODE_5490_length_2864_cov_89","Ntome_NODE_7180_length_2625_cov_161",95.946,2590,84,8,28,2609,1,2577,0,4181,2581,2576
"21514","Nsylvestris_NODE_5497_length_2862_cov_91","Ntome_NODE_1943_length_4211_cov_178",96.147,2881,82,4,5,2862,116,2990,0,4678,2857,2874
"21529","Nsylvestris_NODE_5502_length_2861_cov_217","Ntome_NODE_835_length_5331_cov_242",97.818,2842,57,2,20,2861,5326,2490,0,4900,2841,2836
"21532","Nsylvestris_NODE_5504_length_2861_cov_158","Ntome_NODE_6956_length_2657_cov_203",97.158,2604,64,6,102,2702,2,2598,0,4390,2600,2596
"21540","Nsylvestris_NODE_5507_length_2861_cov_52","Ntome_NODE_3762_length_3432_cov_290",86.28,379,47,2,2008,2382,2804,2427,4.14e-112,407,374,377
"21599","Nsylvestris_NODE_5520_length_2858_cov_108","Ntome_NODE_4840_length_3123_cov_285",93.682,2833,135,25,56,2857,2866,47,0,4200,2801,2819
"21617","Nsylvestris_NODE_5526_length_2857_cov_44","Ntome_NODE_4525_length_3204_cov_41",96.628,2402,74,2,159,2553,520,2921,0,3980,2394,2401
"21633","Nsylvestris_NODE_5530_length_2855_cov_224","Ntome_NODE_4706_length_3158_cov_238",96.27,2842,94,9,1,2830,2843,2,0,4650,2829,2841
"21650","Nsylvestris_NODE_5536_length_2855_cov_36","Ntome_NODE_7154_length_2630_cov_20",95.404,2633,117,3,124,2755,1,2630,0,4189,2631,2629
"21663","Nsylvestris_NODE_5541_length_2854_cov_70","Ntome_NODE_7562_length_2560_cov_292",81.496,2032,324,29,709,2711,391,2399,0,1622,2002,2008
"21664","Nsylvestris_NODE_5542_length_2852_cov_228","Ntome_NODE_5557_length_2948_cov_290",94.423,2618,132,7,196,2804,2948,336,0,4013,2608,2612
"21704","Nsylvestris_NODE_5553_length_2851_cov_91","Ntome_NODE_17522_length_1401_cov_25",89.474,114,11,1,2005,2117,1285,1398,1.29e-32,143,112,113
"21804","Nsylvestris_NODE_5581_length_2846_cov_210","Ntome_NODE_4463_length_3216_cov_246",98.07,2798,46,2,49,2846,3019,230,0,4861,2797,2789
"21858","Nsylvestris_NODE_5595_length_2841_cov_151","Ntome_NODE_5331_length_3000_cov_225",96.112,2855,74,14,1,2841,40,2871,0,4623,2840,2831
"21863","Nsylvestris_NODE_5598_length_2841_cov_122","Ntome_NODE_2054_length_4138_cov_177",95.566,2616,102,6,47,2653,1,2611,0,4176,2606,2610
"21934","Nsylvestris_NODE_5618_length_2835_cov_153","Ntome_NODE_1071_length_4997_cov_170",96.465,2433,77,6,393,2823,2579,154,0,4008,2430,2425
"21935","Nsylvestris_NODE_5619_length_2835_cov_63","Ntome_NODE_9651_length_2245_cov_271",98.113,53,1,0,2783,2835,1257,1309,1.31e-17,93.5,52,52
"21961","Nsylvestris_NODE_5627_length_2832_cov_223","Ntome_NODE_6004_length_2846_cov_261",96.401,2806,72,7,14,2812,2784,1,0,4595,2798,2783
"21997","Nsylvestris_NODE_5638_length_2831_cov_29","Ntome_NODE_5962_length_2857_cov_24",97.272,2273,49,3,29,2300,90,2350,0,3842,2271,2260
"22020","Nsylvestris_NODE_5645_length_2829_cov_211","Ntome_NODE_4924_length_3104_cov_262",96.808,2851,59,11,1,2829,2921,81,0,4732,2828,2840
"22031","Nsylvestris_NODE_5648_length_2828_cov_178","Ntome_NODE_29979_length_629_cov_5",76.037,217,46,6,505,719,532,320,4.65e-22,108,214,212
"22070","Nsylvestris_NODE_5661_length_2825_cov_50","Ntome_NODE_29308_length_656_cov_24",84.286,210,23,5,2601,2808,438,639,9.64e-49,196,207,201
"22127","Nsylvestris_NODE_5677_length_2823_cov_29","Ntome_NODE_5658_length_2925_cov_283",95.993,2720,85,10,1,2711,2833,129,0,4397,2710,2704
"22152","Nsylvestris_NODE_5686_length_2822_cov_27","Ntome_NODE_12982_length_1844_cov_104",95.776,1586,67,0,998,2583,1647,62,0,2558,1585,1585
"22153","Nsylvestris_NODE_5687_length_2822_cov_26","Ntome_NODE_5070_length_3061_cov_113",93.748,2751,141,14,53,2775,248,2995,0,4098,2722,2747
"22192","Nsylvestris_NODE_5698_length_2820_cov_224","Ntome_NODE_228_length_7228_cov_122",96.897,2675,77,4,120,2793,4550,7219,0,4475,2673,2669
"22195","Nsylvestris_NODE_5700_length_2820_cov_134","Ntome_NODE_6072_length_2835_cov_122",93.299,2686,136,24,18,2683,2785,124,0,3923,2665,2661
"22196","Nsylvestris_NODE_5701_length_2820_cov_130","Ntome_NODE_3037_length_3684_cov_152",95.021,2792,121,9,37,2820,3,2784,0,4370,2783,2781
"22215","Nsylvestris_NODE_5708_length_2818_cov_224","Ntome_NODE_5634_length_2931_cov_260",96.503,2774,85,8,48,2818,96,2860,0,4575,2770,2764
"22237","Nsylvestris_NODE_5714_length_2818_cov_31","Ntome_NODE_35553_length_353_cov_2",95.751,353,13,1,2324,2674,1,353,1.77e-160,568,350,352
"22292","Nsylvestris_NODE_5729_length_2816_cov_153","Ntome_NODE_7022_length_2652_cov_36",95.677,2614,111,2,4,2615,2614,1,0,4200,2611,2613
"22369","Nsylvestris_NODE_5751_length_2810_cov_131","Ntome_NODE_6543_length_2739_cov_285",94.39,2674,118,9,150,2810,46,2700,0,4078,2660,2654
"22370","Nsylvestris_NODE_5752_length_2810_cov_120","Ntome_NODE_1180_length_4860_cov_111",94.163,2844,114,28,1,2805,2976,146,0,4285,2804,2830
"22407","Nsylvestris_NODE_5763_length_2807_cov_187","Ntome_NODE_2306_length_4002_cov_267",96.024,2515,91,5,252,2764,2508,1,0,4082,2512,2507
"22455","Nsylvestris_NODE_5777_length_2805_cov_192","Ntome_NODE_7466_length_2575_cov_189",94.635,2535,112,12,59,2582,1,2522,0,3906,2523,2521
"22525","Nsylvestris_NODE_5796_length_2801_cov_132","Ntome_NODE_4404_length_3237_cov_141",96.465,2461,67,9,356,2801,2492,37,0,4045,2445,2455
"22566","Nsylvestris_NODE_5807_length_2799_cov_89","Ntome_NODE_3543_length_3503_cov_124",96.468,2746,75,14,61,2799,49,2779,0,4514,2738,2730
"22589","Nsylvestris_NODE_5814_length_2798_cov_95","Ntome_NODE_6680_length_2716_cov_133",96.502,2659,84,4,47,2701,1,2654,0,4386,2654,2653
"22692","Nsylvestris_NODE_5846_length_2793_cov_69","Ntome_NODE_5801_length_2894_cov_95",94.434,2767,102,24,52,2792,2808,68,0,4209,2740,2740
"22693","Nsylvestris_NODE_5847_length_2792_cov_221","Ntome_NODE_2110_length_4103_cov_276",96.251,2454,86,2,93,2541,2499,47,0,4017,2448,2452
"22715","Nsylvestris_NODE_5853_length_2791_cov_118","Ntome_NODE_8713_length_2382_cov_201",93.889,2242,111,14,477,2694,2291,52,0,3358,2217,2239
"22823","Nsylvestris_NODE_5886_length_2787_cov_13","Ntome_NODE_6921_length_2670_cov_47",84.115,2323,338,24,326,2635,2507,203,0,2217,2309,2304
"22830","Nsylvestris_NODE_5889_length_2786_cov_214","Ntome_NODE_5740_length_2908_cov_195",94.092,2759,112,25,57,2786,2811,75,0,4145,2729,2736
"22856","Nsylvestris_NODE_5897_length_2783_cov_210","Ntome_NODE_3878_length_3394_cov_102",95.788,2374,82,6,129,2494,53,2416,0,3814,2365,2363
"22874","Nsylvestris_NODE_5900_length_2782_cov_223","Ntome_NODE_6800_length_2694_cov_300",95.261,2722,74,11,9,2718,16,2694,0,4261,2709,2678
"22894","Nsylvestris_NODE_5905_length_2780_cov_212","Ntome_NODE_4051_length_3334_cov_237",96.66,2665,50,15,95,2726,3334,676,0,4392,2631,2658
"22903","Nsylvestris_NODE_5908_length_2780_cov_41","Ntome_NODE_3294_length_3590_cov_41",93.309,2735,142,18,49,2779,2721,24,0,3999,2730,2697
"22912","Nsylvestris_NODE_5911_length_2779_cov_210","Ntome_NODE_5153_length_3043_cov_258",96.933,2739,65,9,46,2773,178,2908,0,4575,2727,2730
"22960","Nsylvestris_NODE_5923_length_2776_cov_136","Ntome_NODE_26373_length_788_cov_235",95.779,616,23,3,1,613,3,618,0,990,612,615
"23008","Nsylvestris_NODE_5936_length_2773_cov_94","Ntome_NODE_6399_length_2767_cov_84",94.949,2673,102,10,3,2642,2723,51,0,4157,2639,2672
"23026","Nsylvestris_NODE_5942_length_2770_cov_220","Ntome_NODE_7477_length_2574_cov_115",94.927,2523,118,7,175,2697,2513,1,0,3941,2522,2512
"23052","Nsylvestris_NODE_5950_length_2769_cov_206","Ntome_NODE_6844_length_2686_cov_194",96.426,2686,70,6,70,2732,2683,1,0,4405,2662,2682
"23059","Nsylvestris_NODE_5952_length_2769_cov_161","Ntome_NODE_5725_length_2912_cov_227",94.691,2769,138,3,1,2767,2808,47,0,4290,2766,2761
"23081","Nsylvestris_NODE_5960_length_2768_cov_59","Ntome_NODE_6821_length_2690_cov_145",94.819,2683,110,15,19,2685,1,2670,0,4157,2666,2669
"23152","Nsylvestris_NODE_5980_length_2765_cov_72","Ntome_NODE_3942_length_3375_cov_34",95.841,2573,97,8,117,2685,2567,1,0,4150,2568,2566
"23153","Nsylvestris_NODE_5981_length_2764_cov_236","Ntome_NODE_479_length_6085_cov_276",98.885,2690,22,3,1,2682,2751,5440,0,4795,2681,2689
"23166","Nsylvestris_NODE_5985_length_2764_cov_19","Ntome_NODE_1597_length_4456_cov_100",94.376,2756,127,13,3,2746,1639,4378,0,4205,2743,2739
"23206","Nsylvestris_NODE_5996_length_2761_cov_139","Ntome_NODE_15819_length_1556_cov_160",95.401,1435,56,7,1232,2663,78,1505,0,2276,1431,1427
"23281","Nsylvestris_NODE_6017_length_2757_cov_224","Ntome_NODE_6375_length_2772_cov_182",96.474,2751,58,13,9,2728,23,2765,0,4506,2719,2742
"23284","Nsylvestris_NODE_6019_length_2757_cov_97","Ntome_NODE_5916_length_2868_cov_112",94.488,2413,130,3,188,2599,404,2814,0,3716,2411,2410
"23301","Nsylvestris_NODE_6025_length_2755_cov_179","Ntome_NODE_5370_length_2993_cov_168",96.938,2711,61,9,5,2711,187,2879,0,4527,2706,2692
"23347","Nsylvestris_NODE_6037_length_2753_cov_222","Ntome_NODE_5034_length_3068_cov_281",96.698,2695,77,7,64,2751,3018,329,0,4473,2687,2689
"23348","Nsylvestris_NODE_6038_length_2753_cov_209","Ntome_NODE_6849_length_2685_cov_119",95.335,2658,110,3,82,2734,2650,2,0,4209,2652,2648
"23361","Nsylvestris_NODE_6041_length_2752_cov_127","Ntome_NODE_317_length_6640_cov_140",97.875,2635,56,0,1,2635,2683,49,0,4556,2634,2634
"23389","Nsylvestris_NODE_6048_length_2750_cov_146","Ntome_NODE_6065_length_2836_cov_222",95.398,2716,115,4,42,2750,44,2756,0,4314,2708,2712
"23398","Nsylvestris_NODE_6052_length_2749_cov_37","Ntome_NODE_5189_length_3035_cov_151",96.393,2523,66,7,12,2512,36,2555,0,4132,2500,2519
"23432","Nsylvestris_NODE_6060_length_2747_cov_34","Ntome_NODE_6755_length_2703_cov_38",94.205,2709,132,8,1,2699,8,2701,0,4109,2698,2693
"23473","Nsylvestris_NODE_6074_length_2743_cov_161","Ntome_NODE_5898_length_2872_cov_41",94.632,2664,105,10,33,2683,2826,188,0,4093,2650,2638
"23489","Nsylvestris_NODE_6079_length_2742_cov_155","Ntome_NODE_8513_length_2411_cov_236",93.66,2161,108,10,538,2677,2236,84,0,3205,2139,2152
"23504","Nsylvestris_NODE_6084_length_2741_cov_147","Ntome_NODE_5773_length_2902_cov_258",94.795,2709,119,14,8,2706,176,2872,0,4202,2698,2696
"23505","Nsylvestris_NODE_6085_length_2741_cov_95","Ntome_NODE_7346_length_2595_cov_137",94.636,2442,59,19,2,2380,2580,148,0,3718,2378,2432
"23563","Nsylvestris_NODE_6101_length_2737_cov_164","Ntome_NODE_16055_length_1535_cov_18",95.652,1495,62,2,537,2031,1,1492,0,2398,1494,1491
"23651","Nsylvestris_NODE_6127_length_2731_cov_167","Ntome_NODE_14348_length_1700_cov_288",93.001,1443,59,14,425,1856,1570,159,0,2067,1431,1411
"23690","Nsylvestris_NODE_6138_length_2728_cov_155","Ntome_NODE_7234_length_2617_cov_189",93.953,2580,126,20,120,2688,13,2573,0,3873,2568,2560
"23704","Nsylvestris_NODE_6142_length_2727_cov_216","Ntome_NODE_560_length_5870_cov_259",95.607,2481,59,12,275,2727,4127,1669,0,3932,2452,2458
"23708","Nsylvestris_NODE_6144_length_2727_cov_95","Ntome_NODE_11377_length_2028_cov_105",92.279,1865,77,20,838,2672,1941,114,0,2584,1834,1827
"23717","Nsylvestris_NODE_6147_length_2727_cov_26","Ntome_NODE_10415_length_2144_cov_43",79.227,905,153,31,921,1814,1522,642,2.18e-169,597,893,880
"23737","Nsylvestris_NODE_6154_length_2725_cov_170","Ntome_NODE_5488_length_2964_cov_188",93.57,2597,148,11,43,2633,363,2946,0,3853,2590,2583
"23750","Nsylvestris_NODE_6158_length_2724_cov_117","Ntome_NODE_2693_length_3817_cov_121",93.084,2675,158,18,6,2673,2772,118,0,3890,2667,2654
"23786","Nsylvestris_NODE_6168_length_2722_cov_230","Ntome_NODE_3186_length_3625_cov_255",98.477,2363,36,0,360,2722,3625,1263,0,4165,2362,2362
"23796","Nsylvestris_NODE_6171_length_2722_cov_142","Ntome_NODE_1056_length_5012_cov_209",97.381,2673,50,9,54,2711,2700,33,0,4530,2657,2667
"23797","Nsylvestris_NODE_6173_length_2722_cov_72","Ntome_NODE_1696_length_4385_cov_34",91.137,1918,124,12,770,2664,2491,4385,0,2558,1894,1894
"23798","Nsylvestris_NODE_6174_length_2721_cov_184","Ntome_NODE_6810_length_2693_cov_83",95.34,2575,81,9,110,2652,2612,45,0,4054,2542,2567
"23832","Nsylvestris_NODE_6185_length_2720_cov_51","Ntome_NODE_1039_length_5030_cov_156",97.612,2178,52,0,245,2422,272,2449,0,3735,2177,2177
"23868","Nsylvestris_NODE_6195_length_2718_cov_227","Ntome_NODE_7571_length_2558_cov_277",96.596,2556,64,6,1,2538,2554,4,0,4217,2537,2550
"23869","Nsylvestris_NODE_6196_length_2718_cov_213","Ntome_NODE_4644_length_3173_cov_218",97.664,2483,45,3,1,2471,3169,688,0,4252,2470,2481
"23885","Nsylvestris_NODE_6201_length_2717_cov_44","Ntome_NODE_7400_length_2585_cov_99",97.297,2368,55,2,348,2715,215,2573,0,4010,2367,2358
"23886","Nsylvestris_NODE_6202_length_2717_cov_28","Ntome_NODE_17135_length_1437_cov_6",85.292,1387,201,2,651,2034,1387,1,0,1428,1383,1386
"23905","Nsylvestris_NODE_6208_length_2715_cov_79","Ntome_NODE_6778_length_2698_cov_63",93.129,2707,166,7,18,2713,1,2698,0,3951,2695,2697
"24052","Nsylvestris_NODE_6246_length_2708_cov_48","Ntome_NODE_2172_length_4075_cov_32",94.467,2476,118,9,60,2529,2464,2,0,3795,2469,2462
"24069","Nsylvestris_NODE_6251_length_2707_cov_112","Ntome_NODE_2393_length_3964_cov_240",92.737,1666,67,23,11,1626,3955,2294,0,2357,1615,1661
"24121","Nsylvestris_NODE_6267_length_2704_cov_103","Ntome_NODE_8065_length_2481_cov_122",97.437,2068,51,2,7,2073,2374,308,0,3524,2066,2066
"24133","Nsylvestris_NODE_6270_length_2703_cov_120","Ntome_NODE_1714_length_4371_cov_239",78.125,256,53,1,379,631,855,1110,1.21e-37,159,252,255
"24141","Nsylvestris_NODE_6272_length_2703_cov_78","Ntome_NODE_1124_length_4927_cov_46",95.96,99,4,0,1,99,1984,2082,3.36e-38,161,98,98
"24142","Nsylvestris_NODE_6273_length_2703_cov_54","Ntome_NODE_8339_length_2437_cov_11",97.542,2360,58,0,270,2629,2361,2,0,4037,2359,2359
"24197","Nsylvestris_NODE_6289_length_2699_cov_224","Ntome_NODE_6895_length_2675_cov_282",95.133,2630,121,5,40,2668,2624,1,0,4141,2628,2623
"24209","Nsylvestris_NODE_6293_length_2698_cov_227","Ntome_NODE_6627_length_2724_cov_267",96.848,2665,56,15,9,2655,2663,9,0,4431,2646,2654
"24313","Nsylvestris_NODE_6323_length_2693_cov_115","Ntome_NODE_6786_length_2695_cov_229",96.498,2484,80,7,1,2483,117,2594,0,4098,2482,2477
"24318","Nsylvestris_NODE_6326_length_2693_cov_67","Ntome_NODE_6392_length_2769_cov_86",94.059,2693,134,9,22,2693,8,2695,0,4063,2671,2687
"24343","Nsylvestris_NODE_6334_length_2692_cov_140","Ntome_NODE_2917_length_3729_cov_105",80.714,280,23,12,121,393,2028,1773,1.54e-46,189,272,255
"24361","Nsylvestris_NODE_6339_length_2691_cov_223","Ntome_NODE_7147_length_2630_cov_295",93.224,2509,77,35,178,2636,83,2548,0,3605,2458,2465
"24367","Nsylvestris_NODE_6341_length_2690_cov_235","Ntome_NODE_6957_length_2662_cov_108",95.884,2648,68,17,17,2648,15,2637,0,4248,2631,2622
"24383","Nsylvestris_NODE_6346_length_2689_cov_230","Ntome_NODE_2854_length_3754_cov_223",96.754,2680,65,16,6,2672,3720,1050,0,4447,2666,2670
"24414","Nsylvestris_NODE_6351_length_2688_cov_171","Ntome_NODE_12951_length_1846_cov_104",100,29,0,0,2021,2049,1289,1317,5.84e-06,54.7,28,28
"24415","Nsylvestris_NODE_6352_length_2688_cov_96","Ntome_NODE_3779_length_3427_cov_54",92.308,2392,113,33,1,2369,44,2387,0,3332,2368,2343
"24507","Nsylvestris_NODE_6377_length_2683_cov_197","Ntome_NODE_3241_length_3607_cov_273",94.845,2328,78,20,4,2302,2382,68,0,3596,2298,2314
"24525","Nsylvestris_NODE_6383_length_2682_cov_110","Ntome_NODE_8542_length_2407_cov_26",89.203,2019,193,10,372,2370,312,2325,0,2497,1998,2013
"24584","Nsylvestris_NODE_6400_length_2680_cov_156","Ntome_NODE_7064_length_2644_cov_287",96.227,2465,93,0,7,2471,2518,54,0,4037,2464,2464
"24659","Nsylvestris_NODE_6422_length_2675_cov_78","Ntome_NODE_6701_length_2713_cov_166",93.69,2599,130,13,1,2585,2627,49,0,3860,2584,2578
"24693","Nsylvestris_NODE_6432_length_2672_cov_168","Ntome_NODE_34367_length_402_cov_3",96.02,402,16,0,1109,1510,1,402,0,654,401,401
"24705","Nsylvestris_NODE_6436_length_2671_cov_234","Ntome_NODE_4593_length_3184_cov_156",96.879,2531,67,4,1,2521,2529,1,0,4226,2520,2528
"24706","Nsylvestris_NODE_6437_length_2671_cov_158","Ntome_NODE_7262_length_2611_cov_228",93.89,2553,127,15,4,2534,2605,60,0,3823,2530,2545
"24725","Nsylvestris_NODE_6444_length_2670_cov_226","Ntome_NODE_2301_length_4006_cov_268",97.607,2674,55,6,2,2670,1055,3724,0,4575,2668,2669
"24729","Nsylvestris_NODE_6446_length_2670_cov_200","Ntome_NODE_1680_length_4402_cov_293",79.337,392,46,18,855,1231,400,29,1.15e-62,243,376,371
"24733","Nsylvestris_NODE_6448_length_2670_cov_145","Ntome_NODE_3971_length_3363_cov_123",92.034,2498,133,25,1,2446,3226,743,0,3450,2445,2483
"24851","Nsylvestris_NODE_6482_length_2664_cov_160","Ntome_NODE_1974_length_4191_cov_114",97.958,2547,49,2,5,2549,12,2557,0,4412,2544,2545
"24873","Nsylvestris_NODE_6488_length_2663_cov_82","Ntome_NODE_8781_length_2373_cov_110",89.172,628,26,7,140,749,2373,1770,0,745,609,603
"24877","Nsylvestris_NODE_6490_length_2662_cov_208","Ntome_NODE_7367_length_2591_cov_195",95.188,2452,97,13,43,2475,90,2539,0,3855,2432,2449
"24880","Nsylvestris_NODE_6492_length_2662_cov_172","Ntome_NODE_1753_length_4340_cov_241",96.806,2442,45,7,198,2615,2540,108,0,4047,2417,2432
"24925","Nsylvestris_NODE_6507_length_2659_cov_215","Ntome_NODE_6980_length_2658_cov_260",95.012,2566,100,12,52,2611,6,2549,0,4004,2559,2543
"24981","Nsylvestris_NODE_6522_length_2657_cov_68","Ntome_NODE_9650_length_2245_cov_290",98.182,55,1,0,2603,2657,1532,1478,9.45e-19,97.1,54,54
"24982","Nsylvestris_NODE_6523_length_2657_cov_39","Ntome_NODE_1250_length_4785_cov_87",95,580,28,1,2041,2620,1874,2452,0,909,579,578
"25035","Nsylvestris_NODE_6537_length_2654_cov_206","Ntome_NODE_13676_length_1769_cov_253",92.987,1811,78,22,547,2350,1769,1,0,2595,1803,1768
"25047","Nsylvestris_NODE_6541_length_2653_cov_216","Ntome_NODE_772_length_5430_cov_171",97.368,38,1,0,2616,2653,94,57,2.66e-09,65.8,37,37
"25095","Nsylvestris_NODE_6555_length_2650_cov_113","Ntome_NODE_964_length_5140_cov_108",97.731,2336,52,1,82,2417,2838,504,0,4019,2335,2334
"25096","Nsylvestris_NODE_6556_length_2650_cov_54","Ntome_NODE_5243_length_3019_cov_74",85.61,549,54,13,325,863,2393,2926,4.65e-156,553,538,533
"25147","Nsylvestris_NODE_6572_length_2648_cov_59","Ntome_NODE_6611_length_2728_cov_200",95.51,2695,58,24,1,2648,40,2718,0,4248,2647,2678
"25208","Nsylvestris_NODE_6590_length_2645_cov_11","Ntome_NODE_84_length_8783_cov_174",82.717,2650,401,34,1,2609,6071,8704,0,2303,2608,2633
"25209","Nsylvestris_NODE_6591_length_2644_cov_225","Ntome_NODE_1457_length_4571_cov_272",86.27,2571,297,35,55,2594,195,2740,0,2741,2539,2545
"25229","Nsylvestris_NODE_6596_length_2643_cov_171","Ntome_NODE_10210_length_2169_cov_173",93.909,2118,93,8,251,2339,2115,5,0,3164,2088,2110
"25245","Nsylvestris_NODE_6601_length_2642_cov_199","Ntome_NODE_6530_length_2743_cov_103",97.812,2422,50,1,188,2609,325,2743,0,4176,2421,2418
"25257","Nsylvestris_NODE_6604_length_2641_cov_186","Ntome_NODE_7520_length_2567_cov_157",94.435,2408,100,19,70,2466,2465,81,0,3674,2396,2384
"25267","Nsylvestris_NODE_6607_length_2641_cov_154","Ntome_NODE_7912_length_2504_cov_244",94.208,2210,107,9,204,2398,2284,81,0,3352,2194,2203
"25309","Nsylvestris_NODE_6621_length_2638_cov_188","Ntome_NODE_8410_length_2425_cov_185",96.089,2327,76,9,222,2541,2319,1,0,3779,2319,2318
"25356","Nsylvestris_NODE_6633_length_2636_cov_207","Ntome_NODE_7544_length_2564_cov_121",93.93,2356,121,10,113,2454,173,2520,0,3539,2341,2347
"25357","Nsylvestris_NODE_6634_length_2636_cov_172","Ntome_NODE_6732_length_2706_cov_250",94.319,2658,101,29,1,2636,2684,55,0,4026,2635,2629
"25409","Nsylvestris_NODE_6648_length_2634_cov_17","Ntome_NODE_4584_length_3186_cov_27",96.697,2634,87,0,1,2634,523,3156,0,4383,2633,2633
"25410","Nsylvestris_NODE_6649_length_2634_cov_14","Ntome_NODE_6779_length_2698_cov_48",96.032,2369,82,1,278,2634,2559,191,0,3843,2356,2368
"25439","Nsylvestris_NODE_6658_length_2632_cov_206","Ntome_NODE_6968_length_2660_cov_266",97.101,2518,61,5,51,2560,2514,1,0,4235,2509,2513
"25452","Nsylvestris_NODE_6662_length_2631_cov_225","Ntome_NODE_2302_length_4005_cov_229",96.806,2536,61,14,44,2574,3255,735,0,4217,2530,2520
"25457","Nsylvestris_NODE_6664_length_2631_cov_136","Ntome_NODE_6628_length_2724_cov_251",91.504,2554,134,34,49,2566,2547,41,0,3437,2517,2506
"25519","Nsylvestris_NODE_6688_length_2624_cov_174","Ntome_NODE_7179_length_2625_cov_177",93.54,2616,92,18,1,2599,2556,1,0,3823,2598,2555
"25561","Nsylvestris_NODE_6699_length_2622_cov_195","Ntome_NODE_7879_length_2511_cov_261",83.333,72,8,4,222,290,882,952,9.46e-09,63.9,68,70
"25596","Nsylvestris_NODE_6710_length_2620_cov_53","Ntome_NODE_8963_length_2344_cov_12",94.062,2223,115,8,98,2319,2266,60,0,3358,2221,2206
"25597","Nsylvestris_NODE_6711_length_2620_cov_28","Ntome_NODE_4317_length_3256_cov_116",95.25,2463,107,2,168,2620,3205,743,0,3892,2452,2462
"25606","Nsylvestris_NODE_6714_length_2619_cov_175","Ntome_NODE_11107_length_2059_cov_274",95.437,2060,66,10,135,2194,2032,1,0,3258,2059,2031
"25647","Nsylvestris_NODE_6726_length_2617_cov_36","Ntome_NODE_7753_length_2532_cov_79",94.261,2457,94,23,185,2617,66,2499,0,3712,2432,2433
"25648","Nsylvestris_NODE_6727_length_2617_cov_31","Ntome_NODE_4722_length_3154_cov_44",97.811,2193,38,3,435,2617,3104,912,0,3775,2182,2192
"25654","Nsylvestris_NODE_6730_length_2615_cov_114","Ntome_NODE_7739_length_2534_cov_139",93.965,2502,115,15,31,2511,44,2530,0,3751,2480,2486
"25766","Nsylvestris_NODE_6761_length_2611_cov_169","Ntome_NODE_14374_length_1698_cov_100",94.745,1256,66,0,1332,2587,1258,3,0,1954,1255,1255
"25796","Nsylvestris_NODE_6772_length_2609_cov_44","Ntome_NODE_6619_length_2726_cov_40",94.045,2351,128,9,138,2480,328,2674,0,3555,2342,2346
"25799","Nsylvestris_NODE_6774_length_2608_cov_215","Ntome_NODE_6594_length_2731_cov_278",93.198,2602,104,26,30,2603,2681,125,0,3757,2573,2556
"25835","Nsylvestris_NODE_6785_length_2606_cov_78","Ntome_NODE_32140_length_539_cov_264",83.571,140,19,4,2442,2580,46,182,3.29e-28,128,138,136
"25847","Nsylvestris_NODE_6789_length_2605_cov_142","Ntome_NODE_8004_length_2490_cov_248",94.335,2383,107,13,67,2423,2381,1,0,3627,2356,2380
"25877","Nsylvestris_NODE_6797_length_2604_cov_138","Ntome_NODE_3612_length_3481_cov_133",96.806,1440,45,1,50,1488,1365,2804,0,2403,1438,1439
"25959","Nsylvestris_NODE_6817_length_2601_cov_33","Ntome_NODE_9385_length_2284_cov_66",96.295,2159,65,6,455,2599,2279,122,0,3530,2144,2157
"26006","Nsylvestris_NODE_6830_length_2598_cov_165","Ntome_NODE_6991_length_2656_cov_173",94.315,2533,116,10,37,2554,1,2520,0,3855,2517,2519
"26034","Nsylvestris_NODE_6837_length_2597_cov_13","Ntome_NODE_4217_length_3285_cov_72",86.275,102,13,1,2,103,2702,2602,1.19e-22,110,101,100
"26091","Nsylvestris_NODE_6854_length_2593_cov_232","Ntome_NODE_7832_length_2518_cov_269",94.047,2503,111,9,88,2584,48,2518,0,3762,2496,2470
"26126","Nsylvestris_NODE_6864_length_2592_cov_57","Ntome_NODE_18113_length_1349_cov_149",85.088,456,50,7,1615,2069,503,65,6.14e-125,449,454,438
"26127","Nsylvestris_NODE_6865_length_2592_cov_42","Ntome_NODE_6921_length_2670_cov_47",97.095,2582,71,4,2,2581,91,2670,0,4349,2579,2579
"26156","Nsylvestris_NODE_6877_length_2588_cov_231","Ntome_NODE_4606_length_3181_cov_254",95.875,2570,76,10,3,2548,498,3061,0,4132,2545,2563
"26157","Nsylvestris_NODE_6878_length_2588_cov_226","Ntome_NODE_4105_length_3319_cov_273",98.628,2479,33,1,1,2479,818,3295,0,4388,2478,2477
"26163","Nsylvestris_NODE_6880_length_2588_cov_151","Ntome_NODE_9263_length_2301_cov_79",95.06,1680,58,6,125,1781,1,1678,0,2619,1656,1677
"26209","Nsylvestris_NODE_6894_length_2586_cov_205","Ntome_NODE_6021_length_2843_cov_285",96.331,2589,91,3,1,2586,2831,244,0,4252,2585,2587
"26250","Nsylvestris_NODE_6905_length_2584_cov_114","Ntome_NODE_1940_length_4214_cov_47",75.604,414,77,19,1968,2369,663,262,6.86e-45,183,401,401
"26286","Nsylvestris_NODE_6915_length_2583_cov_29","Ntome_NODE_86_length_8769_cov_146",86.905,84,11,0,234,317,2386,2303,3.3e-18,95.3,83,83
"26306","Nsylvestris_NODE_6921_length_2582_cov_16","Ntome_NODE_8032_length_2486_cov_44",93.224,2450,101,21,1,2419,2462,47,0,3544,2418,2415
"26337","Nsylvestris_NODE_6928_length_2580_cov_228","Ntome_NODE_6879_length_2678_cov_254",95.624,2582,84,11,1,2562,2578,6,0,4115,2561,2572
"26408","Nsylvestris_NODE_6950_length_2577_cov_58","Ntome_NODE_7332_length_2598_cov_59",94.941,2530,122,4,52,2577,2598,71,0,3958,2525,2527
"26442","Nsylvestris_NODE_6958_length_2576_cov_23","Ntome_NODE_13143_length_1826_cov_51",83.175,315,50,2,1129,1443,1541,1230,1.82e-75,285,314,311
"26478","Nsylvestris_NODE_6969_length_2574_cov_119","Ntome_NODE_4035_length_3338_cov_247",95.419,2423,87,17,3,2414,49,2458,0,3838,2411,2409
"26568","Nsylvestris_NODE_6994_length_2570_cov_133","Ntome_NODE_5440_length_2975_cov_217",95.704,1746,75,0,213,1958,836,2581,0,2809,1745,1745
"26598","Nsylvestris_NODE_7005_length_2568_cov_216","Ntome_NODE_9113_length_2321_cov_304",94.305,2230,66,21,267,2480,89,2273,0,3358,2213,2184
"26603","Nsylvestris_NODE_7007_length_2568_cov_166","Ntome_NODE_26197_length_797_cov_210",97.468,79,2,0,2450,2528,382,304,1.94e-30,135,78,78
"26604","Nsylvestris_NODE_7008_length_2568_cov_160","Ntome_NODE_12529_length_1894_cov_283",93.95,1785,96,8,204,1979,1819,38,0,2687,1775,1781
"26627","Nsylvestris_NODE_7016_length_2567_cov_108","Ntome_NODE_6481_length_2751_cov_246",96.003,2527,77,14,51,2562,83,2600,0,4085,2511,2517
"26669","Nsylvestris_NODE_7030_length_2564_cov_169","Ntome_NODE_8050_length_2483_cov_248",100,55,0,0,1,55,1578,1524,1.96e-20,102,54,54
"26670","Nsylvestris_NODE_7031_length_2564_cov_161","Ntome_NODE_5280_length_3012_cov_52",98.122,2502,42,2,1,2502,2499,3,0,4355,2501,2496
"26682","Nsylvestris_NODE_7035_length_2563_cov_220","Ntome_NODE_7480_length_2573_cov_292",94.081,2534,117,21,1,2524,11,2521,0,3818,2523,2510
"26687","Nsylvestris_NODE_7037_length_2563_cov_190","Ntome_NODE_13433_length_1792_cov_296",97.734,1633,35,1,350,1980,52,1684,0,2809,1630,1632
"26693","Nsylvestris_NODE_7039_length_2563_cov_158","Ntome_NODE_5720_length_2913_cov_106",92.223,1903,115,10,330,2217,2120,236,0,2663,1887,1884
"26706","Nsylvestris_NODE_7042_length_2563_cov_31","Ntome_NODE_8921_length_2351_cov_30",95.389,2342,88,8,135,2468,2351,22,0,3709,2333,2329
"26773","Nsylvestris_NODE_7062_length_2560_cov_179","Ntome_NODE_9208_length_2308_cov_33",95.23,2285,104,3,201,2481,1,2284,0,3611,2280,2283
"26795","Nsylvestris_NODE_7070_length_2559_cov_75","Ntome_NODE_2217_length_4051_cov_228",90.278,72,6,1,2475,2545,332,403,1.18e-17,93.5,70,71
"26812","Nsylvestris_NODE_7075_length_2558_cov_132","Ntome_NODE_6605_length_2729_cov_185",97.654,2558,55,2,1,2558,2594,42,0,4386,2557,2552
"26818","Nsylvestris_NODE_7077_length_2557_cov_230","Ntome_NODE_353_length_6496_cov_280",96.651,2568,74,4,1,2557,3896,6462,0,4255,2556,2566
"26851","Nsylvestris_NODE_7085_length_2555_cov_203","Ntome_NODE_5200_length_3031_cov_81",96.367,2037,69,3,524,2555,2488,452,0,3347,2031,2036
"26912","Nsylvestris_NODE_7103_length_2553_cov_97","Ntome_NODE_7707_length_2539_cov_45",96.229,2466,76,9,49,2505,2458,1,0,4023,2456,2457
"26920","Nsylvestris_NODE_7106_length_2552_cov_208","Ntome_NODE_8805_length_2369_cov_167",96.491,2280,72,6,208,2481,2326,49,0,3760,2273,2277
"26967","Nsylvestris_NODE_7120_length_2550_cov_62","Ntome_NODE_16637_length_1483_cov_14",97.367,1481,39,0,689,2169,1483,3,0,2519,1480,1480
"26971","Nsylvestris_NODE_7122_length_2550_cov_45","Ntome_NODE_7168_length_2628_cov_84",96.471,2550,78,3,4,2550,2543,3,0,4200,2546,2540
"27016","Nsylvestris_NODE_7133_length_2549_cov_20","Ntome_NODE_6426_length_2762_cov_71",96.4,2500,86,2,46,2545,2654,159,0,4115,2499,2495
"27049","Nsylvestris_NODE_7142_length_2546_cov_202","Ntome_NODE_10173_length_2174_cov_284",94.214,2022,75,21,446,2433,106,2119,0,3048,1987,2013
"27140","Nsylvestris_NODE_7167_length_2540_cov_216","Ntome_NODE_7293_length_2605_cov_292",96.697,2452,42,10,30,2469,1,2425,0,4043,2439,2424
"27146","Nsylvestris_NODE_7170_length_2540_cov_198","Ntome_NODE_8414_length_2425_cov_56",96.416,2344,68,5,151,2488,2372,39,0,3849,2337,2333
"27154","Nsylvestris_NODE_7173_length_2539_cov_227","Ntome_NODE_868_length_5269_cov_120",97.202,2359,64,1,1,2359,3003,647,0,3989,2358,2356
"27208","Nsylvestris_NODE_7189_length_2537_cov_87","Ntome_NODE_11123_length_2057_cov_113",95.552,1956,87,0,346,2301,55,2010,0,3131,1955,1955
"27212","Nsylvestris_NODE_7191_length_2537_cov_45","Ntome_NODE_9634_length_2248_cov_248",86.944,337,44,0,557,893,1694,1358,8e-104,379,336,336
"27220","Nsylvestris_NODE_7194_length_2536_cov_40","Ntome_NODE_13526_length_1784_cov_3",92.999,1814,92,23,553,2361,1,1784,0,2614,1808,1783
"27268","Nsylvestris_NODE_7208_length_2532_cov_183","Ntome_NODE_7407_length_2584_cov_243",95.474,2541,58,25,11,2508,2532,6,0,4002,2497,2526
"27282","Nsylvestris_NODE_7212_length_2532_cov_87","Ntome_NODE_7604_length_2553_cov_160",91.801,866,53,9,1603,2456,1694,2553,0,1190,853,859
"27283","Nsylvestris_NODE_7213_length_2531_cov_226","Ntome_NODE_7601_length_2553_cov_294",96.862,2390,62,6,105,2484,23,2409,0,3986,2379,2386
"27320","Nsylvestris_NODE_7225_length_2530_cov_130","Ntome_NODE_930_length_5192_cov_209",96.044,2477,95,1,1,2477,2513,40,0,4028,2476,2473
"27321","Nsylvestris_NODE_7226_length_2530_cov_89","Ntome_NODE_7861_length_2515_cov_133",93.058,2420,103,19,56,2452,2465,88,0,3478,2396,2377
"27322","Nsylvestris_NODE_7227_length_2530_cov_64","Ntome_NODE_7926_length_2502_cov_72",97.889,2511,43,4,19,2528,2502,1,0,4335,2509,2501
"27366","Nsylvestris_NODE_7240_length_2528_cov_144","Ntome_NODE_293_length_6755_cov_121",96.749,2461,74,5,68,2528,71,2525,0,4096,2460,2454
"27367","Nsylvestris_NODE_7241_length_2528_cov_94","Ntome_NODE_6571_length_2735_cov_73",95.116,2498,97,12,1,2480,45,2535,0,3914,2479,2490
"27368","Nsylvestris_NODE_7242_length_2528_cov_81","Ntome_NODE_1602_length_4452_cov_92",96.838,2277,63,2,1,2268,2092,4368,0,3797,2267,2276
"27389","Nsylvestris_NODE_7249_length_2527_cov_102","Ntome_NODE_19809_length_1209_cov_141",91.803,1159,63,14,1367,2519,50,1182,0,1585,1152,1132
"27397","Nsylvestris_NODE_7252_length_2526_cov_201","Ntome_NODE_8019_length_2488_cov_296",95.452,2199,95,2,132,2325,239,2437,0,3502,2193,2198
"27433","Nsylvestris_NODE_7263_length_2524_cov_223","Ntome_NODE_8235_length_2453_cov_265",95.227,2242,94,8,194,2423,189,2429,0,3535,2229,2240
"27450","Nsylvestris_NODE_7268_length_2524_cov_139","Ntome_NODE_10088_length_2188_cov_171",90.099,2030,129,20,7,2034,170,2129,0,2569,2027,1959
"27527","Nsylvestris_NODE_7287_length_2521_cov_103","Ntome_NODE_8058_length_2482_cov_96",95.395,2454,72,19,29,2469,2431,6,0,3868,2440,2425
"27597","Nsylvestris_NODE_7307_length_2518_cov_222","Ntome_NODE_7822_length_2520_cov_288",93.783,2445,116,16,1,2436,2474,57,0,3640,2435,2417
"27598","Nsylvestris_NODE_7308_length_2518_cov_219","Ntome_NODE_8262_length_2447_cov_291",95.562,2321,59,6,40,2335,31,2332,0,3675,2295,2301
"27655","Nsylvestris_NODE_7327_length_2516_cov_59","Ntome_NODE_8091_length_2476_cov_122",97.217,2479,63,2,1,2479,2473,1,0,4191,2478,2472
"27673","Nsylvestris_NODE_7333_length_2515_cov_87","Ntome_NODE_19317_length_1250_cov_251",94.956,1031,47,1,116,1146,64,1089,0,1611,1030,1025
"27689","Nsylvestris_NODE_7339_length_2514_cov_132","Ntome_NODE_23160_length_974_cov_6",92.536,978,55,6,1437,2408,967,2,0,1386,971,965
"27690","Nsylvestris_NODE_7340_length_2514_cov_123","Ntome_NODE_6766_length_2700_cov_105",93.536,2336,127,11,15,2342,28,2347,0,3456,2327,2319
"27713","Nsylvestris_NODE_7346_length_2513_cov_190","Ntome_NODE_8466_length_2417_cov_269",94.659,2378,76,23,125,2476,32,2384,0,3640,2351,2352
"27768","Nsylvestris_NODE_7361_length_2511_cov_64","Ntome_NODE_10388_length_2147_cov_99",93.115,2106,132,6,154,2250,2147,46,0,3073,2096,2101
"27817","Nsylvestris_NODE_7377_length_2507_cov_208","Ntome_NODE_19783_length_1211_cov_240",96.04,101,4,0,332,432,574,474,2.41e-39,165,100,100
"27838","Nsylvestris_NODE_7383_length_2507_cov_171","Ntome_NODE_10873_length_2088_cov_22",94.527,2083,96,3,328,2410,24,2088,0,3199,2082,2064
"27950","Nsylvestris_NODE_7414_length_2502_cov_199","Ntome_NODE_7749_length_2533_cov_71",95.376,2422,89,11,37,2439,2418,1,0,3831,2402,2417
"27960","Nsylvestris_NODE_7416_length_2502_cov_140","Ntome_NODE_1641_length_4426_cov_284",85.911,291,35,4,268,556,3853,3567,1.36e-81,305,288,286
"27969","Nsylvestris_NODE_7420_length_2501_cov_169","Ntome_NODE_5957_length_2859_cov_229",97.144,2451,47,3,53,2492,83,2521,0,4117,2439,2438
"27985","Nsylvestris_NODE_7427_length_2500_cov_75","Ntome_NODE_9009_length_2338_cov_64",83.617,1410,214,15,582,1981,654,2056,0,1308,1399,1402
"28034","Nsylvestris_NODE_7441_length_2497_cov_111","Ntome_NODE_12780_length_1864_cov_280",96.25,1040,31,1,195,1234,1819,788,0,1698,1039,1031
"28075","Nsylvestris_NODE_7452_length_2495_cov_194","Ntome_NODE_10897_length_2085_cov_277",94.871,2008,70,9,365,2360,2035,49,0,3107,1995,1986
"28085","Nsylvestris_NODE_7456_length_2494_cov_226","Ntome_NODE_8772_length_2374_cov_104",95.487,2393,78,12,90,2476,6,2374,0,3794,2386,2368
"28147","Nsylvestris_NODE_7475_length_2491_cov_228","Ntome_NODE_2993_length_3702_cov_281",97.746,2263,49,2,43,2305,1442,3702,0,3895,2262,2260
"28148","Nsylvestris_NODE_7476_length_2491_cov_204","Ntome_NODE_1219_length_4812_cov_121",72.553,1563,378,44,216,1748,4412,2871,7.58e-129,462,1532,1541
"28157","Nsylvestris_NODE_7479_length_2491_cov_123","Ntome_NODE_7320_length_2600_cov_266",95.291,1338,54,4,1116,2450,1265,2596,0,2113,1334,1331
"28165","Nsylvestris_NODE_7482_length_2490_cov_206","Ntome_NODE_7510_length_2569_cov_182",93.921,2418,113,12,12,2407,85,2490,0,3620,2395,2405
"28209","Nsylvestris_NODE_7494_length_2486_cov_172","Ntome_NODE_7992_length_2491_cov_283",95.52,2232,82,7,1,2217,125,2353,0,3552,2216,2228
"28225","Nsylvestris_NODE_7499_length_2486_cov_63","Ntome_NODE_7514_length_2569_cov_56",83.083,999,164,5,1436,2431,1185,2181,0,904,995,996
"28237","Nsylvestris_NODE_7503_length_2485_cov_180","Ntome_NODE_863_length_5280_cov_173",95.459,2136,51,8,73,2174,5280,3157,0,3365,2101,2123
"28277","Nsylvestris_NODE_7517_length_2483_cov_176","Ntome_NODE_9855_length_2218_cov_45",93.938,2227,81,20,56,2237,2218,1,0,3315,2181,2217
"28306","Nsylvestris_NODE_7527_length_2481_cov_184","Ntome_NODE_8128_length_2471_cov_218",94.408,2414,67,28,32,2410,41,2421,0,3648,2378,2380
"28316","Nsylvestris_NODE_7531_length_2480_cov_141","Ntome_NODE_1780_length_4327_cov_31",94.793,2362,98,8,30,2371,4325,1969,0,3657,2341,2356
"28349","Nsylvestris_NODE_7542_length_2478_cov_239","Ntome_NODE_1980_length_4187_cov_273",98.03,2437,42,1,1,2437,3445,1015,0,4229,2436,2430
"28408","Nsylvestris_NODE_7555_length_2476_cov_226","Ntome_NODE_7267_length_2610_cov_292",97.093,2442,54,5,45,2470,2576,136,0,4100,2425,2440
"28409","Nsylvestris_NODE_7556_length_2476_cov_198","Ntome_NODE_8140_length_2469_cov_257",96.907,2425,59,11,1,2412,2469,48,0,4048,2411,2421
"28432","Nsylvestris_NODE_7562_length_2476_cov_44","Ntome_NODE_2512_length_3902_cov_251",81.233,2158,364,24,212,2353,582,2714,0,1703,2141,2132
"28433","Nsylvestris_NODE_7563_length_2476_cov_27","Ntome_NODE_9647_length_2246_cov_70",84.615,156,24,0,2227,2382,436,281,1.43e-36,156,155,155
"28497","Nsylvestris_NODE_7579_length_2473_cov_50","Ntome_NODE_21_length_11525_cov_123",76.457,892,181,24,387,1265,11018,10143,3.5e-127,457,878,875
"28574","Nsylvestris_NODE_7601_length_2470_cov_221","Ntome_NODE_7446_length_2578_cov_247",97.743,2348,41,6,110,2449,2349,6,0,4032,2339,2343
"28575","Nsylvestris_NODE_7602_length_2470_cov_194","Ntome_NODE_490_length_6041_cov_96",95.127,2278,93,10,174,2444,3746,6012,0,3576,2270,2266
"28605","Nsylvestris_NODE_7614_length_2469_cov_10","Ntome_NODE_5127_length_3049_cov_120",97.038,2363,55,2,107,2469,2491,144,0,3962,2362,2347
"28611","Nsylvestris_NODE_7616_length_2468_cov_210","Ntome_NODE_7678_length_2544_cov_195",94.652,2431,95,13,3,2410,49,2467,0,3736,2407,2418
"28690","Nsylvestris_NODE_7638_length_2465_cov_138","Ntome_NODE_10870_length_2088_cov_133",96.597,1763,60,0,318,2080,277,2039,0,2924,1762,1762
"28725","Nsylvestris_NODE_7651_length_2462_cov_212","Ntome_NODE_571_length_5827_cov_209",97.171,2439,61,5,28,2462,3361,5795,0,4115,2434,2434
"28748","Nsylvestris_NODE_7658_length_2459_cov_212","Ntome_NODE_9255_length_2301_cov_253",94.47,2188,81,16,245,2412,2168,1,0,3334,2167,2167
"28755","Nsylvestris_NODE_7661_length_2459_cov_170","Ntome_NODE_7557_length_2562_cov_160",94.53,2468,109,15,14,2459,39,2502,0,3786,2445,2463
"28759","Nsylvestris_NODE_7663_length_2459_cov_77","Ntome_NODE_10283_length_2158_cov_191",95.952,2100,67,6,372,2459,52,2145,0,3391,2087,2093
"28767","Nsylvestris_NODE_7666_length_2459_cov_23","Ntome_NODE_532_length_5928_cov_26",96.474,2411,79,2,50,2459,32,2437,0,3976,2409,2405
"28776","Nsylvestris_NODE_7669_length_2458_cov_60","Ntome_NODE_20194_length_1177_cov_134",94.316,1038,52,2,52,1089,52,1082,0,1583,1037,1030
"28787","Nsylvestris_NODE_7673_length_2457_cov_217","Ntome_NODE_895_length_5234_cov_274",96.829,2397,54,5,72,2457,5184,2799,0,3986,2385,2385
"28797","Nsylvestris_NODE_7678_length_2457_cov_94","Ntome_NODE_9150_length_2318_cov_71",94.895,2057,75,14,47,2086,2265,222,0,3190,2039,2043
"28826","Nsylvestris_NODE_7686_length_2455_cov_76","Ntome_NODE_3444_length_3532_cov_45",86.263,2264,211,51,201,2404,2490,267,0,2366,2203,2223
"28827","Nsylvestris_NODE_7687_length_2454_cov_223","Ntome_NODE_8923_length_2350_cov_239",96.408,2311,69,10,1,2308,8,2307,0,3795,2307,2299
"28845","Nsylvestris_NODE_7691_length_2454_cov_166","Ntome_NODE_13799_length_1758_cov_9",96.016,1757,70,0,496,2252,2,1758,0,2857,1756,1756
"28867","Nsylvestris_NODE_7698_length_2453_cov_129","Ntome_NODE_2157_length_4080_cov_229",95.644,1033,30,4,8,1040,64,1081,0,1644,1032,1017
"28868","Nsylvestris_NODE_7699_length_2453_cov_115","Ntome_NODE_13206_length_1819_cov_39",92.958,142,10,0,232,373,974,1115,3.86e-52,207,141,141
"28888","Nsylvestris_NODE_7706_length_2452_cov_78","Ntome_NODE_8757_length_2377_cov_65",95.298,2382,107,4,67,2448,1,2377,0,3773,2381,2376
"28905","Nsylvestris_NODE_7711_length_2451_cov_96","Ntome_NODE_9874_length_2216_cov_81",96.798,2186,51,4,64,2231,2216,32,0,3631,2167,2184
"28910","Nsylvestris_NODE_7713_length_2451_cov_19","Ntome_NODE_3385_length_3556_cov_15",87.767,2297,246,17,61,2327,1015,3306,0,2652,2266,2291
"28914","Nsylvestris_NODE_7716_length_2450_cov_171","Ntome_NODE_7784_length_2527_cov_200",92.298,2402,162,9,66,2450,2407,12,0,3389,2384,2395
"28928","Nsylvestris_NODE_7720_length_2450_cov_64","Ntome_NODE_11635_length_1998_cov_117",90.26,154,10,3,2184,2332,1795,1948,8.35e-49,196,148,153
"28988","Nsylvestris_NODE_7733_length_2447_cov_122","Ntome_NODE_12951_length_1846_cov_104",86.207,145,17,3,2018,2160,305,162,5.09e-36,154,142,143
"29080","Nsylvestris_NODE_7759_length_2443_cov_232","Ntome_NODE_3466_length_3525_cov_302",97.789,2442,50,3,2,2443,88,2525,0,4207,2441,2437
"29087","Nsylvestris_NODE_7762_length_2443_cov_206","Ntome_NODE_8539_length_2407_cov_258",95.971,2383,51,11,5,2355,2374,5,0,3827,2350,2369
"29088","Nsylvestris_NODE_7763_length_2443_cov_162","Ntome_NODE_8043_length_2484_cov_270",95.077,2417,85,6,4,2420,2383,1,0,3773,2416,2382
"29118","Nsylvestris_NODE_7772_length_2442_cov_115","Ntome_NODE_8295_length_2442_cov_147",96.352,2111,73,2,3,2113,34,2140,0,3469,2110,2106
"29162","Nsylvestris_NODE_7783_length_2440_cov_168","Ntome_NODE_662_length_5636_cov_125",95.581,2127,62,13,297,2407,2111,1,0,3378,2110,2110
"29217","Nsylvestris_NODE_7802_length_2435_cov_219","Ntome_NODE_4686_length_3162_cov_126",95.451,2374,82,11,27,2387,34,2394,0,3762,2360,2360
"29246","Nsylvestris_NODE_7809_length_2435_cov_72","Ntome_NODE_3278_length_3596_cov_228",95.349,1978,77,5,267,2243,47,2010,0,3129,1976,1963
"29261","Nsylvestris_NODE_7814_length_2434_cov_212","Ntome_NODE_3240_length_3607_cov_280",96.456,2088,54,4,9,2083,14,2094,0,3428,2074,2080
"29278","Nsylvestris_NODE_7819_length_2434_cov_43","Ntome_NODE_8251_length_2451_cov_30",94.597,2406,118,9,3,2401,2401,1,0,3712,2398,2400
"29300","Nsylvestris_NODE_7826_length_2433_cov_75","Ntome_NODE_7918_length_2504_cov_111",95.74,2418,62,15,45,2423,2417,2,0,3856,2378,2415
"29307","Nsylvestris_NODE_7829_length_2432_cov_129","Ntome_NODE_13116_length_1829_cov_252",93.727,1339,52,19,1099,2414,1330,1,0,1978,1315,1329
"29324","Nsylvestris_NODE_7834_length_2431_cov_150","Ntome_NODE_5431_length_2978_cov_298",100,55,0,0,1,55,986,932,1.86e-20,102,54,54
"29335","Nsylvestris_NODE_7838_length_2430_cov_207","Ntome_NODE_8902_length_2353_cov_289",94.418,2096,108,6,290,2380,200,2291,0,3214,2090,2091
"29361","Nsylvestris_NODE_7847_length_2428_cov_147","Ntome_NODE_7802_length_2524_cov_254",94.765,2407,89,10,49,2428,110,2506,0,3712,2379,2396
"29368","Nsylvestris_NODE_7849_length_2428_cov_39","Ntome_NODE_5535_length_2954_cov_110",77.494,391,71,9,1003,1387,205,584,1.77e-55,219,384,379
"29395","Nsylvestris_NODE_7856_length_2427_cov_74","Ntome_NODE_7804_length_2524_cov_132",91.069,2497,120,40,1,2424,2493,27,0,3280,2423,2466
"29446","Nsylvestris_NODE_7871_length_2425_cov_207","Ntome_NODE_12112_length_1943_cov_178",97.745,1951,33,4,14,1961,1943,1,0,3349,1947,1942
"29470","Nsylvestris_NODE_7879_length_2424_cov_112","Ntome_NODE_10587_length_2122_cov_56",95.724,2128,85,1,217,2344,2122,1,0,3421,2127,2121
"29475","Nsylvestris_NODE_7881_length_2423_cov_225","Ntome_NODE_8997_length_2339_cov_263",96.898,2353,47,8,79,2423,2338,4,0,3917,2344,2334
"29490","Nsylvestris_NODE_7886_length_2423_cov_36","Ntome_NODE_6187_length_2813_cov_250",96.78,2422,77,1,1,2421,2596,175,0,4039,2420,2421
"29514","Nsylvestris_NODE_7893_length_2422_cov_121","Ntome_NODE_1579_length_4469_cov_265",96.387,1107,36,4,930,2033,3894,2789,0,1820,1103,1105
"29515","Nsylvestris_NODE_7894_length_2422_cov_99","Ntome_NODE_6411_length_2765_cov_113",94.768,2389,66,10,37,2379,1,2376,0,3664,2342,2375
"29523","Nsylvestris_NODE_7898_length_2421_cov_219","Ntome_NODE_2997_length_3700_cov_128",89.45,218,22,1,2194,2411,1358,1142,3.7e-72,274,217,216
"29534","Nsylvestris_NODE_7902_length_2421_cov_179","Ntome_NODE_426_length_6232_cov_192",93.576,2366,122,18,1,2350,65,2416,0,3500,2349,2351
"29541","Nsylvestris_NODE_7905_length_2421_cov_31","Ntome_NODE_15_length_12070_cov_222",75.294,425,84,18,417,831,5087,4674,6.42e-45,183,414,413
"29560","Nsylvestris_NODE_7911_length_2418_cov_228","Ntome_NODE_8018_length_2488_cov_298",94.826,2358,93,18,34,2367,2413,61,0,3651,2333,2352
"29566","Nsylvestris_NODE_7914_length_2418_cov_82","Ntome_NODE_8240_length_2453_cov_182",97.358,1930,51,0,349,2278,2262,333,0,3282,1929,1929
"29604","Nsylvestris_NODE_7922_length_2416_cov_119","Ntome_NODE_7720_length_2537_cov_291",95.746,2374,94,5,3,2374,2449,81,0,3818,2371,2368
"29630","Nsylvestris_NODE_7931_length_2415_cov_20","Ntome_NODE_9949_length_2206_cov_6",95.188,2203,102,2,198,2396,1,2203,0,3478,2198,2202
"29639","Nsylvestris_NODE_7934_length_2414_cov_151","Ntome_NODE_6459_length_2756_cov_187",91.939,2419,131,29,31,2414,24,2413,0,3328,2383,2389
"29640","Nsylvestris_NODE_7935_length_2414_cov_105","Ntome_NODE_36910_length_313_cov_3",93.311,299,19,1,109,407,313,16,3.44e-122,440,298,297
"29649","Nsylvestris_NODE_7939_length_2414_cov_10","Ntome_NODE_10643_length_2113_cov_11",73.484,577,130,18,223,790,3,565,8.22e-49,196,567,562
"29678","Nsylvestris_NODE_7948_length_2412_cov_219","Ntome_NODE_7743_length_2533_cov_286",97.703,2394,49,4,22,2409,120,2513,0,4111,2387,2393
"29689","Nsylvestris_NODE_7952_length_2412_cov_184","Ntome_NODE_11277_length_2041_cov_16",95.323,1967,92,0,265,2231,2017,51,0,3123,1966,1966
"29746","Nsylvestris_NODE_7968_length_2410_cov_97","Ntome_NODE_7200_length_2622_cov_120",96.599,2411,71,8,1,2408,2593,191,0,3988,2407,2402
"29750","Nsylvestris_NODE_7971_length_2409_cov_199","Ntome_NODE_7085_length_2641_cov_248",95.525,2324,82,13,37,2343,2588,270,0,3696,2306,2318
"29783","Nsylvestris_NODE_7980_length_2409_cov_69","Ntome_NODE_25104_length_857_cov_87",82.481,645,59,23,118,724,9,637,5.54e-145,516,606,628
"29786","Nsylvestris_NODE_7982_length_2406_cov_104","Ntome_NODE_17419_length_1413_cov_214",92.562,1089,80,1,1063,2150,1191,103,0,1561,1087,1088
"29812","Nsylvestris_NODE_7991_length_2405_cov_125","Ntome_NODE_8314_length_2440_cov_110",96.077,2396,68,10,19,2405,2440,62,0,3880,2386,2378
"29816","Nsylvestris_NODE_7993_length_2405_cov_45","Ntome_NODE_14001_length_1738_cov_17",97.296,1738,42,4,296,2031,1,1735,0,2944,1735,1734
"29842","Nsylvestris_NODE_8003_length_2403_cov_123","Ntome_NODE_13346_length_1803_cov_125",94.814,1832,60,12,520,2347,1803,3,0,2824,1827,1800
"29855","Nsylvestris_NODE_8007_length_2402_cov_189","Ntome_NODE_343_length_6555_cov_139",96.351,2247,74,4,1,2246,4316,6555,0,3688,2245,2239
"29933","Nsylvestris_NODE_8030_length_2398_cov_130","Ntome_NODE_10230_length_2166_cov_32",92.801,2167,137,8,122,2270,2166,1,0,3120,2148,2165
"29943","Nsylvestris_NODE_8034_length_2398_cov_23","Ntome_NODE_697_length_5567_cov_183",82.599,885,143,7,1275,2149,4363,5246,0,771,874,883
"30024","Nsylvestris_NODE_8061_length_2393_cov_40","Ntome_NODE_6424_length_2762_cov_236",95.596,2384,89,10,1,2382,2610,241,0,3807,2381,2369
"30034","Nsylvestris_NODE_8064_length_2392_cov_156","Ntome_NODE_10676_length_2110_cov_57",93.014,2090,99,14,186,2261,52,2108,0,3007,2075,2056
"30052","Nsylvestris_NODE_8070_length_2392_cov_29","Ntome_NODE_18536_length_1313_cov_10",92.639,1345,67,8,402,1746,1313,1,0,1906,1344,1312
"30123","Nsylvestris_NODE_8092_length_2388_cov_67","Ntome_NODE_2906_length_3735_cov_23",84.184,196,27,3,1455,1647,520,326,4.89e-46,187,192,194
"30141","Nsylvestris_NODE_8099_length_2387_cov_188","Ntome_NODE_11972_length_1961_cov_180",94.027,1825,82,9,264,2067,55,1873,0,2741,1803,1818
"30184","Nsylvestris_NODE_8114_length_2385_cov_159","Ntome_NODE_14867_length_1647_cov_255",94.741,1426,57,16,75,1484,1604,181,0,2202,1409,1423
"30188","Nsylvestris_NODE_8116_length_2385_cov_96","Ntome_NODE_11635_length_1998_cov_117",90.598,117,9,2,38,153,1956,1841,4.96e-36,154,115,115
"30189","Nsylvestris_NODE_8117_length_2385_cov_86","Ntome_NODE_24767_length_876_cov_152",96.257,668,24,1,1633,2300,667,1,0,1094,667,666
"30210","Nsylvestris_NODE_8123_length_2384_cov_47","Ntome_NODE_17910_length_1365_cov_231",96.524,633,22,0,1546,2178,995,363,0,1048,632,632
"30213","Nsylvestris_NODE_8125_length_2383_cov_205","Ntome_NODE_7105_length_2637_cov_278",96.114,2290,79,7,3,2286,257,2542,0,3727,2283,2285
"30220","Nsylvestris_NODE_8128_length_2383_cov_172","Ntome_NODE_7797_length_2525_cov_226",94.256,2385,121,10,3,2383,140,2512,0,3631,2380,2372
"30221","Nsylvestris_NODE_8129_length_2383_cov_105","Ntome_NODE_8706_length_2384_cov_54",78.416,505,105,4,1255,1757,1577,1075,9.92e-88,326,502,502
"30227","Nsylvestris_NODE_8131_length_2383_cov_47","Ntome_NODE_1160_length_4886_cov_127",98.693,153,2,0,2231,2383,1468,1316,1.31e-71,272,152,152
"30234","Nsylvestris_NODE_8134_length_2382_cov_210","Ntome_NODE_9410_length_2279_cov_295",96.445,2110,72,3,28,2136,2,2109,0,3478,2108,2107
"30272","Nsylvestris_NODE_8144_length_2381_cov_188","Ntome_NODE_8421_length_2423_cov_241",93.963,2286,99,15,20,2291,28,2288,0,3421,2271,2260
"30277","Nsylvestris_NODE_8146_length_2381_cov_140","Ntome_NODE_4733_length_3152_cov_178",95.742,2372,88,4,20,2381,2943,575,0,3808,2361,2368
"30304","Nsylvestris_NODE_8155_length_2379_cov_208","Ntome_NODE_8287_length_2443_cov_283",95.354,2389,77,16,5,2379,2369,1,0,3766,2374,2368
"30337","Nsylvestris_NODE_8166_length_2376_cov_75","Ntome_NODE_6705_length_2713_cov_131",92.527,2355,129,14,46,2371,276,2612,0,3330,2325,2336
"30347","Nsylvestris_NODE_8170_length_2375_cov_201","Ntome_NODE_8227_length_2454_cov_283",96.119,2190,79,4,188,2375,2408,223,0,3568,2187,2185
"30368","Nsylvestris_NODE_8175_length_2375_cov_65","Ntome_NODE_8166_length_2465_cov_233",95.398,2347,95,9,31,2373,2382,45,0,3723,2342,2337
"30369","Nsylvestris_NODE_8176_length_2375_cov_60","Ntome_NODE_10890_length_2086_cov_159",97.333,75,2,0,2301,2375,1711,1637,2.99e-28,128,74,74
"30388","Nsylvestris_NODE_8185_length_2373_cov_223","Ntome_NODE_1845_length_4275_cov_234",96.175,2222,65,6,117,2319,1995,4215,0,3615,2202,2220
"30406","Nsylvestris_NODE_8191_length_2373_cov_19","Ntome_NODE_1755_length_4339_cov_132",77.245,1459,273,44,774,2213,2370,3788,0,800,1439,1418
"30409","Nsylvestris_NODE_8193_length_2372_cov_193","Ntome_NODE_33453_length_449_cov_4",99.777,449,1,0,966,1414,1,449,0,824,448,448
"30410","Nsylvestris_NODE_8194_length_2372_cov_193","Ntome_NODE_7933_length_2500_cov_155",94.996,2378,85,17,3,2369,2363,9,0,3701,2366,2354
"30452","Nsylvestris_NODE_8205_length_2371_cov_211","Ntome_NODE_5817_length_2891_cov_209",97.197,2069,42,5,264,2319,2068,3,0,3485,2055,2065
"30460","Nsylvestris_NODE_8208_length_2371_cov_17","Ntome_NODE_19_length_11828_cov_48",76.875,800,149,24,427,1197,3894,3102,4.4e-116,420,770,792
"30544","Nsylvestris_NODE_8235_length_2367_cov_65","Ntome_NODE_16520_length_1494_cov_237",83.051,177,30,0,912,1088,54,230,2.94e-38,161,176,176
"30547","Nsylvestris_NODE_8237_length_2367_cov_52","Ntome_NODE_10147_length_2178_cov_232",94.421,2097,101,5,1,2082,2152,57,0,3210,2081,2095
"30556","Nsylvestris_NODE_8240_length_2366_cov_211","Ntome_NODE_10653_length_2112_cov_291",97.25,2036,42,4,160,2182,2078,44,0,3437,2022,2034
"30560","Nsylvestris_NODE_8242_length_2366_cov_185","Ntome_NODE_2558_length_3881_cov_201",98.058,2369,40,2,1,2366,3075,710,0,4115,2365,2365
"30601","Nsylvestris_NODE_8256_length_2362_cov_153","Ntome_NODE_11624_length_2000_cov_211",88.992,1944,109,46,41,1938,116,2000,0,2307,1897,1884
"30635","Nsylvestris_NODE_8265_length_2360_cov_178","Ntome_NODE_9449_length_2275_cov_215",95.73,2225,69,10,38,2249,2275,64,0,3559,2211,2211
"30680","Nsylvestris_NODE_8280_length_2358_cov_42","Ntome_NODE_11562_length_2007_cov_28",77.778,225,35,8,791,1013,766,977,3.84e-27,124,222,211
"30684","Nsylvestris_NODE_8283_length_2357_cov_210","Ntome_NODE_4353_length_3249_cov_141",97.89,2275,47,1,69,2342,3243,969,0,3934,2273,2274
"30718","Nsylvestris_NODE_8293_length_2356_cov_130","Ntome_NODE_1369_length_4659_cov_129",95,1680,66,10,225,1896,2913,4582,0,2621,1671,1669
"30726","Nsylvestris_NODE_8296_length_2356_cov_43","Ntome_NODE_7288_length_2606_cov_167",96.364,55,2,0,1,55,897,951,3.89e-17,91.6,54,54
"30738","Nsylvestris_NODE_8299_length_2355_cov_90","Ntome_NODE_1233_length_4796_cov_185",96.526,2303,58,10,56,2355,199,2482,0,3790,2299,2283
"30763","Nsylvestris_NODE_8308_length_2354_cov_136","Ntome_NODE_8941_length_2347_cov_142",93.498,2307,97,24,3,2294,2345,77,0,3380,2291,2268
"30768","Nsylvestris_NODE_8310_length_2354_cov_105","Ntome_NODE_5567_length_2947_cov_100",95.373,2161,68,7,1,2131,2882,724,0,3408,2130,2158
"30801","Nsylvestris_NODE_8320_length_2353_cov_31","Ntome_NODE_35203_length_366_cov_5",88.503,374,23,6,1898,2271,366,13,1.56e-120,435,373,353
"30805","Nsylvestris_NODE_8322_length_2352_cov_223","Ntome_NODE_10457_length_2137_cov_295",97.685,1944,36,1,170,2113,203,2137,0,3332,1943,1934
"30811","Nsylvestris_NODE_8324_length_2352_cov_85","Ntome_NODE_9245_length_2303_cov_29",94.227,2044,96,10,11,2043,2297,265,0,3101,2032,2032
"30870","Nsylvestris_NODE_8341_length_2349_cov_221","Ntome_NODE_9370_length_2286_cov_292",96.792,2213,54,8,141,2348,2224,24,0,3677,2207,2200
"30876","Nsylvestris_NODE_8344_length_2349_cov_195","Ntome_NODE_7973_length_2494_cov_227",94.789,2303,91,12,1,2292,2424,140,0,3561,2291,2284
"30905","Nsylvestris_NODE_8353_length_2348_cov_149","Ntome_NODE_4541_length_3199_cov_208",97.674,989,23,0,828,1816,1485,497,0,1700,988,988
"30929","Nsylvestris_NODE_8363_length_2346_cov_149","Ntome_NODE_3783_length_3426_cov_103",98.226,2142,32,4,97,2237,6,2142,0,3740,2140,2136
"30960","Nsylvestris_NODE_8372_length_2345_cov_18","Ntome_NODE_9482_length_2272_cov_18",92.391,1945,121,17,374,2301,312,2246,0,2747,1927,1934
"31032","Nsylvestris_NODE_8392_length_2342_cov_97","Ntome_NODE_9885_length_2215_cov_87",93.579,2087,129,3,102,2187,2135,53,0,3107,2085,2082
"31050","Nsylvestris_NODE_8398_length_2341_cov_34","Ntome_NODE_422_length_6235_cov_106",93.502,2170,105,13,170,2338,2477,4611,0,3193,2168,2134
"31093","Nsylvestris_NODE_8411_length_2338_cov_226","Ntome_NODE_7910_length_2504_cov_288",95.83,2350,79,12,1,2338,2496,154,0,3779,2337,2342
"31106","Nsylvestris_NODE_8416_length_2337_cov_65","Ntome_NODE_8553_length_2406_cov_53",89.104,670,38,8,1501,2144,939,279,0,800,643,660
"31270","Nsylvestris_NODE_8464_length_2330_cov_54","Ntome_NODE_3782_length_3426_cov_175",84.146,82,8,5,630,708,3194,3115,3.88e-12,75,78,79
"31277","Nsylvestris_NODE_8468_length_2330_cov_23","Ntome_NODE_7031_length_2650_cov_79",95.662,2236,88,4,46,2278,2230,1,0,3583,2232,2229
"31300","Nsylvestris_NODE_8476_length_2328_cov_86","Ntome_NODE_6320_length_2784_cov_168",91.441,1659,88,10,300,1952,1823,213,0,2228,1652,1610
"31313","Nsylvestris_NODE_8480_length_2327_cov_152","Ntome_NODE_12501_length_1897_cov_78",93.561,1848,98,15,14,1846,4,1845,0,2734,1832,1841
"31314","Nsylvestris_NODE_8481_length_2327_cov_111","Ntome_NODE_1064_length_5003_cov_286",95.876,97,4,0,2231,2327,4378,4282,3.74e-37,158,96,96
"31327","Nsylvestris_NODE_8485_length_2327_cov_25","Ntome_NODE_7387_length_2588_cov_113",90.058,2062,108,27,344,2327,364,2406,0,2582,1983,2042
"31339","Nsylvestris_NODE_8490_length_2325_cov_240","Ntome_NODE_1146_length_4902_cov_288",96.06,2335,82,2,1,2325,4571,2237,0,3794,2324,2334
"31342","Nsylvestris_NODE_8492_length_2325_cov_176","Ntome_NODE_7307_length_2602_cov_212",94.374,1813,81,7,522,2324,48,1849,0,2763,1802,1801
"31355","Nsylvestris_NODE_8497_length_2324_cov_233","Ntome_NODE_7628_length_2550_cov_288",94.817,2180,85,8,122,2275,220,2397,0,3374,2153,2177
"31356","Nsylvestris_NODE_8498_length_2324_cov_226","Ntome_NODE_938_length_5179_cov_200",96.637,2260,72,4,36,2294,2769,5025,0,3749,2258,2256
"31365","Nsylvestris_NODE_8501_length_2324_cov_200","Ntome_NODE_3223_length_3612_cov_202",94.793,1863,84,6,239,2100,1894,44,0,2891,1861,1850
"31387","Nsylvestris_NODE_8510_length_2323_cov_142","Ntome_NODE_8778_length_2373_cov_184",91.942,2358,131,31,1,2323,28,2361,0,3247,2322,2333
"31399","Nsylvestris_NODE_8514_length_2322_cov_196","Ntome_NODE_10699_length_2106_cov_284",92.449,2013,99,25,171,2155,51,2038,0,2826,1984,1987
"31457","Nsylvestris_NODE_8532_length_2321_cov_28","Ntome_NODE_10935_length_2082_cov_14",95.926,2111,48,8,201,2302,2082,1,0,3387,2101,2081
"31471","Nsylvestris_NODE_8538_length_2320_cov_52","Ntome_NODE_22474_length_1018_cov_109",94.444,54,3,0,1,54,353,300,6.42e-15,84.2,53,53
"31491","Nsylvestris_NODE_8546_length_2319_cov_14","Ntome_NODE_8923_length_2350_cov_239",100,33,0,0,1,33,977,1009,3e-08,62.1,32,32
"31492","Nsylvestris_NODE_8547_length_2318_cov_231","Ntome_NODE_264_length_6990_cov_236",97.165,2328,39,1,18,2318,9,2336,0,3908,2300,2327
"31501","Nsylvestris_NODE_8550_length_2317_cov_238","Ntome_NODE_895_length_5234_cov_274",98.187,2317,42,0,1,2317,510,2826,0,4047,2316,2316
"31505","Nsylvestris_NODE_8552_length_2317_cov_25","Ntome_NODE_3043_length_3681_cov_140",82.911,158,23,4,428,583,3492,3647,1.35e-31,139,155,155
"31537","Nsylvestris_NODE_8562_length_2315_cov_83","Ntome_NODE_9725_length_2237_cov_49",70.414,845,204,37,438,1253,420,1247,6.27e-30,134,815,827
"31538","Nsylvestris_NODE_8563_length_2315_cov_43","Ntome_NODE_9866_length_2217_cov_21",92.145,2228,114,36,10,2212,2192,1,0,3088,2202,2191
"31586","Nsylvestris_NODE_8580_length_2313_cov_58","Ntome_NODE_143_length_7925_cov_49",93.345,2329,136,6,3,2313,7921,5594,0,3424,2310,2327
"31667","Nsylvestris_NODE_8601_length_2309_cov_130","Ntome_NODE_4203_length_3293_cov_232",93.412,2125,119,11,78,2195,411,2521,0,3129,2117,2110
"31668","Nsylvestris_NODE_8602_length_2309_cov_125","Ntome_NODE_11922_length_1968_cov_42",95.478,1968,83,4,236,2198,1968,2,0,3136,1962,1966
"31686","Nsylvestris_NODE_8608_length_2308_cov_49","Ntome_NODE_14042_length_1734_cov_9",91.806,1672,132,3,501,2171,4,1671,0,2324,1670,1667
"31719","Nsylvestris_NODE_8619_length_2306_cov_217","Ntome_NODE_7076_length_2642_cov_288",94.73,2258,112,3,48,2305,2284,34,0,3504,2257,2250
"31733","Nsylvestris_NODE_8623_length_2306_cov_61","Ntome_NODE_21570_length_1077_cov_5",95.508,1024,46,0,1225,2248,1024,1,0,1637,1023,1023
"31734","Nsylvestris_NODE_8624_length_2296_cov_48","Ntome_NODE_4060_length_3332_cov_101",95.152,1980,89,2,290,2263,53,2031,0,3118,1973,1978
"31735","Nsylvestris_NODE_8626_length_2306_cov_35","Ntome_NODE_38256_length_283_cov_4",97.509,281,7,0,958,1238,283,3,1.94e-134,481,280,280
"31761","Nsylvestris_NODE_8635_length_2304_cov_28","Ntome_NODE_9242_length_2303_cov_119",94.228,2183,84,14,10,2167,63,2228,0,3295,2157,2165
"31762","Nsylvestris_NODE_8636_length_2303_cov_147","Ntome_NODE_6345_length_2779_cov_193",92.405,79,6,0,1561,1639,1049,1127,8.12e-24,113,78,78
"31808","Nsylvestris_NODE_8652_length_2300_cov_151","Ntome_NODE_5104_length_3053_cov_255",94.196,1275,60,5,1,1264,1272,1,0,1932,1263,1271
"31832","Nsylvestris_NODE_8660_length_2299_cov_204","Ntome_NODE_8264_length_2447_cov_193",95.337,2252,87,10,53,2297,2260,20,0,3561,2244,2240
"31863","Nsylvestris_NODE_8669_length_2298_cov_125","Ntome_NODE_10687_length_2108_cov_224",94.464,2023,95,6,237,2243,2059,38,0,3099,2006,2021
"31879","Nsylvestris_NODE_8676_length_2297_cov_180","Ntome_NODE_8429_length_2423_cov_58",95.583,2128,58,11,154,2267,2151,46,0,3376,2113,2105
"32026","Nsylvestris_NODE_8720_length_2292_cov_44","Ntome_NODE_12221_length_1930_cov_255",98.182,55,1,0,2238,2292,544,490,8.14e-19,97.1,54,54
"32027","Nsylvestris_NODE_8721_length_2292_cov_44","Ntome_NODE_618_length_5724_cov_155",90.826,327,26,4,254,579,767,1090,1.52e-120,435,325,323
"32040","Nsylvestris_NODE_8726_length_2291_cov_154","Ntome_NODE_390_length_6347_cov_174",76.807,927,181,27,11,911,2208,1290,3.19e-137,490,900,918
"32114","Nsylvestris_NODE_8747_length_2288_cov_224","Ntome_NODE_10232_length_2165_cov_309",96.006,2103,80,2,190,2288,2103,1,0,3415,2098,2102
"32122","Nsylvestris_NODE_8750_length_2288_cov_158","Ntome_NODE_9388_length_2283_cov_150",94.858,2217,93,13,27,2228,2261,51,0,3443,2201,2210
"32137","Nsylvestris_NODE_8755_length_2287_cov_127","Ntome_NODE_5102_length_3054_cov_99",91.019,2160,99,30,1,2134,910,3000,0,2826,2133,2090
"32175","Nsylvestris_NODE_8768_length_2285_cov_10","Ntome_NODE_8756_length_2377_cov_97",96.435,2188,77,1,98,2285,123,2309,0,3607,2187,2186
"32186","Nsylvestris_NODE_8772_length_2284_cov_101","Ntome_NODE_13918_length_1745_cov_18",95.528,1744,68,4,432,2166,1745,3,0,2780,1734,1742
"32213","Nsylvestris_NODE_8782_length_2282_cov_141","Ntome_NODE_9198_length_2308_cov_253",96.251,2214,74,3,23,2236,1,2205,0,3620,2213,2204
"32231","Nsylvestris_NODE_8788_length_2281_cov_142","Ntome_NODE_6634_length_2723_cov_188",93.007,2288,117,27,5,2272,36,2300,0,3299,2267,2264
"32232","Nsylvestris_NODE_8789_length_2281_cov_102","Ntome_NODE_16_length_12024_cov_84",86.088,956,111,10,1,934,4497,5452,0,1009,933,955
"32252","Nsylvestris_NODE_8796_length_2279_cov_210","Ntome_NODE_4776_length_3139_cov_228",93.534,2227,103,15,80,2277,856,3070,0,3277,2197,2214
"32253","Nsylvestris_NODE_8797_length_2279_cov_181","Ntome_NODE_11931_length_1966_cov_258",95.583,1811,56,7,323,2120,1858,59,0,2880,1797,1799
"32276","Nsylvestris_NODE_8803_length_2279_cov_69","Ntome_NODE_9089_length_2325_cov_32",95.386,1734,69,5,551,2277,1830,101,0,2748,1726,1729
"32320","Nsylvestris_NODE_8816_length_2277_cov_121","Ntome_NODE_2317_length_3999_cov_229",95.124,2297,82,12,1,2277,36,2322,0,3594,2276,2286
"32345","Nsylvestris_NODE_8824_length_2276_cov_16","Ntome_NODE_36521_length_324_cov_2",97.368,228,6,0,2049,2276,313,86,1.19e-106,388,227,227
"32357","Nsylvestris_NODE_8828_length_2275_cov_193","Ntome_NODE_9044_length_2331_cov_289",95.149,2247,105,3,3,2246,38,2283,0,3542,2243,2245
"32412","Nsylvestris_NODE_8847_length_2273_cov_24","Ntome_NODE_9273_length_2300_cov_31",95.679,2268,85,5,8,2273,10,2266,0,3633,2265,2256
"32413","Nsylvestris_NODE_8848_length_2272_cov_218","Ntome_NODE_263_length_7001_cov_221",95.994,2072,73,6,75,2138,6877,4808,0,3358,2063,2069
"32429","Nsylvestris_NODE_8854_length_2272_cov_17","Ntome_NODE_33429_length_450_cov_4",93.612,454,18,3,270,721,6,450,0,667,451,444
"32446","Nsylvestris_NODE_8860_length_2273_cov_145","Ntome_NODE_11154_length_2054_cov_216",93.414,1822,110,7,167,1979,1843,23,0,2691,1812,1820
"32447","Nsylvestris_NODE_8861_length_2270_cov_67","Ntome_NODE_39817_length_251_cov_4",90.98,255,17,3,914,1168,2,250,1.21e-91,339,254,248
"32456","Nsylvestris_NODE_8865_length_2269_cov_215","Ntome_NODE_10390_length_2146_cov_266",93.833,2108,106,15,103,2198,45,2140,0,3151,2095,2095
"32457","Nsylvestris_NODE_8866_length_2269_cov_198","Ntome_NODE_2534_length_3892_cov_226",96.371,2232,76,3,1,2227,8,2239,0,3668,2226,2231
"32465","Nsylvestris_NODE_8869_length_2268_cov_235","Ntome_NODE_1105_length_4943_cov_302",94.915,59,2,1,2210,2268,1826,1883,3.75e-17,91.6,58,57
"32485","Nsylvestris_NODE_8875_length_2267_cov_201","Ntome_NODE_14866_length_1647_cov_277",95.635,1535,53,10,694,2222,97,1623,0,2451,1528,1526
"32494","Nsylvestris_NODE_8878_length_2267_cov_80","Ntome_NODE_7977_length_2494_cov_137",95.418,2226,86,10,4,2217,6,2227,0,3531,2213,2221
"32549","Nsylvestris_NODE_8893_length_2265_cov_49","Ntome_NODE_8633_length_2394_cov_126",97.071,2219,63,2,1,2218,2293,76,0,3736,2217,2217
"32586","Nsylvestris_NODE_8906_length_2263_cov_90","Ntome_NODE_9338_length_2291_cov_49",97.098,2240,64,1,21,2260,1,2239,0,3775,2239,2238
"32642","Nsylvestris_NODE_8925_length_2260_cov_223","Ntome_NODE_148_length_7871_cov_262",96.584,2020,63,3,193,2212,4767,2754,0,3343,2019,2013
"32684","Nsylvestris_NODE_8939_length_2258_cov_184","Ntome_NODE_110_length_8318_cov_170",95.526,2101,69,13,136,2213,2293,195,0,3336,2077,2098
"32712","Nsylvestris_NODE_8948_length_2257_cov_221","Ntome_NODE_4145_length_3309_cov_259",97.356,1967,47,1,295,2256,38,2004,0,3339,1961,1966
"32713","Nsylvestris_NODE_8949_length_2257_cov_218","Ntome_NODE_734_length_5490_cov_289",94.944,2215,92,3,44,2257,70,2265,0,3452,2213,2195
"32727","Nsylvestris_NODE_8955_length_2257_cov_92","Ntome_NODE_2211_length_4055_cov_52",97.702,2219,43,2,46,2257,4050,1833,0,3808,2211,2217
"32830","Nsylvestris_NODE_8988_length_2253_cov_11","Ntome_NODE_37215_length_306_cov_3",94.578,166,9,0,94,259,166,1,3.47e-67,257,165,165
"32920","Nsylvestris_NODE_9015_length_2249_cov_160","Ntome_NODE_14261_length_1709_cov_223",92.641,1685,84,15,125,1776,32,1709,0,2388,1651,1677
"32921","Nsylvestris_NODE_9016_length_2249_cov_145","Ntome_NODE_11023_length_2070_cov_16",94.879,2070,85,7,89,2138,2069,1,0,3216,2049,2068
"32936","Nsylvestris_NODE_9023_length_2248_cov_217","Ntome_NODE_501_length_6015_cov_213",96.414,2259,56,9,4,2248,5993,3746,0,3699,2244,2247
"32953","Nsylvestris_NODE_9029_length_2247_cov_184","Ntome_NODE_9687_length_2241_cov_205",94.988,2155,85,10,107,2247,74,2219,0,3360,2140,2145
"32956","Nsylvestris_NODE_9031_length_2247_cov_110","Ntome_NODE_393_length_6341_cov_163",95.866,2177,69,6,63,2237,4179,6336,0,3502,2174,2157
"32957","Nsylvestris_NODE_9032_length_2247_cov_106","Ntome_NODE_8269_length_2446_cov_222",96.729,1070,32,2,1029,2095,1,1070,0,1779,1066,1069
"32958","Nsylvestris_NODE_9033_length_2247_cov_105","Ntome_NODE_5961_length_2858_cov_71",93.451,1649,67,12,539,2170,5,1629,0,2409,1631,1624
"32971","Nsylvestris_NODE_9038_length_2246_cov_129","Ntome_NODE_9783_length_2228_cov_45",95.418,2008,64,12,127,2111,217,2219,0,3173,1984,2002
"32992","Nsylvestris_NODE_9045_length_2245_cov_122","Ntome_NODE_11243_length_2044_cov_229",73.897,272,69,2,1840,2110,1632,1902,3.68e-22,108,270,270
"32996","Nsylvestris_NODE_9047_length_2245_cov_74","Ntome_NODE_12599_length_1887_cov_20",95.977,1889,72,3,189,2075,1887,1,0,3064,1886,1886
"32997","Nsylvestris_NODE_9048_length_2245_cov_72","Ntome_NODE_12166_length_1938_cov_17",96.199,1894,70,1,129,2022,1,1892,0,3097,1893,1891
"33042","Nsylvestris_NODE_9063_length_2243_cov_196","Ntome_NODE_9476_length_2272_cov_173",95.765,2196,75,5,63,2243,2223,31,0,3524,2180,2192
"33049","Nsylvestris_NODE_9067_length_2243_cov_124","Ntome_NODE_4495_length_3210_cov_259",95.422,1791,55,7,375,2158,1818,48,0,2828,1783,1770
"33116","Nsylvestris_NODE_9088_length_2239_cov_216","Ntome_NODE_11611_length_2001_cov_225",95.631,2014,60,11,191,2189,1,2001,0,3206,1998,2000
"33120","Nsylvestris_NODE_9090_length_2239_cov_26","Ntome_NODE_9152_length_2317_cov_294",93.888,2225,115,8,1,2206,95,2317,0,3336,2205,2222
"33121","Nsylvestris_NODE_9091_length_2238_cov_189","Ntome_NODE_6572_length_2734_cov_281",94.646,1737,82,7,468,2203,59,1785,0,2682,1735,1726
"33127","Nsylvestris_NODE_9095_length_2237_cov_181","Ntome_NODE_9269_length_2300_cov_234",93.317,2065,95,14,3,2057,269,2300,0,3009,2054,2031
"33133","Nsylvestris_NODE_9097_length_2237_cov_142","Ntome_NODE_10036_length_2195_cov_133",95.618,2191,73,13,50,2223,11,2195,0,3493,2173,2184
"33136","Nsylvestris_NODE_9099_length_2237_cov_96","Ntome_NODE_18375_length_1328_cov_22",96.758,987,32,0,375,1361,1284,298,0,1646,986,986
"33153","Nsylvestris_NODE_9105_length_2236_cov_94","Ntome_NODE_11866_length_1974_cov_128",95.942,1651,61,2,591,2236,257,1906,0,2673,1645,1649
"33169","Nsylvestris_NODE_9111_length_2232_cov_170","Ntome_NODE_5794_length_2896_cov_261",96.273,2227,79,4,7,2232,9,2232,0,3650,2225,2223
"33217","Nsylvestris_NODE_9127_length_2233_cov_83","Ntome_NODE_5822_length_2890_cov_164",94.463,2059,78,9,1,2030,229,2280,0,3138,2029,2051
"33260","Nsylvestris_NODE_9140_length_2231_cov_47","Ntome_NODE_19090_length_1268_cov_9",91.085,258,20,3,1974,2231,1265,1011,7.12e-94,346,257,254
"33277","Nsylvestris_NODE_9145_length_2230_cov_203","Ntome_NODE_8938_length_2347_cov_281",95.86,2198,62,14,11,2182,2289,95,0,3528,2171,2194
"33296","Nsylvestris_NODE_9150_length_2230_cov_74","Ntome_NODE_29979_length_629_cov_5",85.849,636,75,10,620,1248,629,2,0,662,628,627
"33305","Nsylvestris_NODE_9154_length_2229_cov_198","Ntome_NODE_10418_length_2143_cov_231",97.2,2107,44,4,41,2145,2143,50,0,3550,2104,2093
"33306","Nsylvestris_NODE_9155_length_2229_cov_193","Ntome_NODE_745_length_5472_cov_203",92.196,2063,113,29,60,2097,5457,3418,0,2874,2037,2039
"33339","Nsylvestris_NODE_9165_length_2228_cov_179","Ntome_NODE_18611_length_1307_cov_265",93.772,578,23,3,1534,2108,692,1259,0,856,574,567
"33386","Nsylvestris_NODE_9180_length_2226_cov_98","Ntome_NODE_2239_length_4041_cov_152",92.845,1817,108,6,194,1988,1948,132,0,2615,1794,1816
"33416","Nsylvestris_NODE_9189_length_2225_cov_128","Ntome_NODE_10258_length_2161_cov_294",93.733,1883,71,13,64,1927,55,1909,0,2780,1863,1854
"33423","Nsylvestris_NODE_9192_length_2225_cov_44","Ntome_NODE_10121_length_2183_cov_45",94.627,2066,81,10,150,2212,2047,9,0,3173,2062,2038
"33424","Nsylvestris_NODE_9193_length_2224_cov_222","Ntome_NODE_9969_length_2203_cov_293",95.758,2169,74,7,40,2191,36,2203,0,3480,2151,2167
"33429","Nsylvestris_NODE_9195_length_2224_cov_179","Ntome_NODE_10583_length_2122_cov_162",96.399,1833,64,2,225,2055,2042,210,0,3018,1830,1832
"33433","Nsylvestris_NODE_9197_length_2224_cov_125","Ntome_NODE_13095_length_1832_cov_63",94.079,1807,67,15,388,2172,2,1790,0,2708,1784,1788
"33442","Nsylvestris_NODE_9200_length_2223_cov_235","Ntome_NODE_735_length_5489_cov_162",93.637,2106,74,20,23,2082,2136,45,0,3092,2059,2091
"33443","Nsylvestris_NODE_9201_length_2223_cov_36","Ntome_NODE_14725_length_1663_cov_9",95.364,1661,76,1,130,1789,1,1661,0,2639,1659,1660
"33447","Nsylvestris_NODE_9203_length_2223_cov_22","Ntome_NODE_3879_length_3394_cov_32",97.554,1840,44,1,385,2223,3124,1285,0,3147,1838,1839
"33509","Nsylvestris_NODE_9223_length_2220_cov_80","Ntome_NODE_11395_length_2026_cov_80",93.375,1932,84,19,5,1911,1913,1,0,2819,1906,1912
"33561","Nsylvestris_NODE_9239_length_2216_cov_222","Ntome_NODE_14084_length_1729_cov_59",90.187,1712,74,33,5,1691,6,1648,0,2145,1686,1642
"33596","Nsylvestris_NODE_9250_length_2215_cov_196","Ntome_NODE_10765_length_2099_cov_232",93.768,2118,107,14,87,2198,2099,1,0,3157,2111,2098
"33629","Nsylvestris_NODE_9261_length_2213_cov_41","Ntome_NODE_367_length_6440_cov_146",98.182,55,1,0,2159,2213,3579,3633,7.86e-19,97.1,54,54
"33641","Nsylvestris_NODE_9265_length_2212_cov_18","Ntome_NODE_3663_length_3466_cov_101",98.182,55,1,0,2158,2212,309,363,7.85e-19,97.1,54,54
"33685","Nsylvestris_NODE_9280_length_2209_cov_209","Ntome_NODE_8158_length_2466_cov_294",97.563,2134,41,7,78,2209,2419,295,0,3642,2131,2124
"33686","Nsylvestris_NODE_9281_length_2209_cov_184","Ntome_NODE_11233_length_2046_cov_10",93.659,2050,120,3,132,2177,1,2044,0,3057,2045,2043
"33691","Nsylvestris_NODE_9284_length_2209_cov_95","Ntome_NODE_23215_length_970_cov_256",94.944,890,35,8,39,923,1,885,0,1386,884,884
"33742","Nsylvestris_NODE_9302_length_2207_cov_98","Ntome_NODE_11169_length_2053_cov_31",95.04,1976,86,5,33,1997,2022,48,0,3096,1964,1974
"33777","Nsylvestris_NODE_9314_length_2206_cov_77","Ntome_NODE_10692_length_2108_cov_15",95.553,2114,73,10,69,2179,2103,8,0,3363,2110,2095
"33778","Nsylvestris_NODE_9315_length_2206_cov_39","Ntome_NODE_10786_length_2098_cov_12",93.379,2054,109,9,145,2180,2058,14,0,3014,2035,2044
"33827","Nsylvestris_NODE_9330_length_2203_cov_185","Ntome_NODE_8096_length_2475_cov_190",94.224,2095,88,15,47,2127,2297,222,0,3168,2080,2075
"33839","Nsylvestris_NODE_9334_length_2203_cov_84","Ntome_NODE_2497_length_3909_cov_109",96.19,2205,66,7,1,2203,170,2358,0,3591,2202,2188
"33867","Nsylvestris_NODE_9338_length_2202_cov_177","Ntome_NODE_9621_length_2250_cov_264",93.753,2241,96,12,3,2202,2250,13,0,3323,2199,2237
"33879","Nsylvestris_NODE_9342_length_2202_cov_23","Ntome_NODE_2181_length_4070_cov_163",95.082,1830,74,9,147,1970,1974,3793,0,2867,1823,1819
"33912","Nsylvestris_NODE_9352_length_2200_cov_198","Ntome_NODE_10052_length_2193_cov_229",95.471,2208,62,13,1,2194,2,2185,0,3489,2193,2183
"33920","Nsylvestris_NODE_9355_length_2200_cov_57","Ntome_NODE_9613_length_2252_cov_38",94.845,1707,78,8,271,1970,2237,534,0,2656,1699,1703
"33949","Nsylvestris_NODE_9365_length_2198_cov_218","Ntome_NODE_1256_length_4775_cov_213",97.339,2180,47,4,1,2180,2387,219,0,3694,2179,2168
"33996","Nsylvestris_NODE_9380_length_2196_cov_222","Ntome_NODE_37755_length_294_cov_3",88.496,113,10,3,1262,1371,1,113,5.94e-30,134,109,112
"34069","Nsylvestris_NODE_9405_length_2193_cov_12","Ntome_NODE_5110_length_3052_cov_100",98.113,53,1,0,1871,1923,2997,3049,1.01e-17,93.5,52,52
"34073","Nsylvestris_NODE_9407_length_2192_cov_217","Ntome_NODE_10658_length_2111_cov_295",95.448,2065,52,9,25,2080,2083,52,0,3254,2055,2031
"34076","Nsylvestris_NODE_9409_length_2192_cov_85","Ntome_NODE_12875_length_1854_cov_27",94.167,1800,76,9,354,2145,1795,17,0,2715,1791,1778
"34087","Nsylvestris_NODE_9413_length_2191_cov_229","Ntome_NODE_18217_length_1341_cov_192",96.61,59,1,1,2134,2191,862,804,7.78e-19,97.1,57,58
"34127","Nsylvestris_NODE_9425_length_2189_cov_179","Ntome_NODE_13648_length_1772_cov_275",94.545,55,3,0,1,55,693,747,1.68e-15,86.1,54,54
"34161","Nsylvestris_NODE_9437_length_2187_cov_162","Ntome_NODE_7845_length_2517_cov_151",96.212,1584,50,2,72,1645,126,1709,0,2584,1573,1583
"34195","Nsylvestris_NODE_9448_length_2186_cov_43","Ntome_NODE_15435_length_1591_cov_23",95.185,1620,49,12,203,1822,1,1591,0,2532,1619,1590
"34211","Nsylvestris_NODE_9453_length_2185_cov_141","Ntome_NODE_3003_length_3698_cov_163",80.42,1001,159,29,3,978,35,1023,0,728,975,988
"34231","Nsylvestris_NODE_9460_length_2184_cov_123","Ntome_NODE_10095_length_2187_cov_173",95.014,2106,95,8,84,2184,2120,20,0,3299,2100,2100
"34232","Nsylvestris_NODE_9461_length_2182_cov_30","Ntome_NODE_238_length_7150_cov_209",89.456,294,23,4,76,361,1017,724,1.92e-99,364,285,293
"34233","Nsylvestris_NODE_9462_length_2184_cov_23","Ntome_NODE_16723_length_1474_cov_125",98.182,55,1,0,2130,2184,401,455,7.75e-19,97.1,54,54
"34264","Nsylvestris_NODE_9472_length_2182_cov_145","Ntome_NODE_9037_length_2332_cov_225",93.044,2099,111,13,49,2136,2245,171,0,3035,2087,2074
"34275","Nsylvestris_NODE_9476_length_2182_cov_10","Ntome_NODE_6586_length_2732_cov_277",98.182,55,1,0,1,55,1883,1829,7.74e-19,97.1,54,54
"34289","Nsylvestris_NODE_9481_length_2181_cov_12","Ntome_NODE_1227_length_4802_cov_140",91.905,210,17,0,1,210,3287,3078,2.56e-78,294,209,209
"34293","Nsylvestris_NODE_9483_length_2180_cov_174","Ntome_NODE_5035_length_3068_cov_166",94.989,1816,71,12,376,2180,3068,1262,0,2832,1804,1806
"34308","Nsylvestris_NODE_9489_length_2179_cov_39","Ntome_NODE_5703_length_2917_cov_129",96.408,2088,67,5,4,2084,38,2124,0,3434,2080,2086
"34320","Nsylvestris_NODE_9493_length_2179_cov_216","Ntome_NODE_10249_length_2163_cov_187",94.267,1971,81,14,54,2006,152,2108,0,2985,1952,1956
"34368","Nsylvestris_NODE_9507_length_2176_cov_206","Ntome_NODE_6764_length_2700_cov_185",93.881,2010,80,22,66,2054,15,2002,0,2990,1988,1987
"34408","Nsylvestris_NODE_9520_length_2173_cov_213","Ntome_NODE_9526_length_2266_cov_267",95.294,1955,89,3,121,2075,2213,262,0,3097,1954,1951
"34444","Nsylvestris_NODE_9530_length_2172_cov_152","Ntome_NODE_3849_length_3405_cov_103",95.91,2176,52,10,1,2161,2155,2,0,3491,2160,2153
"34490","Nsylvestris_NODE_9543_length_2171_cov_54","Ntome_NODE_8710_length_2383_cov_15",94.626,2140,90,15,1,2123,2317,186,0,3291,2122,2131
"34508","Nsylvestris_NODE_9549_length_2170_cov_115","Ntome_NODE_8029_length_2486_cov_207",95.686,1020,25,7,94,1103,1347,2357,0,1622,1009,1010
"34545","Nsylvestris_NODE_9560_length_2169_cov_66","Ntome_NODE_12009_length_1957_cov_58",91.896,1888,83,35,297,2127,80,1954,0,2575,1830,1874
"34624","Nsylvestris_NODE_9584_length_2166_cov_66","Ntome_NODE_11810_length_1980_cov_123",97.445,1918,46,3,249,2165,48,1963,0,3267,1916,1915
"34634","Nsylvestris_NODE_9587_length_2166_cov_47","Ntome_NODE_5215_length_3026_cov_95",82.023,1997,247,40,265,2166,312,2291,0,1596,1901,1979
"34644","Nsylvestris_NODE_9592_length_2165_cov_209","Ntome_NODE_9038_length_2332_cov_217",96.388,2104,68,5,56,2158,2,2098,0,3458,2102,2096
"34699","Nsylvestris_NODE_9608_length_2163_cov_217","Ntome_NODE_1614_length_4444_cov_209",92.059,2103,117,25,45,2129,52,2122,0,2913,2084,2070
"34712","Nsylvestris_NODE_9613_length_2163_cov_59","Ntome_NODE_587_length_5799_cov_120",95.483,2081,87,1,1,2074,2164,84,0,3315,2073,2080
"34713","Nsylvestris_NODE_9614_length_2163_cov_22","Ntome_NODE_105_length_8440_cov_257",87.013,77,8,2,7,82,2088,2163,1.66e-15,86.1,75,75
"34745","Nsylvestris_NODE_9625_length_2162_cov_24","Ntome_NODE_9561_length_2259_cov_96",94.757,2117,86,10,49,2158,2234,136,0,3271,2109,2098
"34769","Nsylvestris_NODE_9632_length_2161_cov_8","Ntome_NODE_38923_length_269_cov_3",97.297,148,4,0,1,148,122,269,1.55e-65,252,147,147
"34782","Nsylvestris_NODE_9636_length_2160_cov_29","Ntome_NODE_10354_length_2152_cov_19",95.366,2050,70,6,43,2089,94,2121,0,3236,2046,2027
"34793","Nsylvestris_NODE_9641_length_2159_cov_203","Ntome_NODE_712_length_5539_cov_171",95.06,2085,67,14,29,2102,3422,5481,0,3247,2073,2059
"34854","Nsylvestris_NODE_9657_length_2158_cov_49","Ntome_NODE_27794_length_720_cov_209",91.15,226,17,3,962,1186,331,108,4.2e-81,303,224,223
"34862","Nsylvestris_NODE_9660_length_2157_cov_209","Ntome_NODE_11273_length_2041_cov_266",97.312,1860,40,6,206,2061,131,1984,0,3149,1855,1853
"34873","Nsylvestris_NODE_9665_length_2157_cov_43","Ntome_NODE_2455_length_3928_cov_106",93.965,2121,110,5,1,2112,3828,1717,0,3192,2111,2111
"34874","Nsylvestris_NODE_9666_length_2157_cov_37","Ntome_NODE_9707_length_2239_cov_75",94.881,2149,102,5,3,2148,47,2190,0,3352,2145,2143
"34892","Nsylvestris_NODE_9672_length_2156_cov_169","Ntome_NODE_15368_length_1596_cov_286",90.818,1590,70,24,44,1592,1555,1,0,2058,1548,1554
"34899","Nsylvestris_NODE_9677_length_2156_cov_24","Ntome_NODE_34689_length_387_cov_2",97.416,387,10,0,755,1141,1,387,0,660,386,386
"34906","Nsylvestris_NODE_9680_length_2155_cov_191","Ntome_NODE_10810_length_2094_cov_279",92.906,2044,89,21,106,2118,23,2041,0,2920,2012,2018
"34907","Nsylvestris_NODE_9681_length_2155_cov_62","Ntome_NODE_9792_length_2226_cov_246",91.621,2184,99,26,2,2155,47,2176,0,2942,2153,2129
"34941","Nsylvestris_NODE_9691_length_2153_cov_124","Ntome_NODE_12682_length_1877_cov_36",94.544,1888,64,9,79,1946,1870,2,0,2880,1867,1868
"34942","Nsylvestris_NODE_9692_length_2153_cov_114","Ntome_NODE_19187_length_1260_cov_280",92.026,464,37,0,90,553,1158,695,0,652,463,463
"34954","Nsylvestris_NODE_9696_length_2152_cov_230","Ntome_NODE_8927_length_2349_cov_268",96.316,2090,55,8,2,2071,2321,234,0,3413,2069,2087
"34968","Nsylvestris_NODE_9701_length_2152_cov_175","Ntome_NODE_9334_length_2291_cov_159",96.59,1818,51,4,183,1990,422,2238,0,3003,1807,1816
"34999","Nsylvestris_NODE_9714_length_2151_cov_112","Ntome_NODE_12626_length_1884_cov_92",96.318,1711,59,3,86,1795,1883,176,0,2808,1709,1707
"35027","Nsylvestris_NODE_9724_length_2150_cov_72","Ntome_NODE_14465_length_1689_cov_234",97.095,654,19,0,1375,2028,983,1636,0,1103,653,653
"35070","Nsylvestris_NODE_9736_length_2149_cov_81","Ntome_NODE_8990_length_2340_cov_170",94.556,2149,100,6,7,2149,2325,188,0,3304,2142,2137
"35090","Nsylvestris_NODE_9743_length_2147_cov_189","Ntome_NODE_37480_length_300_cov_3",95.802,262,6,5,642,900,40,299,1.43e-115,418,258,259
"35112","Nsylvestris_NODE_9751_length_2147_cov_17","Ntome_NODE_10597_length_2121_cov_17",96.59,2082,68,1,13,2094,2101,23,0,3448,2081,2078
"35163","Nsylvestris_NODE_9766_length_2145_cov_172","Ntome_NODE_3083_length_3664_cov_81",97.105,2107,53,4,42,2144,3664,1562,0,3546,2102,2102
"35182","Nsylvestris_NODE_9773_length_2144_cov_182","Ntome_NODE_12162_length_1938_cov_249",97.076,1847,41,7,99,1936,1,1843,0,3099,1837,1842
"35183","Nsylvestris_NODE_9774_length_2144_cov_154","Ntome_NODE_10551_length_2126_cov_39",95.531,2081,75,5,63,2125,1,2081,0,3312,2062,2080
"35190","Nsylvestris_NODE_9777_length_2143_cov_231","Ntome_NODE_9330_length_2291_cov_295",95.2,2146,78,15,1,2143,1,2124,0,3369,2142,2123
"35191","Nsylvestris_NODE_9778_length_2143_cov_194","Ntome_NODE_13478_length_1788_cov_292",96.803,1783,45,6,1,1774,1780,1,0,2966,1773,1779
"35196","Nsylvestris_NODE_9780_length_2143_cov_111","Ntome_NODE_7347_length_2595_cov_137",93.372,2052,73,19,2,2033,5,2013,0,2977,2031,2008
"35200","Nsylvestris_NODE_9782_length_2142_cov_228","Ntome_NODE_10480_length_2134_cov_226",94.312,2145,84,18,16,2142,2133,9,0,3251,2126,2124
"35213","Nsylvestris_NODE_9788_length_2142_cov_10","Ntome_NODE_17061_length_1442_cov_234",95.789,95,4,0,491,585,1348,1442,4.45e-36,154,94,94
"35224","Nsylvestris_NODE_9791_length_2141_cov_209","Ntome_NODE_10771_length_2099_cov_84",95.394,2106,71,13,7,2098,6,2099,0,3328,2091,2093
"35283","Nsylvestris_NODE_9808_length_2139_cov_50","Ntome_NODE_6836_length_2687_cov_206",93.988,2129,94,15,1,2123,43,2143,0,3192,2122,2100
"35296","Nsylvestris_NODE_9813_length_2138_cov_216","Ntome_NODE_3331_length_3576_cov_187",95.429,1947,59,7,149,2074,2266,329,0,3075,1925,1937
"35300","Nsylvestris_NODE_9815_length_2138_cov_173","Ntome_NODE_9555_length_2260_cov_126",95.015,1986,77,16,120,2092,45,2021,0,3099,1972,1976
"35348","Nsylvestris_NODE_9829_length_2136_cov_85","Ntome_NODE_24280_length_907_cov_267",93.548,62,2,1,2077,2136,699,760,3.53e-17,91.6,59,61
"35354","Nsylvestris_NODE_9832_length_2135_cov_217","Ntome_NODE_11017_length_2070_cov_275",94.45,2018,87,9,119,2135,9,2002,0,3083,2016,1993
"35355","Nsylvestris_NODE_9833_length_2135_cov_206","Ntome_NODE_4641_length_3174_cov_83",93.544,697,23,8,80,776,752,78,0,1018,696,674
"35358","Nsylvestris_NODE_9835_length_2135_cov_165","Ntome_NODE_3491_length_3520_cov_228",95.881,2015,71,9,124,2135,1515,3520,0,3251,2011,2005
"35395","Nsylvestris_NODE_9847_length_2134_cov_196","Ntome_NODE_17988_length_1358_cov_246",92.264,1047,59,13,1045,2074,11,1052,0,1465,1029,1041
"35400","Nsylvestris_NODE_9851_length_2133_cov_223","Ntome_NODE_10277_length_2158_cov_289",97.098,2102,57,2,31,2130,2105,6,0,3541,2099,2099
"35401","Nsylvestris_NODE_9852_length_2133_cov_219","Ntome_NODE_13545_length_1782_cov_12",95.379,1796,68,5,88,1882,1,1782,0,2843,1794,1781
"35481","Nsylvestris_NODE_9876_length_2130_cov_153","Ntome_NODE_7029_length_2650_cov_222",92.248,2051,119,27,59,2095,2602,578,0,2870,2036,2024
"35493","Nsylvestris_NODE_9880_length_2130_cov_65","Ntome_NODE_8395_length_2428_cov_92",92.956,2158,81,24,7,2127,284,2407,0,3077,2120,2123
"35496","Nsylvestris_NODE_9882_length_2129_cov_234","Ntome_NODE_12155_length_1939_cov_147",95.972,1837,53,8,209,2035,21,1846,0,2963,1826,1825
"35516","Nsylvestris_NODE_9887_length_2129_cov_189","Ntome_NODE_11244_length_2044_cov_210",95.339,1974,74,10,48,2011,1,1966,0,3120,1963,1965
"35520","Nsylvestris_NODE_9889_length_2129_cov_134","Ntome_NODE_9690_length_2241_cov_72",94.934,1974,85,4,50,2020,2238,277,0,3077,1970,1961
"35527","Nsylvestris_NODE_9893_length_2129_cov_89","Ntome_NODE_20427_length_1159_cov_174",86.38,279,38,0,1620,1898,652,930,1.15e-81,305,278,278
"35541","Nsylvestris_NODE_9897_length_2128_cov_159","Ntome_NODE_9912_length_2211_cov_266",94.062,2105,98,11,18,2119,97,2177,0,3169,2101,2080
"35568","Nsylvestris_NODE_9906_length_2127_cov_24","Ntome_NODE_9769_length_2229_cov_147",95.841,2140,62,10,4,2124,2173,42,0,3434,2120,2131
"35578","Nsylvestris_NODE_9911_length_2126_cov_187","Ntome_NODE_8777_length_2373_cov_218",93.388,2193,74,20,1,2126,28,2216,0,3181,2125,2188
"35585","Nsylvestris_NODE_9914_length_2126_cov_127","Ntome_NODE_5358_length_2996_cov_133",96.17,2089,68,5,47,2126,260,2345,0,3404,2079,2085
"35603","Nsylvestris_NODE_9920_length_2126_cov_39","Ntome_NODE_12523_length_1895_cov_153",93.143,1823,78,23,111,1901,1841,34,0,2630,1790,1807
"35614","Nsylvestris_NODE_9924_length_2125_cov_201","Ntome_NODE_5854_length_2882_cov_294",96.505,2003,61,8,80,2077,716,2714,0,3302,1997,1998
"35619","Nsylvestris_NODE_9926_length_2125_cov_139","Ntome_NODE_10816_length_2094_cov_170",94.089,2064,63,22,52,2093,40,2066,0,3081,2041,2026
"35624","Nsylvestris_NODE_9928_length_2125_cov_41","Ntome_NODE_13077_length_1834_cov_8",97.219,1834,48,1,232,2062,1834,1,0,3101,1830,1833
"35625","Nsylvestris_NODE_9929_length_2124_cov_226","Ntome_NODE_5121_length_3050_cov_281",95.318,2136,83,7,1,2124,42,2172,0,3374,2123,2130
"35666","Nsylvestris_NODE_9941_length_2123_cov_8","Ntome_NODE_21988_length_1050_cov_179",100,55,0,0,1,55,610,556,1.62e-20,102,54,54
"35831","Nsylvestris_NODE_9992_length_2117_cov_78","Ntome_NODE_9809_length_2224_cov_70",97.505,2084,52,0,1,2084,14,2097,0,3561,2083,2083
"35836","Nsylvestris_NODE_9994_length_2117_cov_31","Ntome_NODE_10964_length_2078_cov_91",91.811,1795,124,10,196,1980,162,1943,0,2479,1784,1781
"35893","Nsylvestris_NODE_10012_length_2114_cov_39","Ntome_NODE_528_length_5940_cov_234",89.431,123,12,1,714,835,3307,3429,4.39e-36,154,121,122
"35918","Nsylvestris_NODE_10019_length_2113_cov_136","Ntome_NODE_11914_length_1967_cov_235",94.802,1866,76,13,76,1932,1919,66,0,2889,1856,1853
"35919","Nsylvestris_NODE_10021_length_2113_cov_116","Ntome_NODE_11503_length_2014_cov_90",97.165,1975,56,0,139,2113,10,1984,0,3338,1974,1974
"35920","Nsylvestris_NODE_10022_length_2113_cov_114","Ntome_NODE_324_length_6617_cov_226",92.138,1997,115,11,99,2061,3994,5982,0,2780,1962,1988
"35931","Nsylvestris_NODE_10025_length_2113_cov_31","Ntome_NODE_986_length_5110_cov_73",95.241,1954,64,15,185,2112,4603,2653,0,3066,1927,1950
"35968","Nsylvestris_NODE_10038_length_2111_cov_207","Ntome_NODE_11159_length_2053_cov_292",97.864,1685,33,3,318,1999,1761,77,0,2909,1681,1684
"36014","Nsylvestris_NODE_10052_length_2110_cov_201","Ntome_NODE_11550_length_2008_cov_199",97.885,1797,37,1,148,1943,1845,49,0,3107,1795,1796
"36022","Nsylvestris_NODE_10055_length_2110_cov_115","Ntome_NODE_10957_length_2079_cov_155",95.033,1953,64,17,1,1946,2063,137,0,3038,1945,1926
"36025","Nsylvestris_NODE_10057_length_2110_cov_11","Ntome_NODE_5936_length_2865_cov_57",94.263,2109,106,1,2,2110,322,2415,0,3210,2108,2093
"36038","Nsylvestris_NODE_10062_length_2109_cov_190","Ntome_NODE_6050_length_2839_cov_130",95.853,1953,62,11,168,2109,2801,857,0,3140,1941,1944
"36050","Nsylvestris_NODE_10067_length_2108_cov_104","Ntome_NODE_4957_length_3095_cov_244",93.216,1990,120,7,106,2089,2530,550,0,2913,1983,1980
"36068","Nsylvestris_NODE_10073_length_2107_cov_48","Ntome_NODE_6142_length_2824_cov_41",90.801,1174,61,21,840,1976,49,1212,0,1526,1136,1163
"36071","Nsylvestris_NODE_10075_length_2106_cov_117","Ntome_NODE_3903_length_3385_cov_199",92.788,2080,114,21,1,2063,1267,3327,0,2977,2062,2060
"36111","Nsylvestris_NODE_10089_length_2104_cov_175","Ntome_NODE_9451_length_2274_cov_281",95.684,2039,83,5,70,2104,12,2049,0,3273,2034,2037
"36116","Nsylvestris_NODE_10091_length_2104_cov_71","Ntome_NODE_14097_length_1731_cov_5",95.168,1573,75,1,532,2103,1724,152,0,2483,1571,1572
"36125","Nsylvestris_NODE_10098_length_2103_cov_106","Ntome_NODE_26885_length_764_cov_31",85.606,132,7,7,1356,1484,189,67,2.65e-28,128,128,122
"36126","Nsylvestris_NODE_10099_length_2103_cov_54","Ntome_NODE_16327_length_1510_cov_201",95.704,1420,53,2,334,1745,43,1462,0,2278,1411,1419
"36144","Nsylvestris_NODE_10105_length_2102_cov_133","Ntome_NODE_7285_length_2607_cov_100",94.619,1691,80,6,416,2102,1724,41,0,2608,1686,1683
"36184","Nsylvestris_NODE_10118_length_2100_cov_220","Ntome_NODE_4741_length_3148_cov_272",95.43,2035,63,17,79,2100,3135,1118,0,3216,2021,2017
"36229","Nsylvestris_NODE_10131_length_2099_cov_55","Ntome_NODE_20900_length_1124_cov_257",95.522,67,3,0,3,69,445,511,3.44e-22,108,66,66
"36230","Nsylvestris_NODE_10132_length_2099_cov_47","Ntome_NODE_20742_length_1135_cov_137",95.099,755,22,4,1341,2095,788,49,0,1175,754,739
"36238","Nsylvestris_NODE_10135_length_2098_cov_204","Ntome_NODE_9851_length_2218_cov_244",94.857,2061,89,14,1,2053,2169,118,0,3203,2052,2051
"36302","Nsylvestris_NODE_10154_length_2095_cov_30","Ntome_NODE_9902_length_2213_cov_39",93.472,2114,98,17,1,2095,16,2108,0,3103,2094,2092
"36315","Nsylvestris_NODE_10159_length_2094_cov_14","Ntome_NODE_11175_length_2052_cov_167",92.065,1903,123,19,1,1898,1925,46,0,2652,1897,1879
"36341","Nsylvestris_NODE_10169_length_2092_cov_207","Ntome_NODE_1895_length_4239_cov_192",96.111,1903,64,2,99,1991,2714,812,0,3096,1892,1902
"36426","Nsylvestris_NODE_10198_length_2088_cov_224","Ntome_NODE_10130_length_2181_cov_268",97.793,2084,42,3,9,2088,2,2085,0,3591,2079,2083
"36436","Nsylvestris_NODE_10201_length_2088_cov_18","Ntome_NODE_14475_length_1688_cov_25",97.532,1661,41,0,409,2069,1661,1,0,2841,1660,1660
"36517","Nsylvestris_NODE_10227_length_2085_cov_108","Ntome_NODE_3822_length_3412_cov_192",96.462,2035,72,0,51,2085,3355,1321,0,3360,2034,2034
"36542","Nsylvestris_NODE_10233_length_2084_cov_105","Ntome_NODE_10792_length_2097_cov_112",97.382,1719,42,3,367,2083,1772,55,0,2922,1716,1717
"36554","Nsylvestris_NODE_10237_length_2083_cov_212","Ntome_NODE_9525_length_2266_cov_286",94.61,1985,84,3,118,2083,60,2040,0,3051,1965,1980
"36616","Nsylvestris_NODE_10258_length_2080_cov_205","Ntome_NODE_7334_length_2597_cov_275",98.305,59,1,0,1,59,618,676,4.41e-21,104,58,58
"36621","Nsylvestris_NODE_10260_length_2080_cov_136","Ntome_NODE_12521_length_1895_cov_232",92.126,1867,101,25,182,2032,1838,2,0,2591,1850,1836
"36636","Nsylvestris_NODE_10264_length_2079_cov_205","Ntome_NODE_1740_length_4352_cov_273",97.182,1774,49,1,122,1895,2522,4294,0,2998,1773,1772
"36669","Nsylvestris_NODE_10273_length_2079_cov_39","Ntome_NODE_8504_length_2412_cov_92",79.705,611,85,22,1320,1921,906,326,1.08e-111,405,601,580
"36698","Nsylvestris_NODE_10284_length_2077_cov_217","Ntome_NODE_11235_length_2045_cov_238",94.416,1988,88,13,7,1975,2039,56,0,3035,1968,1983
"36699","Nsylvestris_NODE_10285_length_2077_cov_198","Ntome_NODE_9095_length_2324_cov_188",96.944,2029,46,4,51,2077,2059,45,0,3389,2026,2014
"36706","Nsylvestris_NODE_10288_length_2077_cov_159","Ntome_NODE_7062_length_2645_cov_35",94.975,2010,84,7,43,2045,2343,344,0,3136,2002,1999
"36764","Nsylvestris_NODE_10307_length_2074_cov_187","Ntome_NODE_12089_length_1946_cov_247",93.452,1512,76,10,456,1946,1569,60,0,2222,1490,1509
"36771","Nsylvestris_NODE_10310_length_2074_cov_143","Ntome_NODE_10512_length_2130_cov_287",92.379,1837,86,35,109,1895,1915,83,0,2567,1786,1832
"36823","Nsylvestris_NODE_10327_length_2072_cov_42","Ntome_NODE_7267_length_2610_cov_292",86.515,1891,230,20,151,2024,2369,487,0,2056,1873,1882
"36872","Nsylvestris_NODE_10343_length_2070_cov_45","Ntome_NODE_12703_length_1873_cov_61",96.107,1824,60,5,36,1853,5,1823,0,2964,1817,1818
"36891","Nsylvestris_NODE_10349_length_2069_cov_198","Ntome_NODE_12861_length_1856_cov_141",95.676,1804,72,5,116,1918,43,1841,0,2894,1802,1798
"36924","Nsylvestris_NODE_10360_length_2068_cov_73","Ntome_NODE_14168_length_1720_cov_11",95.531,1544,69,0,319,1862,1640,97,0,2470,1543,1543
"36971","Nsylvestris_NODE_10375_length_2066_cov_161","Ntome_NODE_273_length_6942_cov_169",96.145,1660,47,5,1,1646,2044,388,0,2695,1645,1656
"36972","Nsylvestris_NODE_10376_length_2065_cov_54","Ntome_NODE_390_length_6347_cov_174",81.152,191,27,8,417,602,1724,1538,2.58e-33,145,185,186
"37009","Nsylvestris_NODE_10388_length_2064_cov_12","Ntome_NODE_11350_length_2031_cov_238",81.416,113,20,1,1077,1188,1694,1806,3.41e-17,91.6,111,112
"37030","Nsylvestris_NODE_10395_length_2063_cov_14","Ntome_NODE_12238_length_1929_cov_27",90.328,1923,104,30,159,2062,1879,20,0,2446,1903,1859
"37031","Nsylvestris_NODE_10396_length_2062_cov_234","Ntome_NODE_232_length_7193_cov_285",98.275,1971,24,1,1,1961,5029,6999,0,3443,1960,1970
"37089","Nsylvestris_NODE_10413_length_2061_cov_41","Ntome_NODE_4258_length_3276_cov_73",91.608,143,11,1,1197,1338,1649,1507,7.01e-49,196,141,142
"37090","Nsylvestris_NODE_10414_length_2061_cov_12","Ntome_NODE_29079_length_665_cov_8",87.755,147,18,0,815,961,519,665,1.18e-41,172,146,146
"37094","Nsylvestris_NODE_10416_length_2060_cov_216","Ntome_NODE_3228_length_3610_cov_282",97.506,1925,48,0,1,1925,1633,3557,0,3290,1924,1924
"37095","Nsylvestris_NODE_10417_length_2060_cov_137","Ntome_NODE_11605_length_2002_cov_273",95.995,1648,62,1,355,1998,168,1815,0,2675,1643,1647
"37096","Nsylvestris_NODE_10418_length_2060_cov_114","Ntome_NODE_12995_length_1843_cov_104",94.89,1683,50,7,323,1987,177,1841,0,2599,1664,1664
"37097","Nsylvestris_NODE_10419_length_2060_cov_31","Ntome_NODE_8374_length_2430_cov_290",89.54,870,90,1,1022,1890,1227,2096,0,1101,868,869
"37123","Nsylvestris_NODE_10424_length_2059_cov_170","Ntome_NODE_5106_length_3053_cov_210",100,55,0,0,2005,2059,367,313,1.57e-20,102,54,54
"37127","Nsylvestris_NODE_10426_length_2059_cov_166","Ntome_NODE_10635_length_2114_cov_173",97.701,2044,43,2,1,2040,27,2070,0,3511,2039,2043
"37128","Nsylvestris_NODE_10428_length_2058_cov_162","Ntome_NODE_10868_length_2088_cov_216",94.075,2076,79,10,13,2058,2088,27,0,3112,2045,2061
"37178","Nsylvestris_NODE_10443_length_2057_cov_222","Ntome_NODE_15107_length_1623_cov_106",93.819,1537,63,10,497,2008,1541,12,0,2283,1511,1529
"37207","Nsylvestris_NODE_10453_length_2056_cov_140","Ntome_NODE_11568_length_2006_cov_215",95.672,1964,62,13,110,2056,1985,28,0,3134,1946,1957
"37216","Nsylvestris_NODE_10456_length_2056_cov_18","Ntome_NODE_15327_length_1602_cov_15",97.502,1601,40,0,335,1935,1601,1,0,2736,1600,1600
"37226","Nsylvestris_NODE_10459_length_2055_cov_159","Ntome_NODE_12173_length_1937_cov_167",91.501,1906,114,24,56,1935,1937,54,0,2579,1879,1883
"37230","Nsylvestris_NODE_10461_length_2055_cov_82","Ntome_NODE_9878_length_2215_cov_258",94.105,1934,68,12,2,1895,95,2022,0,2898,1893,1927
"37241","Nsylvestris_NODE_10465_length_2055_cov_29","Ntome_NODE_7330_length_2599_cov_54",98.381,556,9,0,1322,1877,725,170,0,977,555,555
"37300","Nsylvestris_NODE_10483_length_2052_cov_214","Ntome_NODE_11390_length_2026_cov_277",92.949,2014,70,34,82,2052,17,2001,0,2867,1970,1984
"37301","Nsylvestris_NODE_10484_length_2052_cov_194","Ntome_NODE_834_length_5337_cov_207",98.104,1793,30,3,1,1793,3482,5270,0,3120,1792,1788
"37302","Nsylvestris_NODE_10485_length_2052_cov_157","Ntome_NODE_10053_length_2193_cov_207",97.23,1877,44,4,25,1899,2193,323,0,3171,1874,1870
"37336","Nsylvestris_NODE_10494_length_2051_cov_93","Ntome_NODE_6776_length_2698_cov_135",93.556,2064,117,9,1,2051,4,2064,0,3061,2050,2060
"37349","Nsylvestris_NODE_10498_length_2051_cov_37","Ntome_NODE_10948_length_2080_cov_55",92.357,2015,98,16,1,1968,26,2031,0,2817,1967,2005
"37376","Nsylvestris_NODE_10506_length_2050_cov_28","Ntome_NODE_34796_length_383_cov_2",94.643,392,12,1,546,937,383,1,4.55e-170,599,391,382
"37382","Nsylvestris_NODE_10509_length_2049_cov_198","Ntome_NODE_11039_length_2067_cov_264",95.311,2026,78,9,27,2047,2066,53,0,3199,2020,2013
"37416","Nsylvestris_NODE_10518_length_2048_cov_222","Ntome_NODE_11317_length_2034_cov_288",94.39,1943,91,12,14,1939,1989,48,0,2968,1925,1941
"37441","Nsylvestris_NODE_10528_length_2047_cov_34","Ntome_NODE_10285_length_2158_cov_99",91.385,2043,149,16,12,2045,101,2125,0,2772,2033,2024
"37445","Nsylvestris_NODE_10530_length_2047_cov_16","Ntome_NODE_19_length_11828_cov_48",73.715,1712,333,79,415,2047,10054,8381,2.14e-158,560,1632,1673
"37468","Nsylvestris_NODE_10537_length_2046_cov_129","Ntome_NODE_10422_length_2143_cov_67",94.553,2038,57,23,18,2020,11,2029,0,3099,2002,2018
"37520","Nsylvestris_NODE_10555_length_2043_cov_87","Ntome_NODE_3355_length_3566_cov_189",95.025,1990,86,10,56,2042,2073,94,0,3114,1986,1979
"37523","Nsylvestris_NODE_10557_length_2043_cov_29","Ntome_NODE_7336_length_2597_cov_191",87.967,723,59,17,285,1002,205,904,0,828,717,699
"37544","Nsylvestris_NODE_10564_length_2042_cov_28","Ntome_NODE_14577_length_1678_cov_32",93.379,1601,79,18,390,1977,46,1632,0,2344,1587,1586
"37551","Nsylvestris_NODE_10567_length_2041_cov_184","Ntome_NODE_13182_length_1821_cov_235",92.316,1887,60,33,33,1901,1821,2,0,2603,1868,1819
"37586","Nsylvestris_NODE_10580_length_2040_cov_131","Ntome_NODE_17005_length_1448_cov_103",97.056,951,27,1,580,1530,388,1337,0,1600,950,949
"37613","Nsylvestris_NODE_10589_length_2039_cov_52","Ntome_NODE_38542_length_277_cov_4",97.473,277,7,0,366,642,1,277,2.86e-132,473,276,276
"37617","Nsylvestris_NODE_10591_length_2039_cov_47","Ntome_NODE_9842_length_2220_cov_23",94.023,1673,96,4,85,1755,2220,550,0,2532,1670,1670
"37669","Nsylvestris_NODE_10608_length_2036_cov_88","Ntome_NODE_16641_length_1483_cov_9",96.108,1439,56,0,325,1763,45,1483,0,2348,1438,1438
"37676","Nsylvestris_NODE_10611_length_2036_cov_26","Ntome_NODE_36570_length_322_cov_4",95.886,316,13,0,541,856,322,7,6.05e-144,512,315,315
"37689","Nsylvestris_NODE_10616_length_2035_cov_161","Ntome_NODE_12140_length_1941_cov_142",96.007,1753,53,4,62,1798,114,1865,0,2833,1736,1751
"37699","Nsylvestris_NODE_10620_length_2035_cov_22","Ntome_NODE_8793_length_2371_cov_146",93.982,1994,95,11,56,2035,2253,271,0,2994,1979,1982
"37716","Nsylvestris_NODE_10627_length_2034_cov_79","Ntome_NODE_29712_length_639_cov_260",86.813,364,34,5,1436,1799,585,236,2.28e-108,394,363,349
"37728","Nsylvestris_NODE_10632_length_2033_cov_201","Ntome_NODE_10061_length_2190_cov_245",92.912,2102,74,26,1,2033,41,2136,0,2987,2032,2095
"37729","Nsylvestris_NODE_10633_length_2033_cov_178","Ntome_NODE_9754_length_2231_cov_171",95.856,1834,66,7,1,1824,1881,48,0,2957,1823,1833
"37745","Nsylvestris_NODE_10640_length_2032_cov_198","Ntome_NODE_10499_length_2132_cov_259",93.836,2028,92,16,27,2030,47,2065,0,3022,2003,2018
"37768","Nsylvestris_NODE_10647_length_2032_cov_22","Ntome_NODE_12056_length_1951_cov_9",94.427,1866,99,3,61,1925,46,1907,0,2865,1864,1861
"37781","Nsylvestris_NODE_10650_length_2031_cov_196","Ntome_NODE_11378_length_2028_cov_70",96.66,1976,60,5,15,1986,50,2023,0,3278,1971,1973
"37803","Nsylvestris_NODE_10658_length_2031_cov_39","Ntome_NODE_484_length_6072_cov_222",97.501,1881,47,0,42,1922,5960,4080,0,3214,1880,1880
"37828","Nsylvestris_NODE_10668_length_2029_cov_230","Ntome_NODE_1153_length_4896_cov_305",96.947,2031,43,4,1,2029,2050,37,0,3389,2028,2013
"37829","Nsylvestris_NODE_10669_length_2029_cov_220","Ntome_NODE_8184_length_2461_cov_268",95.565,1984,73,8,57,2029,2359,380,0,3162,1972,1979
"37856","Nsylvestris_NODE_10677_length_2029_cov_42","Ntome_NODE_11312_length_2036_cov_55",94.279,2010,57,16,1,1984,1990,13,0,3022,1983,1977
"37863","Nsylvestris_NODE_10680_length_2028_cov_191","Ntome_NODE_2313_length_4000_cov_150",93.737,1948,80,14,107,2028,3947,2016,0,2883,1921,1931
"37875","Nsylvestris_NODE_10684_length_2027_cov_220","Ntome_NODE_11565_length_2006_cov_282",93.912,1889,93,8,75,1958,1958,87,0,2832,1883,1871
"37913","Nsylvestris_NODE_10695_length_2026_cov_175","Ntome_NODE_13726_length_1765_cov_57",96.552,1566,40,5,432,1993,210,1765,0,2580,1561,1555
"37927","Nsylvestris_NODE_10700_length_2025_cov_216","Ntome_NODE_12199_length_1931_cov_283",95.922,1888,61,6,120,2005,51,1924,0,3046,1885,1873
"37930","Nsylvestris_NODE_10702_length_2025_cov_180","Ntome_NODE_12945_length_1847_cov_99",95.678,1666,69,1,161,1823,49,1714,0,2675,1662,1665
"37931","Nsylvestris_NODE_10703_length_2025_cov_132","Ntome_NODE_11882_length_1972_cov_219",95.303,1831,85,1,20,1850,141,1970,0,2904,1830,1829
"37932","Nsylvestris_NODE_10704_length_2025_cov_127","Ntome_NODE_22867_length_992_cov_42",97.241,870,24,0,1120,1989,874,5,0,1474,869,869
"37937","Nsylvestris_NODE_10706_length_2024_cov_223","Ntome_NODE_29238_length_659_cov_7",94.175,515,30,0,1,515,566,52,0,785,514,514
"37943","Nsylvestris_NODE_10708_length_2022_cov_208","Ntome_NODE_140_length_7962_cov_220",96.338,2021,65,6,1,2014,2120,102,0,3314,2013,2018
"37944","Nsylvestris_NODE_10709_length_2024_cov_201","Ntome_NODE_12239_length_1928_cov_276",95.779,1824,67,3,204,2021,73,1892,0,2933,1817,1819
"37945","Nsylvestris_NODE_10710_length_2024_cov_126","Ntome_NODE_11459_length_2018_cov_217",93.064,2033,73,26,1,1981,2,2018,0,2911,1980,2016
"37977","Nsylvestris_NODE_10724_length_2023_cov_46","Ntome_NODE_11287_length_2039_cov_148",93.057,1930,101,14,6,1912,1993,74,0,2791,1906,1919
"37989","Nsylvestris_NODE_10729_length_2022_cov_199","Ntome_NODE_11840_length_1976_cov_228",93.364,1748,94,10,77,1805,1795,51,0,2566,1728,1744
"38021","Nsylvestris_NODE_10740_length_2021_cov_87","Ntome_NODE_14642_length_1673_cov_93",92.502,1467,85,14,519,1972,125,1579,0,2076,1453,1454
"38022","Nsylvestris_NODE_10741_length_2021_cov_82","Ntome_NODE_13431_length_1793_cov_17",96.549,1217,40,2,241,1456,1217,2,0,2013,1215,1215
"38043","Nsylvestris_NODE_10749_length_2020_cov_56","Ntome_NODE_12609_length_1886_cov_27",94.967,1689,77,5,233,1914,1837,150,0,2641,1681,1687
"38054","Nsylvestris_NODE_10753_length_2019_cov_62","Ntome_NODE_10928_length_2082_cov_117",95.028,1951,74,13,70,2012,2032,97,0,3044,1942,1935
"38055","Nsylvestris_NODE_10754_length_2019_cov_56","Ntome_NODE_1460_length_4568_cov_46",95.212,2005,83,6,20,2019,15,2011,0,3158,1999,1996
"38083","Nsylvestris_NODE_10761_length_2018_cov_99","Ntome_NODE_23304_length_965_cov_71",92.808,584,18,3,432,1015,965,406,0,824,583,559
"38097","Nsylvestris_NODE_10765_length_2017_cov_222","Ntome_NODE_2873_length_3739_cov_183",96.131,1835,67,3,153,1985,3324,1492,0,2992,1832,1832
"38146","Nsylvestris_NODE_10780_length_2016_cov_104","Ntome_NODE_12729_length_1869_cov_236",93.778,1816,92,12,1,1808,1846,44,0,2708,1807,1802
"38152","Nsylvestris_NODE_10783_length_2016_cov_31","Ntome_NODE_12424_length_1906_cov_60",92.9,1676,86,9,367,2016,1856,188,0,2405,1649,1668
"38180","Nsylvestris_NODE_10793_length_2015_cov_29","Ntome_NODE_10950_length_2080_cov_47",89.188,1785,121,26,258,2015,1882,143,0,2161,1757,1739
"38187","Nsylvestris_NODE_10796_length_2014_cov_116","Ntome_NODE_4114_length_3316_cov_231",95.183,872,33,1,1152,2014,3268,2397,0,1369,862,871
"38197","Nsylvestris_NODE_10799_length_2014_cov_30","Ntome_NODE_1242_length_4789_cov_105",81.657,845,126,19,1123,1945,1857,2694,0,675,822,837
"38203","Nsylvestris_NODE_10802_length_2013_cov_184","Ntome_NODE_12484_length_1899_cov_92",98.162,1850,34,0,76,1925,1897,48,0,3229,1849,1849
"38328","Nsylvestris_NODE_10840_length_2009_cov_19","Ntome_NODE_11800_length_1981_cov_48",94.319,1813,75,7,199,2009,182,1968,0,2752,1810,1786
"38352","Nsylvestris_NODE_10850_length_2007_cov_200","Ntome_NODE_12494_length_1897_cov_245",93.75,1808,96,10,1,1805,1851,58,0,2697,1804,1793
"38357","Nsylvestris_NODE_10852_length_2010_cov_122","Ntome_NODE_16159_length_1525_cov_90",90.349,746,49,11,1278,2010,842,107,0,957,732,735
"38358","Nsylvestris_NODE_10853_length_2007_cov_19","Ntome_NODE_22208_length_1034_cov_9",93.907,1034,63,0,763,1796,1,1034,0,1561,1033,1033
"38413","Nsylvestris_NODE_10871_length_2004_cov_202","Ntome_NODE_14639_length_1673_cov_196",94.492,1634,63,9,240,1871,48,1656,0,2494,1631,1608
"38440","Nsylvestris_NODE_10879_length_2003_cov_111","Ntome_NODE_12758_length_1867_cov_31",96.356,1866,68,0,1,1866,1867,2,0,3070,1865,1865
"38447","Nsylvestris_NODE_10882_length_2002_cov_215","Ntome_NODE_2868_length_3750_cov_151",95.113,1719,72,10,130,1846,1758,50,0,2699,1716,1708
"38484","Nsylvestris_NODE_10894_length_2001_cov_175","Ntome_NODE_12029_length_1954_cov_122",95.476,1901,43,13,56,1920,1945,52,0,2994,1864,1893
"38491","Nsylvestris_NODE_10897_length_2001_cov_65","Ntome_NODE_696_length_5567_cov_202",93.704,2017,89,21,1,2001,5305,3311,0,2987,2000,1994
"38513","Nsylvestris_NODE_10904_length_2000_cov_10","Ntome_NODE_2277_length_4017_cov_272",98.182,55,1,0,1946,2000,3118,3064,7.09e-19,97.1,54,54
"38596","Nsylvestris_NODE_10931_length_1996_cov_184","Ntome_NODE_10019_length_2197_cov_195",95.278,1906,78,7,49,1947,2003,103,0,3011,1898,1900
"38637","Nsylvestris_NODE_10946_length_1994_cov_210","Ntome_NODE_3405_length_3545_cov_197",96.119,1778,50,12,93,1857,3502,1731,0,2883,1764,1771
"38646","Nsylvestris_NODE_10949_length_1994_cov_119","Ntome_NODE_12189_length_1935_cov_73",94.782,1629,73,7,368,1993,1634,15,0,2527,1625,1619
"38662","Nsylvestris_NODE_10956_length_1993_cov_201","Ntome_NODE_13193_length_1820_cov_272",94.092,1845,76,15,103,1939,1,1820,0,2772,1836,1819
"38663","Nsylvestris_NODE_10957_length_1993_cov_190","Ntome_NODE_13124_length_1828_cov_238",97.475,1822,36,2,8,1829,1,1812,0,3101,1821,1811
"38668","Nsylvestris_NODE_10959_length_1993_cov_86","Ntome_NODE_12725_length_1870_cov_20",97.385,1874,43,4,20,1891,1870,1,0,3184,1871,1869
"38672","Nsylvestris_NODE_10962_length_1993_cov_8","Ntome_NODE_2822_length_3765_cov_81",91.113,2048,111,23,1,1993,3101,1070,0,2708,1992,2031
"38676","Nsylvestris_NODE_10964_length_1992_cov_163","Ntome_NODE_6108_length_2829_cov_206",96.505,1974,44,5,1,1970,822,2774,0,3240,1969,1952
"38680","Nsylvestris_NODE_10966_length_1992_cov_32","Ntome_NODE_11554_length_2008_cov_118",79.587,436,81,4,1154,1582,1201,1635,1.08e-81,305,428,434
"38687","Nsylvestris_NODE_10969_length_1991_cov_218","Ntome_NODE_11379_length_2027_cov_301",95.661,1959,51,9,42,1969,22,1977,0,3116,1927,1955
"38691","Nsylvestris_NODE_10971_length_1991_cov_205","Ntome_NODE_13446_length_1791_cov_245",92.48,1782,74,20,31,1795,1791,53,0,2494,1764,1738
"38699","Nsylvestris_NODE_10974_length_1991_cov_174","Ntome_NODE_10647_length_2113_cov_194",96.527,1958,43,10,8,1950,42,1989,0,3216,1942,1947
"38715","Nsylvestris_NODE_10980_length_1990_cov_194","Ntome_NODE_12774_length_1865_cov_180",94.26,1777,73,5,72,1821,1818,44,0,2689,1749,1774
"38745","Nsylvestris_NODE_10988_length_1989_cov_217","Ntome_NODE_11729_length_1988_cov_283",94.964,1926,90,3,19,1940,1988,66,0,3013,1921,1922
"38751","Nsylvestris_NODE_10990_length_1989_cov_135","Ntome_NODE_11954_length_1963_cov_67",94.266,1866,67,19,47,1902,114,1949,0,2817,1855,1835
"38755","Nsylvestris_NODE_10992_length_1989_cov_22","Ntome_NODE_11021_length_2070_cov_75",95.795,1974,67,11,32,1989,42,2015,0,3171,1957,1973
"38758","Nsylvestris_NODE_10994_length_1988_cov_209","Ntome_NODE_1001_length_5089_cov_187",97.927,1592,25,3,262,1848,5089,3501,0,2750,1586,1588
"38783","Nsylvestris_NODE_11002_length_1987_cov_169","Ntome_NODE_13255_length_1813_cov_189",95.528,1543,60,1,386,1919,179,1721,0,2459,1533,1542
"38798","Nsylvestris_NODE_11009_length_1986_cov_204","Ntome_NODE_18361_length_1329_cov_112",79.755,326,41,19,358,673,886,576,6.7e-54,213,315,310
"38824","Nsylvestris_NODE_11019_length_1985_cov_42","Ntome_NODE_29487_length_649_cov_4",93.178,557,30,4,1406,1959,97,648,0,811,553,551
"38903","Nsylvestris_NODE_11044_length_1982_cov_185","Ntome_NODE_11013_length_2071_cov_161",95.944,1849,52,6,93,1938,54,1882,0,2977,1845,1828
"38908","Nsylvestris_NODE_11047_length_1977_cov_74","Ntome_NODE_12635_length_1883_cov_37",92.191,461,34,2,1435,1894,1420,1879,0,651,459,459
"38982","Nsylvestris_NODE_11070_length_1980_cov_77","Ntome_NODE_10784_length_2098_cov_85",88.683,1944,113,41,32,1926,2070,185,0,2272,1894,1885
"38983","Nsylvestris_NODE_11071_length_1980_cov_67","Ntome_NODE_12724_length_1870_cov_22",93.545,1828,82,12,124,1925,1870,53,0,2689,1801,1817
"39008","Nsylvestris_NODE_11078_length_1979_cov_121","Ntome_NODE_16006_length_1538_cov_250",95.646,1401,52,6,580,1979,1394,2,0,2241,1399,1392
"39016","Nsylvestris_NODE_11082_length_1978_cov_226","Ntome_NODE_12133_length_1942_cov_53",95.419,1790,69,10,147,1928,72,1856,0,2839,1781,1784
"39024","Nsylvestris_NODE_11085_length_1978_cov_103","Ntome_NODE_16757_length_1470_cov_257",95.534,627,25,1,76,702,1418,795,0,1000,626,623
"39025","Nsylvestris_NODE_11086_length_1978_cov_77","Ntome_NODE_13034_length_1838_cov_15",97.594,1704,32,3,113,1813,140,1837,0,2911,1700,1697
"39042","Nsylvestris_NODE_11092_length_1977_cov_181","Ntome_NODE_12057_length_1950_cov_247",95.467,1809,57,14,167,1969,112,1901,0,2863,1802,1789
"39043","Nsylvestris_NODE_11093_length_1977_cov_102","Ntome_NODE_12765_length_1866_cov_87",94.499,1836,75,15,47,1878,53,1866,0,2808,1831,1813
"39054","Nsylvestris_NODE_11096_length_1977_cov_11","Ntome_NODE_30346_length_615_cov_5",96.585,615,21,0,935,1549,615,1,0,1020,614,614
"39057","Nsylvestris_NODE_11098_length_1976_cov_227","Ntome_NODE_11553_length_2008_cov_140",94.521,1971,64,13,1,1945,1964,12,0,3001,1944,1952
"39068","Nsylvestris_NODE_11102_length_1976_cov_58","Ntome_NODE_3437_length_3533_cov_289",98.182,55,1,0,1,55,1365,1311,7e-19,97.1,54,54
"39088","Nsylvestris_NODE_11110_length_1975_cov_33","Ntome_NODE_7846_length_2517_cov_141",90,80,8,0,1892,1971,179,258,4.18e-21,104,79,79
"39105","Nsylvestris_NODE_11116_length_1969_cov_156","Ntome_NODE_26570_length_778_cov_272",94.35,708,32,6,1267,1969,724,20,0,1079,702,704
"39172","Nsylvestris_NODE_11136_length_1971_cov_83","Ntome_NODE_11191_length_2050_cov_246",94.786,1918,96,1,49,1966,136,2049,0,2985,1917,1913
"39207","Nsylvestris_NODE_11151_length_1969_cov_11","Ntome_NODE_21501_length_1081_cov_186",96.364,55,2,0,1,55,558,612,3.25e-17,91.6,54,54
"39214","Nsylvestris_NODE_11154_length_1968_cov_75","Ntome_NODE_24281_length_907_cov_260",95.238,63,3,0,1,63,327,265,5.39e-20,100,62,62
"39228","Nsylvestris_NODE_11160_length_1967_cov_165","Ntome_NODE_12459_length_1902_cov_103",93.133,1893,116,10,64,1944,1,1891,0,2763,1880,1890
"39300","Nsylvestris_NODE_11180_length_1962_cov_55","Ntome_NODE_26604_length_777_cov_27",88.034,234,25,2,1299,1529,489,256,2.99e-72,274,230,233
"39332","Nsylvestris_NODE_11190_length_1964_cov_95","Ntome_NODE_17423_length_1410_cov_16",97.8,1227,27,0,540,1766,1279,53,0,2117,1226,1226
"39516","Nsylvestris_NODE_11254_length_1956_cov_220","Ntome_NODE_12023_length_1954_cov_297",96.393,1802,63,1,53,1854,1907,108,0,2966,1801,1799
"39517","Nsylvestris_NODE_11255_length_1956_cov_218","Ntome_NODE_11894_length_1970_cov_265",97.254,1857,41,7,49,1899,7,1859,0,3138,1850,1852
"39522","Nsylvestris_NODE_11257_length_1956_cov_197","Ntome_NODE_12028_length_1954_cov_178",94.498,1854,83,6,119,1956,1,1851,0,2841,1837,1850
"39542","Nsylvestris_NODE_11265_length_1955_cov_184","Ntome_NODE_11404_length_2025_cov_228",93.776,1912,85,15,10,1894,2011,107,0,2841,1884,1904
"39543","Nsylvestris_NODE_11266_length_1955_cov_166","Ntome_NODE_40_length_10198_cov_97",91.356,1689,91,23,130,1810,10192,8551,0,2259,1680,1641
"39549","Nsylvestris_NODE_11270_length_1955_cov_54","Ntome_NODE_14213_length_1714_cov_143",94.128,1686,76,6,89,1751,28,1713,0,2543,1662,1685
"39550","Nsylvestris_NODE_11271_length_1955_cov_41","Ntome_NODE_13083_length_1832_cov_46",81.761,159,19,4,1,153,783,629,3.18e-27,124,152,154
"39560","Nsylvestris_NODE_11275_length_1954_cov_161","Ntome_NODE_14999_length_1635_cov_278",96.194,1550,48,6,328,1869,1635,89,0,2525,1541,1546
"39567","Nsylvestris_NODE_11279_length_1954_cov_78","Ntome_NODE_16089_length_1529_cov_63",95.357,603,10,7,195,792,1443,854,0,942,597,589
"39588","Nsylvestris_NODE_11286_length_1953_cov_186","Ntome_NODE_4975_length_3090_cov_165",93.017,1747,118,4,85,1830,1317,3060,0,2547,1745,1743
"39589","Nsylvestris_NODE_11287_length_1953_cov_168","Ntome_NODE_12071_length_1948_cov_315",91.87,123,10,0,1107,1229,1900,1778,1.12e-41,172,122,122
"39592","Nsylvestris_NODE_11289_length_1953_cov_93","Ntome_NODE_13072_length_1834_cov_73",94.235,1752,65,22,207,1952,48,1769,0,2643,1745,1721
"39612","Nsylvestris_NODE_11295_length_1952_cov_104","Ntome_NODE_3259_length_3603_cov_63",95.064,1783,76,6,163,1941,1778,4,0,2795,1778,1774
"39623","Nsylvestris_NODE_11300_length_1951_cov_146","Ntome_NODE_5577_length_2940_cov_148",94.531,1664,64,8,224,1866,136,1793,0,2543,1642,1657
"39713","Nsylvestris_NODE_11327_length_1948_cov_224","Ntome_NODE_18199_length_1342_cov_283",95.224,1005,48,0,469,1473,1210,206,0,1591,1004,1004
"39725","Nsylvestris_NODE_11333_length_1948_cov_114","Ntome_NODE_17114_length_1438_cov_87",87.532,1171,88,23,49,1193,1191,53,0,1301,1144,1138
"39773","Nsylvestris_NODE_11347_length_1947_cov_122","Ntome_NODE_3906_length_3384_cov_289",91.266,1019,63,14,932,1933,2332,3341,0,1365,1001,1009
"39777","Nsylvestris_NODE_11349_length_1947_cov_15","Ntome_NODE_3396_length_3548_cov_51",92.44,1680,86,13,154,1805,3491,1825,0,2361,1651,1666
"39850","Nsylvestris_NODE_11370_length_1946_cov_35","Ntome_NODE_3038_length_3683_cov_217",100,52,0,0,1,52,987,1038,6.9e-19,97.1,51,51
"39930","Nsylvestris_NODE_11396_length_1942_cov_148","Ntome_NODE_11815_length_1979_cov_247",95.838,1946,75,6,1,1942,6,1949,0,3140,1941,1943
"39945","Nsylvestris_NODE_11401_length_1942_cov_11","Ntome_NODE_5736_length_2909_cov_151",95.984,1942,78,0,1,1942,860,2801,0,3155,1941,1941
"39951","Nsylvestris_NODE_11404_length_1941_cov_196","Ntome_NODE_11192_length_2050_cov_230",92.845,1747,95,19,124,1846,197,1937,0,2507,1722,1740
"39954","Nsylvestris_NODE_11406_length_1941_cov_115","Ntome_NODE_11712_length_1988_cov_83",95.016,1545,60,13,49,1580,43,1583,0,2410,1531,1540
"39969","Nsylvestris_NODE_11411_length_1940_cov_209","Ntome_NODE_5180_length_3035_cov_281",95.952,1902,39,11,8,1887,132,2017,0,3051,1879,1885
"39996","Nsylvestris_NODE_11420_length_1939_cov_44","Ntome_NODE_13522_length_1784_cov_60",97.128,1393,37,2,25,1416,1770,380,0,2348,1391,1390
"40022","Nsylvestris_NODE_11429_length_1938_cov_26","Ntome_NODE_45_length_10031_cov_124",82.68,485,77,3,882,1361,8748,9230,2.78e-117,424,479,482
"40049","Nsylvestris_NODE_11440_length_1937_cov_68","Ntome_NODE_12423_length_1906_cov_77",88.822,1825,137,32,124,1896,1833,24,0,2178,1772,1809
"40067","Nsylvestris_NODE_11446_length_1936_cov_163","Ntome_NODE_10152_length_2177_cov_200",95.338,1952,70,7,3,1936,2177,229,0,3081,1933,1948
"40068","Nsylvestris_NODE_11447_length_1936_cov_163","Ntome_NODE_11543_length_2009_cov_113",96.083,1838,48,7,101,1932,1939,120,0,2974,1831,1819
"40069","Nsylvestris_NODE_11448_length_1936_cov_137","Ntome_NODE_7916_length_2504_cov_134",80.537,149,15,10,3,145,2336,2196,1.48e-20,102,142,140
"40070","Nsylvestris_NODE_11449_length_1936_cov_127","Ntome_NODE_13258_length_1813_cov_98",95.238,1827,55,17,127,1935,1,1813,0,2863,1808,1812
"40071","Nsylvestris_NODE_11450_length_1936_cov_113","Ntome_NODE_12911_length_1851_cov_38",94.351,1841,97,4,40,1879,1835,1,0,2817,1839,1834
"40072","Nsylvestris_NODE_11451_length_1936_cov_99","Ntome_NODE_36098_length_336_cov_3",86.798,356,20,7,1247,1602,331,3,1.02e-101,372,355,328
"40073","Nsylvestris_NODE_11452_length_1936_cov_84","Ntome_NODE_12588_length_1889_cov_18",97.739,1548,31,3,346,1890,1889,343,0,2662,1544,1546
"40074","Nsylvestris_NODE_11453_length_1936_cov_43","Ntome_NODE_12217_length_1931_cov_41",95.141,1914,66,12,36,1936,1931,32,0,2994,1900,1899
"40100","Nsylvestris_NODE_11460_length_1935_cov_27","Ntome_NODE_1639_length_4429_cov_164",90.888,428,35,2,6,433,3898,3475,9.36e-162,571,427,423
"40103","Nsylvestris_NODE_11462_length_1935_cov_16","Ntome_NODE_6768_length_2700_cov_53",97.09,1821,51,2,1,1821,221,2039,0,3068,1820,1818
"40126","Nsylvestris_NODE_11469_length_1933_cov_214","Ntome_NODE_25838_length_813_cov_248",100,52,0,0,1,52,584,635,6.86e-19,97.1,51,51
"40127","Nsylvestris_NODE_11470_length_1933_cov_208","Ntome_NODE_10831_length_2092_cov_213",92.352,1922,84,26,7,1881,76,1981,0,2676,1874,1905
"40263","Nsylvestris_NODE_11512_length_1929_cov_111","Ntome_NODE_11913_length_1968_cov_235",94.984,1854,90,3,79,1929,72,1925,0,2905,1850,1853
"40297","Nsylvestris_NODE_11525_length_1927_cov_116","Ntome_NODE_10548_length_2126_cov_175",95.702,1838,66,10,8,1837,252,2084,0,2944,1829,1832
"40352","Nsylvestris_NODE_11544_length_1925_cov_28","Ntome_NODE_596_length_5780_cov_32",95.994,1922,52,6,26,1925,172,2090,0,3099,1899,1918
"40375","Nsylvestris_NODE_11551_length_1924_cov_207","Ntome_NODE_14709_length_1665_cov_21",96.029,1662,57,1,104,1765,1665,13,0,2695,1661,1652
"40401","Nsylvestris_NODE_11559_length_1923_cov_179","Ntome_NODE_16058_length_1534_cov_269",94.049,1546,63,16,233,1761,1,1534,0,2318,1528,1533
"40402","Nsylvestris_NODE_11560_length_1923_cov_170","Ntome_NODE_15279_length_1607_cov_53",94.804,1559,72,6,222,1776,1,1554,0,2422,1554,1553
"40418","Nsylvestris_NODE_11566_length_1922_cov_202","Ntome_NODE_12743_length_1868_cov_171",94.872,1677,85,1,50,1725,89,1765,0,2619,1675,1676
"40459","Nsylvestris_NODE_11580_length_1921_cov_205","Ntome_NODE_8369_length_2431_cov_284",94.329,1728,69,18,218,1921,26,1748,0,2621,1703,1722
"40491","Nsylvestris_NODE_11591_length_1920_cov_206","Ntome_NODE_14486_length_1687_cov_99",93.274,1695,95,8,167,1850,1687,1,0,2481,1683,1686
"40524","Nsylvestris_NODE_11604_length_1919_cov_10","Ntome_NODE_4816_length_3130_cov_104",94.545,55,3,0,1865,1919,1409,1355,1.47e-15,86.1,54,54
"40546","Nsylvestris_NODE_11613_length_1917_cov_216","Ntome_NODE_11236_length_2045_cov_236",93.288,1907,92,11,2,1903,99,1974,0,2780,1901,1875
"40576","Nsylvestris_NODE_11621_length_1916_cov_212","Ntome_NODE_13055_length_1835_cov_274",95.536,1568,57,7,361,1916,268,1834,0,2495,1555,1566
"40587","Nsylvestris_NODE_11625_length_1916_cov_115","Ntome_NODE_9709_length_2238_cov_43",87.911,1704,197,8,50,1749,194,1892,0,1997,1699,1698
"40622","Nsylvestris_NODE_11637_length_1914_cov_193","Ntome_NODE_7611_length_2552_cov_257",96.87,1885,42,11,1,1877,2541,666,0,3138,1876,1875
"40628","Nsylvestris_NODE_11640_length_1914_cov_143","Ntome_NODE_12378_length_1911_cov_217",94.188,1910,79,17,21,1914,3,1896,0,2883,1893,1893
"40656","Nsylvestris_NODE_11651_length_1912_cov_211","Ntome_NODE_9332_length_2291_cov_244",96.477,1788,56,5,7,1790,2254,470,0,2946,1783,1784
"40660","Nsylvestris_NODE_11653_length_1912_cov_199","Ntome_NODE_5577_length_2940_cov_148",93.694,1126,56,10,797,1912,1774,2894,0,1672,1115,1120
"40677","Nsylvestris_NODE_11659_length_1911_cov_32","Ntome_NODE_18682_length_1301_cov_51",96.309,298,11,0,93,390,1287,990,2.66e-137,490,297,297
"40694","Nsylvestris_NODE_11663_length_1909_cov_126","Ntome_NODE_11869_length_1974_cov_34",96.523,1898,49,5,5,1895,1966,79,0,3123,1890,1887
"40711","Nsylvestris_NODE_11668_length_1909_cov_22","Ntome_NODE_8486_length_2414_cov_278",82.648,559,95,2,860,1417,1018,461,2.06e-138,494,557,557
"40715","Nsylvestris_NODE_11670_length_1909_cov_189","Ntome_NODE_412_length_6272_cov_262",97.593,1911,44,2,1,1909,6262,4352,0,3273,1908,1910
"40727","Nsylvestris_NODE_11674_length_1909_cov_100","Ntome_NODE_4880_length_3115_cov_200",77.151,1383,283,27,59,1432,3007,1649,0,773,1373,1358
"40753","Nsylvestris_NODE_11683_length_1907_cov_177","Ntome_NODE_15565_length_1578_cov_276",95.554,1372,53,6,379,1748,159,1524,0,2189,1369,1365
"40769","Nsylvestris_NODE_11688_length_1907_cov_15","Ntome_NODE_2056_length_4137_cov_133",96.467,1783,56,3,128,1907,2279,4057,0,2937,1779,1778
"40776","Nsylvestris_NODE_11691_length_1906_cov_192","Ntome_NODE_13938_length_1743_cov_211",97.143,1645,37,6,183,1820,1690,49,0,2769,1637,1641
"40818","Nsylvestris_NODE_11705_length_1904_cov_154","Ntome_NODE_17190_length_1430_cov_264",94.058,1380,55,5,1,1356,1382,6,0,2069,1355,1376
"40874","Nsylvestris_NODE_11722_length_1902_cov_176","Ntome_NODE_12061_length_1950_cov_56",96.483,1905,64,1,1,1902,2,1906,0,3144,1901,1904
"40949","Nsylvestris_NODE_11742_length_1900_cov_170","Ntome_NODE_15846_length_1554_cov_9",95.522,1474,61,3,188,1657,82,1554,0,2351,1469,1472
"40950","Nsylvestris_NODE_11743_length_1900_cov_162","Ntome_NODE_420_length_6242_cov_30",82.165,1127,173,18,762,1883,3356,2253,0,942,1121,1103
"40966","Nsylvestris_NODE_11750_length_1899_cov_184","Ntome_NODE_16252_length_1516_cov_285",95.385,65,2,1,377,440,1254,1318,1.45e-20,102,63,64
"40973","Nsylvestris_NODE_11753_length_1899_cov_152","Ntome_NODE_12001_length_1958_cov_124",91.941,1886,132,10,1,1872,19,1898,0,2623,1871,1879
"41003","Nsylvestris_NODE_11766_length_1897_cov_213","Ntome_NODE_11843_length_1976_cov_138",92.04,1784,83,27,7,1748,1875,109,0,2453,1741,1766
"41016","Nsylvestris_NODE_11771_length_1897_cov_73","Ntome_NODE_5312_length_3004_cov_299",96.667,60,2,0,1,60,1120,1061,5.2e-20,100,59,59
"41048","Nsylvestris_NODE_11780_length_1895_cov_224","Ntome_NODE_12178_length_1936_cov_269",93.372,1901,86,8,13,1891,19,1901,0,2776,1878,1882
"41052","Nsylvestris_NODE_11782_length_1895_cov_172","Ntome_NODE_17793_length_1375_cov_159",94.809,1098,54,1,423,1520,9,1103,0,1709,1097,1094
"41053","Nsylvestris_NODE_11783_length_1895_cov_151","Ntome_NODE_10997_length_2073_cov_190",96.953,1805,53,2,92,1895,2023,220,0,3027,1803,1803
"41065","Nsylvestris_NODE_11787_length_1895_cov_50","Ntome_NODE_13503_length_1786_cov_31",94.223,1679,80,5,175,1850,114,1778,0,2547,1675,1664
"41072","Nsylvestris_NODE_11790_length_1894_cov_170","Ntome_NODE_13779_length_1759_cov_281",95.202,1459,47,4,180,1634,1489,50,0,2285,1454,1439
"41134","Nsylvestris_NODE_11809_length_1892_cov_196","Ntome_NODE_8583_length_2401_cov_68",92.744,1833,101,16,81,1892,66,1887,0,2619,1811,1821
"41138","Nsylvestris_NODE_11811_length_1892_cov_111","Ntome_NODE_13742_length_1763_cov_163",93.437,1676,86,12,220,1877,1690,21,0,2464,1657,1669
"41164","Nsylvestris_NODE_11822_length_1890_cov_111","Ntome_NODE_12332_length_1917_cov_185",94.059,1515,90,0,48,1562,127,1641,0,2300,1514,1514
"41165","Nsylvestris_NODE_11823_length_1890_cov_30","Ntome_NODE_10403_length_2145_cov_61",95.031,1791,82,2,100,1890,324,2107,0,2808,1790,1783
"41166","Nsylvestris_NODE_11824_length_1890_cov_22","Ntome_NODE_9497_length_2270_cov_80",82.857,245,42,0,250,494,905,661,3.81e-56,220,244,244
"41184","Nsylvestris_NODE_11829_length_1889_cov_93","Ntome_NODE_25325_length_843_cov_44",94.033,553,18,5,197,749,254,791,0,824,552,537
"41194","Nsylvestris_NODE_11833_length_1890_cov_12","Ntome_NODE_245_length_7124_cov_110",79.093,397,72,10,929,1317,3000,3393,6.25e-69,263,388,393
"41261","Nsylvestris_NODE_11858_length_1885_cov_53","Ntome_NODE_14778_length_1658_cov_25",95.221,1653,79,0,163,1815,1,1653,0,2615,1652,1652
"41264","Nsylvestris_NODE_11860_length_1885_cov_23","Ntome_NODE_3547_length_3502_cov_35",96.97,33,0,1,764,795,2620,2588,4.08e-06,54.7,31,32
"41273","Nsylvestris_NODE_11865_length_1884_cov_184","Ntome_NODE_12868_length_1854_cov_191",96.438,1853,56,6,36,1880,3,1853,0,3048,1844,1850
"41285","Nsylvestris_NODE_11871_length_1883_cov_193","Ntome_NODE_9605_length_2253_cov_219",100,51,0,0,1,51,743,793,2.4e-18,95.3,50,50
"41288","Nsylvestris_NODE_11873_length_1883_cov_20","Ntome_NODE_10630_length_2115_cov_57",94.939,1877,77,8,2,1862,122,1996,0,2924,1860,1874
"41293","Nsylvestris_NODE_11875_length_1883_cov_7","Ntome_NODE_12167_length_1938_cov_14",95.749,1882,77,1,1,1879,1887,6,0,3029,1878,1881
"41294","Nsylvestris_NODE_11876_length_1882_cov_230","Ntome_NODE_1778_length_4328_cov_307",98.38,1667,27,0,1,1667,2662,4328,0,2929,1666,1666
"41336","Nsylvestris_NODE_11887_length_1881_cov_123","Ntome_NODE_16762_length_1469_cov_238",96.361,1319,31,3,47,1364,1,1303,0,2154,1317,1302
"41342","Nsylvestris_NODE_11890_length_1881_cov_86","Ntome_NODE_19159_length_1262_cov_261",96.552,58,2,0,1824,1881,689,746,6.67e-19,97.1,57,57
"41356","Nsylvestris_NODE_11895_length_1880_cov_217","Ntome_NODE_2539_length_3889_cov_270",93.925,1893,78,12,6,1864,3838,1949,0,2824,1858,1889
"41359","Nsylvestris_NODE_11897_length_1880_cov_188","Ntome_NODE_1684_length_4398_cov_169",98.246,57,1,0,1824,1880,715,771,5.15e-20,100,56,56
"41385","Nsylvestris_NODE_11906_length_1879_cov_222","Ntome_NODE_11489_length_2015_cov_286",95.158,1838,75,6,1,1831,1945,115,0,2889,1830,1830
"41394","Nsylvestris_NODE_11910_length_1879_cov_167","Ntome_NODE_10538_length_2127_cov_137",93.208,1855,94,7,47,1878,1846,1,0,2699,1831,1845
"41422","Nsylvestris_NODE_11920_length_1878_cov_148","Ntome_NODE_1419_length_4613_cov_159",95.742,1832,71,3,53,1878,106,1936,0,2944,1825,1830
"41437","Nsylvestris_NODE_11926_length_1877_cov_225","Ntome_NODE_12145_length_1940_cov_273",94.913,1848,81,7,5,1844,95,1937,0,2880,1839,1842
"41443","Nsylvestris_NODE_11929_length_1877_cov_163","Ntome_NODE_5818_length_2891_cov_148",93.728,1690,57,15,168,1826,170,1841,0,2488,1658,1671
"41465","Nsylvestris_NODE_11936_length_1876_cov_219","Ntome_NODE_13700_length_1768_cov_31",92.988,1797,81,15,66,1852,3,1764,0,2579,1786,1761
"41485","Nsylvestris_NODE_11941_length_1876_cov_25","Ntome_NODE_12265_length_1925_cov_223",91.799,1890,112,10,1,1876,51,1911,0,2591,1875,1860
"41500","Nsylvestris_NODE_11947_length_1875_cov_192","Ntome_NODE_11872_length_1973_cov_267",93.139,1574,85,16,23,1583,1728,165,0,2287,1560,1563
"41501","Nsylvestris_NODE_11948_length_1875_cov_185","Ntome_NODE_16168_length_1524_cov_292",95.433,1445,36,9,319,1759,1469,51,0,2276,1440,1418
"41521","Nsylvestris_NODE_11956_length_1875_cov_40","Ntome_NODE_21975_length_1051_cov_29",92.907,1001,52,6,73,1057,999,2,0,1437,984,997
"41543","Nsylvestris_NODE_11964_length_1874_cov_179","Ntome_NODE_14703_length_1665_cov_249",97.038,1553,41,3,1,1552,1589,41,0,2608,1551,1548
"41581","Nsylvestris_NODE_11975_length_1873_cov_168","Ntome_NODE_18149_length_1347_cov_27",96.22,1270,44,1,61,1326,1344,75,0,2076,1265,1269
"41596","Nsylvestris_NODE_11981_length_1872_cov_201","Ntome_NODE_19187_length_1260_cov_280",96.171,1097,42,0,76,1172,1159,63,0,1794,1096,1096
"41604","Nsylvestris_NODE_11984_length_1872_cov_11","Ntome_NODE_1113_length_4934_cov_306",100,55,0,0,1818,1872,1427,1373,1.43e-20,102,54,54
"41614","Nsylvestris_NODE_11988_length_1871_cov_150","Ntome_NODE_17122_length_1438_cov_10",93.785,1432,59,10,51,1468,5,1420,0,2124,1417,1415
"41615","Nsylvestris_NODE_11989_length_1871_cov_46","Ntome_NODE_12515_length_1896_cov_66",94.74,1844,84,5,33,1871,16,1851,0,2856,1838,1835
"41630","Nsylvestris_NODE_11995_length_1870_cov_200","Ntome_NODE_16296_length_1512_cov_151",93.575,1432,59,15,388,1804,39,1452,0,2104,1416,1413
"41639","Nsylvestris_NODE_11999_length_1870_cov_137","Ntome_NODE_12681_length_1877_cov_40",95.213,1713,78,2,113,1821,1,1713,0,2706,1708,1712
"41650","Nsylvestris_NODE_12004_length_1869_cov_100","Ntome_NODE_11511_length_2013_cov_176",93.894,1785,59,19,107,1869,231,1987,0,2647,1762,1756
"41662","Nsylvestris_NODE_12008_length_1869_cov_17","Ntome_NODE_18760_length_1295_cov_56",84.054,1041,158,6,255,1288,53,1092,0,996,1033,1039
"41709","Nsylvestris_NODE_12021_length_1867_cov_116","Ntome_NODE_15081_length_1627_cov_21",95.96,1584,60,3,223,1806,1627,48,0,2567,1583,1579
"41713","Nsylvestris_NODE_12023_length_1867_cov_47","Ntome_NODE_24701_length_880_cov_238",84.649,456,33,19,8,427,876,422,3.46e-116,420,419,454
"41740","Nsylvestris_NODE_12031_length_1865_cov_225","Ntome_NODE_2455_length_3928_cov_106",94.388,1568,84,3,225,1791,1565,1,0,2405,1566,1564
"41741","Nsylvestris_NODE_12032_length_1865_cov_218","Ntome_NODE_23312_length_964_cov_267",98.182,55,1,0,1,55,714,660,6.61e-19,97.1,54,54
"41786","Nsylvestris_NODE_12047_length_1864_cov_199","Ntome_NODE_10815_length_2094_cov_196",96.711,1824,45,6,53,1864,251,2071,0,3022,1811,1820
"41805","Nsylvestris_NODE_12055_length_1863_cov_227","Ntome_NODE_9450_length_2274_cov_285",93.821,1861,69,19,34,1850,50,1908,0,2758,1816,1858
"41812","Nsylvestris_NODE_12058_length_1863_cov_92","Ntome_NODE_906_length_5215_cov_209",92.754,69,2,1,1797,1862,1951,2019,6.61e-19,97.1,65,68
"41843","Nsylvestris_NODE_12070_length_1861_cov_106","Ntome_NODE_2528_length_3895_cov_249",93.082,1778,114,7,10,1782,22,1795,0,2593,1772,1773
"41855","Nsylvestris_NODE_12075_length_1860_cov_222","Ntome_NODE_12966_length_1845_cov_92",93.374,1811,87,12,41,1847,1,1782,0,2649,1806,1781
"41905","Nsylvestris_NODE_12095_length_1858_cov_217","Ntome_NODE_8940_length_2347_cov_195",92.677,1707,74,16,65,1747,1694,15,0,2412,1682,1679
"41928","Nsylvestris_NODE_12103_length_1857_cov_58","Ntome_NODE_1587_length_4464_cov_168",82.558,86,12,3,1404,1486,393,308,1.11e-11,73.1,82,85
"41946","Nsylvestris_NODE_12109_length_1856_cov_212","Ntome_NODE_2279_length_4016_cov_236",93.387,1739,97,10,49,1774,23,1756,0,2558,1725,1733
"41956","Nsylvestris_NODE_12112_length_1856_cov_168","Ntome_NODE_17487_length_1404_cov_282",95.513,1404,56,3,32,1428,1,1404,0,2237,1396,1403
"41993","Nsylvestris_NODE_12121_length_1855_cov_213","Ntome_NODE_10409_length_2144_cov_229",93.923,1810,67,7,7,1806,61,1837,0,2693,1799,1776
"42001","Nsylvestris_NODE_12124_length_1855_cov_42","Ntome_NODE_12788_length_1864_cov_66",93.787,1851,83,11,28,1852,1,1845,0,2752,1824,1844
"42002","Nsylvestris_NODE_12125_length_1855_cov_40","Ntome_NODE_6256_length_2797_cov_90",95.349,43,2,0,1785,1827,113,155,1.43e-10,69.4,42,42
"42010","Nsylvestris_NODE_12129_length_1855_cov_14","Ntome_NODE_6325_length_2783_cov_55",91.161,577,40,4,132,705,1,569,0,773,573,568
"42053","Nsylvestris_NODE_12145_length_1853_cov_186","Ntome_NODE_11271_length_2041_cov_285",92.356,1609,79,22,237,1838,1625,54,0,2250,1601,1571
"42079","Nsylvestris_NODE_12153_length_1852_cov_148","Ntome_NODE_14659_length_1671_cov_166",98.516,1280,19,0,73,1352,1330,51,0,2259,1279,1279
"42103","Nsylvestris_NODE_12162_length_1852_cov_24","Ntome_NODE_33308_length_456_cov_292",98.182,55,1,0,1,55,302,248,6.57e-19,97.1,54,54
"42119","Nsylvestris_NODE_12168_length_1851_cov_145","Ntome_NODE_8130_length_2471_cov_177",98.603,1002,13,1,112,1113,1097,2097,0,1772,1001,1000
"42120","Nsylvestris_NODE_12169_length_1851_cov_94","Ntome_NODE_13641_length_1773_cov_90",92.915,1736,74,12,70,1798,80,1773,0,2479,1728,1693
"42143","Nsylvestris_NODE_12177_length_1850_cov_25","Ntome_NODE_27141_length_751_cov_13",82.407,108,15,4,1678,1784,640,744,3.05e-17,91.6,106,104
"42151","Nsylvestris_NODE_12179_length_1849_cov_222","Ntome_NODE_12952_length_1846_cov_97",96.564,1746,51,4,64,1802,1786,43,0,2883,1738,1743
"42157","Nsylvestris_NODE_12182_length_1849_cov_212","Ntome_NODE_12549_length_1892_cov_289",93.607,1752,63,16,64,1779,1789,51,0,2569,1715,1738
"42167","Nsylvestris_NODE_12185_length_1849_cov_148","Ntome_NODE_13672_length_1770_cov_103",92.133,1627,99,14,180,1795,43,1651,0,2268,1615,1608
"42171","Nsylvestris_NODE_12187_length_1849_cov_75","Ntome_NODE_26146_length_800_cov_11",87.037,162,19,2,1657,1817,413,253,1.76e-44,182,160,160
"42172","Nsylvestris_NODE_12188_length_1849_cov_45","Ntome_NODE_15023_length_1632_cov_238",95.238,63,1,2,1,62,994,933,1.82e-19,99,61,61
"42173","Nsylvestris_NODE_12189_length_1849_cov_44","Ntome_NODE_16093_length_1532_cov_5",95.294,1530,67,5,217,1744,1532,6,0,2422,1527,1526
"42183","Nsylvestris_NODE_12193_length_1848_cov_202","Ntome_NODE_4174_length_3303_cov_161",95.079,1321,59,3,136,1450,3205,1885,0,2074,1314,1320
"42189","Nsylvestris_NODE_12195_length_1848_cov_189","Ntome_NODE_1323_length_4704_cov_143",94.939,1798,58,11,57,1848,3225,1455,0,2785,1791,1770
"42210","Nsylvestris_NODE_12202_length_1849_cov_96","Ntome_NODE_13211_length_1818_cov_107",94.141,1792,90,7,24,1809,1809,27,0,2713,1785,1782
"42220","Nsylvestris_NODE_12205_length_1848_cov_27","Ntome_NODE_14449_length_1691_cov_13",93.804,1630,73,12,82,1688,1685,61,0,2425,1606,1624
"42242","Nsylvestris_NODE_12215_length_1846_cov_217","Ntome_NODE_12504_length_1896_cov_271",94.018,1822,92,11,11,1826,1811,1,0,2745,1815,1810
"42249","Nsylvestris_NODE_12218_length_1846_cov_145","Ntome_NODE_14065_length_1731_cov_253",94.421,1631,67,7,213,1841,1682,74,0,2486,1628,1608
"42250","Nsylvestris_NODE_12219_length_1846_cov_118","Ntome_NODE_13064_length_1835_cov_53",91.396,1662,99,18,129,1770,1649,12,0,2237,1641,1637
"42268","Nsylvestris_NODE_12226_length_1845_cov_155","Ntome_NODE_15353_length_1598_cov_242",92.996,1599,69,26,68,1653,19,1587,0,2292,1585,1568
"42274","Nsylvestris_NODE_12228_length_1845_cov_98","Ntome_NODE_14846_length_1651_cov_78",88.455,1126,113,5,50,1174,1318,209,0,1343,1124,1109
"42281","Nsylvestris_NODE_12231_length_1844_cov_182","Ntome_NODE_15695_length_1568_cov_233",95.245,1472,47,7,364,1814,1568,99,0,2309,1450,1469
"42285","Nsylvestris_NODE_12233_length_1844_cov_143","Ntome_NODE_9359_length_2288_cov_107",92.071,1526,105,8,193,1706,728,2249,0,2134,1513,1521
"42308","Nsylvestris_NODE_12242_length_1843_cov_36","Ntome_NODE_12566_length_1883_cov_152",93.136,1792,100,8,58,1843,1809,35,0,2606,1785,1774
"42309","Nsylvestris_NODE_12243_length_1843_cov_25","Ntome_NODE_7298_length_2605_cov_78",83.562,146,20,4,1676,1820,2176,2318,4.98e-30,134,144,142
"42325","Nsylvestris_NODE_12249_length_1842_cov_180","Ntome_NODE_1498_length_4534_cov_264",96.527,1699,55,3,141,1836,81,1778,0,2808,1695,1697
"42341","Nsylvestris_NODE_12256_length_1842_cov_42","Ntome_NODE_10704_length_2106_cov_234",95.185,1537,58,7,20,1546,100,1630,0,2414,1526,1530
"42342","Nsylvestris_NODE_12258_length_1842_cov_17","Ntome_NODE_10224_length_2167_cov_94",73.52,642,156,11,598,1232,905,1539,1.72e-59,231,634,634
"42348","Nsylvestris_NODE_12261_length_1841_cov_194","Ntome_NODE_11699_length_1991_cov_239",95.133,1808,62,13,1,1794,1953,158,0,2828,1793,1795
"42352","Nsylvestris_NODE_12263_length_1841_cov_152","Ntome_NODE_13229_length_1816_cov_263",95.507,1736,70,5,54,1781,1754,19,0,2767,1727,1735
"42362","Nsylvestris_NODE_12267_length_1840_cov_220","Ntome_NODE_7737_length_2534_cov_223",95.76,1698,46,11,101,1787,2367,685,0,2713,1686,1682
"42377","Nsylvestris_NODE_12272_length_1840_cov_149","Ntome_NODE_11285_length_2039_cov_174",94.134,1773,83,8,1,1757,160,1927,0,2678,1756,1767
"42404","Nsylvestris_NODE_12280_length_1839_cov_210","Ntome_NODE_2115_length_4101_cov_298",98.173,1642,28,2,84,1724,4101,2461,0,2865,1640,1640
"42411","Nsylvestris_NODE_12283_length_1839_cov_170","Ntome_NODE_13186_length_1821_cov_152",94.391,1658,75,10,48,1704,1768,128,0,2531,1656,1640
"42412","Nsylvestris_NODE_12284_length_1839_cov_158","Ntome_NODE_5929_length_2866_cov_161",96.444,225,8,0,609,833,2768,2544,9.67e-102,372,224,224
"42413","Nsylvestris_NODE_12285_length_1839_cov_136","Ntome_NODE_13743_length_1763_cov_124",93.938,1765,72,16,92,1839,9,1755,0,2634,1747,1746
"42417","Nsylvestris_NODE_12287_length_1838_cov_219","Ntome_NODE_11131_length_2056_cov_243",94.364,1792,85,9,1,1790,82,1859,0,2736,1789,1777
"42441","Nsylvestris_NODE_12295_length_1838_cov_14","Ntome_NODE_12248_length_1927_cov_44",96.017,1833,66,3,10,1838,1870,41,0,2974,1828,1829
"42457","Nsylvestris_NODE_12300_length_1837_cov_122","Ntome_NODE_20761_length_1134_cov_32",90.826,109,9,1,236,343,210,102,2.29e-33,145,107,108
"42464","Nsylvestris_NODE_12303_length_1837_cov_32","Ntome_NODE_10968_length_2077_cov_275",94.946,1840,75,12,1,1837,194,2018,0,2867,1836,1824
"42465","Nsylvestris_NODE_12305_length_1836_cov_234","Ntome_NODE_12942_length_1847_cov_284",96.678,1806,57,1,31,1836,1,1803,0,3000,1805,1802
"42498","Nsylvestris_NODE_12318_length_1835_cov_160","Ntome_NODE_2569_length_3874_cov_242",94.391,1765,71,14,17,1757,75,1835,0,2686,1740,1760
"42531","Nsylvestris_NODE_12330_length_1834_cov_88","Ntome_NODE_19436_length_1239_cov_145",92.444,675,29,7,1120,1789,762,105,0,944,669,657
"42560","Nsylvestris_NODE_12340_length_1833_cov_214","Ntome_NODE_12322_length_1918_cov_261",97.787,1672,33,2,161,1832,4,1671,0,2880,1671,1667
"42572","Nsylvestris_NODE_12345_length_1833_cov_150","Ntome_NODE_816_length_5359_cov_177",94.173,1819,74,19,3,1794,3546,5359,0,2743,1791,1813
"42616","Nsylvestris_NODE_12358_length_1831_cov_222","Ntome_NODE_6664_length_2718_cov_178",95.612,1504,66,0,95,1598,2666,1163,0,2412,1503,1503
"42632","Nsylvestris_NODE_12363_length_1831_cov_98","Ntome_NODE_14891_length_1645_cov_27",95.75,1553,66,0,207,1759,1645,93,0,2503,1552,1552
"42655","Nsylvestris_NODE_12371_length_1830_cov_206","Ntome_NODE_12206_length_1932_cov_259",95.561,1577,51,10,57,1625,43,1608,0,2507,1568,1565
"42656","Nsylvestris_NODE_12372_length_1830_cov_88","Ntome_NODE_15174_length_1616_cov_108",72.595,551,114,26,628,1150,941,400,6.35e-34,147,522,541
"42688","Nsylvestris_NODE_12384_length_1828_cov_89","Ntome_NODE_16064_length_1534_cov_91",92.729,1389,72,16,1,1379,1521,152,0,1978,1378,1369
"42697","Nsylvestris_NODE_12387_length_1828_cov_52","Ntome_NODE_11713_length_1990_cov_57",95.776,1823,67,5,1,1817,1894,76,0,2931,1816,1818
"42711","Nsylvestris_NODE_12392_length_1827_cov_79","Ntome_NODE_14193_length_1716_cov_34",94.383,1709,81,1,96,1804,1699,6,0,2610,1708,1693
"42788","Nsylvestris_NODE_12418_length_1825_cov_67","Ntome_NODE_10100_length_2186_cov_263",87.662,1621,178,15,42,1650,2119,509,0,1866,1608,1610
"42809","Nsylvestris_NODE_12426_length_1823_cov_138","Ntome_NODE_17717_length_1382_cov_156",93.21,1296,64,4,195,1485,57,1333,0,1884,1290,1276
"42810","Nsylvestris_NODE_12427_length_1824_cov_109","Ntome_NODE_23378_length_961_cov_102",94.366,781,30,3,773,1550,961,192,0,1186,777,769
"42827","Nsylvestris_NODE_12434_length_1823_cov_209","Ntome_NODE_12597_length_1887_cov_47",90.417,1774,89,37,42,1773,111,1845,0,2259,1731,1734
"42894","Nsylvestris_NODE_12456_length_1821_cov_94","Ntome_NODE_12953_length_1846_cov_88",93.65,1811,76,15,8,1815,1784,10,0,2671,1807,1774
"42899","Nsylvestris_NODE_12459_length_1821_cov_28","Ntome_NODE_4268_length_3272_cov_34",95.677,1573,68,0,94,1666,463,2035,0,2529,1572,1572
"42903","Nsylvestris_NODE_12461_length_1821_cov_11","Ntome_NODE_22497_length_1016_cov_269",98.333,60,0,1,1761,1820,577,519,3.86e-21,104,59,58
"42907","Nsylvestris_NODE_12463_length_1820_cov_125","Ntome_NODE_14458_length_1690_cov_41",96.816,1476,38,1,193,1668,1544,78,0,2457,1475,1466
"42957","Nsylvestris_NODE_12483_length_1817_cov_184","Ntome_NODE_11018_length_2070_cov_216",94.924,1832,52,13,9,1817,1,1814,0,2830,1808,1813
"42990","Nsylvestris_NODE_12495_length_1816_cov_30","Ntome_NODE_12570_length_1891_cov_55",92.799,1847,82,16,1,1812,1864,34,0,2627,1811,1830
"43033","Nsylvestris_NODE_12509_length_1814_cov_179","Ntome_NODE_13868_length_1749_cov_240",93.769,1669,66,18,15,1661,1746,94,0,2471,1646,1652
"43039","Nsylvestris_NODE_12513_length_1813_cov_203","Ntome_NODE_15971_length_1541_cov_194",94.106,1527,33,12,62,1563,1541,47,0,2268,1501,1494
"43040","Nsylvestris_NODE_12514_length_1813_cov_183","Ntome_NODE_14445_length_1691_cov_213",94.338,1678,47,14,90,1730,1686,20,0,2529,1640,1666
"43134","Nsylvestris_NODE_12539_length_1811_cov_25","Ntome_NODE_14285_length_1707_cov_15",94.852,1593,56,4,64,1646,1678,102,0,2464,1582,1576
"43144","Nsylvestris_NODE_12544_length_1810_cov_119","Ntome_NODE_5716_length_2913_cov_84",94.545,55,3,0,1,55,321,267,1.39e-15,86.1,54,54
"43160","Nsylvestris_NODE_12550_length_1809_cov_119","Ntome_NODE_3496_length_3518_cov_129",96.892,1802,51,2,1,1799,1707,3506,0,3013,1798,1799
"43167","Nsylvestris_NODE_12552_length_1809_cov_111","Ntome_NODE_15537_length_1580_cov_282",94.748,1447,45,10,362,1799,1526,102,0,2222,1437,1424
"43177","Nsylvestris_NODE_12556_length_1809_cov_10","Ntome_NODE_13556_length_1781_cov_31",92.486,173,11,2,1638,1809,1405,1234,6.02e-64,246,171,171
"43183","Nsylvestris_NODE_12558_length_1808_cov_220","Ntome_NODE_1282_length_4750_cov_151",96.014,1430,54,2,168,1597,4675,3249,0,2322,1429,1426
"43190","Nsylvestris_NODE_12561_length_1808_cov_210","Ntome_NODE_13480_length_1788_cov_224",95.655,1749,63,7,71,1808,1782,36,0,2796,1737,1746
"43197","Nsylvestris_NODE_12565_length_1808_cov_182","Ntome_NODE_12987_length_1843_cov_237",94.128,1771,69,14,5,1763,41,1788,0,2662,1758,1747
"43217","Nsylvestris_NODE_12572_length_1808_cov_57","Ntome_NODE_31224_length_581_cov_5",96.902,581,18,0,1002,1582,581,1,0,974,580,580
"43222","Nsylvestris_NODE_12575_length_1808_cov_18","Ntome_NODE_6568_length_2735_cov_210",95.302,149,5,2,90,237,2731,2584,1.3e-60,235,147,147
"43225","Nsylvestris_NODE_12577_length_1808_cov_15","Ntome_NODE_13965_length_1741_cov_15",95.209,1461,64,3,1,1458,262,1719,0,2305,1457,1457
"43248","Nsylvestris_NODE_12584_length_1807_cov_25","Ntome_NODE_7352_length_2594_cov_207",79.74,1693,311,26,72,1748,296,1972,0,1197,1676,1676
"43262","Nsylvestris_NODE_12588_length_1806_cov_204","Ntome_NODE_13396_length_1797_cov_266",95.057,1740,67,12,11,1738,58,1790,0,2719,1727,1732
"43275","Nsylvestris_NODE_12593_length_1806_cov_10","Ntome_NODE_13216_length_1818_cov_11",94.553,1487,73,4,56,1536,39,1523,0,2290,1480,1484
"43288","Nsylvestris_NODE_12599_length_1805_cov_143","Ntome_NODE_19475_length_1236_cov_34",74.713,348,78,10,1139,1481,824,1166,6.26e-34,147,342,342
"43302","Nsylvestris_NODE_12605_length_1804_cov_181","Ntome_NODE_13248_length_1814_cov_183",95.198,1645,59,13,29,1669,43,1671,0,2582,1640,1628
"43307","Nsylvestris_NODE_12607_length_1804_cov_148","Ntome_NODE_14605_length_1676_cov_50",95.183,1557,64,6,42,1594,11,1560,0,2449,1552,1549
"43336","Nsylvestris_NODE_12616_length_1802_cov_222","Ntome_NODE_13274_length_1810_cov_293",91.595,1737,90,24,46,1769,68,1761,0,2348,1723,1693
"43342","Nsylvestris_NODE_12619_length_1803_cov_193","Ntome_NODE_1043_length_5028_cov_252",94.897,1646,66,9,49,1686,1636,1,0,2558,1637,1635
"43351","Nsylvestris_NODE_12622_length_1803_cov_92","Ntome_NODE_14964_length_1639_cov_187",94.793,845,19,5,980,1801,360,1202,0,1293,821,842
"43393","Nsylvestris_NODE_12633_length_1802_cov_129","Ntome_NODE_20705_length_1138_cov_8",93.942,1139,55,4,406,1531,1138,1,0,1709,1125,1137
"43394","Nsylvestris_NODE_12634_length_1802_cov_122","Ntome_NODE_16345_length_1509_cov_44",96.588,1436,46,1,84,1519,1509,77,0,2377,1435,1432
"43403","Nsylvestris_NODE_12637_length_1802_cov_65","Ntome_NODE_13251_length_1814_cov_53",91.881,1675,111,10,2,1675,7,1657,0,2316,1673,1650
"43464","Nsylvestris_NODE_12656_length_1800_cov_50","Ntome_NODE_8591_length_2399_cov_289",100,36,0,0,1,36,730,765,5e-10,67.6,35,35
"43465","Nsylvestris_NODE_12657_length_1800_cov_43","Ntome_NODE_13493_length_1787_cov_157",95.221,1632,64,1,1,1632,28,1645,0,2569,1631,1617
"43466","Nsylvestris_NODE_12659_length_1799_cov_220","Ntome_NODE_13045_length_1836_cov_191",95.927,1596,55,5,204,1799,143,1728,0,2579,1595,1585
"43490","Nsylvestris_NODE_12667_length_1799_cov_101","Ntome_NODE_14489_length_1687_cov_15",92.857,126,9,0,1375,1500,927,1052,4.76e-45,183,125,125
"43496","Nsylvestris_NODE_12670_length_1798_cov_231","Ntome_NODE_12894_length_1852_cov_124",95.623,1759,58,4,20,1768,29,1778,0,2804,1748,1749
"43501","Nsylvestris_NODE_12672_length_1798_cov_224","Ntome_NODE_13919_length_1744_cov_281",95.033,1671,74,5,9,1671,9,1678,0,2617,1662,1669
"43514","Nsylvestris_NODE_12677_length_1798_cov_102","Ntome_NODE_32930_length_483_cov_5",91.429,490,34,3,1195,1683,1,483,0,665,488,482
"43527","Nsylvestris_NODE_12682_length_1798_cov_9","Ntome_NODE_440_length_6189_cov_35",94.286,35,2,0,1575,1609,1223,1189,3.89e-06,54.7,34,34
"43538","Nsylvestris_NODE_12686_length_1797_cov_207","Ntome_NODE_12857_length_1855_cov_258",94.74,1768,77,7,2,1765,1784,29,0,2736,1763,1755
"43539","Nsylvestris_NODE_12687_length_1797_cov_148","Ntome_NODE_14897_length_1644_cov_245",94.464,1391,65,6,382,1769,263,1644,0,2132,1387,1381
"43547","Nsylvestris_NODE_12691_length_1796_cov_225","Ntome_NODE_12816_length_1859_cov_279",94.167,1783,82,2,3,1782,70,1833,0,2697,1779,1763
"43557","Nsylvestris_NODE_12694_length_1796_cov_79","Ntome_NODE_12689_length_1875_cov_28",94.752,1772,78,7,19,1783,42,1805,0,2743,1764,1763
"43564","Nsylvestris_NODE_12697_length_1795_cov_203","Ntome_NODE_12947_length_1846_cov_241",94.695,1753,69,6,1,1729,1819,67,0,2700,1728,1752
"43589","Nsylvestris_NODE_12706_length_1795_cov_58","Ntome_NODE_14648_length_1673_cov_17",94.906,1649,56,9,49,1697,53,1673,0,2555,1648,1620
"43641","Nsylvestris_NODE_12721_length_1793_cov_204","Ntome_NODE_15094_length_1624_cov_282",94.581,1587,73,2,118,1704,1574,1,0,2442,1586,1573
"43668","Nsylvestris_NODE_12732_length_1792_cov_213","Ntome_NODE_2406_length_3956_cov_205",96.061,1777,43,9,1,1751,2397,622,0,2868,1750,1775
"43689","Nsylvestris_NODE_12738_length_1792_cov_159","Ntome_NODE_3285_length_3593_cov_155",93.14,1516,66,14,204,1681,3593,2078,0,2189,1477,1515
"43714","Nsylvestris_NODE_12747_length_1792_cov_11","Ntome_NODE_1942_length_4212_cov_160",96.364,55,2,0,1738,1792,3879,3825,2.95e-17,91.6,54,54
"43741","Nsylvestris_NODE_12757_length_1791_cov_70","Ntome_NODE_13135_length_1827_cov_175",95.845,1733,60,8,61,1791,56,1778,0,2791,1730,1722
"43753","Nsylvestris_NODE_12761_length_1791_cov_17","Ntome_NODE_5421_length_2981_cov_101",92.043,1684,97,18,1,1674,2121,465,0,2333,1673,1656
"43763","Nsylvestris_NODE_12766_length_1789_cov_98","Ntome_NODE_14396_length_1696_cov_147",87.342,79,10,0,1,79,1088,1166,2.95e-17,91.6,78,78
"43767","Nsylvestris_NODE_12768_length_1790_cov_39","Ntome_NODE_13146_length_1826_cov_21",94.074,1603,70,2,75,1674,246,1826,0,2410,1599,1580
"43768","Nsylvestris_NODE_12769_length_1790_cov_13","Ntome_NODE_36951_length_312_cov_3",96.795,312,10,0,1405,1716,312,1,8.83e-147,521,311,311
"43780","Nsylvestris_NODE_12775_length_1789_cov_147","Ntome_NODE_11138_length_2056_cov_81",95.558,1756,53,15,40,1789,73,1809,0,2787,1749,1736
"43786","Nsylvestris_NODE_12777_length_1789_cov_104","Ntome_NODE_11738_length_1988_cov_107",96.456,1693,53,5,36,1721,1971,279,0,2787,1685,1692
"43798","Nsylvestris_NODE_12782_length_1788_cov_227","Ntome_NODE_12998_length_1842_cov_296",94.226,1784,61,13,14,1768,48,1818,0,2686,1754,1770
"43802","Nsylvestris_NODE_12784_length_1788_cov_148","Ntome_NODE_15080_length_1627_cov_24",94.954,1625,67,2,166,1775,1,1625,0,2532,1609,1624
"43838","Nsylvestris_NODE_12798_length_1784_cov_216","Ntome_NODE_15564_length_1578_cov_287",97.971,1331,25,2,185,1513,248,1578,0,2307,1328,1330
"43839","Nsylvestris_NODE_12799_length_1786_cov_215","Ntome_NODE_15255_length_1609_cov_41",94.097,1440,59,11,69,1497,4,1428,0,2165,1428,1424
"43842","Nsylvestris_NODE_12801_length_1786_cov_197","Ntome_NODE_4752_length_3146_cov_164",95.221,1653,70,5,100,1743,3054,1402,0,2606,1643,1652
"43918","Nsylvestris_NODE_12821_length_1784_cov_128","Ntome_NODE_14152_length_1721_cov_176",93.382,1511,67,13,41,1525,1715,212,0,2206,1484,1503
"43919","Nsylvestris_NODE_12822_length_1784_cov_27","Ntome_NODE_5333_length_3000_cov_201",98.182,55,1,0,1730,1784,774,828,6.32e-19,97.1,54,54
"43920","Nsylvestris_NODE_12823_length_1784_cov_19","Ntome_NODE_20909_length_1123_cov_31",81.095,201,22,12,1584,1773,237,42,6.19e-34,147,189,195
"43941","Nsylvestris_NODE_12830_length_1783_cov_13","Ntome_NODE_16499_length_1496_cov_228",98.182,55,1,0,1,55,932,878,6.32e-19,97.1,54,54
"43952","Nsylvestris_NODE_12835_length_1782_cov_206","Ntome_NODE_15350_length_1599_cov_246",94.942,1542,63,8,195,1726,1538,2,0,2401,1531,1536
"43953","Nsylvestris_NODE_12836_length_1782_cov_150","Ntome_NODE_11734_length_1988_cov_178",95.444,1690,52,9,1,1668,1768,82,0,2671,1667,1686
"43964","Nsylvestris_NODE_12840_length_1782_cov_57","Ntome_NODE_13074_length_1834_cov_46",89.806,1648,116,27,175,1779,1640,2,0,2065,1604,1638
"43991","Nsylvestris_NODE_12848_length_1781_cov_222","Ntome_NODE_12409_length_1907_cov_258",92.767,1742,76,14,49,1781,1732,32,0,2473,1732,1700
"44016","Nsylvestris_NODE_12859_length_1780_cov_134","Ntome_NODE_12331_length_1920_cov_191",95.034,1309,60,3,18,1325,1777,473,0,2052,1307,1304
"44019","Nsylvestris_NODE_12861_length_1780_cov_14","Ntome_NODE_10252_length_2162_cov_193",87.113,194,15,5,316,499,1576,1769,2.16e-53,211,183,193
"44020","Nsylvestris_NODE_12863_length_1779_cov_222","Ntome_NODE_1651_length_4421_cov_113",96.367,1734,44,11,51,1777,4403,2682,0,2835,1726,1721
"44023","Nsylvestris_NODE_12865_length_1779_cov_116","Ntome_NODE_20382_length_1163_cov_12",79.279,888,148,22,359,1240,260,1117,8.53e-167,588,881,857
"44024","Nsylvestris_NODE_12866_length_1779_cov_52","Ntome_NODE_34071_length_416_cov_5",92.048,415,21,5,486,888,1,415,2.39e-162,573,402,414
"44034","Nsylvestris_NODE_12870_length_1778_cov_215","Ntome_NODE_14419_length_1693_cov_279",96.104,1694,44,14,91,1770,1,1686,0,2743,1679,1685
"44035","Nsylvestris_NODE_12872_length_1778_cov_152","Ntome_NODE_13591_length_1777_cov_206",94.866,1636,79,3,96,1726,1775,140,0,2551,1630,1635
"44041","Nsylvestris_NODE_12875_length_1778_cov_16","Ntome_NODE_19603_length_1225_cov_243",97.143,35,0,1,747,781,678,711,2.97e-07,58.4,34,33
"44057","Nsylvestris_NODE_12881_length_1777_cov_26","Ntome_NODE_317_length_6640_cov_140",98.182,55,1,0,1723,1777,3636,3690,6.3e-19,97.1,54,54
"44058","Nsylvestris_NODE_12882_length_1777_cov_21","Ntome_NODE_10684_length_2108_cov_259",86.169,1352,180,6,118,1465,1658,310,0,1454,1347,1348
"44080","Nsylvestris_NODE_12889_length_1776_cov_128","Ntome_NODE_528_length_5940_cov_234",84.653,606,89,2,161,766,2123,1522,1.09e-170,601,605,601
"44084","Nsylvestris_NODE_12891_length_1776_cov_45","Ntome_NODE_11182_length_2051_cov_132",94.477,1684,74,5,78,1747,276,1954,0,2577,1669,1678
"44094","Nsylvestris_NODE_12897_length_1775_cov_119","Ntome_NODE_13651_length_1772_cov_147",94.831,1741,42,18,59,1775,41,1757,0,2673,1716,1716
"44136","Nsylvestris_NODE_12910_length_1773_cov_223","Ntome_NODE_16349_length_1509_cov_13",96.62,1509,51,0,16,1524,1509,1,0,2505,1508,1508
"44139","Nsylvestris_NODE_12912_length_1773_cov_37","Ntome_NODE_11468_length_2017_cov_230",98.047,256,5,0,1518,1773,1787,1532,5.42e-124,446,255,255
"44145","Nsylvestris_NODE_12915_length_1772_cov_230","Ntome_NODE_35805_length_345_cov_3",95.115,348,14,1,838,1185,345,1,5.19e-154,545,347,344
"44148","Nsylvestris_NODE_12917_length_1772_cov_200","Ntome_NODE_1425_length_4603_cov_264",94.912,1710,72,5,66,1772,4361,2664,0,2662,1706,1697
"44149","Nsylvestris_NODE_12918_length_1772_cov_195","Ntome_NODE_15195_length_1614_cov_244",90.584,1593,95,28,82,1652,55,1614,0,2060,1570,1559
"44158","Nsylvestris_NODE_12921_length_1772_cov_103","Ntome_NODE_5030_length_3070_cov_274",75.119,1467,300,50,212,1647,126,1558,1.8e-178,627,1435,1432
"44164","Nsylvestris_NODE_12924_length_1771_cov_234","Ntome_NODE_16199_length_1521_cov_130",96.047,1442,44,5,202,1640,1475,44,0,2335,1438,1431
"44165","Nsylvestris_NODE_12925_length_1771_cov_219","Ntome_NODE_12495_length_1897_cov_226",94.975,1771,54,9,8,1771,1838,96,0,2745,1763,1742
"44175","Nsylvestris_NODE_12929_length_1771_cov_184","Ntome_NODE_13183_length_1821_cov_220",93.195,1778,93,13,8,1763,1774,3,0,2588,1755,1771
"44192","Nsylvestris_NODE_12935_length_1771_cov_17","Ntome_NODE_13489_length_1788_cov_23",95.303,1767,73,7,6,1769,1760,1,0,2795,1763,1759
"44209","Nsylvestris_NODE_12942_length_1770_cov_191","Ntome_NODE_12958_length_1845_cov_269",93.248,1718,80,12,58,1767,47,1736,0,2497,1709,1689
"44241","Nsylvestris_NODE_12951_length_1768_cov_188","Ntome_NODE_13823_length_1755_cov_275",90.708,1582,64,18,1,1564,50,1566,0,2030,1563,1516
"44242","Nsylvestris_NODE_12952_length_1768_cov_153","Ntome_NODE_11700_length_1991_cov_220",94.363,1437,62,9,50,1467,1991,555,0,2187,1417,1436
"44243","Nsylvestris_NODE_12953_length_1768_cov_118","Ntome_NODE_1570_length_4480_cov_156",95.413,1744,55,7,1,1738,937,2661,0,2754,1737,1724
"44244","Nsylvestris_NODE_12954_length_1768_cov_74","Ntome_NODE_3778_length_3427_cov_257",80.838,167,18,9,1151,1309,1998,1838,1.34e-25,119,158,160
"44303","Nsylvestris_NODE_12972_length_1766_cov_43","Ntome_NODE_2169_length_4076_cov_286",91.045,67,6,0,1,67,862,796,2.91e-17,91.6,66,66
"44329","Nsylvestris_NODE_12981_length_1765_cov_142","Ntome_NODE_13255_length_1813_cov_189",78.994,1133,216,20,171,1292,270,1391,0,754,1121,1121
"44339","Nsylvestris_NODE_12985_length_1765_cov_15","Ntome_NODE_16281_length_1511_cov_47",90.351,114,10,1,1653,1765,345,232,1.7e-34,148,112,113
"44348","Nsylvestris_NODE_12990_length_1764_cov_206","Ntome_NODE_13744_length_1763_cov_76",97.107,1694,42,7,39,1731,59,1746,0,2850,1692,1687
"44396","Nsylvestris_NODE_13004_length_1763_cov_154","Ntome_NODE_14189_length_1716_cov_212",94.034,1341,63,13,322,1651,258,1592,0,2017,1329,1334
"44401","Nsylvestris_NODE_13006_length_1763_cov_87","Ntome_NODE_21872_length_1056_cov_204",95.049,1030,36,9,730,1749,25,1049,0,1605,1019,1024
"44402","Nsylvestris_NODE_13007_length_1763_cov_33","Ntome_NODE_13569_length_1780_cov_50",100,53,0,0,1711,1763,618,670,1.74e-19,99,52,52
"44443","Nsylvestris_NODE_13022_length_1761_cov_29","Ntome_NODE_861_length_5282_cov_197",88.647,1788,112,45,1,1755,2871,4600,0,2093,1754,1729
"44468","Nsylvestris_NODE_13031_length_1760_cov_84","Ntome_NODE_13321_length_1806_cov_109",94.959,1726,80,4,6,1724,1785,60,0,2699,1718,1725
"44477","Nsylvestris_NODE_13035_length_1759_cov_209","Ntome_NODE_4768_length_3141_cov_175",80.905,597,105,8,374,967,2376,1786,5.33e-129,462,593,590
"44516","Nsylvestris_NODE_13048_length_1758_cov_69","Ntome_NODE_9077_length_2327_cov_79",92.906,1325,59,8,33,1354,2280,988,0,1893,1321,1292
"44526","Nsylvestris_NODE_13052_length_1757_cov_198","Ntome_NODE_9426_length_2277_cov_235",93.844,1722,64,18,72,1753,146,1865,0,2555,1681,1719
"44550","Nsylvestris_NODE_13064_length_1756_cov_42","Ntome_NODE_4949_length_3098_cov_51",88.69,168,16,3,81,248,2564,2400,1.28e-50,202,167,164
"44567","Nsylvestris_NODE_13070_length_1755_cov_88","Ntome_NODE_10609_length_2119_cov_132",89.742,1589,97,32,8,1570,1735,187,0,1971,1562,1548
"44568","Nsylvestris_NODE_13071_length_1755_cov_71","Ntome_NODE_14008_length_1737_cov_36",94.256,1654,86,5,51,1703,21,1666,0,2519,1652,1645
"44569","Nsylvestris_NODE_13072_length_1755_cov_14","Ntome_NODE_4125_length_3315_cov_100",98.017,605,12,0,1,605,1201,597,0,1051,604,604
"44583","Nsylvestris_NODE_13077_length_1753_cov_157","Ntome_NODE_15210_length_1613_cov_115",95.97,1588,60,3,43,1626,1,1588,0,2575,1583,1587
"44584","Nsylvestris_NODE_13078_length_1753_cov_147","Ntome_NODE_14561_length_1679_cov_132",96.075,1325,45,6,390,1713,340,1658,0,2152,1323,1318
"44612","Nsylvestris_NODE_13087_length_1752_cov_124","Ntome_NODE_16291_length_1513_cov_13",95.767,1512,63,1,27,1538,1,1511,0,2436,1511,1510
"44627","Nsylvestris_NODE_13092_length_1752_cov_58","Ntome_NODE_34769_length_384_cov_3",97.479,357,6,1,1213,1569,31,384,2.32e-172,606,356,353
"44644","Nsylvestris_NODE_13099_length_1751_cov_61","Ntome_NODE_12706_length_1872_cov_259",95.769,1631,45,9,89,1697,1679,51,0,2608,1608,1628
"44647","Nsylvestris_NODE_13101_length_1751_cov_47","Ntome_NODE_15097_length_1624_cov_74",79.279,1221,182,43,251,1418,1425,223,0,787,1167,1202
"44664","Nsylvestris_NODE_13108_length_1750_cov_109","Ntome_NODE_4758_length_3144_cov_237",92.961,1577,96,10,1,1571,3144,1577,0,2283,1570,1567
"44670","Nsylvestris_NODE_13110_length_1750_cov_32","Ntome_NODE_19691_length_1219_cov_21",90.127,1185,99,11,386,1567,1170,1,0,1524,1181,1169
"44686","Nsylvestris_NODE_13116_length_1749_cov_125","Ntome_NODE_15236_length_1610_cov_203",96.765,1484,48,0,237,1720,1608,125,0,2475,1483,1483
"44711","Nsylvestris_NODE_13125_length_1748_cov_44","Ntome_NODE_2172_length_4075_cov_32",96.296,1620,55,5,133,1748,2435,4053,0,2654,1615,1618
"44729","Nsylvestris_NODE_13131_length_1746_cov_220","Ntome_NODE_5009_length_3080_cov_236",93.564,1414,82,7,336,1746,1436,29,0,2098,1410,1407
"44732","Nsylvestris_NODE_13134_length_1746_cov_15","Ntome_NODE_13859_length_1750_cov_111",98.182,55,1,0,1692,1746,867,813,6.19e-19,97.1,54,54
"44748","Nsylvestris_NODE_13140_length_1745_cov_68","Ntome_NODE_15824_length_1556_cov_18",95.809,1527,51,1,217,1743,1514,1,0,2453,1526,1513
"44772","Nsylvestris_NODE_13149_length_1744_cov_133","Ntome_NODE_18733_length_1297_cov_288",95.521,826,35,1,850,1673,893,68,0,1319,823,825
"44779","Nsylvestris_NODE_13152_length_1744_cov_90","Ntome_NODE_19298_length_1252_cov_26",95.183,1204,44,7,454,1653,54,1247,0,1890,1199,1193
"44780","Nsylvestris_NODE_13153_length_1744_cov_47","Ntome_NODE_1463_length_4565_cov_142",93.606,1517,94,1,1,1514,4041,2525,0,2261,1513,1516
"44781","Nsylvestris_NODE_13154_length_1744_cov_8","Ntome_NODE_84_length_8783_cov_174",81.606,1669,269,26,1,1641,5885,4227,0,1347,1640,1658
"44795","Nsylvestris_NODE_13159_length_1743_cov_35","Ntome_NODE_11258_length_2043_cov_76",90.323,1364,127,5,44,1407,373,1731,0,1783,1363,1358
"44807","Nsylvestris_NODE_13164_length_1742_cov_188","Ntome_NODE_14228_length_1712_cov_239",95.913,1615,47,5,64,1674,57,1656,0,2599,1610,1599
"44814","Nsylvestris_NODE_13167_length_1742_cov_83","Ntome_NODE_6092_length_2831_cov_197",96.016,1707,45,10,39,1726,1778,76,0,2754,1687,1702
"44815","Nsylvestris_NODE_13168_length_1742_cov_81","Ntome_NODE_13697_length_1768_cov_61",94.043,1729,67,16,42,1742,1767,47,0,2590,1700,1720
"44838","Nsylvestris_NODE_13176_length_1741_cov_108","Ntome_NODE_8563_length_2404_cov_94",93.014,1460,88,11,258,1715,2331,884,0,2119,1457,1447
"44839","Nsylvestris_NODE_13177_length_1741_cov_104","Ntome_NODE_10718_length_2105_cov_214",94.158,1763,69,14,1,1741,10,1760,0,2654,1740,1750
"44848","Nsylvestris_NODE_13182_length_1740_cov_211","Ntome_NODE_15735_length_1565_cov_90",95.131,1561,71,4,101,1661,2,1557,0,2457,1560,1555
"44868","Nsylvestris_NODE_13188_length_1740_cov_59","Ntome_NODE_25802_length_816_cov_7",82.086,815,140,6,529,1340,814,3,0,691,811,811
"44876","Nsylvestris_NODE_13192_length_1739_cov_229","Ntome_NODE_11618_length_2000_cov_302",94.632,1658,67,10,44,1696,233,1873,0,2549,1652,1640
"44880","Nsylvestris_NODE_13194_length_1739_cov_200","Ntome_NODE_13714_length_1766_cov_219",94.975,1592,50,9,51,1616,45,1632,0,2470,1565,1587
"44893","Nsylvestris_NODE_13200_length_1739_cov_77","Ntome_NODE_12539_length_1894_cov_77",95.317,1687,70,5,58,1739,1821,139,0,2669,1681,1682
"44940","Nsylvestris_NODE_13215_length_1737_cov_198","Ntome_NODE_24907_length_869_cov_6",75.334,823,181,13,524,1332,1,815,7.06e-103,375,808,814
"44949","Nsylvestris_NODE_13219_length_1737_cov_123","Ntome_NODE_12396_length_1909_cov_102",93.668,1374,81,3,320,1692,1729,361,0,2050,1372,1368
"44968","Nsylvestris_NODE_13225_length_1736_cov_209","Ntome_NODE_15033_length_1631_cov_269",95.4,1587,48,7,103,1681,1631,62,0,2503,1578,1569
"44979","Nsylvestris_NODE_13229_length_1736_cov_65","Ntome_NODE_29612_length_644_cov_4",92.727,55,4,0,1117,1171,116,62,6.19e-14,80.5,54,54
"45005","Nsylvestris_NODE_13240_length_1735_cov_56","Ntome_NODE_17435_length_1409_cov_10",96.512,1405,49,0,143,1547,1405,1,0,2324,1404,1404
"45027","Nsylvestris_NODE_13247_length_1734_cov_195","Ntome_NODE_14371_length_1698_cov_212",97.55,1592,38,1,107,1698,2,1592,0,2723,1591,1590
"45033","Nsylvestris_NODE_13251_length_1733_cov_193","Ntome_NODE_3365_length_3563_cov_218",94.733,1367,55,8,217,1570,3512,2150,0,2109,1353,1362
"45047","Nsylvestris_NODE_13258_length_1732_cov_102","Ntome_NODE_37896_length_290_cov_201",96.311,244,6,2,245,485,1,244,1.5e-109,398,240,243
"45048","Nsylvestris_NODE_13259_length_1732_cov_66","Ntome_NODE_15504_length_1584_cov_61",95.512,1582,60,4,133,1703,1582,1,0,2518,1570,1581
"45049","Nsylvestris_NODE_13260_length_1732_cov_56","Ntome_NODE_13663_length_1771_cov_119",93.038,1738,86,7,1,1732,42,1750,0,2507,1731,1708
"45056","Nsylvestris_NODE_13263_length_1732_cov_50","Ntome_NODE_15516_length_1583_cov_25",91.88,1601,88,19,120,1696,1,1583,0,2198,1576,1582
"45060","Nsylvestris_NODE_13265_length_1732_cov_19","Ntome_NODE_12608_length_1886_cov_29",94.223,1731,94,4,1,1729,1753,27,0,2638,1728,1726
"45115","Nsylvestris_NODE_13283_length_1730_cov_63","Ntome_NODE_14904_length_1644_cov_102",95.258,1645,68,5,1,1640,1640,1,0,2597,1639,1639
"45119","Nsylvestris_NODE_13285_length_1730_cov_38","Ntome_NODE_14951_length_1641_cov_53",94.658,1404,72,3,119,1519,45,1448,0,2174,1400,1403
"45131","Nsylvestris_NODE_13288_length_1729_cov_210","Ntome_NODE_13906_length_1746_cov_260",95.828,1606,53,5,6,1599,1650,47,0,2582,1593,1603
"45179","Nsylvestris_NODE_13302_length_1727_cov_59","Ntome_NODE_13785_length_1759_cov_149",90.852,317,18,5,30,336,673,988,1.49e-114,414,306,315
"45180","Nsylvestris_NODE_13303_length_1728_cov_52","Ntome_NODE_18361_length_1329_cov_112",90.164,61,5,1,4,63,744,684,2.22e-13,78.7,59,60
"45200","Nsylvestris_NODE_13311_length_1726_cov_32","Ntome_NODE_15725_length_1566_cov_7",93.45,1481,85,3,61,1541,98,1566,0,2187,1480,1468
"45225","Nsylvestris_NODE_13322_length_1726_cov_174","Ntome_NODE_14383_length_1697_cov_133",94.504,1692,62,18,23,1690,1,1685,0,2580,1667,1684
"45264","Nsylvestris_NODE_13334_length_1725_cov_175","Ntome_NODE_3902_length_3386_cov_82",95.743,1245,44,4,56,1296,3266,2027,0,1997,1240,1239
"45274","Nsylvestris_NODE_13338_length_1725_cov_109","Ntome_NODE_9768_length_2229_cov_163",95.717,1681,53,8,1,1677,2111,446,0,2687,1676,1665
"45289","Nsylvestris_NODE_13343_length_1724_cov_189","Ntome_NODE_13356_length_1801_cov_205",94.641,1101,50,6,538,1634,1136,41,0,1698,1096,1095
"45334","Nsylvestris_NODE_13358_length_1722_cov_151","Ntome_NODE_14673_length_1668_cov_275",95.191,1622,62,4,36,1645,1,1618,0,2549,1609,1617
"45354","Nsylvestris_NODE_13366_length_1721_cov_120","Ntome_NODE_2257_length_4030_cov_102",96.433,1570,47,4,112,1672,2461,4030,0,2580,1560,1569
"45379","Nsylvestris_NODE_13376_length_1720_cov_14","Ntome_NODE_3309_length_3583_cov_93",92.371,1573,106,12,159,1720,1665,3234,0,2228,1561,1569
"45405","Nsylvestris_NODE_13386_length_1719_cov_30","Ntome_NODE_2647_length_3839_cov_297",96.875,64,0,2,1,64,3582,3643,1.01e-21,106,63,61
"45424","Nsylvestris_NODE_13392_length_1718_cov_16","Ntome_NODE_11897_length_1970_cov_158",93.219,1696,106,5,3,1695,1907,218,0,2486,1692,1689
"45440","Nsylvestris_NODE_13398_length_1717_cov_148","Ntome_NODE_16865_length_1459_cov_241",94.721,1326,51,6,395,1711,1351,36,0,2043,1316,1315
"45452","Nsylvestris_NODE_13403_length_1717_cov_6","Ntome_NODE_1851_length_4271_cov_133",91.918,1757,80,17,1,1717,1932,3666,0,2401,1716,1734
"45478","Nsylvestris_NODE_13412_length_1716_cov_23","Ntome_NODE_14194_length_1716_cov_14",94.391,1676,77,4,8,1683,49,1707,0,2558,1675,1658
"45486","Nsylvestris_NODE_13415_length_1715_cov_221","Ntome_NODE_12546_length_1893_cov_234",95.377,1644,70,5,30,1670,1774,134,0,2610,1640,1640
"45509","Nsylvestris_NODE_13421_length_1715_cov_155","Ntome_NODE_13126_length_1828_cov_233",96.694,1724,42,8,1,1714,1737,19,0,2854,1713,1718
"45517","Nsylvestris_NODE_13425_length_1715_cov_56","Ntome_NODE_13629_length_1774_cov_29",95.313,1728,60,5,4,1715,1758,36,0,2723,1711,1722
"45559","Nsylvestris_NODE_13439_length_1713_cov_212","Ntome_NODE_547_length_5899_cov_282",94.559,1599,74,9,8,1598,1656,63,0,2459,1590,1593
"45596","Nsylvestris_NODE_13449_length_1712_cov_166","Ntome_NODE_2743_length_3795_cov_218",96.144,1608,40,9,1,1602,1647,56,0,2606,1601,1591
"45599","Nsylvestris_NODE_13451_length_1712_cov_39","Ntome_NODE_14954_length_1640_cov_174",98.361,61,1,0,1652,1712,1250,1190,2.8e-22,108,60,60
"45614","Nsylvestris_NODE_13456_length_1711_cov_166","Ntome_NODE_6722_length_2708_cov_256",91.081,1110,64,9,45,1125,2464,1361,0,1469,1080,1103
"45661","Nsylvestris_NODE_13471_length_1710_cov_31","Ntome_NODE_13608_length_1776_cov_53",93.662,1704,87,12,11,1698,20,1718,0,2529,1687,1698
"45698","Nsylvestris_NODE_13482_length_1708_cov_55","Ntome_NODE_11473_length_2017_cov_13",93.554,1691,79,13,39,1708,316,1997,0,2492,1669,1681
"45699","Nsylvestris_NODE_13483_length_1708_cov_49","Ntome_NODE_13717_length_1766_cov_77",95.045,1433,65,2,225,1657,239,1665,0,2248,1432,1426
"45718","Nsylvestris_NODE_13489_length_1707_cov_178","Ntome_NODE_7996_length_2491_cov_165",95.262,1182,38,2,259,1431,187,1359,0,1857,1172,1172
"45741","Nsylvestris_NODE_13495_length_1706_cov_227","Ntome_NODE_13535_length_1782_cov_267",92.959,1676,93,19,40,1702,1684,21,0,2418,1662,1663
"45754","Nsylvestris_NODE_13501_length_1706_cov_83","Ntome_NODE_8450_length_2420_cov_178",93.363,226,15,0,1473,1698,302,77,1.18e-90,335,225,225
"45755","Nsylvestris_NODE_13502_length_1706_cov_57","Ntome_NODE_39022_length_267_cov_2",98.127,267,5,0,784,1050,267,1,4e-130,466,266,266
"45783","Nsylvestris_NODE_13511_length_1705_cov_54","Ntome_NODE_16861_length_1461_cov_12",96.177,1465,49,6,86,1547,1,1461,0,2388,1461,1460
"45839","Nsylvestris_NODE_13528_length_1703_cov_122","Ntome_NODE_2403_length_3958_cov_284",94.488,127,7,0,813,939,2601,2475,5.78e-49,196,126,126
"45840","Nsylvestris_NODE_13529_length_1703_cov_115","Ntome_NODE_14163_length_1720_cov_128",93.944,1354,54,11,192,1521,56,1405,0,2021,1329,1349
"45875","Nsylvestris_NODE_13542_length_1701_cov_227","Ntome_NODE_16864_length_1459_cov_269",95.757,1414,40,8,126,1528,1,1405,0,2261,1402,1404
"45876","Nsylvestris_NODE_13543_length_1701_cov_223","Ntome_NODE_16217_length_1519_cov_285",98.718,1404,18,0,64,1467,1458,55,0,2494,1403,1403
"45895","Nsylvestris_NODE_13547_length_1701_cov_97","Ntome_NODE_9376_length_2285_cov_242",94.342,1520,86,0,96,1615,2103,584,0,2331,1519,1519
"45896","Nsylvestris_NODE_13548_length_1701_cov_71","Ntome_NODE_5056_length_3063_cov_177",95.534,918,36,3,356,1270,2103,3018,0,1463,914,915
"45911","Nsylvestris_NODE_13553_length_1700_cov_208","Ntome_NODE_15347_length_1599_cov_282",94.681,1504,37,15,43,1523,1564,81,0,2294,1480,1483
"45912","Nsylvestris_NODE_13554_length_1700_cov_178","Ntome_NODE_15104_length_1623_cov_176",92.116,1522,83,18,82,1571,62,1578,0,2111,1489,1516
"45918","Nsylvestris_NODE_13556_length_1700_cov_164","Ntome_NODE_16777_length_1468_cov_135",96.664,1409,46,1,150,1557,1417,9,0,2340,1407,1408
"45945","Nsylvestris_NODE_13566_length_1699_cov_193","Ntome_NODE_14557_length_1679_cov_236",95.684,1622,58,6,10,1623,1665,48,0,2597,1613,1617
"45966","Nsylvestris_NODE_13573_length_1699_cov_116","Ntome_NODE_15881_length_1550_cov_45",96.025,1459,34,8,79,1526,105,1550,0,2351,1447,1445
"45972","Nsylvestris_NODE_13575_length_1698_cov_41","Ntome_NODE_7114_length_2636_cov_93",82.883,111,6,11,1561,1664,2325,2429,3.62e-16,87.9,103,104
"45993","Nsylvestris_NODE_13585_length_1698_cov_32","Ntome_NODE_984_length_5115_cov_59",77.004,1335,280,24,211,1533,4415,3096,0,739,1322,1319
"45994","Nsylvestris_NODE_13586_length_1698_cov_23","Ntome_NODE_204_length_7420_cov_91",88.571,175,10,3,1,175,6433,6597,3.44e-51,204,174,164
"46004","Nsylvestris_NODE_13590_length_1697_cov_223","Ntome_NODE_15204_length_1613_cov_280",94.716,1533,56,13,115,1641,1,1514,0,2359,1526,1513
"46017","Nsylvestris_NODE_13597_length_1696_cov_198","Ntome_NODE_13326_length_1805_cov_220",92.924,1611,78,7,73,1657,1627,27,0,2311,1584,1600
"46031","Nsylvestris_NODE_13603_length_1695_cov_215","Ntome_NODE_3354_length_3567_cov_136",92.049,1698,80,13,33,1695,194,1871,0,2337,1662,1677
"46036","Nsylvestris_NODE_13605_length_1695_cov_190","Ntome_NODE_14912_length_1643_cov_259",96.027,1636,47,7,60,1695,1637,20,0,2645,1635,1617
"46054","Nsylvestris_NODE_13612_length_1694_cov_216","Ntome_NODE_14013_length_1736_cov_299",91.076,1692,84,15,6,1645,8,1684,0,2226,1639,1676
"46055","Nsylvestris_NODE_13613_length_1694_cov_209","Ntome_NODE_13537_length_1782_cov_220",92.141,1565,87,13,1,1539,1757,203,0,2176,1538,1554
"46122","Nsylvestris_NODE_13637_length_1692_cov_51","Ntome_NODE_16002_length_1539_cov_17",96.554,1538,51,1,157,1692,1,1538,0,2545,1535,1537
"46123","Nsylvestris_NODE_13638_length_1692_cov_29","Ntome_NODE_433_length_6221_cov_85",98.182,55,1,0,1,55,1217,1271,5.99e-19,97.1,54,54
"46152","Nsylvestris_NODE_13652_length_1690_cov_162","Ntome_NODE_16201_length_1521_cov_96",96.274,1476,29,9,38,1490,1,1473,0,2398,1452,1472
"46162","Nsylvestris_NODE_13656_length_1690_cov_76","Ntome_NODE_39488_length_258_cov_4",85.714,259,13,10,1044,1279,1,258,1.21e-65,252,235,257
"46163","Nsylvestris_NODE_13660_length_1690_cov_15","Ntome_NODE_12952_length_1846_cov_97",77.627,1475,289,32,235,1690,1566,114,0,857,1455,1452
"46229","Nsylvestris_NODE_13681_length_1688_cov_38","Ntome_NODE_14811_length_1655_cov_34",94.667,1669,63,10,11,1667,1655,1,0,2566,1656,1654
"46260","Nsylvestris_NODE_13695_length_1685_cov_201","Ntome_NODE_13759_length_1761_cov_257",93.709,1685,100,4,2,1685,1761,82,0,2519,1683,1679
"46280","Nsylvestris_NODE_13701_length_1685_cov_68","Ntome_NODE_20162_length_1179_cov_224",91.124,169,8,4,124,289,37,201,9.43e-57,222,165,164
"46286","Nsylvestris_NODE_13703_length_1685_cov_26","Ntome_NODE_37157_length_307_cov_31",100,55,0,0,1,55,149,203,1.28e-20,102,54,54
"46301","Nsylvestris_NODE_13709_length_1684_cov_30","Ntome_NODE_21473_length_1093_cov_2",85.853,926,115,14,757,1678,40,953,0,972,921,913
"46327","Nsylvestris_NODE_13720_length_1683_cov_14","Ntome_NODE_32365_length_524_cov_3",92.228,193,14,1,1,193,329,520,9.22e-72,272,192,191
"46339","Nsylvestris_NODE_13724_length_1682_cov_178","Ntome_NODE_4132_length_3312_cov_117",96.339,1557,35,7,4,1551,4,1547,0,2540,1547,1543
"46340","Nsylvestris_NODE_13725_length_1682_cov_161","Ntome_NODE_14483_length_1687_cov_178",95.487,1551,49,8,105,1640,1637,93,0,2457,1535,1544
"46378","Nsylvestris_NODE_13738_length_1680_cov_215","Ntome_NODE_14592_length_1676_cov_260",94.059,1515,85,3,85,1594,162,1676,0,2294,1509,1514
"46382","Nsylvestris_NODE_13740_length_1680_cov_189","Ntome_NODE_5489_length_2964_cov_91",95.894,1510,54,7,82,1587,1798,293,0,2438,1505,1505
"46398","Nsylvestris_NODE_13746_length_1679_cov_223","Ntome_NODE_14443_length_1691_cov_246",95.255,1644,48,14,2,1638,26,1646,0,2577,1636,1620
"46442","Nsylvestris_NODE_13760_length_1678_cov_48","Ntome_NODE_14278_length_1708_cov_25",96.344,1641,52,7,19,1653,1679,41,0,2691,1634,1638
"46470","Nsylvestris_NODE_13768_length_1677_cov_45","Ntome_NODE_38352_length_281_cov_5",80.702,285,31,12,134,398,1,281,4.4e-50,200,264,280
"46497","Nsylvestris_NODE_13778_length_1676_cov_39","Ntome_NODE_11918_length_1968_cov_121",82.609,322,56,0,1103,1424,1424,1745,1.18e-75,285,321,321
"46533","Nsylvestris_NODE_13791_length_1674_cov_95","Ntome_NODE_35341_length_360_cov_7",96.667,360,9,1,181,537,360,1,4.79e-169,595,356,359
"46564","Nsylvestris_NODE_13803_length_1673_cov_11","Ntome_NODE_8286_length_2444_cov_18",95.371,1685,66,1,1,1673,1919,235,0,2669,1672,1684
"46572","Nsylvestris_NODE_13808_length_1672_cov_194","Ntome_NODE_14546_length_1680_cov_238",95.717,1611,55,7,76,1672,1632,22,0,2580,1596,1610
"46585","Nsylvestris_NODE_13812_length_1672_cov_108","Ntome_NODE_39815_length_252_cov_4",89.72,214,10,6,547,760,51,252,5.51e-69,263,213,201
"46586","Nsylvestris_NODE_13813_length_1672_cov_86","Ntome_NODE_7358_length_2593_cov_127",95.699,1674,57,7,1,1672,397,2057,0,2678,1671,1660
"46587","Nsylvestris_NODE_13814_length_1672_cov_67","Ntome_NODE_13416_length_1794_cov_283",97.555,1636,39,1,12,1646,42,1677,0,2798,1634,1635
"46614","Nsylvestris_NODE_13824_length_1670_cov_81","Ntome_NODE_14082_length_1729_cov_73",94.723,1554,64,4,108,1659,1561,24,0,2399,1551,1537
"46617","Nsylvestris_NODE_13826_length_1671_cov_66","Ntome_NODE_12727_length_1869_cov_272",87.016,1032,132,2,466,1496,414,1444,0,1162,1030,1030
"46622","Nsylvestris_NODE_13828_length_1671_cov_19","Ntome_NODE_13852_length_1751_cov_51",93.04,1566,87,12,128,1671,1627,62,0,2268,1543,1565
"46643","Nsylvestris_NODE_13836_length_1670_cov_20","Ntome_NODE_4583_length_3185_cov_63",97.267,1537,42,0,78,1614,66,1602,0,2606,1536,1536
"46684","Nsylvestris_NODE_13850_length_1668_cov_160","Ntome_NODE_4457_length_3220_cov_129",97.895,1615,32,1,1,1613,367,1981,0,2793,1612,1614
"46690","Nsylvestris_NODE_13852_length_1668_cov_131","Ntome_NODE_13931_length_1744_cov_24",96.072,1604,62,1,31,1633,1708,105,0,2612,1602,1603
"46694","Nsylvestris_NODE_13855_length_1668_cov_17","Ntome_NODE_24907_length_869_cov_6",75.061,826,178,20,580,1388,1,815,6.82e-98,359,808,814
"46708","Nsylvestris_NODE_13860_length_1667_cov_198","Ntome_NODE_14754_length_1660_cov_144",94.396,1481,74,7,41,1513,1620,141,0,2266,1472,1479
"46714","Nsylvestris_NODE_13862_length_1667_cov_17","Ntome_NODE_989_length_5108_cov_151",94.25,1600,88,4,70,1666,3135,1537,0,2442,1596,1598
"46725","Nsylvestris_NODE_13866_length_1666_cov_215","Ntome_NODE_13897_length_1746_cov_271",94.981,1554,62,8,119,1666,1575,32,0,2423,1547,1543
"46757","Nsylvestris_NODE_13878_length_1665_cov_213","Ntome_NODE_14185_length_1716_cov_284",93.548,1643,86,7,28,1665,25,1652,0,2429,1637,1627
"46760","Nsylvestris_NODE_13880_length_1665_cov_204","Ntome_NODE_16485_length_1497_cov_271",95.361,1509,44,10,67,1561,1,1497,0,2375,1494,1496
"46808","Nsylvestris_NODE_13896_length_1663_cov_125","Ntome_NODE_12552_length_1892_cov_197",95.647,1539,53,6,70,1598,1889,355,0,2459,1528,1534
"46815","Nsylvestris_NODE_13899_length_1662_cov_216","Ntome_NODE_11995_length_1958_cov_262",96.632,1455,44,3,125,1574,1802,348,0,2410,1449,1454
"46843","Nsylvestris_NODE_13908_length_1662_cov_60","Ntome_NODE_2947_length_3719_cov_173",85.714,56,8,0,250,305,163,218,7.72e-08,60.2,55,55
"46858","Nsylvestris_NODE_13914_length_1661_cov_177","Ntome_NODE_12536_length_1894_cov_91",96.545,1621,44,1,1,1609,274,1894,0,2673,1608,1620
"46859","Nsylvestris_NODE_13915_length_1661_cov_90","Ntome_NODE_16491_length_1497_cov_144",94.737,1444,61,9,195,1626,1442,2,0,2231,1431,1440
"46864","Nsylvestris_NODE_13917_length_1660_cov_195","Ntome_NODE_9157_length_2317_cov_215",78.069,1108,193,28,411,1505,1402,332,0,654,1094,1070
"46865","Nsylvestris_NODE_13918_length_1660_cov_194","Ntome_NODE_14764_length_1659_cov_239",94.431,1275,61,8,393,1660,1467,196,0,1953,1267,1271
"46874","Nsylvestris_NODE_13924_length_1659_cov_220","Ntome_NODE_10380_length_2148_cov_187",85.653,467,63,4,1078,1542,588,124,8.29e-137,488,464,464
"46875","Nsylvestris_NODE_13925_length_1659_cov_206","Ntome_NODE_1379_length_4652_cov_235",94.797,1480,50,14,189,1659,1496,35,0,2281,1470,1461
"46892","Nsylvestris_NODE_13933_length_1659_cov_19","Ntome_NODE_13412_length_1795_cov_50",94.217,1660,91,2,1,1659,37,1692,0,2529,1658,1655
"46899","Nsylvestris_NODE_13936_length_1658_cov_194","Ntome_NODE_11462_length_2018_cov_200",95.184,1225,58,1,306,1530,1972,749,0,1934,1224,1223
"46939","Nsylvestris_NODE_13949_length_1657_cov_84","Ntome_NODE_4016_length_3345_cov_117",96.503,1430,42,5,178,1607,1570,149,0,2357,1429,1421
"46947","Nsylvestris_NODE_13952_length_1657_cov_7","Ntome_NODE_7657_length_2547_cov_50",95.775,1657,70,0,1,1657,1983,327,0,2673,1656,1656
"46979","Nsylvestris_NODE_13963_length_1655_cov_98","Ntome_NODE_16933_length_1453_cov_283",100,41,0,0,1615,1655,858,898,7.63e-13,76.8,40,40
"47004","Nsylvestris_NODE_13972_length_1653_cov_208","Ntome_NODE_15581_length_1577_cov_274",94.476,1593,55,14,8,1584,1576,1,0,2423,1576,1575
"47009","Nsylvestris_NODE_13974_length_1653_cov_114","Ntome_NODE_15142_length_1619_cov_203",93.867,1598,75,6,7,1597,1582,1,0,2386,1590,1581
"47023","Nsylvestris_NODE_13980_length_1652_cov_223","Ntome_NODE_15202_length_1604_cov_302",95.244,1535,64,5,37,1566,1565,35,0,2422,1529,1530
"47026","Nsylvestris_NODE_13982_length_1652_cov_147","Ntome_NODE_13230_length_1816_cov_247",93.397,1469,73,11,192,1645,1514,55,0,2154,1453,1459
"47033","Nsylvestris_NODE_13986_length_1643_cov_206","Ntome_NODE_1758_length_4336_cov_160",94.624,1544,55,9,38,1561,4315,2780,0,2366,1523,1535
"47080","Nsylvestris_NODE_14002_length_1648_cov_193","Ntome_NODE_13761_length_1761_cov_224",95.448,1450,58,6,50,1491,1758,309,0,2305,1441,1449
"47108","Nsylvestris_NODE_14016_length_1647_cov_214","Ntome_NODE_15302_length_1604_cov_289",96.794,1591,44,6,58,1645,1602,16,0,2649,1587,1586
"47132","Nsylvestris_NODE_14027_length_1646_cov_183","Ntome_NODE_15583_length_1577_cov_251",94.485,1505,65,9,88,1588,81,1571,0,2303,1500,1490
"47145","Nsylvestris_NODE_14032_length_1646_cov_70","Ntome_NODE_15832_length_1555_cov_109",91.572,1495,98,12,14,1497,1527,50,0,2037,1483,1477
"47151","Nsylvestris_NODE_14035_length_1646_cov_46","Ntome_NODE_15656_length_1571_cov_237",92.678,1516,89,11,141,1640,1510,1,0,2165,1499,1509
"47242","Nsylvestris_NODE_14062_length_1644_cov_26","Ntome_NODE_8124_length_2472_cov_88",96.872,1151,36,0,494,1644,2421,1271,0,1927,1150,1150
"47248","Nsylvestris_NODE_14064_length_1643_cov_138","Ntome_NODE_782_length_5408_cov_260",91.688,1576,61,23,108,1643,2295,3840,0,2121,1535,1545
"47254","Nsylvestris_NODE_14066_length_1643_cov_117","Ntome_NODE_12383_length_1911_cov_55",95.421,1616,74,0,1,1616,1618,3,0,2575,1615,1615
"47259","Nsylvestris_NODE_14069_length_1643_cov_7","Ntome_NODE_12723_length_1870_cov_27",96.005,1627,65,0,9,1635,1670,44,0,2645,1626,1626
"47286","Nsylvestris_NODE_14079_length_1642_cov_112","Ntome_NODE_12475_length_1900_cov_190",98.919,740,8,0,194,933,500,1239,0,1323,739,739
"47295","Nsylvestris_NODE_14084_length_1641_cov_217","Ntome_NODE_15182_length_1615_cov_188",96.721,1586,42,7,64,1641,29,1612,0,2632,1577,1583
"47296","Nsylvestris_NODE_14085_length_1641_cov_190","Ntome_NODE_6104_length_2830_cov_50",93.6,1500,64,11,72,1565,1,1474,0,2209,1493,1473
"47303","Nsylvestris_NODE_14088_length_1641_cov_160","Ntome_NODE_5823_length_2890_cov_115",89.572,374,35,4,117,489,2817,2447,8.26e-132,472,372,370
"47328","Nsylvestris_NODE_14099_length_1640_cov_134","Ntome_NODE_10445_length_2139_cov_214",94.88,1543,58,7,103,1637,587,2116,0,2392,1534,1529
"47335","Nsylvestris_NODE_14102_length_1640_cov_48","Ntome_NODE_6256_length_2797_cov_90",94.737,38,2,0,1156,1193,492,455,7.62e-08,60.2,37,37
"47342","Nsylvestris_NODE_14105_length_1640_cov_14","Ntome_NODE_14586_length_1677_cov_114",95.455,1056,41,3,99,1150,1274,222,0,1677,1051,1052
"47346","Nsylvestris_NODE_14107_length_1639_cov_228","Ntome_NODE_13620_length_1774_cov_274",93.871,1550,78,10,101,1639,77,1620,0,2320,1538,1543
"47374","Nsylvestris_NODE_14115_length_1639_cov_113","Ntome_NODE_33764_length_431_cov_26",92.188,128,10,0,1053,1180,171,298,1.56e-44,182,127,127
"47384","Nsylvestris_NODE_14119_length_1639_cov_68","Ntome_NODE_3644_length_3472_cov_88",96.371,1047,38,0,47,1093,113,1159,0,1724,1046,1046
"47405","Nsylvestris_NODE_14127_length_1638_cov_36","Ntome_NODE_27902_length_715_cov_2",97.203,715,20,0,612,1326,715,1,0,1210,714,714
"47441","Nsylvestris_NODE_14139_length_1636_cov_222","Ntome_NODE_7163_length_2628_cov_251",96.567,1631,45,2,1,1621,1630,1,0,2691,1620,1629
"47487","Nsylvestris_NODE_14150_length_1635_cov_125","Ntome_NODE_12266_length_1925_cov_218",75.378,1125,260,15,398,1515,380,1494,1.73e-148,527,1117,1114
"47492","Nsylvestris_NODE_14152_length_1635_cov_101","Ntome_NODE_14000_length_1738_cov_28",93.491,1521,67,14,47,1546,1596,87,0,2231,1499,1509
"47528","Nsylvestris_NODE_14163_length_1634_cov_173","Ntome_NODE_15457_length_1588_cov_133",93.758,769,40,5,654,1422,763,1523,0,1147,768,760
"47538","Nsylvestris_NODE_14167_length_1634_cov_12","Ntome_NODE_24907_length_869_cov_6",96.767,866,28,0,281,1146,866,1,0,1445,865,865
"47545","Nsylvestris_NODE_14170_length_1633_cov_202","Ntome_NODE_8617_length_2396_cov_196",97.26,1533,31,6,107,1633,863,2390,0,2588,1526,1527
"47558","Nsylvestris_NODE_14175_length_1633_cov_22","Ntome_NODE_15664_length_1571_cov_25",95.647,1585,49,4,33,1612,2,1571,0,2527,1579,1569
"47574","Nsylvestris_NODE_14183_length_1632_cov_56","Ntome_NODE_27556_length_730_cov_10",85.915,568,46,18,50,600,695,145,6.09e-163,575,550,550
"47581","Nsylvestris_NODE_14187_length_1632_cov_11","Ntome_NODE_13265_length_1812_cov_90",100,55,0,0,1578,1632,1011,957,1.24e-20,102,54,54
"47587","Nsylvestris_NODE_14190_length_1631_cov_85","Ntome_NODE_26772_length_769_cov_27",79.016,386,55,12,860,1222,299,681,2.52e-62,241,362,382
"47588","Nsylvestris_NODE_14192_length_1631_cov_33","Ntome_NODE_23531_length_953_cov_21",94.671,957,35,3,679,1631,3,947,0,1471,952,944
"47589","Nsylvestris_NODE_14193_length_1629_cov_28","Ntome_NODE_10609_length_2119_cov_132",83.81,315,38,8,1050,1356,1494,1803,3.19e-76,287,306,309
"47598","Nsylvestris_NODE_14197_length_1630_cov_30","Ntome_NODE_14588_length_1677_cov_47",93.719,1608,94,6,27,1628,1675,69,0,2403,1601,1606
"47599","Nsylvestris_NODE_14198_length_1629_cov_218","Ntome_NODE_14468_length_1688_cov_285",96.75,1477,37,4,108,1579,1645,175,0,2451,1471,1470
"47609","Nsylvestris_NODE_14202_length_1629_cov_55","Ntome_NODE_219_length_7287_cov_204",78.215,661,103,27,983,1625,5525,6162,1.1e-105,385,642,637
"47610","Nsylvestris_NODE_14204_length_1629_cov_13","Ntome_NODE_3804_length_3420_cov_149",95.599,1636,60,7,1,1629,1077,2707,0,2612,1628,1630
"47613","Nsylvestris_NODE_14206_length_1628_cov_185","Ntome_NODE_13978_length_1740_cov_131",93.512,1526,73,15,6,1524,1609,103,0,2246,1518,1506
"47620","Nsylvestris_NODE_14209_length_1628_cov_143","Ntome_NODE_16791_length_1467_cov_149",97.825,1471,28,2,119,1589,1,1467,0,2536,1470,1466
"47624","Nsylvestris_NODE_14211_length_1628_cov_56","Ntome_NODE_13094_length_1832_cov_86",93.551,1194,63,6,429,1622,1685,506,0,1766,1193,1179
"47625","Nsylvestris_NODE_14212_length_1628_cov_55","Ntome_NODE_14340_length_1701_cov_149",94.778,1398,55,12,237,1628,313,1698,0,2161,1391,1385
"47628","Nsylvestris_NODE_14214_length_1627_cov_219","Ntome_NODE_14511_length_1684_cov_207",93.423,1490,79,12,101,1574,1663,177,0,2191,1473,1486
"47636","Nsylvestris_NODE_14218_length_1627_cov_60","Ntome_NODE_1237_length_4793_cov_193",97.385,1415,37,0,1,1415,2961,4375,0,2409,1414,1414
"47655","Nsylvestris_NODE_14226_length_1626_cov_194","Ntome_NODE_1512_length_4527_cov_204",97.166,1235,35,0,51,1285,75,1309,0,2087,1234,1234
"47685","Nsylvestris_NODE_14237_length_1625_cov_124","Ntome_NODE_14765_length_1659_cov_181",96.398,1610,54,2,18,1624,1,1609,0,2649,1606,1608
"47691","Nsylvestris_NODE_14240_length_1625_cov_64","Ntome_NODE_4102_length_3319_cov_113",93.206,1619,77,16,32,1625,1611,1,0,2350,1593,1610
"47711","Nsylvestris_NODE_14248_length_1624_cov_206","Ntome_NODE_15294_length_1605_cov_273",96.185,1494,32,10,70,1563,1598,130,0,2420,1493,1468
"47723","Nsylvestris_NODE_14253_length_1624_cov_89","Ntome_NODE_10542_length_2127_cov_40",94.553,1487,73,2,92,1576,464,1944,0,2290,1484,1480
"47734","Nsylvestris_NODE_14257_length_1624_cov_20","Ntome_NODE_4732_length_3152_cov_181",87.677,990,68,20,653,1624,1,954,0,1103,971,953
"47760","Nsylvestris_NODE_14265_length_1623_cov_48","Ntome_NODE_2305_length_4003_cov_139",92.006,1351,91,8,59,1408,246,1580,0,1881,1349,1334
"47782","Nsylvestris_NODE_14272_length_1622_cov_192","Ntome_NODE_16443_length_1501_cov_238",94.97,1491,53,15,136,1612,11,1493,0,2318,1476,1482
"47783","Nsylvestris_NODE_14273_length_1622_cov_181","Ntome_NODE_10962_length_2078_cov_100",91.053,1643,97,25,1,1622,1707,94,0,2174,1621,1613
"47823","Nsylvestris_NODE_14286_length_1621_cov_213","Ntome_NODE_14320_length_1703_cov_115",94.627,1433,55,12,153,1583,1461,49,0,2200,1430,1412
"47842","Nsylvestris_NODE_14293_length_1621_cov_167","Ntome_NODE_13281_length_1810_cov_193",95.209,1628,68,5,1,1621,55,1679,0,2566,1620,1624
"47881","Nsylvestris_NODE_14305_length_1620_cov_215","Ntome_NODE_15212_length_1611_cov_267",96.568,1486,45,4,29,1508,1607,122,0,2457,1479,1485
"47885","Nsylvestris_NODE_14308_length_1620_cov_86","Ntome_NODE_16023_length_1537_cov_119",92.891,1491,98,3,130,1620,1483,1,0,2159,1490,1482
"47929","Nsylvestris_NODE_14321_length_1619_cov_79","Ntome_NODE_13028_length_1839_cov_35",93.685,1647,59,16,1,1619,1828,199,0,2423,1618,1629
"47933","Nsylvestris_NODE_14323_length_1619_cov_29","Ntome_NODE_9543_length_2263_cov_233",96.156,1509,56,1,113,1619,6,1514,0,2464,1506,1508
"47945","Nsylvestris_NODE_14328_length_1618_cov_222","Ntome_NODE_14466_length_1689_cov_205",90.869,1599,96,22,9,1597,1609,51,0,2098,1588,1558
"47980","Nsylvestris_NODE_14342_length_1615_cov_211","Ntome_NODE_16150_length_1526_cov_193",91.505,1542,97,18,34,1560,1,1523,0,2091,1526,1522
"47998","Nsylvestris_NODE_14349_length_1615_cov_116","Ntome_NODE_15354_length_1598_cov_219",97.148,1543,40,4,67,1605,56,1598,0,2603,1538,1542
"47999","Nsylvestris_NODE_14350_length_1615_cov_93","Ntome_NODE_14281_length_1707_cov_84",91.249,1577,82,30,75,1610,1658,97,0,2097,1535,1561
"48007","Nsylvestris_NODE_14353_length_1615_cov_9","Ntome_NODE_7184_length_2625_cov_14",94.65,1645,58,6,1,1615,2200,556,0,2523,1614,1644
"48013","Nsylvestris_NODE_14356_length_1614_cov_192","Ntome_NODE_20841_length_1129_cov_7",94.806,1136,51,6,207,1341,1129,1,0,1764,1134,1128
"48018","Nsylvestris_NODE_14358_length_1614_cov_102","Ntome_NODE_4446_length_3222_cov_220",95.99,1247,33,7,105,1343,455,1692,0,2010,1238,1237
"48023","Nsylvestris_NODE_14361_length_1614_cov_68","Ntome_NODE_15198_length_1614_cov_154",93.871,1550,69,20,11,1548,1536,1,0,2313,1537,1535
"48024","Nsylvestris_NODE_14362_length_1614_cov_44","Ntome_NODE_4937_length_3101_cov_55",83.636,165,17,5,1,165,2801,2647,5.59e-34,147,164,154
"48025","Nsylvestris_NODE_14364_length_1615_cov_25","Ntome_NODE_23649_length_946_cov_89",93.885,278,10,6,1339,1615,852,581,5e-114,412,276,271
"48050","Nsylvestris_NODE_14374_length_1612_cov_221","Ntome_NODE_3552_length_3499_cov_294",96.201,1632,41,7,1,1612,1714,84,0,2651,1611,1630
"48064","Nsylvestris_NODE_14380_length_1612_cov_113","Ntome_NODE_7729_length_2536_cov_193",94.89,1546,55,10,19,1557,2428,900,0,2396,1538,1528
"48070","Nsylvestris_NODE_14383_length_1612_cov_25","Ntome_NODE_16298_length_1512_cov_130",91.957,1492,91,13,139,1612,1509,29,0,2063,1473,1480
"48071","Nsylvestris_NODE_14384_length_1612_cov_23","Ntome_NODE_13889_length_1747_cov_71",92.666,1459,82,8,15,1470,217,1653,0,2078,1455,1436
"48101","Nsylvestris_NODE_14393_length_1611_cov_35","Ntome_NODE_16348_length_1509_cov_20",93.305,1434,78,14,43,1466,1428,3,0,2100,1423,1425
"48102","Nsylvestris_NODE_14394_length_1611_cov_11","Ntome_NODE_12497_length_1897_cov_177",96.201,1632,40,4,1,1610,218,1849,0,2651,1609,1631
"48120","Nsylvestris_NODE_14400_length_1610_cov_180","Ntome_NODE_1223_length_4809_cov_176",96.077,1555,45,5,1,1555,1986,3524,0,2519,1554,1538
"48121","Nsylvestris_NODE_14401_length_1610_cov_113","Ntome_NODE_15409_length_1593_cov_111",94.862,1265,48,6,350,1601,1264,4,0,1960,1251,1260
"48131","Nsylvestris_NODE_14405_length_1610_cov_15","Ntome_NODE_39731_length_254_cov_1",95.669,254,11,0,965,1218,254,1,6.44e-113,409,253,253
"48151","Nsylvestris_NODE_14410_length_1609_cov_127","Ntome_NODE_16077_length_1533_cov_25",92.524,1351,82,8,39,1384,148,1484,0,1917,1345,1336
"48174","Nsylvestris_NODE_14418_length_1609_cov_26","Ntome_NODE_16551_length_1492_cov_10",95.007,1402,56,6,93,1493,1,1389,0,2189,1400,1388
"48181","Nsylvestris_NODE_14421_length_1608_cov_208","Ntome_NODE_15152_length_1618_cov_212",93.57,1493,69,4,142,1608,124,1615,0,2200,1466,1491
"48184","Nsylvestris_NODE_14423_length_1608_cov_152","Ntome_NODE_17535_length_1399_cov_259",95.227,1299,48,8,110,1397,1359,64,0,2043,1287,1295
"48214","Nsylvestris_NODE_14433_length_1607_cov_57","Ntome_NODE_16125_length_1529_cov_54",95.287,1464,65,4,147,1607,54,1516,0,2318,1460,1462
"48217","Nsylvestris_NODE_14435_length_1607_cov_45","Ntome_NODE_18530_length_1314_cov_18",96.071,1120,44,0,227,1346,1120,1,0,1825,1119,1119
"48221","Nsylvestris_NODE_14437_length_1606_cov_193","Ntome_NODE_15219_length_1612_cov_97",94.202,1604,68,9,2,1603,1581,1,0,2423,1601,1580
"48222","Nsylvestris_NODE_14438_length_1606_cov_177","Ntome_NODE_14786_length_1657_cov_94",93.534,1562,69,12,48,1579,89,1648,0,2296,1531,1559
"48246","Nsylvestris_NODE_14446_length_1606_cov_11","Ntome_NODE_11446_length_2020_cov_35",94.763,1394,73,0,1,1394,1672,279,0,2170,1393,1393
"48262","Nsylvestris_NODE_14454_length_1604_cov_219","Ntome_NODE_14421_length_1693_cov_257",92.026,1555,116,7,44,1593,92,1643,0,2178,1549,1551
"48270","Nsylvestris_NODE_14457_length_1604_cov_179","Ntome_NODE_2279_length_4016_cov_236",97.059,1530,36,3,49,1578,1543,23,0,2567,1529,1520
"48275","Nsylvestris_NODE_14459_length_1604_cov_123","Ntome_NODE_10020_length_2197_cov_187",95.709,1445,58,3,45,1487,1454,12,0,2322,1442,1442
"48288","Nsylvestris_NODE_14463_length_1604_cov_23","Ntome_NODE_15374_length_1596_cov_135",89.209,973,71,20,36,1004,13,955,0,1184,968,942
"48296","Nsylvestris_NODE_14468_length_1603_cov_216","Ntome_NODE_12974_length_1845_cov_11",94.366,1562,79,6,1,1555,1600,41,0,2388,1554,1559
"48305","Nsylvestris_NODE_14471_length_1603_cov_48","Ntome_NODE_15345_length_1600_cov_27",95.145,1586,71,2,1,1583,16,1598,0,2497,1582,1582
"48325","Nsylvestris_NODE_14480_length_1602_cov_122","Ntome_NODE_33061_length_473_cov_9",96.359,412,12,3,1084,1493,63,473,0,675,409,410
"48337","Nsylvestris_NODE_14485_length_1602_cov_40","Ntome_NODE_21002_length_1116_cov_27",93.199,1088,53,10,2,1087,5,1073,0,1580,1085,1068
"48340","Nsylvestris_NODE_14487_length_1601_cov_157","Ntome_NODE_14573_length_1678_cov_129",94.788,1439,44,8,35,1447,1485,52,0,2213,1412,1433
"48346","Nsylvestris_NODE_14491_length_1601_cov_86","Ntome_NODE_17260_length_1424_cov_35",80.914,1116,184,17,71,1182,117,1207,0,854,1111,1090
"48361","Nsylvestris_NODE_14496_length_1600_cov_212","Ntome_NODE_7538_length_2564_cov_290",97.878,1555,27,4,45,1597,971,2521,0,2684,1552,1550
"48362","Nsylvestris_NODE_14497_length_1600_cov_208","Ntome_NODE_16820_length_1464_cov_59",91.565,1470,91,14,22,1478,1,1450,0,1997,1456,1449
"48363","Nsylvestris_NODE_14498_length_1600_cov_204","Ntome_NODE_17026_length_1446_cov_186",95.783,1399,56,2,154,1549,47,1445,0,2254,1395,1398
"48367","Nsylvestris_NODE_14500_length_1600_cov_174","Ntome_NODE_14504_length_1685_cov_183",95.271,1607,69,2,1,1600,62,1668,0,2540,1599,1606
"48385","Nsylvestris_NODE_14506_length_1599_cov_174","Ntome_NODE_18191_length_1343_cov_149",94.27,1309,52,15,178,1479,51,1343,0,1980,1301,1292
"48386","Nsylvestris_NODE_14507_length_1599_cov_136","Ntome_NODE_17819_length_1373_cov_48",96.8,1375,28,5,71,1431,1,1373,0,2281,1360,1372
"48398","Nsylvestris_NODE_14512_length_1599_cov_23","Ntome_NODE_26394_length_787_cov_151",98.182,55,1,0,1545,1599,167,221,5.66e-19,97.1,54,54
"48420","Nsylvestris_NODE_14519_length_1598_cov_111","Ntome_NODE_13123_length_1828_cov_275",91.587,1569,78,24,1,1542,7,1548,0,2117,1541,1541
"48424","Nsylvestris_NODE_14521_length_1598_cov_93","Ntome_NODE_14248_length_1710_cov_235",95.215,1442,69,0,50,1491,269,1710,0,2281,1441,1441
"48429","Nsylvestris_NODE_14523_length_1598_cov_26","Ntome_NODE_12235_length_1929_cov_78",96.247,373,14,0,1174,1546,891,519,4.54e-174,612,372,372
"48430","Nsylvestris_NODE_14524_length_1597_cov_224","Ntome_NODE_14234_length_1711_cov_276",95.551,1506,54,9,21,1525,1,1494,0,2398,1504,1493
"48451","Nsylvestris_NODE_14529_length_1597_cov_105","Ntome_NODE_16459_length_1500_cov_136",92.825,1352,80,11,219,1563,1380,39,0,1943,1344,1341
"48475","Nsylvestris_NODE_14536_length_1596_cov_200","Ntome_NODE_15858_length_1552_cov_258",94.394,1552,70,5,2,1539,1,1549,0,2368,1537,1548
"48493","Nsylvestris_NODE_14543_length_1596_cov_11","Ntome_NODE_9013_length_2337_cov_80",77.809,703,123,18,595,1269,977,1674,2.97e-111,403,674,697
"48550","Nsylvestris_NODE_14560_length_1593_cov_198","Ntome_NODE_16484_length_1497_cov_300",95.917,1445,42,6,10,1445,10,1446,0,2326,1435,1436
"48562","Nsylvestris_NODE_14565_length_1593_cov_31","Ntome_NODE_18861_length_1287_cov_8",86.279,1188,97,21,328,1488,3,1151,0,1230,1160,1148
"48585","Nsylvestris_NODE_14572_length_1592_cov_143","Ntome_NODE_11267_length_2042_cov_163",91.667,1356,52,20,237,1591,1296,1,0,1821,1354,1295
"48611","Nsylvestris_NODE_14580_length_1591_cov_63","Ntome_NODE_16834_length_1462_cov_50",96.514,1463,49,2,108,1569,1,1462,0,2418,1461,1461
"48612","Nsylvestris_NODE_14581_length_1591_cov_38","Ntome_NODE_12183_length_1935_cov_235",86.159,1156,157,3,267,1420,434,1588,0,1245,1153,1154
"48644","Nsylvestris_NODE_14593_length_1589_cov_200","Ntome_NODE_14751_length_1660_cov_225",95.925,1546,47,6,2,1535,1653,112,0,2492,1533,1541
"48645","Nsylvestris_NODE_14594_length_1589_cov_195","Ntome_NODE_3589_length_3487_cov_171",93.351,1549,79,6,7,1532,10,1557,0,2268,1525,1547
"48662","Nsylvestris_NODE_14601_length_1589_cov_46","Ntome_NODE_10329_length_2154_cov_112",91.693,963,47,17,634,1589,134,1070,0,1304,955,936
"48666","Nsylvestris_NODE_14603_length_1589_cov_18","Ntome_NODE_12183_length_1935_cov_235",90.886,1602,103,20,5,1589,1719,144,0,2109,1584,1575
"48702","Nsylvestris_NODE_14616_length_1587_cov_127","Ntome_NODE_20241_length_1174_cov_153",96.137,673,26,0,765,1437,673,1,0,1099,672,672
"48703","Nsylvestris_NODE_14617_length_1587_cov_116","Ntome_NODE_14499_length_1685_cov_283",91.805,1501,83,19,110,1587,1540,57,0,2054,1477,1483
"48704","Nsylvestris_NODE_14618_length_1587_cov_104","Ntome_NODE_13772_length_1760_cov_168",94.168,1526,44,13,15,1529,1528,37,0,2283,1514,1491
"48707","Nsylvestris_NODE_14621_length_1587_cov_65","Ntome_NODE_14746_length_1661_cov_53",93.56,1615,52,16,6,1586,63,1659,0,2359,1580,1596
"48710","Nsylvestris_NODE_14623_length_1586_cov_219","Ntome_NODE_8141_length_2469_cov_154",88.4,1069,66,30,1,1038,2435,1394,0,1234,1037,1041
"48720","Nsylvestris_NODE_14626_length_1586_cov_158","Ntome_NODE_9548_length_2262_cov_132",93.701,1397,56,12,60,1436,2254,870,0,2063,1376,1384
"48724","Nsylvestris_NODE_14628_length_1586_cov_59","Ntome_NODE_12134_length_1942_cov_48",94.234,1266,54,10,126,1382,684,1939,0,1916,1256,1255
"48766","Nsylvestris_NODE_14642_length_1585_cov_13","Ntome_NODE_15123_length_1621_cov_291",97.917,48,1,0,1,48,708,661,4.36e-15,84.2,47,47
"48792","Nsylvestris_NODE_14652_length_1584_cov_52","Ntome_NODE_36797_length_316_cov_4",83.251,203,32,2,1174,1375,115,316,1.16e-45,185,201,201
"48823","Nsylvestris_NODE_14665_length_1583_cov_28","Ntome_NODE_21975_length_1051_cov_29",82.27,925,135,20,651,1555,5,920,0,773,904,915
"48824","Nsylvestris_NODE_14667_length_1582_cov_195","Ntome_NODE_17158_length_1434_cov_237",94.203,1173,44,8,140,1311,47,1196,0,1768,1171,1149
"48830","Nsylvestris_NODE_14671_length_1582_cov_25","Ntome_NODE_17251_length_1425_cov_9",94.971,1392,60,6,168,1559,1382,1,0,2174,1391,1381
"48850","Nsylvestris_NODE_14679_length_1581_cov_147","Ntome_NODE_17431_length_1409_cov_115",94.264,1046,57,3,55,1098,1,1045,0,1596,1043,1044
"48866","Nsylvestris_NODE_14686_length_1580_cov_219","Ntome_NODE_188_length_7497_cov_123",96.465,1584,52,1,1,1580,854,2437,0,2612,1579,1583
"48888","Nsylvestris_NODE_14694_length_1580_cov_93","Ntome_NODE_18137_length_1348_cov_14",75.207,484,107,10,342,814,1,482,4.11e-55,217,472,481
"48894","Nsylvestris_NODE_14697_length_1579_cov_207","Ntome_NODE_17210_length_1429_cov_202",95.625,1120,49,0,412,1531,61,1180,0,1797,1119,1119
"48895","Nsylvestris_NODE_14698_length_1579_cov_200","Ntome_NODE_15694_length_1568_cov_249",95.016,1565,55,6,1,1554,12,1564,0,2436,1553,1552
"48896","Nsylvestris_NODE_14699_length_1579_cov_172","Ntome_NODE_15619_length_1574_cov_139",90.689,1407,83,19,200,1572,1393,1,0,1829,1372,1392
"48909","Nsylvestris_NODE_14704_length_1579_cov_41","Ntome_NODE_18426_length_1323_cov_229",93.399,1318,56,18,228,1532,1323,24,0,1923,1304,1299
"48910","Nsylvestris_NODE_14705_length_1579_cov_29","Ntome_NODE_19106_length_1267_cov_29",93.14,1239,55,12,300,1536,1,1211,0,1790,1236,1210
"48918","Nsylvestris_NODE_14709_length_1579_cov_12","Ntome_NODE_17305_length_1420_cov_20",89.109,202,20,1,1122,1321,202,1,4.05e-65,250,199,201
"48925","Nsylvestris_NODE_14712_length_1578_cov_200","Ntome_NODE_5208_length_3029_cov_145",93.421,1596,60,22,7,1578,56,1630,0,2324,1571,1574
"48937","Nsylvestris_NODE_14717_length_1578_cov_15","Ntome_NODE_12009_length_1957_cov_58",96.364,55,2,0,1524,1578,1497,1551,2.6e-17,91.6,54,54
"48954","Nsylvestris_NODE_14724_length_1577_cov_79","Ntome_NODE_4619_length_3180_cov_54",91.362,1505,96,8,1,1502,1474,1,0,2028,1501,1473
"48955","Nsylvestris_NODE_14725_length_1577_cov_29","Ntome_NODE_15181_length_1615_cov_243",92.421,1491,46,18,97,1577,156,1589,0,2065,1480,1433
"48961","Nsylvestris_NODE_14728_length_1576_cov_224","Ntome_NODE_4153_length_3306_cov_275",96.221,1482,53,1,98,1576,1503,22,0,2423,1478,1481
"48987","Nsylvestris_NODE_14737_length_1576_cov_25","Ntome_NODE_19371_length_1245_cov_237",81.649,485,79,9,1054,1533,544,1023,1.77e-108,394,479,479
"49006","Nsylvestris_NODE_14743_length_1576_cov_153","Ntome_NODE_15733_length_1565_cov_164",92.559,1223,67,7,272,1488,1389,185,0,1733,1216,1204
"49012","Nsylvestris_NODE_14745_length_1575_cov_81","Ntome_NODE_18746_length_1296_cov_113",95.734,1172,28,11,423,1575,54,1222,0,1868,1152,1168
"49013","Nsylvestris_NODE_14746_length_1575_cov_69","Ntome_NODE_14499_length_1685_cov_283",86.531,245,28,3,1332,1575,346,106,1.44e-69,265,243,240
"49021","Nsylvestris_NODE_14749_length_1575_cov_19","Ntome_NODE_262_length_7011_cov_223",92.902,1578,71,11,1,1575,3036,4575,0,2255,1574,1539
"49054","Nsylvestris_NODE_14761_length_1573_cov_214","Ntome_NODE_16610_length_1485_cov_264",93.542,1471,51,17,66,1525,1459,22,0,2150,1459,1437
"49070","Nsylvestris_NODE_14766_length_1573_cov_128","Ntome_NODE_3164_length_3631_cov_228",100,55,0,0,1519,1573,1263,1209,1.2e-20,102,54,54
"49084","Nsylvestris_NODE_14773_length_1573_cov_25","Ntome_NODE_17134_length_1437_cov_8",95.49,1419,59,3,2,1416,16,1433,0,2261,1414,1417
"49095","Nsylvestris_NODE_14777_length_1572_cov_56","Ntome_NODE_15560_length_1579_cov_113",95.493,1531,61,4,19,1542,1530,1,0,2438,1523,1529
"49096","Nsylvestris_NODE_14778_length_1572_cov_30","Ntome_NODE_14294_length_1706_cov_131",93.179,1510,36,16,9,1482,1532,54,0,2156,1473,1478
"49122","Nsylvestris_NODE_14788_length_1570_cov_227","Ntome_NODE_12692_length_1874_cov_265",97.77,1435,28,2,1,1435,399,1829,0,2470,1434,1430
"49123","Nsylvestris_NODE_14789_length_1570_cov_200","Ntome_NODE_15518_length_1582_cov_291",91.724,1462,81,18,102,1555,1536,107,0,1993,1453,1429
"49128","Nsylvestris_NODE_14791_length_1570_cov_117","Ntome_NODE_19983_length_1193_cov_169",91.736,1210,67,8,233,1427,2,1193,0,1650,1194,1191
"49169","Nsylvestris_NODE_14804_length_1569_cov_77","Ntome_NODE_14580_length_1677_cov_241",95.474,1370,58,3,93,1459,1465,97,0,2183,1366,1368
"49182","Nsylvestris_NODE_14809_length_1569_cov_13","Ntome_NODE_13660_length_1771_cov_169",96.364,55,2,0,1515,1569,1441,1387,2.58e-17,91.6,54,54
"49183","Nsylvestris_NODE_14810_length_1569_cov_11","Ntome_NODE_12404_length_1908_cov_21",96.364,55,2,0,1515,1569,451,397,2.58e-17,91.6,54,54
"49190","Nsylvestris_NODE_14813_length_1568_cov_87","Ntome_NODE_1638_length_4429_cov_218",92.553,1504,69,14,37,1514,2885,4371,0,2117,1477,1486
"49191","Nsylvestris_NODE_14814_length_1568_cov_86","Ntome_NODE_14626_length_1674_cov_79",93.207,1428,71,10,1,1408,1588,167,0,2076,1407,1421
"49201","Nsylvestris_NODE_14819_length_1567_cov_215","Ntome_NODE_16774_length_1468_cov_245",96.439,1404,36,3,67,1469,1,1391,0,2303,1402,1390
"49205","Nsylvestris_NODE_14821_length_1567_cov_201","Ntome_NODE_15340_length_1600_cov_226",91.467,1547,67,23,13,1496,56,1600,0,2065,1483,1544
"49210","Nsylvestris_NODE_14823_length_1567_cov_153","Ntome_NODE_14956_length_1640_cov_73",93.571,1571,68,15,23,1567,1637,74,0,2311,1544,1563
"49240","Nsylvestris_NODE_14837_length_1566_cov_20","Ntome_NODE_4217_length_3285_cov_72",84.932,146,20,2,10,154,2178,2034,5.42e-34,147,144,144
"49256","Nsylvestris_NODE_14843_length_1565_cov_186","Ntome_NODE_13383_length_1799_cov_248",94.834,1510,64,5,5,1507,1746,244,0,2344,1502,1502
"49302","Nsylvestris_NODE_14857_length_1564_cov_186","Ntome_NODE_16332_length_1510_cov_81",94.806,1444,58,9,128,1562,1,1436,0,2235,1434,1435
"49323","Nsylvestris_NODE_14866_length_1563_cov_204","Ntome_NODE_14326_length_1702_cov_258",93.628,1538,80,10,3,1526,1642,109,0,2281,1523,1533
"49324","Nsylvestris_NODE_14867_length_1563_cov_203","Ntome_NODE_14843_length_1650_cov_241",89.176,1589,80,34,1,1547,66,1604,0,1897,1546,1538
"49325","Nsylvestris_NODE_14868_length_1563_cov_199","Ntome_NODE_19540_length_1231_cov_42",92.327,1225,94,0,287,1511,1231,7,0,1742,1224,1224
"49329","Nsylvestris_NODE_14870_length_1563_cov_190","Ntome_NODE_17058_length_1443_cov_25",80.925,173,28,5,176,347,225,393,1.52e-29,132,171,168
"49330","Nsylvestris_NODE_14871_length_1563_cov_145","Ntome_NODE_16489_length_1497_cov_157",91.611,1204,83,11,302,1498,1322,130,0,1648,1196,1192
"49363","Nsylvestris_NODE_14885_length_1562_cov_38","Ntome_NODE_15505_length_1584_cov_57",88.119,404,34,11,52,448,1584,1188,1.02e-130,468,396,396
"49375","Nsylvestris_NODE_14889_length_1561_cov_212","Ntome_NODE_15076_length_1627_cov_269",96.164,1564,41,8,1,1561,60,1607,0,2538,1560,1547
"49376","Nsylvestris_NODE_14890_length_1561_cov_210","Ntome_NODE_12960_length_1845_cov_237",93.652,1528,79,9,51,1561,272,1798,0,2268,1510,1526
"49382","Nsylvestris_NODE_14893_length_1561_cov_58","Ntome_NODE_15100_length_1624_cov_18",96.441,1461,49,2,57,1514,1600,140,0,2407,1457,1460
"49385","Nsylvestris_NODE_14895_length_1561_cov_13","Ntome_NODE_1600_length_4453_cov_70",98.182,55,1,0,1507,1561,322,268,5.52e-19,97.1,54,54
"49396","Nsylvestris_NODE_14899_length_1560_cov_101","Ntome_NODE_23790_length_937_cov_27",96.022,729,20,5,779,1506,217,937,0,1177,727,720
"49409","Nsylvestris_NODE_14904_length_1560_cov_12","Ntome_NODE_15082_length_1627_cov_20",94.461,1372,68,6,54,1422,90,1456,0,2106,1368,1366
"49436","Nsylvestris_NODE_14912_length_1559_cov_21","Ntome_NODE_1527_length_4515_cov_191",89.482,1331,82,14,1,1280,1015,2338,0,1629,1279,1323
"49449","Nsylvestris_NODE_14916_length_1558_cov_213","Ntome_NODE_15090_length_1626_cov_75",94.188,1514,71,6,60,1558,1514,3,0,2292,1498,1511
"49464","Nsylvestris_NODE_14922_length_1558_cov_121","Ntome_NODE_15254_length_1609_cov_78",93.775,1478,79,10,7,1483,1571,106,0,2207,1476,1465
"49465","Nsylvestris_NODE_14923_length_1558_cov_99","Ntome_NODE_22756_length_1000_cov_8",94.522,1004,43,9,238,1233,1000,1,0,1539,995,999
"49466","Nsylvestris_NODE_14924_length_1556_cov_223","Ntome_NODE_16591_length_1487_cov_245",93.91,1445,80,6,37,1477,1474,34,0,2174,1440,1440
"49484","Nsylvestris_NODE_14930_length_1557_cov_90","Ntome_NODE_15238_length_1610_cov_180",96.669,1411,44,2,116,1524,1530,121,0,2342,1408,1409
"49488","Nsylvestris_NODE_14932_length_1557_cov_31","Ntome_NODE_19513_length_1233_cov_55",91.132,1263,73,11,65,1320,1231,1,0,1676,1255,1230
"49495","Nsylvestris_NODE_14936_length_1556_cov_198","Ntome_NODE_16522_length_1494_cov_215",93.627,1271,70,8,1,1266,1444,180,0,1888,1265,1264
"49503","Nsylvestris_NODE_14939_length_1556_cov_107","Ntome_NODE_26613_length_777_cov_15",92.636,679,48,1,273,949,71,749,0,976,676,678
"49529","Nsylvestris_NODE_14947_length_1555_cov_215","Ntome_NODE_922_length_5199_cov_132",95.79,1449,36,8,78,1514,1602,167,0,2314,1436,1435
"49537","Nsylvestris_NODE_14950_length_1555_cov_183","Ntome_NODE_11962_length_1962_cov_97",95.16,1529,73,1,11,1539,1737,210,0,2412,1528,1527
"49570","Nsylvestris_NODE_14962_length_1554_cov_18","Ntome_NODE_27087_length_754_cov_19",83.193,238,37,1,1028,1265,235,1,1.45e-54,215,237,234
"49628","Nsylvestris_NODE_14983_length_1552_cov_5","Ntome_NODE_38776_length_272_cov_3",91.045,268,23,1,367,633,272,5,1.76e-98,361,266,267
"49650","Nsylvestris_NODE_14991_length_1551_cov_183","Ntome_NODE_30335_length_615_cov_15",96.875,32,1,0,1,32,522,491,3.35e-06,54.7,31,31
"49670","Nsylvestris_NODE_15000_length_1549_cov_57","Ntome_NODE_17756_length_1379_cov_83",94.616,1263,42,13,4,1266,1285,49,0,1932,1262,1236
"49694","Nsylvestris_NODE_15009_length_1549_cov_113","Ntome_NODE_14576_length_1678_cov_53",92.8,1500,82,16,23,1506,23,1512,0,2148,1483,1489
"49705","Nsylvestris_NODE_15014_length_1549_cov_40","Ntome_NODE_10334_length_2153_cov_184",85.872,1090,142,6,69,1157,1921,843,0,1149,1088,1078
"49713","Nsylvestris_NODE_15017_length_1548_cov_221","Ntome_NODE_14877_length_1646_cov_276",93.412,1533,94,6,1,1530,88,1616,0,2265,1529,1528
"49714","Nsylvestris_NODE_15018_length_1548_cov_188","Ntome_NODE_17763_length_1378_cov_229",93.414,1321,74,10,105,1418,1318,4,0,1945,1313,1314
"49721","Nsylvestris_NODE_15021_length_1548_cov_131","Ntome_NODE_15644_length_1572_cov_228",91.194,1499,99,17,1,1485,1532,53,0,2006,1484,1479
"49737","Nsylvestris_NODE_15026_length_1548_cov_61","Ntome_NODE_20455_length_1157_cov_178",95.5,1089,40,7,302,1381,45,1133,0,1731,1079,1088
"49738","Nsylvestris_NODE_15028_length_1548_cov_18","Ntome_NODE_21616_length_1073_cov_242",98.148,54,1,0,1494,1547,511,458,1.97e-18,95.3,53,53
"49739","Nsylvestris_NODE_15029_length_1547_cov_234","Ntome_NODE_15269_length_1607_cov_280",94.293,1542,65,9,16,1547,3,1531,0,2338,1531,1528
"49765","Nsylvestris_NODE_15037_length_1548_cov_85","Ntome_NODE_646_length_5653_cov_261",96.429,56,1,1,1,56,940,994,2.55e-17,91.6,55,54
"49766","Nsylvestris_NODE_15038_length_1547_cov_74","Ntome_NODE_18310_length_1333_cov_17",96.403,1279,46,0,41,1319,1333,55,0,2108,1278,1278
"49776","Nsylvestris_NODE_15042_length_1547_cov_28","Ntome_NODE_14351_length_1700_cov_90",95.346,1504,66,1,1,1500,155,1658,0,2386,1499,1503
"49777","Nsylvestris_NODE_15043_length_1547_cov_20","Ntome_NODE_21648_length_1071_cov_35",95.326,1027,47,1,459,1485,1028,3,0,1629,1026,1025
"49780","Nsylvestris_NODE_15046_length_1546_cov_221","Ntome_NODE_18584_length_1309_cov_267",96.337,1092,37,2,9,1099,1303,214,0,1792,1090,1089
"49784","Nsylvestris_NODE_15048_length_1543_cov_183","Ntome_NODE_1574_length_4477_cov_138",91.452,1322,75,14,226,1526,4190,2886,0,1781,1300,1304
"49789","Nsylvestris_NODE_15051_length_1546_cov_55","Ntome_NODE_8156_length_2467_cov_49",91.928,1499,91,15,59,1546,1725,246,0,2071,1487,1479
"49790","Nsylvestris_NODE_15052_length_1546_cov_48","Ntome_NODE_36083_length_336_cov_4",94.925,335,17,0,871,1205,335,1,5.88e-148,525,334,334
"49797","Nsylvestris_NODE_15056_length_1545_cov_220","Ntome_NODE_15915_length_1546_cov_212",95.021,1426,55,5,66,1491,31,1440,0,2226,1425,1409
"49820","Nsylvestris_NODE_15064_length_1545_cov_86","Ntome_NODE_4263_length_3273_cov_198",92.687,1094,71,7,49,1137,1136,47,0,1568,1088,1089
"49827","Nsylvestris_NODE_15068_length_1544_cov_223","Ntome_NODE_14107_length_1726_cov_196",94.367,1509,59,12,48,1544,1519,25,0,2292,1496,1494
"49835","Nsylvestris_NODE_15071_length_1544_cov_195","Ntome_NODE_19377_length_1245_cov_10",93.902,1230,44,6,88,1289,1227,1,0,1827,1201,1226
"49839","Nsylvestris_NODE_15073_length_1544_cov_109","Ntome_NODE_15229_length_1611_cov_136",92.669,1555,73,11,3,1543,1554,27,0,2202,1540,1527
"49849","Nsylvestris_NODE_15078_length_1544_cov_30","Ntome_NODE_17982_length_1360_cov_8",92.962,952,54,7,574,1516,392,1339,0,1375,942,947
"49854","Nsylvestris_NODE_15080_length_1543_cov_181","Ntome_NODE_17575_length_1395_cov_288",92.421,1293,59,17,247,1517,1277,2,0,1808,1270,1275
"49906","Nsylvestris_NODE_15099_length_1541_cov_88","Ntome_NODE_9225_length_2306_cov_73",96.114,1441,53,1,50,1490,732,2169,0,2348,1440,1437
"49907","Nsylvestris_NODE_15100_length_1540_cov_218","Ntome_NODE_3592_length_3486_cov_156",94.33,1164,66,0,377,1540,1904,3067,0,1784,1163,1163
"49914","Nsylvestris_NODE_15103_length_1540_cov_198","Ntome_NODE_16532_length_1493_cov_265",92.439,1402,70,18,3,1382,1451,64,0,1969,1379,1387
"49915","Nsylvestris_NODE_15104_length_1540_cov_187","Ntome_NODE_16287_length_1513_cov_226",95.411,1460,32,9,2,1452,29,1462,0,2292,1450,1433
"49921","Nsylvestris_NODE_15108_length_1540_cov_119","Ntome_NODE_14714_length_1664_cov_257",90.71,1550,86,27,1,1536,138,1643,0,2012,1535,1505
"49925","Nsylvestris_NODE_15110_length_1540_cov_77","Ntome_NODE_15317_length_1603_cov_84",92.886,1504,81,14,50,1540,57,1547,0,2161,1490,1490
"49929","Nsylvestris_NODE_15112_length_1539_cov_191","Ntome_NODE_8265_length_2447_cov_169",96.904,969,28,1,10,978,1461,2427,0,1622,968,966
"49935","Nsylvestris_NODE_15115_length_1539_cov_150","Ntome_NODE_10865_length_2089_cov_9",76.22,1148,219,36,341,1461,1,1121,5.77e-158,558,1120,1120
"49972","Nsylvestris_NODE_15126_length_1537_cov_88","Ntome_NODE_16816_length_1464_cov_189",95.77,922,39,0,155,1076,1464,543,0,1487,921,921
"50003","Nsylvestris_NODE_15139_length_1536_cov_14","Ntome_NODE_20097_length_1184_cov_274",98.182,55,1,0,1,55,762,708,5.43e-19,97.1,54,54
"50006","Nsylvestris_NODE_15142_length_1535_cov_214","Ntome_NODE_17023_length_1446_cov_265",94.078,1334,41,16,18,1335,1446,135,0,1991,1317,1311
"50021","Nsylvestris_NODE_15148_length_1535_cov_98","Ntome_NODE_29107_length_664_cov_10",87.5,96,11,1,421,516,497,403,6.97e-23,110,95,94
"50040","Nsylvestris_NODE_15156_length_1534_cov_187","Ntome_NODE_17361_length_1415_cov_258",93.671,1185,60,9,127,1302,39,1217,0,1759,1175,1178
"50041","Nsylvestris_NODE_15157_length_1534_cov_173","Ntome_NODE_15584_length_1577_cov_251",90.834,1462,70,14,74,1511,1474,53,0,1899,1437,1421
"50045","Nsylvestris_NODE_15159_length_1534_cov_162","Ntome_NODE_6469_length_2754_cov_222",92.117,1294,76,18,201,1480,1020,2301,0,1801,1279,1281
"50065","Nsylvestris_NODE_15165_length_1534_cov_50","Ntome_NODE_773_length_5429_cov_147",85.446,213,25,6,255,464,1672,1463,3.99e-55,217,209,209
"50066","Nsylvestris_NODE_15166_length_1534_cov_47","Ntome_NODE_17666_length_1387_cov_20",94.317,1390,53,7,27,1396,1384,1,0,2106,1369,1383
"50074","Nsylvestris_NODE_15169_length_1533_cov_229","Ntome_NODE_2867_length_3750_cov_160",96.889,1511,38,1,1,1502,1637,127,0,2521,1501,1510
"50126","Nsylvestris_NODE_15187_length_1532_cov_25","Ntome_NODE_38798_length_271_cov_5",95.572,271,12,0,374,644,271,1,1.01e-120,435,270,270
"50127","Nsylvestris_NODE_15188_length_1532_cov_16","Ntome_NODE_26512_length_782_cov_4",97.5,40,1,0,54,93,764,725,1.18e-10,69.4,39,39
"50151","Nsylvestris_NODE_15197_length_1531_cov_135","Ntome_NODE_15484_length_1585_cov_197",94.067,1500,65,10,49,1530,1533,40,0,2255,1481,1493
"50172","Nsylvestris_NODE_15205_length_1531_cov_11","Ntome_NODE_6263_length_2794_cov_241",100,55,0,0,1,55,2001,2055,1.16e-20,102,54,54
"50192","Nsylvestris_NODE_15212_length_1530_cov_195","Ntome_NODE_17463_length_1406_cov_265",93.38,1420,61,21,52,1452,1,1406,0,2071,1400,1405
"50201","Nsylvestris_NODE_15216_length_1530_cov_79","Ntome_NODE_14431_length_1692_cov_258",93.759,1362,68,10,174,1528,1422,71,0,2028,1354,1351
"50218","Nsylvestris_NODE_15222_length_1529_cov_210","Ntome_NODE_7348_length_2595_cov_132",93.333,885,35,7,306,1184,2595,1729,0,1286,878,866
"50229","Nsylvestris_NODE_15227_length_1529_cov_87","Ntome_NODE_6502_length_2747_cov_291",91.746,315,13,7,180,489,2699,2393,6.07e-118,425,309,306
"50234","Nsylvestris_NODE_15230_length_1529_cov_45","Ntome_NODE_20265_length_1172_cov_31",95.263,1161,51,3,117,1273,1161,1,0,1836,1156,1160
"50235","Nsylvestris_NODE_15231_length_1529_cov_32","Ntome_NODE_1023_length_5060_cov_150",95.69,1485,49,10,50,1526,1524,47,0,2374,1476,1477
"50270","Nsylvestris_NODE_15243_length_1527_cov_68","Ntome_NODE_16213_length_1520_cov_56",91.047,1452,85,17,81,1507,89,1520,0,1919,1426,1431
"50276","Nsylvestris_NODE_15247_length_1526_cov_193","Ntome_NODE_20256_length_1173_cov_177",89.642,1033,62,16,136,1162,133,1126,0,1273,1026,993
"50289","Nsylvestris_NODE_15250_length_1526_cov_151","Ntome_NODE_9919_length_2210_cov_238",95.608,1389,53,4,135,1523,1489,109,0,2220,1388,1380
"50298","Nsylvestris_NODE_15255_length_1526_cov_50","Ntome_NODE_17834_length_1372_cov_168",95.84,1322,43,2,3,1312,4,1325,0,2126,1309,1321
"50302","Nsylvestris_NODE_15257_length_1526_cov_17","Ntome_NODE_14506_length_1685_cov_92",93.25,1526,74,11,22,1526,1607,90,0,2220,1504,1517
"50303","Nsylvestris_NODE_15258_length_1526_cov_10","Ntome_NODE_14464_length_1689_cov_266",98.182,55,1,0,1,55,799,745,5.39e-19,97.1,54,54
"50309","Nsylvestris_NODE_15261_length_1525_cov_167","Ntome_NODE_15958_length_1542_cov_221",92.333,1539,60,21,21,1525,9,1523,0,2135,1504,1514
"50310","Nsylvestris_NODE_15262_length_1525_cov_100","Ntome_NODE_20813_length_1131_cov_59",95.848,1132,34,7,44,1164,2,1131,0,1818,1120,1129
"50318","Nsylvestris_NODE_15266_length_1525_cov_13","Ntome_NODE_16666_length_1480_cov_71",94.881,1387,65,3,27,1409,51,1435,0,2163,1382,1384
"50328","Nsylvestris_NODE_15270_length_1524_cov_211","Ntome_NODE_16039_length_1536_cov_64",91.26,1476,84,21,29,1496,1536,98,0,1969,1467,1438
"50354","Nsylvestris_NODE_15279_length_1524_cov_7","Ntome_NODE_6111_length_2829_cov_167",85.333,75,6,3,17,87,1699,1772,9.08e-12,73.1,70,73
"50375","Nsylvestris_NODE_15288_length_1522_cov_118","Ntome_NODE_18559_length_1311_cov_104",92.268,1151,80,6,379,1522,1264,116,0,1624,1143,1148
"50419","Nsylvestris_NODE_15304_length_1521_cov_42","Ntome_NODE_15285_length_1606_cov_87",92.67,1296,72,5,75,1364,274,1552,0,1845,1289,1278
"50420","Nsylvestris_NODE_15305_length_1521_cov_30","Ntome_NODE_15486_length_1585_cov_170",86.124,1117,133,10,272,1369,292,1405,0,1184,1097,1113
"50421","Nsylvestris_NODE_15306_length_1521_cov_11","Ntome_NODE_8000_length_2491_cov_8",94.543,1521,65,2,1,1521,2328,826,0,2333,1520,1502
"50455","Nsylvestris_NODE_15319_length_1520_cov_54","Ntome_NODE_17321_length_1419_cov_20",94.279,1346,51,11,140,1475,5,1334,0,2036,1335,1329
"50459","Nsylvestris_NODE_15321_length_1520_cov_30","Ntome_NODE_317_length_6640_cov_140",96.364,55,2,0,1,55,3584,3638,2.5e-17,91.6,54,54
"50460","Nsylvestris_NODE_15322_length_1520_cov_27","Ntome_NODE_17301_length_1420_cov_160",93.433,670,36,3,802,1464,393,1061,0,987,662,668
"50464","Nsylvestris_NODE_15324_length_1520_cov_24","Ntome_NODE_910_length_5214_cov_141",78.874,1297,259,12,1,1289,1290,1,0,863,1288,1289
"50465","Nsylvestris_NODE_15325_length_1520_cov_21","Ntome_NODE_9503_length_2269_cov_217",97.237,1520,37,2,1,1519,315,1830,0,2569,1518,1515
"50469","Nsylvestris_NODE_15327_length_1519_cov_215","Ntome_NODE_16737_length_1472_cov_286",95.646,1401,14,8,66,1437,1440,58,0,2206,1371,1382
"50485","Nsylvestris_NODE_15332_length_1519_cov_116","Ntome_NODE_15172_length_1616_cov_118",89.956,1364,90,19,1,1364,1480,164,0,1716,1363,1316
"50498","Nsylvestris_NODE_15337_length_1519_cov_31","Ntome_NODE_8378_length_2430_cov_215",95.161,62,2,1,1177,1238,176,116,5.37e-19,97.1,61,60
"50526","Nsylvestris_NODE_15347_length_1518_cov_41","Ntome_NODE_18628_length_1306_cov_21",92.969,1280,67,7,16,1278,1306,33,0,1844,1262,1273
"50551","Nsylvestris_NODE_15357_length_1517_cov_72","Ntome_NODE_1253_length_4780_cov_210",92.497,1466,63,12,53,1502,4730,3296,0,2054,1449,1434
"50552","Nsylvestris_NODE_15358_length_1516_cov_56","Ntome_NODE_6711_length_2712_cov_143",92.686,752,26,11,401,1142,1468,2200,0,1057,741,732
"50555","Nsylvestris_NODE_15360_length_1517_cov_41","Ntome_NODE_18656_length_1304_cov_104",93.394,1105,70,3,249,1351,151,1254,0,1633,1102,1103
"50567","Nsylvestris_NODE_15366_length_1516_cov_169","Ntome_NODE_21504_length_1081_cov_47",93.834,973,57,1,185,1154,1027,55,0,1461,969,972
"50590","Nsylvestris_NODE_15374_length_1516_cov_13","Ntome_NODE_10784_length_2098_cov_85",76.509,1060,168,44,225,1266,455,1451,2.7e-141,503,1041,996
"50591","Nsylvestris_NODE_15375_length_1516_cov_10","Ntome_NODE_12425_length_1906_cov_56",75.926,1026,200,35,257,1251,103,1112,3.52e-135,483,994,1009
"50642","Nsylvestris_NODE_15393_length_1514_cov_8","Ntome_NODE_4926_length_3104_cov_186",94.495,1326,67,2,188,1510,1323,1,0,2039,1322,1322
"50645","Nsylvestris_NODE_15395_length_1513_cov_78","Ntome_NODE_20691_length_1139_cov_4",95.414,1112,51,0,363,1474,1,1112,0,1772,1111,1111
"50678","Nsylvestris_NODE_15408_length_1512_cov_36","Ntome_NODE_15319_length_1603_cov_66",94.922,1477,57,7,2,1460,69,1545,0,2296,1458,1476
"50679","Nsylvestris_NODE_15409_length_1511_cov_227","Ntome_NODE_8742_length_2379_cov_178",94.222,1350,59,2,44,1387,971,2307,0,2043,1343,1336
"50695","Nsylvestris_NODE_15414_length_1511_cov_145","Ntome_NODE_1065_length_5003_cov_107",86.493,422,54,3,29,449,4920,4501,1.64e-128,460,420,419
"50699","Nsylvestris_NODE_15416_length_1511_cov_61","Ntome_NODE_13510_length_1785_cov_77",94.649,1439,43,14,85,1511,1,1417,0,2200,1426,1416
"50707","Nsylvestris_NODE_15420_length_1510_cov_218","Ntome_NODE_16476_length_1498_cov_227",93.667,1500,67,16,28,1508,1498,8,0,2218,1480,1490
"50711","Nsylvestris_NODE_15422_length_1510_cov_213","Ntome_NODE_68_length_9166_cov_102",84.615,65,9,1,1395,1458,8774,8838,5.41e-09,63.9,63,64
"50712","Nsylvestris_NODE_15423_length_1510_cov_198","Ntome_NODE_16823_length_1463_cov_178",94.777,1436,58,6,7,1435,1,1426,0,2220,1428,1425
"50717","Nsylvestris_NODE_15426_length_1510_cov_138","Ntome_NODE_15455_length_1588_cov_189",85.702,1147,46,32,412,1454,281,1413,0,1101,1042,1132
"50725","Nsylvestris_NODE_15430_length_1510_cov_34","Ntome_NODE_14423_length_1693_cov_170",93.329,1514,85,10,1,1501,183,1693,0,2222,1500,1510
"50737","Nsylvestris_NODE_15433_length_1510_cov_7","Ntome_NODE_811_length_5366_cov_181",96.492,1454,42,1,1,1445,3546,4999,0,2394,1444,1453
"50755","Nsylvestris_NODE_15439_length_1509_cov_46","Ntome_NODE_14145_length_1722_cov_197",95.19,1476,45,8,2,1469,1606,149,0,2309,1467,1457
"50758","Nsylvestris_NODE_15443_length_1508_cov_215","Ntome_NODE_14357_length_1699_cov_249",93.789,1449,48,22,54,1461,252,1699,0,2139,1407,1447
"50764","Nsylvestris_NODE_15446_length_1507_cov_214","Ntome_NODE_20372_length_1163_cov_249",95.19,1185,33,8,232,1414,1,1163,0,1851,1182,1162
"50771","Nsylvestris_NODE_15449_length_1507_cov_164","Ntome_NODE_15629_length_1573_cov_268",94.952,1446,61,7,1,1435,1467,23,0,2255,1434,1444
"50779","Nsylvestris_NODE_15453_length_1507_cov_80","Ntome_NODE_14382_length_1697_cov_158",90.082,1472,93,33,10,1460,59,1498,0,1860,1450,1439
"50785","Nsylvestris_NODE_15455_length_1507_cov_35","Ntome_NODE_36576_length_322_cov_3",91.111,90,5,1,870,956,322,233,1.14e-25,119,86,89
"50792","Nsylvestris_NODE_15458_length_1506_cov_13","Ntome_NODE_1898_length_4236_cov_268",87.024,1287,159,7,221,1502,1676,2959,0,1445,1281,1283
"50798","Nsylvestris_NODE_15460_length_1506_cov_211","Ntome_NODE_16573_length_1489_cov_241",95.634,1420,54,5,7,1419,1469,51,0,2272,1412,1418
"50826","Nsylvestris_NODE_15470_length_1506_cov_8","Ntome_NODE_14855_length_1648_cov_295",100,53,0,0,1,53,577,629,1.48e-19,99,52,52
"50836","Nsylvestris_NODE_15474_length_1505_cov_210","Ntome_NODE_17671_length_1386_cov_276",94.087,1336,68,6,73,1406,8,1334,0,2019,1333,1326
"50837","Nsylvestris_NODE_15475_length_1505_cov_183","Ntome_NODE_1966_length_4198_cov_249",93.653,1481,49,15,42,1480,2587,4064,0,2172,1438,1477
"50838","Nsylvestris_NODE_15476_length_1505_cov_147","Ntome_NODE_15159_length_1617_cov_214",95.792,1212,26,2,283,1491,1303,114,0,1932,1208,1189
"50839","Nsylvestris_NODE_15477_length_1505_cov_86","Ntome_NODE_23827_length_935_cov_238",88.244,689,49,8,699,1355,880,192,0,795,656,688
"50930","Nsylvestris_NODE_15495_length_1503_cov_205","Ntome_NODE_15383_length_1595_cov_261",94.993,1358,59,3,87,1436,47,1403,0,2122,1349,1356
"50936","Nsylvestris_NODE_15497_length_1503_cov_155","Ntome_NODE_14119_length_1725_cov_163",96.715,1461,42,4,1,1455,24,1484,0,2427,1454,1460
"50971","Nsylvestris_NODE_15508_length_1501_cov_144","Ntome_NODE_11665_length_1995_cov_209",95.384,1473,61,4,12,1478,468,1939,0,2337,1466,1471
"50975","Nsylvestris_NODE_15510_length_1501_cov_48","Ntome_NODE_18892_length_1284_cov_200",91.076,874,66,6,81,950,246,1111,0,1171,869,865
"50976","Nsylvestris_NODE_15511_length_1501_cov_37","Ntome_NODE_30106_length_623_cov_226",93.814,291,16,2,1052,1342,344,56,2.75e-121,436,290,288
"50985","Nsylvestris_NODE_15515_length_1500_cov_207","Ntome_NODE_16603_length_1486_cov_278",95.55,1236,35,7,1,1217,1315,81,0,1960,1216,1234
"50989","Nsylvestris_NODE_15517_length_1500_cov_145","Ntome_NODE_17521_length_1401_cov_63",91.884,1380,83,10,120,1492,1364,7,0,1901,1372,1357
"50994","Nsylvestris_NODE_15519_length_1500_cov_58","Ntome_NODE_12202_length_1933_cov_135",91.236,1392,108,9,42,1426,6,1390,0,1882,1384,1384
"51000","Nsylvestris_NODE_15521_length_1500_cov_42","Ntome_NODE_14535_length_1682_cov_58",94.481,1504,76,3,1,1499,66,1567,0,2311,1498,1501
"51003","Nsylvestris_NODE_15524_length_1499_cov_199","Ntome_NODE_36_length_10356_cov_49",91.304,69,6,0,4,72,7414,7346,1.91e-18,95.3,68,68
"51011","Nsylvestris_NODE_15528_length_1499_cov_63","Ntome_NODE_16617_length_1485_cov_74",93.956,546,27,4,946,1489,935,1476,0,821,543,541
"51012","Nsylvestris_NODE_15529_length_1498_cov_37","Ntome_NODE_8842_length_2362_cov_290",98.276,58,1,0,1,58,1253,1196,1.14e-20,102,57,57
"51040","Nsylvestris_NODE_15538_length_1498_cov_96","Ntome_NODE_2799_length_3771_cov_187",88.767,1095,95,11,385,1465,2691,3771,0,1315,1080,1080
"51049","Nsylvestris_NODE_15541_length_1497_cov_205","Ntome_NODE_16274_length_1514_cov_278",92.569,1440,68,16,51,1454,1437,1,0,2030,1403,1436
"51065","Nsylvestris_NODE_15547_length_1497_cov_13","Ntome_NODE_32814_length_491_cov_5",88.889,72,5,2,82,153,367,299,1.15e-15,86.1,71,68
"51098","Nsylvestris_NODE_15559_length_1494_cov_193","Ntome_NODE_16153_length_1526_cov_123",93.563,1336,58,14,45,1362,200,1525,0,1965,1317,1325
"51124","Nsylvestris_NODE_15567_length_1494_cov_32","Ntome_NODE_13709_length_1766_cov_304",79.164,1411,285,7,69,1476,270,1674,0,968,1407,1404
"51131","Nsylvestris_NODE_15571_length_1494_cov_8","Ntome_NODE_245_length_7124_cov_110",90.201,398,39,0,1095,1492,1481,1084,2.64e-146,520,397,397
"51136","Nsylvestris_NODE_15574_length_1493_cov_127","Ntome_NODE_20177_length_1178_cov_242",85.99,828,114,2,89,915,1127,301,0,885,826,826
"51178","Nsylvestris_NODE_15584_length_1492_cov_157","Ntome_NODE_15453_length_1588_cov_217",89.839,1427,108,17,82,1481,1513,97,0,1797,1399,1416
"51188","Nsylvestris_NODE_15588_length_1492_cov_23","Ntome_NODE_6989_length_2657_cov_91",94.58,1439,32,15,69,1491,1443,35,0,2183,1422,1408
"51195","Nsylvestris_NODE_15591_length_1492_cov_7","Ntome_NODE_16860_length_1460_cov_22",94.136,1313,63,9,15,1323,158,1460,0,1986,1308,1302
"51198","Nsylvestris_NODE_15593_length_1491_cov_186","Ntome_NODE_20486_length_1154_cov_280",93.635,1084,45,7,289,1363,1150,82,0,1598,1074,1068
"51208","Nsylvestris_NODE_15596_length_1491_cov_170","Ntome_NODE_14720_length_1663_cov_275",94.088,1370,68,10,2,1362,1606,241,0,2069,1360,1365
"51223","Nsylvestris_NODE_15603_length_1490_cov_134","Ntome_NODE_14315_length_1703_cov_236",93.805,1243,73,2,202,1444,1430,192,0,1866,1242,1238
"51227","Nsylvestris_NODE_15605_length_1490_cov_63","Ntome_NODE_20778_length_1133_cov_7",94.278,1136,62,1,29,1164,1133,1,0,1735,1135,1132
"51236","Nsylvestris_NODE_15608_length_1490_cov_20","Ntome_NODE_21663_length_1070_cov_49",95.533,403,15,3,100,499,665,1067,0,641,399,402
"51264","Nsylvestris_NODE_15616_length_1489_cov_60","Ntome_NODE_2006_length_4170_cov_30",97.507,1484,37,0,1,1484,1484,1,0,2536,1483,1483
"51271","Nsylvestris_NODE_15620_length_1488_cov_205","Ntome_NODE_8153_length_2468_cov_246",94.414,1271,55,5,54,1312,2392,1126,0,1940,1258,1266
"51276","Nsylvestris_NODE_15624_length_1488_cov_111","Ntome_NODE_17412_length_1411_cov_44",91.994,1449,71,19,21,1462,1,1411,0,1991,1441,1410
"51298","Nsylvestris_NODE_15630_length_1487_cov_112","Ntome_NODE_16975_length_1451_cov_85",89.706,1428,92,23,73,1473,1,1400,0,1772,1400,1399
"51299","Nsylvestris_NODE_15631_length_1486_cov_26","Ntome_NODE_33669_length_436_cov_5",99.13,230,2,0,953,1182,1,230,1.28e-114,414,229,229
"51309","Nsylvestris_NODE_15636_length_1486_cov_91","Ntome_NODE_20130_length_1182_cov_101",94.737,760,38,1,685,1442,1033,274,0,1181,757,759
"51323","Nsylvestris_NODE_15642_length_1485_cov_208","Ntome_NODE_5106_length_3053_cov_210",94.055,1413,59,11,13,1418,1431,37,0,2121,1405,1394
"51369","Nsylvestris_NODE_15659_length_1484_cov_19","Ntome_NODE_17526_length_1400_cov_26",95.213,1149,51,4,37,1181,1400,252,0,1814,1144,1148
"51378","Nsylvestris_NODE_15664_length_1483_cov_210","Ntome_NODE_10536_length_2127_cov_266",93.727,1387,75,10,100,1483,706,2083,0,2069,1383,1377
"51389","Nsylvestris_NODE_15669_length_1483_cov_174","Ntome_NODE_14100_length_1727_cov_242",95.455,1188,54,0,219,1406,237,1424,0,1895,1187,1187
"51416","Nsylvestris_NODE_15682_length_1481_cov_223","Ntome_NODE_15586_length_1577_cov_245",96.496,1427,37,6,1,1426,56,1470,0,2346,1425,1414
"51427","Nsylvestris_NODE_15686_length_1481_cov_187","Ntome_NODE_15787_length_1559_cov_220",94.896,1489,54,7,6,1473,45,1532,0,2309,1467,1487
"51458","Nsylvestris_NODE_15698_length_1480_cov_114","Ntome_NODE_15363_length_1597_cov_72",92.18,1266,69,19,146,1403,1426,183,0,1762,1257,1243
"51462","Nsylvestris_NODE_15700_length_1480_cov_79","Ntome_NODE_16427_length_1503_cov_18",94.01,1369,70,8,68,1431,3,1364,0,2063,1363,1361
"51542","Nsylvestris_NODE_15729_length_1477_cov_166","Ntome_NODE_6683_length_2715_cov_298",98.182,55,1,0,1,55,1389,1335,5.22e-19,97.1,54,54
"51556","Nsylvestris_NODE_15735_length_1477_cov_15","Ntome_NODE_5898_length_2872_cov_41",75.762,623,103,27,710,1311,1841,2436,2.91e-71,270,601,595
"51560","Nsylvestris_NODE_15737_length_1476_cov_207","Ntome_NODE_8428_length_2423_cov_76",92.53,1245,71,11,69,1299,2151,915,0,1764,1230,1236
"51593","Nsylvestris_NODE_15749_length_1475_cov_113","Ntome_NODE_38693_length_274_cov_1",92.62,271,17,2,199,466,271,1,2.76e-106,387,267,270
"51594","Nsylvestris_NODE_15750_length_1475_cov_105","Ntome_NODE_16847_length_1461_cov_11",96.361,1429,49,3,43,1468,1461,33,0,2348,1425,1428
"51595","Nsylvestris_NODE_15751_length_1475_cov_18","Ntome_NODE_18807_length_1291_cov_9",95.961,1238,47,2,124,1361,1235,1,0,2006,1237,1234
"51602","Nsylvestris_NODE_15754_length_1474_cov_190","Ntome_NODE_15944_length_1543_cov_136",93.038,1422,62,11,84,1474,1487,72,0,2043,1390,1415
"51605","Nsylvestris_NODE_15756_length_1474_cov_178","Ntome_NODE_18993_length_1276_cov_285",94.33,1164,46,4,52,1209,61,1210,0,1766,1157,1149
"51611","Nsylvestris_NODE_15759_length_1487_cov_94","Ntome_NODE_8321_length_2439_cov_131",90.39,1436,63,32,3,1371,851,2278,0,1818,1368,1427
"51612","Nsylvestris_NODE_15760_length_1474_cov_67","Ntome_NODE_5258_length_3016_cov_169",92.157,51,4,0,1215,1265,2201,2251,8.78e-12,73.1,50,50
"51618","Nsylvestris_NODE_15762_length_1474_cov_11","Ntome_NODE_8881_length_2358_cov_28",94.161,1490,69,4,3,1474,117,1606,0,2254,1471,1489
"51657","Nsylvestris_NODE_15776_length_1472_cov_183","Ntome_NODE_11328_length_2033_cov_257",95.519,1406,55,4,75,1472,264,1669,0,2241,1397,1405
"51673","Nsylvestris_NODE_15782_length_1472_cov_14","Ntome_NODE_6277_length_2792_cov_102",96.721,61,2,0,1412,1472,1991,2051,1.12e-20,102,60,60
"51679","Nsylvestris_NODE_15786_length_1471_cov_201","Ntome_NODE_16193_length_1521_cov_265",93.333,1425,60,9,56,1471,4,1402,0,2073,1415,1398
"51687","Nsylvestris_NODE_15790_length_1471_cov_26","Ntome_NODE_12910_length_1851_cov_165",93.165,1507,62,16,1,1471,267,1768,0,2174,1470,1501
"51697","Nsylvestris_NODE_15795_length_1470_cov_116","Ntome_NODE_15492_length_1585_cov_67",94.18,1512,46,5,1,1470,63,1574,0,2266,1469,1511
"51704","Nsylvestris_NODE_15798_length_1470_cov_59","Ntome_NODE_12755_length_1867_cov_68",90.484,1198,82,8,80,1246,1818,622,0,1552,1166,1196
"51717","Nsylvestris_NODE_15803_length_1469_cov_213","Ntome_NODE_120_length_8167_cov_100",95.771,1206,42,4,1,1197,5032,3827,0,1936,1196,1205
"51718","Nsylvestris_NODE_15804_length_1469_cov_207","Ntome_NODE_10636_length_2114_cov_165",93.455,1146,68,4,327,1469,265,1406,0,1694,1142,1141
"51719","Nsylvestris_NODE_15805_length_1469_cov_169","Ntome_NODE_16951_length_1452_cov_265",92.515,1376,68,18,85,1450,71,1421,0,1938,1365,1350
"51720","Nsylvestris_NODE_15806_length_1469_cov_155","Ntome_NODE_14814_length_1655_cov_8",96.062,711,21,2,597,1306,705,1,0,1151,709,704
"51726","Nsylvestris_NODE_15809_length_1469_cov_74","Ntome_NODE_21345_length_1092_cov_46",89.474,1007,55,11,471,1428,82,1086,0,1225,957,1004
"51746","Nsylvestris_NODE_15817_length_1467_cov_168","Ntome_NODE_4521_length_3205_cov_256",87.73,652,61,16,164,804,170,813,0,743,640,643
"51750","Nsylvestris_NODE_15819_length_1467_cov_159","Ntome_NODE_16022_length_1537_cov_146",93.211,1252,67,9,184,1420,73,1321,0,1825,1236,1248
"51751","Nsylvestris_NODE_15820_length_1467_cov_158","Ntome_NODE_15930_length_1545_cov_70",86.099,223,28,3,115,335,1529,1308,2.93e-61,237,220,221
"51762","Nsylvestris_NODE_15825_length_1466_cov_160","Ntome_NODE_15305_length_1604_cov_228",89.216,1326,70,26,82,1364,141,1436,0,1589,1282,1295
"51763","Nsylvestris_NODE_15826_length_1466_cov_158","Ntome_NODE_16613_length_1485_cov_142",91.892,1369,73,14,55,1385,114,1482,0,1879,1330,1368
"51780","Nsylvestris_NODE_15830_length_1466_cov_48","Ntome_NODE_30_length_10605_cov_97",86.486,74,9,1,128,200,1086,1013,5.22e-14,80.5,72,73
"51781","Nsylvestris_NODE_15831_length_1465_cov_225","Ntome_NODE_14721_length_1663_cov_268",95.368,1425,44,8,1,1420,6,1413,0,2246,1419,1407
"51790","Nsylvestris_NODE_15834_length_1465_cov_66","Ntome_NODE_14422_length_1693_cov_183",86.275,408,53,3,846,1252,884,479,2.08e-122,440,406,405
"51791","Nsylvestris_NODE_15835_length_1465_cov_64","Ntome_NODE_12179_length_1936_cov_97",78.677,1149,224,19,74,1209,1801,661,0,745,1135,1140
"51824","Nsylvestris_NODE_15844_length_1464_cov_100","Ntome_NODE_235_length_7165_cov_86",100,55,0,0,1,55,224,170,1.11e-20,102,54,54
"51845","Nsylvestris_NODE_15851_length_1464_cov_7","Ntome_NODE_28356_length_695_cov_3",89.937,636,56,6,828,1458,1,633,0,813,630,632
"51853","Nsylvestris_NODE_15854_length_1463_cov_196","Ntome_NODE_16340_length_1509_cov_148",94.354,1470,45,13,1,1463,68,1506,0,2220,1462,1438
"51854","Nsylvestris_NODE_15855_length_1463_cov_192","Ntome_NODE_16967_length_1451_cov_222",94.508,1402,62,9,1,1398,1426,36,0,2148,1397,1390
"51868","Nsylvestris_NODE_15859_length_1463_cov_70","Ntome_NODE_10591_length_2121_cov_239",91.331,496,30,6,958,1442,980,1473,0,665,484,493
"51876","Nsylvestris_NODE_15862_length_1463_cov_22","Ntome_NODE_21644_length_1073_cov_4",97.61,1046,25,0,1,1046,25,1070,0,1794,1045,1045
"51888","Nsylvestris_NODE_15866_length_1462_cov_232","Ntome_NODE_12169_length_1937_cov_309",94.471,1465,63,8,3,1462,1,1452,0,2241,1459,1451
"51917","Nsylvestris_NODE_15874_length_1462_cov_133","Ntome_NODE_22041_length_1045_cov_236",92.737,358,26,0,567,924,517,160,9.3e-146,518,357,357
"51921","Nsylvestris_NODE_15876_length_1462_cov_49","Ntome_NODE_18850_length_1287_cov_146",96.274,1154,34,1,93,1246,52,1196,0,1884,1153,1144
"51927","Nsylvestris_NODE_15879_length_1462_cov_13","Ntome_NODE_100_length_8532_cov_83",90.909,275,19,3,193,466,5984,6253,1.28e-99,364,273,269
"51928","Nsylvestris_NODE_15880_length_1462_cov_11","Ntome_NODE_7708_length_2539_cov_16",96.806,1315,41,1,149,1462,2537,1223,0,2194,1313,1314
"51950","Nsylvestris_NODE_15887_length_1461_cov_206","Ntome_NODE_16745_length_1471_cov_285",97.3,1185,24,2,228,1409,1308,129,0,2004,1181,1179
"51960","Nsylvestris_NODE_15891_length_1461_cov_29","Ntome_NODE_14_length_12167_cov_132",79.775,89,11,4,1214,1297,9640,9554,2.44e-07,58.4,83,86
"51992","Nsylvestris_NODE_15903_length_1460_cov_59","Ntome_NODE_15947_length_1543_cov_109",93.671,1422,64,15,4,1409,28,1439,0,2104,1405,1411
"51993","Nsylvestris_NODE_15904_length_1460_cov_47","Ntome_NODE_15135_length_1620_cov_86",93.858,1335,73,6,126,1455,1487,157,0,2002,1329,1330
"51994","Nsylvestris_NODE_15905_length_1460_cov_28","Ntome_NODE_8236_length_2451_cov_251",72.812,754,194,11,177,923,932,1681,4.84e-64,246,746,749
"52004","Nsylvestris_NODE_15908_length_1459_cov_214","Ntome_NODE_2169_length_4076_cov_286",96.483,1450,43,4,7,1454,4064,2621,0,2388,1447,1443
"52034","Nsylvestris_NODE_15918_length_1458_cov_173","Ntome_NODE_21967_length_1051_cov_270",92.089,986,47,7,225,1207,981,24,0,1360,982,957
"52035","Nsylvestris_NODE_15919_length_1458_cov_170","Ntome_NODE_13803_length_1757_cov_94",95.217,1150,45,5,185,1331,561,1703,0,1810,1146,1142
"52036","Nsylvestris_NODE_15920_length_1458_cov_162","Ntome_NODE_17687_length_1385_cov_82",93.638,1336,42,19,8,1326,1,1310,0,1956,1318,1309
"52055","Nsylvestris_NODE_15927_length_1457_cov_211","Ntome_NODE_6147_length_2823_cov_181",95.79,1259,33,5,75,1313,1259,1,0,2013,1238,1258
"52066","Nsylvestris_NODE_15931_length_1457_cov_30","Ntome_NODE_1863_length_4264_cov_272",98.182,55,1,0,1403,1457,3233,3287,5.15e-19,97.1,54,54
"52067","Nsylvestris_NODE_15932_length_1457_cov_16","Ntome_NODE_8297_length_2442_cov_64",94.318,88,5,0,2,89,2051,1964,1.09e-30,135,87,87
"52075","Nsylvestris_NODE_15935_length_1456_cov_185","Ntome_NODE_2397_length_3961_cov_67",96.956,1314,40,0,56,1369,82,1395,0,2206,1313,1313
"52095","Nsylvestris_NODE_15942_length_1455_cov_203","Ntome_NODE_2774_length_3778_cov_180",94.952,1367,44,12,14,1361,3758,2398,0,2119,1347,1360
"52113","Nsylvestris_NODE_15950_length_1455_cov_21","Ntome_NODE_9108_length_2323_cov_61",83.212,137,21,2,135,270,1291,1156,2.36e-27,124,135,135
"52118","Nsylvestris_NODE_15952_length_1454_cov_223","Ntome_NODE_16537_length_1493_cov_210",90.973,1285,101,6,138,1407,1444,160,0,1716,1269,1284
"52140","Nsylvestris_NODE_15959_length_1454_cov_23","Ntome_NODE_5971_length_2855_cov_26",79.507,1137,199,18,5,1134,2463,1354,0,778,1129,1109
"52145","Nsylvestris_NODE_15963_length_1453_cov_192","Ntome_NODE_17056_length_1443_cov_88",95.963,1288,39,6,131,1407,1432,147,0,2078,1276,1285
"52201","Nsylvestris_NODE_15985_length_1451_cov_9","Ntome_NODE_25809_length_815_cov_248",98.305,59,0,1,1,58,439,381,1.1e-20,102,57,58
"52204","Nsylvestris_NODE_15987_length_1450_cov_196","Ntome_NODE_1011_length_5075_cov_133",97.924,1445,24,2,6,1450,1,1439,0,2497,1444,1438
"52211","Nsylvestris_NODE_15990_length_1450_cov_126","Ntome_NODE_24081_length_919_cov_243",92.933,750,30,10,682,1420,864,127,0,1070,738,737
"52225","Nsylvestris_NODE_15995_length_1450_cov_17","Ntome_NODE_13902_length_1746_cov_80",94.153,1317,57,7,140,1450,49,1351,0,1988,1310,1302
"52229","Nsylvestris_NODE_15997_length_1449_cov_189","Ntome_NODE_15860_length_1552_cov_230",94.772,1205,55,2,149,1351,64,1262,0,1869,1202,1198
"52232","Nsylvestris_NODE_15999_length_1449_cov_144","Ntome_NODE_16503_length_1496_cov_162",93.191,1454,79,14,1,1449,53,1491,0,2119,1448,1438
"52237","Nsylvestris_NODE_16001_length_1449_cov_97","Ntome_NODE_29353_length_654_cov_214",93.784,547,21,7,831,1364,61,607,0,809,533,546
"52247","Nsylvestris_NODE_16005_length_1449_cov_48","Ntome_NODE_22341_length_1026_cov_45",90.26,770,42,8,50,795,817,57,0,976,745,760
"52259","Nsylvestris_NODE_16010_length_1448_cov_220","Ntome_NODE_2462_length_3924_cov_189",96.329,1471,31,2,1,1448,2415,3885,0,2396,1447,1470
"52265","Nsylvestris_NODE_16013_length_1448_cov_202","Ntome_NODE_11730_length_1988_cov_278",95.92,1103,29,7,210,1311,852,1939,0,1773,1101,1087
"52277","Nsylvestris_NODE_16017_length_1448_cov_173","Ntome_NODE_6010_length_2845_cov_144",96.405,1196,43,0,205,1400,1813,618,0,1971,1195,1195
"52298","Nsylvestris_NODE_16027_length_1447_cov_150","Ntome_NODE_15532_length_1581_cov_98",93.921,1464,51,14,2,1444,1,1447,0,2176,1442,1446
"52310","Nsylvestris_NODE_16032_length_1447_cov_17","Ntome_NODE_28309_length_697_cov_15",86.325,468,41,10,852,1312,572,121,7.22e-137,488,460,451
"52323","Nsylvestris_NODE_16038_length_1446_cov_52","Ntome_NODE_16025_length_1537_cov_113",82.245,873,143,11,388,1254,344,1210,0,743,866,866
"52336","Nsylvestris_NODE_16043_length_1445_cov_220","Ntome_NODE_6444_length_2758_cov_193",92.529,937,52,9,173,1094,82,1015,0,1327,921,933
"52359","Nsylvestris_NODE_16051_length_1445_cov_59","Ntome_NODE_17687_length_1385_cov_82",85.263,285,24,10,593,862,905,624,1.7e-73,278,269,281
"52370","Nsylvestris_NODE_16057_length_1444_cov_96","Ntome_NODE_16765_length_1469_cov_126",96.157,1405,49,3,3,1405,65,1466,0,2290,1402,1401
"52371","Nsylvestris_NODE_16058_length_1444_cov_87","Ntome_NODE_3085_length_3663_cov_147",93.904,1214,60,6,63,1273,1451,249,0,1820,1210,1202
"52394","Nsylvestris_NODE_16066_length_1443_cov_121","Ntome_NODE_23515_length_954_cov_114",95.013,742,29,2,11,744,791,50,0,1158,733,741
"52410","Nsylvestris_NODE_16072_length_1443_cov_15","Ntome_NODE_8509_length_2412_cov_56",80.212,753,115,16,575,1307,1175,1913,9.11e-151,534,732,738
"52411","Nsylvestris_NODE_16073_length_1443_cov_10","Ntome_NODE_1438_length_4592_cov_123",93.646,1448,55,13,1,1441,905,2322,0,2130,1440,1417
"52416","Nsylvestris_NODE_16075_length_1442_cov_218","Ntome_NODE_16752_length_1470_cov_278",94.571,1271,56,9,11,1273,78,1343,0,1953,1262,1265
"52438","Nsylvestris_NODE_16083_length_1442_cov_23","Ntome_NODE_6179_length_2816_cov_81",91.124,169,14,1,1253,1421,2543,2710,1.73e-58,228,168,167
"52439","Nsylvestris_NODE_16084_length_1441_cov_213","Ntome_NODE_8535_length_2408_cov_38",86.425,1267,89,34,184,1379,1290,36,0,1310,1195,1254
"52444","Nsylvestris_NODE_16086_length_1441_cov_202","Ntome_NODE_1397_length_4635_cov_201",94.694,1093,52,4,295,1382,1828,737,0,1692,1087,1091
"52447","Nsylvestris_NODE_16088_length_1441_cov_188","Ntome_NODE_17015_length_1447_cov_175",95.19,1393,34,11,52,1430,4,1377,0,2170,1378,1373
"52451","Nsylvestris_NODE_16090_length_1441_cov_154","Ntome_NODE_12713_length_1871_cov_191",94.872,936,46,2,47,982,1652,719,0,1461,935,933
"52452","Nsylvestris_NODE_16091_length_1441_cov_149","Ntome_NODE_16780_length_1468_cov_77",95.672,1109,48,0,1,1109,1154,46,0,1783,1108,1108
"52462","Nsylvestris_NODE_16097_length_1440_cov_146","Ntome_NODE_23047_length_980_cov_50",93.85,813,28,8,536,1328,143,953,0,1205,792,810
"52496","Nsylvestris_NODE_16108_length_1439_cov_106","Ntome_NODE_17856_length_1370_cov_211",96.88,1282,33,5,1,1281,1276,1,0,2139,1280,1275
"52502","Nsylvestris_NODE_16112_length_1439_cov_31","Ntome_NODE_10846_length_2091_cov_118",91.221,1458,90,20,1,1438,1440,1,0,1949,1437,1439
"52508","Nsylvestris_NODE_16115_length_1439_cov_10","Ntome_NODE_16681_length_1478_cov_49",90.593,489,44,1,8,496,121,607,0,647,488,486
"52515","Nsylvestris_NODE_16119_length_1437_cov_213","Ntome_NODE_16773_length_1468_cov_272",95.507,1291,50,7,140,1426,140,1426,0,2056,1286,1286
"52520","Nsylvestris_NODE_16122_length_1437_cov_168","Ntome_NODE_16815_length_1464_cov_198",94.441,1439,62,14,1,1433,33,1459,0,2198,1432,1426
"52541","Nsylvestris_NODE_16130_length_1437_cov_49","Ntome_NODE_13551_length_1781_cov_136",93.372,1388,84,6,1,1387,33,1413,0,2047,1386,1380
"52545","Nsylvestris_NODE_16132_length_1437_cov_24","Ntome_NODE_4050_length_3335_cov_123",95.052,1152,54,3,123,1273,1254,105,0,1808,1150,1149
"52546","Nsylvestris_NODE_16133_length_1437_cov_21","Ntome_NODE_3590_length_3486_cov_239",98.182,55,1,0,1383,1437,336,390,5.07e-19,97.1,54,54
"52607","Nsylvestris_NODE_16153_length_1434_cov_220","Ntome_NODE_16137_length_1527_cov_261",94.788,1439,57,10,1,1433,1513,87,0,2226,1432,1426
"52640","Nsylvestris_NODE_16163_length_1433_cov_220","Ntome_NODE_9509_length_2268_cov_261",97.044,1218,31,5,1,1215,1397,182,0,2045,1214,1215
"52675","Nsylvestris_NODE_16173_length_1432_cov_192","Ntome_NODE_18957_length_1280_cov_63",97.684,1166,27,0,72,1237,55,1220,0,2004,1165,1165
"52737","Nsylvestris_NODE_16193_length_1430_cov_121","Ntome_NODE_9644_length_2246_cov_215",94.958,1071,48,5,2,1071,579,1644,0,1674,1069,1065
"52787","Nsylvestris_NODE_16210_length_1429_cov_34","Ntome_NODE_6197_length_2811_cov_282",92.72,261,12,4,154,409,2427,2685,2.69e-101,370,255,258
"52792","Nsylvestris_NODE_16212_length_1429_cov_9","Ntome_NODE_546_length_5902_cov_154",92.239,902,34,12,351,1228,2164,3053,0,1245,877,889
"52818","Nsylvestris_NODE_16222_length_1427_cov_220","Ntome_NODE_16218_length_1519_cov_285",95.139,1296,52,9,90,1379,45,1335,0,2034,1289,1290
"52819","Nsylvestris_NODE_16223_length_1427_cov_206","Ntome_NODE_19551_length_1229_cov_105",88.484,1207,98,12,80,1278,1182,9,0,1421,1198,1173
"52854","Nsylvestris_NODE_16235_length_1426_cov_180","Ntome_NODE_15572_length_1578_cov_120",94.807,1425,66,7,2,1424,2,1420,0,2215,1422,1418
"52855","Nsylvestris_NODE_16236_length_1426_cov_91","Ntome_NODE_36600_length_321_cov_4",97.196,321,9,0,809,1129,1,321,1.5e-153,544,320,320
"52879","Nsylvestris_NODE_16247_length_1425_cov_23","Ntome_NODE_16515_length_1495_cov_22",92.302,1299,67,18,134,1425,1328,56,0,1814,1291,1272
"52890","Nsylvestris_NODE_16252_length_1424_cov_118","Ntome_NODE_23590_length_949_cov_229",87.205,891,72,13,97,946,53,942,0,976,849,889
"52891","Nsylvestris_NODE_16253_length_1424_cov_109","Ntome_NODE_6512_length_2746_cov_158",95.071,913,37,5,390,1301,1457,2362,0,1430,911,905
"52892","Nsylvestris_NODE_16254_length_1424_cov_48","Ntome_NODE_9086_length_2324_cov_146",88.046,962,78,25,472,1419,1347,2285,0,1105,947,938
"52915","Nsylvestris_NODE_16263_length_1423_cov_177","Ntome_NODE_24099_length_918_cov_299",92.405,790,24,15,521,1283,18,798,0,1094,762,780
"52936","Nsylvestris_NODE_16271_length_1422_cov_104","Ntome_NODE_8926_length_2350_cov_61",91.176,782,36,11,245,997,782,1559,0,1031,752,777
"52937","Nsylvestris_NODE_16272_length_1422_cov_74","Ntome_NODE_3592_length_3486_cov_156",91.379,406,35,0,969,1374,3013,3418,1.92e-157,556,405,405
"52947","Nsylvestris_NODE_16277_length_1422_cov_25","Ntome_NODE_25604_length_827_cov_71",95.031,161,8,0,1214,1374,664,824,2.81e-66,254,160,160
"53011","Nsylvestris_NODE_16297_length_1420_cov_47","Ntome_NODE_7152_length_2630_cov_176",83.077,715,94,19,578,1284,1391,696,5.17e-178,625,706,695
"53012","Nsylvestris_NODE_16298_length_1420_cov_22","Ntome_NODE_23389_length_961_cov_10",92.029,966,60,4,232,1186,2,961,0,1341,954,959
"53025","Nsylvestris_NODE_16302_length_1418_cov_154","Ntome_NODE_17297_length_1420_cov_240",90.943,1082,55,12,9,1078,64,1114,0,1415,1069,1050
"53036","Nsylvestris_NODE_16306_length_1419_cov_63","Ntome_NODE_36230_length_332_cov_5",94.88,332,14,1,936,1267,1,329,3.24e-145,516,331,328
"53048","Nsylvestris_NODE_16311_length_1418_cov_129","Ntome_NODE_35974_length_339_cov_5",95.575,339,15,0,597,935,339,1,1.49e-153,544,338,338
"53049","Nsylvestris_NODE_16312_length_1418_cov_117","Ntome_NODE_17219_length_1428_cov_114",93.096,1318,88,3,102,1418,1380,65,0,1927,1316,1315
"53050","Nsylvestris_NODE_16313_length_1418_cov_46","Ntome_NODE_17166_length_1434_cov_50",96.022,1257,46,4,164,1418,1397,143,0,2041,1254,1254
"53071","Nsylvestris_NODE_16319_length_1417_cov_50","Ntome_NODE_16481_length_1498_cov_98",93.849,1203,51,7,46,1238,45,1234,0,1790,1192,1189
"53097","Nsylvestris_NODE_16329_length_1416_cov_183","Ntome_NODE_16084_length_1532_cov_249",96.74,1319,43,0,53,1371,58,1376,0,2198,1318,1318
"53098","Nsylvestris_NODE_16330_length_1416_cov_134","Ntome_NODE_14252_length_1710_cov_117",92.951,1220,63,14,87,1288,495,1709,0,1755,1201,1214
"53109","Nsylvestris_NODE_16335_length_1416_cov_30","Ntome_NODE_13578_length_1779_cov_53",96.358,1373,41,3,53,1416,1434,62,0,2250,1363,1372
"53110","Nsylvestris_NODE_16336_length_1416_cov_24","Ntome_NODE_14890_length_1645_cov_70",94.126,1379,77,3,33,1408,231,1608,0,2095,1375,1377
"53122","Nsylvestris_NODE_16341_length_1415_cov_181","Ntome_NODE_12440_length_1904_cov_236",93.893,1359,78,3,15,1369,1768,411,0,2045,1354,1357
"53134","Nsylvestris_NODE_16346_length_1415_cov_55","Ntome_NODE_1630_length_4434_cov_264",98.182,55,1,0,1361,1415,3258,3312,4.99e-19,97.1,54,54
"53146","Nsylvestris_NODE_16351_length_1414_cov_217","Ntome_NODE_6093_length_2831_cov_157",92.28,1386,58,20,60,1414,1404,2771,0,1921,1354,1367
"53152","Nsylvestris_NODE_16354_length_1414_cov_188","Ntome_NODE_21187_length_1103_cov_115",95.949,1012,30,5,356,1364,1,1004,0,1631,1008,1003
"53159","Nsylvestris_NODE_16357_length_1414_cov_113","Ntome_NODE_39344_length_261_cov_3",95.263,190,9,0,1110,1299,261,72,9.86e-81,302,189,189
"53160","Nsylvestris_NODE_16358_length_1414_cov_75","Ntome_NODE_37361_length_302_cov_6",85.354,198,17,6,1056,1243,1,196,1.72e-48,195,187,195
"53161","Nsylvestris_NODE_16359_length_1414_cov_55","Ntome_NODE_13860_length_1750_cov_69",93.309,1375,66,11,50,1414,306,1664,0,2006,1364,1358
"53162","Nsylvestris_NODE_16361_length_1414_cov_8","Ntome_NODE_12863_length_1855_cov_18",92.954,1334,61,18,104,1414,1570,247,0,1912,1310,1323
"53185","Nsylvestris_NODE_16369_length_1413_cov_30","Ntome_NODE_21093_length_1109_cov_29",88.636,132,14,1,263,394,1096,966,6.27e-38,159,131,130
"53200","Nsylvestris_NODE_16375_length_1412_cov_57","Ntome_NODE_22722_length_1002_cov_213",88.514,148,7,6,3,141,917,771,2.9e-41,171,138,146
"53203","Nsylvestris_NODE_16377_length_1412_cov_12","Ntome_NODE_23551_length_951_cov_129",89.744,78,8,0,1085,1162,917,840,3.85e-20,100,77,77
"53204","Nsylvestris_NODE_16378_length_1412_cov_9","Ntome_NODE_1385_length_4647_cov_137",96.062,1422,41,10,1,1412,2599,1183,0,2302,1411,1416
"53212","Nsylvestris_NODE_16383_length_1411_cov_142","Ntome_NODE_16940_length_1453_cov_134",95.18,1307,43,11,106,1411,163,1450,0,2047,1305,1287
"53248","Nsylvestris_NODE_16397_length_1410_cov_22","Ntome_NODE_36796_length_316_cov_4",92.434,304,17,2,849,1149,1,301,4.32e-119,429,300,300
"53249","Nsylvestris_NODE_16398_length_1410_cov_17","Ntome_NODE_8000_length_2491_cov_8",94.24,816,32,6,598,1410,1,804,0,1232,812,803
"53250","Nsylvestris_NODE_16399_length_1410_cov_11","Ntome_NODE_11798_length_1981_cov_119",100,55,0,0,1,55,499,445,1.07e-20,102,54,54
"53277","Nsylvestris_NODE_16408_length_1409_cov_25","Ntome_NODE_21975_length_1051_cov_29",82.763,847,119,14,161,986,841,1,0,730,825,840
"53284","Nsylvestris_NODE_16412_length_1409_cov_13","Ntome_NODE_15206_length_1613_cov_217",100,55,0,0,1355,1409,799,745,1.07e-20,102,54,54
"53304","Nsylvestris_NODE_16420_length_1408_cov_49","Ntome_NODE_2057_length_4137_cov_118",90.233,1290,82,7,150,1395,2677,3966,0,1644,1245,1289
"53312","Nsylvestris_NODE_16423_length_1400_cov_176","Ntome_NODE_13418_length_1794_cov_174",90.549,1111,62,26,304,1394,687,1774,0,1430,1090,1087
"53321","Nsylvestris_NODE_16427_length_1407_cov_111","Ntome_NODE_13407_length_1796_cov_68",95.337,1351,41,12,13,1359,2,1334,0,2126,1346,1332
"53330","Nsylvestris_NODE_16430_length_1407_cov_30","Ntome_NODE_13708_length_1767_cov_53",95.63,1167,51,0,241,1407,149,1315,0,1873,1166,1166
"53348","Nsylvestris_NODE_16436_length_1406_cov_157","Ntome_NODE_19034_length_1273_cov_202",95.341,1159,47,5,233,1386,47,1203,0,1834,1153,1156
"53356","Nsylvestris_NODE_16440_length_1406_cov_11","Ntome_NODE_7871_length_2513_cov_18",93.492,1383,90,0,1,1383,437,1819,0,2056,1382,1382
"53391","Nsylvestris_NODE_16454_length_1404_cov_199","Ntome_NODE_13955_length_1741_cov_198",95.552,1349,42,11,59,1398,24,1363,0,2143,1339,1339
"53397","Nsylvestris_NODE_16457_length_1404_cov_29","Ntome_NODE_24001_length_925_cov_7",95.264,929,40,2,73,1001,925,1,0,1469,928,924
"53419","Nsylvestris_NODE_16464_length_1387_cov_75","Ntome_NODE_4669_length_3166_cov_115",92.655,177,13,0,264,440,21,197,7.63e-67,255,176,176
"53440","Nsylvestris_NODE_16470_length_1402_cov_215","Ntome_NODE_18609_length_1307_cov_270",92.502,1227,78,6,57,1281,1250,36,0,1744,1224,1214
"53449","Nsylvestris_NODE_16474_length_1402_cov_54","Ntome_NODE_18787_length_1293_cov_137",94.118,1105,46,10,271,1362,47,1145,0,1663,1091,1098
"53456","Nsylvestris_NODE_16477_length_1402_cov_9","Ntome_NODE_37795_length_293_cov_3",95.563,293,10,2,223,515,4,293,3.27e-130,466,292,289
"53457","Nsylvestris_NODE_16478_length_1402_cov_8","Ntome_NODE_1197_length_4840_cov_56",78.205,1404,288,8,2,1399,2811,4202,0,881,1397,1391
"53470","Nsylvestris_NODE_16484_length_1401_cov_82","Ntome_NODE_15950_length_1543_cov_33",94.498,1345,51,6,8,1351,1523,201,0,2052,1343,1322
"53471","Nsylvestris_NODE_16485_length_1401_cov_58","Ntome_NODE_13963_length_1741_cov_25",96.53,1412,33,3,6,1401,207,1618,0,2322,1395,1411
"53483","Nsylvestris_NODE_16490_length_1401_cov_7","Ntome_NODE_5286_length_3011_cov_58",92.669,1405,99,3,1,1401,2288,884,0,2021,1400,1404
"53497","Nsylvestris_NODE_16495_length_1400_cov_63","Ntome_NODE_21937_length_1053_cov_17",94.156,1061,30,13,355,1396,1053,6,0,1587,1041,1047
"53501","Nsylvestris_NODE_16497_length_1400_cov_39","Ntome_NODE_12223_length_1930_cov_99",93.397,1151,67,8,1,1150,80,1222,0,1696,1149,1142
"53516","Nsylvestris_NODE_16504_length_1399_cov_213","Ntome_NODE_17662_length_1387_cov_135",100,51,0,0,1349,1399,1,51,1.78e-18,95.3,50,50
"53527","Nsylvestris_NODE_16508_length_1399_cov_39","Ntome_NODE_9093_length_2324_cov_224",92.623,122,9,0,60,181,1693,1814,6.16e-43,176,121,121
"53530","Nsylvestris_NODE_16510_length_1399_cov_27","Ntome_NODE_17806_length_1374_cov_48",91.089,1313,55,20,79,1372,5,1274,0,1720,1293,1269
"53544","Nsylvestris_NODE_16516_length_1398_cov_201","Ntome_NODE_15913_length_1546_cov_266",94.565,1196,61,4,159,1352,1281,88,0,1845,1193,1193
"53550","Nsylvestris_NODE_16519_length_1398_cov_122","Ntome_NODE_18494_length_1317_cov_222",95.37,1296,46,7,1,1294,15,1298,0,2049,1293,1283
"53559","Nsylvestris_NODE_16523_length_1398_cov_15","Ntome_NODE_36572_length_321_cov_4",91.489,329,16,3,432,757,2,321,5.5e-123,442,325,319
"53627","Nsylvestris_NODE_16544_length_1396_cov_20","Ntome_NODE_6525_length_2744_cov_113",95.545,651,26,3,748,1396,267,916,0,1038,648,649
"53628","Nsylvestris_NODE_16547_length_1395_cov_201","Ntome_NODE_15555_length_1579_cov_236",91.459,1323,71,18,51,1357,205,1501,0,1779,1306,1296
"53629","Nsylvestris_NODE_16548_length_1395_cov_196","Ntome_NODE_14825_length_1653_cov_202",92.533,1299,60,13,15,1300,1570,296,0,1827,1285,1274
"53633","Nsylvestris_NODE_16550_length_1395_cov_186","Ntome_NODE_17002_length_1448_cov_254",95.399,1304,49,6,44,1339,1441,141,0,2065,1295,1300
"53637","Nsylvestris_NODE_16552_length_1395_cov_172","Ntome_NODE_17926_length_1364_cov_228",93.765,1267,66,10,53,1310,102,1364,0,1890,1257,1262
"53638","Nsylvestris_NODE_16553_length_1395_cov_151","Ntome_NODE_16669_length_1479_cov_172",91.753,1358,49,19,54,1395,1311,1,0,1829,1341,1310
"53661","Nsylvestris_NODE_16562_length_1395_cov_17","Ntome_NODE_13412_length_1795_cov_50",75.472,1219,266,17,67,1273,1330,133,1.12e-159,564,1206,1197
"53681","Nsylvestris_NODE_16568_length_1394_cov_113","Ntome_NODE_17290_length_1421_cov_102",95.424,1180,39,5,1,1173,7,1178,0,1866,1172,1171
"53684","Nsylvestris_NODE_16570_length_1394_cov_91","Ntome_NODE_12255_length_1926_cov_156",91.781,146,12,0,482,627,1731,1586,2.82e-51,204,145,145
"53717","Nsylvestris_NODE_16582_length_1393_cov_77","Ntome_NODE_21475_length_1083_cov_276",97.143,525,15,0,827,1351,514,1038,0,887,524,524
"53728","Nsylvestris_NODE_16587_length_1392_cov_166","Ntome_NODE_7730_length_2536_cov_106",95.426,962,41,1,381,1342,1055,97,0,1530,961,958
"53735","Nsylvestris_NODE_16590_length_1392_cov_44","Ntome_NODE_16990_length_1450_cov_74",95.795,1403,36,12,8,1392,1,1398,0,2242,1384,1397
"53748","Nsylvestris_NODE_16595_length_1391_cov_211","Ntome_NODE_17432_length_1409_cov_82",96.04,1212,46,2,182,1391,1237,26,0,1971,1209,1211
"53756","Nsylvestris_NODE_16597_length_1391_cov_206","Ntome_NODE_8689_length_2386_cov_257",95.505,1357,47,4,39,1391,2077,731,0,2156,1352,1346
"53788","Nsylvestris_NODE_16609_length_1390_cov_209","Ntome_NODE_17893_length_1367_cov_88",92.53,1352,56,17,1,1348,8,1318,0,1895,1347,1310
"53794","Nsylvestris_NODE_16612_length_1390_cov_145","Ntome_NODE_18428_length_1323_cov_111",88.93,1355,71,13,6,1330,1306,1,0,1598,1324,1305
"53795","Nsylvestris_NODE_16613_length_1390_cov_133","Ntome_NODE_20978_length_1118_cov_6",91.682,1118,58,15,57,1172,1118,34,0,1517,1115,1084
"53802","Nsylvestris_NODE_16616_length_1390_cov_92","Ntome_NODE_37693_length_295_cov_4",97.966,295,6,0,449,743,295,1,4.11e-144,512,294,294
"53828","Nsylvestris_NODE_16618_length_1390_cov_12","Ntome_NODE_3165_length_3632_cov_195",91.547,1396,69,16,2,1390,1767,414,0,1879,1388,1353
"53838","Nsylvestris_NODE_16624_length_1389_cov_154","Ntome_NODE_18343_length_1330_cov_224",94.414,1110,41,9,3,1109,1301,210,0,1687,1106,1091
"53851","Nsylvestris_NODE_16630_length_1388_cov_190","Ntome_NODE_17488_length_1404_cov_270",94.349,1398,62,9,1,1388,1,1391,0,2128,1387,1390
"53878","Nsylvestris_NODE_16638_length_1387_cov_173","Ntome_NODE_2094_length_4112_cov_264",96.037,1312,29,6,14,1320,1,1294,0,2113,1306,1293
"53890","Nsylvestris_NODE_16643_length_1386_cov_212","Ntome_NODE_14118_length_1725_cov_167",93.197,1323,72,6,48,1364,1707,397,0,1929,1316,1310
"53925","Nsylvestris_NODE_16655_length_1385_cov_163","Ntome_NODE_24890_length_870_cov_10",96.076,739,29,0,535,1273,74,812,0,1205,738,738
"53933","Nsylvestris_NODE_16658_length_1384_cov_25","Ntome_NODE_1988_length_4182_cov_198",90.674,193,17,1,201,392,409,601,7.61e-67,255,191,192
"53947","Nsylvestris_NODE_16664_length_1384_cov_192","Ntome_NODE_15227_length_1611_cov_206",92.018,1303,69,15,56,1333,94,1386,0,1797,1277,1292
"53974","Nsylvestris_NODE_16676_length_1383_cov_93","Ntome_NODE_19039_length_1273_cov_97",95.093,1182,49,1,158,1330,1237,56,0,1853,1172,1181
"53975","Nsylvestris_NODE_16677_length_1383_cov_17","Ntome_NODE_13025_length_1839_cov_72",96.959,1381,42,0,3,1383,1447,67,0,2318,1380,1380
"54006","Nsylvestris_NODE_16688_length_1382_cov_65","Ntome_NODE_2669_length_3828_cov_151",94.886,176,9,0,481,656,933,758,5.84e-73,276,175,175
"54010","Nsylvestris_NODE_16691_length_1382_cov_28","Ntome_NODE_16303_length_1512_cov_62",93.463,1392,66,7,7,1374,1436,46,0,2043,1367,1390
"54014","Nsylvestris_NODE_16693_length_1382_cov_19","Ntome_NODE_2310_length_4001_cov_73",93.22,59,3,1,261,318,3815,3757,1.06e-15,86.1,57,58
"54019","Nsylvestris_NODE_16695_length_1381_cov_209","Ntome_NODE_18215_length_1341_cov_208",96.748,1230,37,3,33,1260,1278,50,0,2047,1227,1228
"54069","Nsylvestris_NODE_16705_length_1381_cov_22","Ntome_NODE_17664_length_1387_cov_25",95.977,1367,51,2,7,1369,1367,1,0,2217,1362,1366
"54070","Nsylvestris_NODE_16706_length_1381_cov_20","Ntome_NODE_6918_length_2670_cov_182",90.361,83,6,1,571,653,729,809,2.25e-22,108,82,80
"54080","Nsylvestris_NODE_16711_length_1380_cov_212","Ntome_NODE_11179_length_2051_cov_261",97.55,1306,31,1,1,1305,621,1926,0,2233,1304,1305
"54081","Nsylvestris_NODE_16712_length_1380_cov_180","Ntome_NODE_15168_length_1616_cov_212",91.47,973,52,5,429,1380,1189,227,0,1308,951,962
"54097","Nsylvestris_NODE_16718_length_1379_cov_159","Ntome_NODE_6236_length_2801_cov_155",94.902,1275,60,3,5,1279,2383,1114,0,1989,1274,1269
"54110","Nsylvestris_NODE_16722_length_1379_cov_81","Ntome_NODE_17298_length_1420_cov_228",93.913,1265,63,12,81,1342,1419,166,0,1897,1261,1253
"54111","Nsylvestris_NODE_16723_length_1379_cov_46","Ntome_NODE_13665_length_1771_cov_117",96.407,1336,37,2,55,1379,221,1556,0,2191,1324,1335
"54122","Nsylvestris_NODE_16727_length_1378_cov_212","Ntome_NODE_5967_length_2855_cov_222",93.398,1333,60,17,1,1323,2727,1413,0,1949,1322,1314
"54129","Nsylvestris_NODE_16730_length_1378_cov_160","Ntome_NODE_2937_length_3722_cov_224",97.968,1329,27,0,1,1329,1412,84,0,2305,1328,1328
"54138","Nsylvestris_NODE_16733_length_1378_cov_48","Ntome_NODE_30487_length_609_cov_35",89.176,619,34,8,52,664,592,1,0,741,612,591
"54139","Nsylvestris_NODE_16734_length_1378_cov_26","Ntome_NODE_20866_length_1127_cov_23",94.844,1125,57,1,201,1324,3,1127,0,1755,1123,1124
"54156","Nsylvestris_NODE_16737_length_1377_cov_236","Ntome_NODE_1856_length_4267_cov_240",96.825,1260,37,1,118,1377,2651,3907,0,2102,1259,1256
"54164","Nsylvestris_NODE_16739_length_1377_cov_208","Ntome_NODE_17674_length_1386_cov_83",93.285,1236,78,5,89,1321,16,1249,0,1818,1232,1233
"54167","Nsylvestris_NODE_16741_length_1377_cov_189","Ntome_NODE_18586_length_1309_cov_255",88.889,468,52,0,431,898,919,452,1.42e-163,577,467,467
"54179","Nsylvestris_NODE_16744_length_1377_cov_150","Ntome_NODE_19239_length_1256_cov_246",93.374,981,52,8,52,1027,1164,192,0,1439,975,972
"54183","Nsylvestris_NODE_16748_length_1377_cov_56","Ntome_NODE_191_length_7484_cov_127",93.458,749,32,10,172,913,7375,6637,0,1096,741,738
"54196","Nsylvestris_NODE_16753_length_1376_cov_211","Ntome_NODE_2732_length_3800_cov_41",94.396,803,45,0,574,1376,2827,2025,0,1234,802,802
"54197","Nsylvestris_NODE_16754_length_1376_cov_211","Ntome_NODE_15552_length_1579_cov_249",95.94,1330,38,6,13,1336,1363,44,0,2143,1323,1319
"54201","Nsylvestris_NODE_16756_length_1373_cov_144","Ntome_NODE_18044_length_1354_cov_129",95.715,1237,43,5,38,1273,119,1346,0,1982,1235,1227
"54208","Nsylvestris_NODE_16760_length_1376_cov_26","Ntome_NODE_15204_length_1613_cov_280",85.083,905,116,7,74,961,1199,297,0,905,887,902
"54209","Nsylvestris_NODE_16761_length_1376_cov_7","Ntome_NODE_468_length_6109_cov_236",98.113,53,1,0,3,55,3901,3953,6.28e-18,93.5,52,52
"54249","Nsylvestris_NODE_16779_length_1374_cov_35","Ntome_NODE_5840_length_2886_cov_188",96.364,55,2,0,1320,1374,2576,2522,2.26e-17,91.6,54,54
"54277","Nsylvestris_NODE_16790_length_1373_cov_182","Ntome_NODE_16902_length_1456_cov_219",90.538,1226,81,19,166,1368,1300,87,0,1589,1202,1213
"54305","Nsylvestris_NODE_16801_length_1372_cov_117","Ntome_NODE_18522_length_1314_cov_280",92.58,1213,63,9,101,1307,1249,58,0,1716,1206,1191
"54314","Nsylvestris_NODE_16805_length_1372_cov_48","Ntome_NODE_16582_length_1488_cov_289",94.992,1278,60,1,1,1274,55,1332,0,2002,1273,1277
"54323","Nsylvestris_NODE_16810_length_1371_cov_224","Ntome_NODE_17574_length_1395_cov_290",95.519,1272,54,1,55,1323,1,1272,0,2030,1268,1271
"54336","Nsylvestris_NODE_16814_length_1371_cov_174","Ntome_NODE_21770_length_1063_cov_244",92.338,1018,65,9,332,1345,55,1063,0,1435,1013,1008
"54349","Nsylvestris_NODE_16819_length_1370_cov_222","Ntome_NODE_17971_length_1360_cov_301",89.879,1324,76,35,1,1290,1354,55,0,1650,1289,1299
"54374","Nsylvestris_NODE_16828_length_1370_cov_21","Ntome_NODE_8360_length_2433_cov_86",94.326,1357,67,6,13,1366,2360,1011,0,2071,1353,1349
"54375","Nsylvestris_NODE_16829_length_1370_cov_20","Ntome_NODE_17553_length_1398_cov_32",79.286,140,21,6,464,599,314,449,2.25e-17,91.6,135,135
"54403","Nsylvestris_NODE_16839_length_1369_cov_19","Ntome_NODE_32598_length_506_cov_8",90.323,93,8,1,1272,1364,223,132,2.87e-26,121,92,91
"54445","Nsylvestris_NODE_16854_length_1367_cov_210","Ntome_NODE_23491_length_955_cov_75",94.35,708,38,2,266,971,198,905,0,1085,705,707
"54446","Nsylvestris_NODE_16855_length_1367_cov_209","Ntome_NODE_2387_length_3967_cov_191",91.443,1344,85,17,36,1367,3911,2586,0,1818,1331,1325
"54451","Nsylvestris_NODE_16857_length_1367_cov_194","Ntome_NODE_18505_length_1316_cov_259",93.286,1266,68,9,1,1249,51,1316,0,1851,1248,1265
"54454","Nsylvestris_NODE_16859_length_1367_cov_177","Ntome_NODE_1136_length_4912_cov_195",95.701,1349,43,6,24,1367,12,1350,0,2156,1343,1338
"54455","Nsylvestris_NODE_16860_length_1367_cov_145","Ntome_NODE_20072_length_1186_cov_172",95.14,1111,51,2,83,1193,1,1108,0,1749,1110,1107
"54474","Nsylvestris_NODE_16867_length_1367_cov_63","Ntome_NODE_19868_length_1204_cov_10",93.383,1209,54,13,141,1331,4,1204,0,1766,1190,1200
"54477","Nsylvestris_NODE_16869_length_1367_cov_48","Ntome_NODE_14819_length_1654_cov_67",91.81,1392,81,17,1,1367,1651,268,0,1908,1366,1383
"54480","Nsylvestris_NODE_16871_length_1367_cov_34","Ntome_NODE_15447_length_1589_cov_42",90.722,873,30,7,1,825,1540,671,0,1116,824,869
"54493","Nsylvestris_NODE_16877_length_1366_cov_170","Ntome_NODE_22068_length_1043_cov_276",88.144,641,73,3,504,1141,294,934,0,760,637,640
"54497","Nsylvestris_NODE_16879_length_1366_cov_134","Ntome_NODE_18920_length_1282_cov_136",89.837,1289,69,23,68,1331,1,1252,0,1598,1263,1251
"54498","Nsylvestris_NODE_16881_length_1366_cov_85","Ntome_NODE_16228_length_1518_cov_243",91.783,1363,68,22,2,1332,57,1407,0,1857,1330,1350
"54506","Nsylvestris_NODE_16886_length_1366_cov_34","Ntome_NODE_13097_length_1832_cov_13",94.849,1262,63,2,51,1311,519,1779,0,1969,1260,1260
"54510","Nsylvestris_NODE_16888_length_1366_cov_6","Ntome_NODE_353_length_6496_cov_280",80.894,1298,236,9,8,1299,4150,5441,0,1013,1291,1291
"54511","Nsylvestris_NODE_16889_length_1366_cov_5","Ntome_NODE_33460_length_448_cov_13",94.152,171,10,0,843,1013,207,37,1.61e-68,261,170,170
"54532","Nsylvestris_NODE_16897_length_1365_cov_87","Ntome_NODE_18687_length_1302_cov_29",90.625,1280,61,15,62,1310,1252,1,0,1644,1248,1251
"54538","Nsylvestris_NODE_16900_length_1365_cov_69","Ntome_NODE_39195_length_264_cov_2",92.893,197,14,0,1121,1317,1,197,2.66e-76,287,196,196
"54539","Nsylvestris_NODE_16901_length_1365_cov_64","Ntome_NODE_27256_length_746_cov_8",95.699,744,32,0,569,1312,746,3,0,1197,743,743
"54551","Nsylvestris_NODE_16906_length_1364_cov_204","Ntome_NODE_16354_length_1508_cov_244",96.806,1127,33,2,1,1125,1488,363,0,1879,1124,1125
"54552","Nsylvestris_NODE_16907_length_1364_cov_204","Ntome_NODE_17077_length_1441_cov_214",96.37,1350,37,5,3,1343,18,1364,0,2211,1340,1346
"54565","Nsylvestris_NODE_16912_length_1364_cov_144","Ntome_NODE_22987_length_984_cov_53",94.538,952,31,6,413,1351,944,1,0,1450,938,943
"54568","Nsylvestris_NODE_16914_length_1364_cov_50","Ntome_NODE_34411_length_400_cov_2",90.647,417,12,4,205,612,1,399,4e-149,529,407,398
"54579","Nsylvestris_NODE_16920_length_1363_cov_187","Ntome_NODE_16194_length_1521_cov_238",94.254,1340,50,13,1,1327,1443,118,0,2023,1326,1325
"54584","Nsylvestris_NODE_16922_length_1364_cov_86","Ntome_NODE_10077_length_2190_cov_69",98.182,55,1,0,1310,1364,448,394,4.81e-19,97.1,54,54
"54585","Nsylvestris_NODE_16924_length_1363_cov_26","Ntome_NODE_606_length_5759_cov_160",94.557,1286,65,2,1,1286,2386,3666,0,1982,1285,1280
"54591","Nsylvestris_NODE_16927_length_1363_cov_15","Ntome_NODE_17570_length_1396_cov_33",95.158,1363,60,3,1,1363,1357,1,0,2146,1362,1356
"54598","Nsylvestris_NODE_16931_length_1362_cov_172","Ntome_NODE_17892_length_1367_cov_141",92.188,1216,79,11,4,1208,1318,108,0,1705,1204,1210
"54607","Nsylvestris_NODE_16936_length_1362_cov_30","Ntome_NODE_21746_length_1065_cov_41",93.041,1049,34,10,252,1300,56,1065,0,1496,1048,1009
"54617","Nsylvestris_NODE_16940_length_1362_cov_7","Ntome_NODE_1745_length_4349_cov_94",97.173,1344,36,2,1,1344,1765,424,0,2270,1343,1341
"54624","Nsylvestris_NODE_16943_length_1355_cov_115","Ntome_NODE_17950_length_1363_cov_23",96.755,1325,43,0,21,1345,1325,1,0,2209,1324,1324
"54625","Nsylvestris_NODE_16944_length_1361_cov_67","Ntome_NODE_16422_length_1503_cov_127",93.5,1277,69,10,7,1281,188,1452,0,1886,1274,1264
"54629","Nsylvestris_NODE_16946_length_1361_cov_35","Ntome_NODE_21474_length_1084_cov_2",86.594,1104,125,12,50,1150,1,1084,0,1197,1100,1083
"54641","Nsylvestris_NODE_16952_length_1360_cov_205","Ntome_NODE_1118_length_4929_cov_196",92.376,1233,77,6,79,1310,4929,3713,0,1740,1231,1216
"54660","Nsylvestris_NODE_16960_length_1360_cov_24","Ntome_NODE_35456_length_356_cov_5",97.183,284,8,0,1077,1360,2,285,1.13e-134,481,283,283
"54661","Nsylvestris_NODE_16961_length_1360_cov_23","Ntome_NODE_17275_length_1422_cov_253",93.684,1045,66,0,51,1095,1342,298,0,1565,1044,1044
"54664","Nsylvestris_NODE_16965_length_1360_cov_8","Ntome_NODE_35420_length_357_cov_6",91.573,356,30,0,613,968,356,1,5.24e-138,492,355,355
"54677","Nsylvestris_NODE_16970_length_1358_cov_193","Ntome_NODE_2368_length_3978_cov_159",93.683,1219,58,8,104,1316,2727,3932,0,1807,1212,1205
"54683","Nsylvestris_NODE_16973_length_1359_cov_134","Ntome_NODE_19754_length_1214_cov_140",92.632,1208,47,17,163,1359,1192,16,0,1700,1196,1176
"54689","Nsylvestris_NODE_16975_length_1359_cov_63","Ntome_NODE_25364_length_840_cov_223",91.328,369,28,3,175,540,780,413,8.69e-141,501,365,367
"54696","Nsylvestris_NODE_16978_length_1359_cov_19","Ntome_NODE_14229_length_1712_cov_85",86.073,1156,161,0,125,1280,1549,394,0,1243,1155,1155
"54697","Nsylvestris_NODE_16979_length_1359_cov_15","Ntome_NODE_34760_length_384_cov_7",97.598,333,8,0,997,1329,383,51,6.53e-162,571,332,332
"54698","Nsylvestris_NODE_16980_length_1359_cov_8","Ntome_NODE_12828_length_1859_cov_11",92.108,1001,54,8,5,1003,978,1,0,1387,998,977
"54736","Nsylvestris_NODE_16992_length_1358_cov_170","Ntome_NODE_20381_length_1163_cov_14",95.193,1165,53,2,54,1217,1,1163,0,1838,1163,1162
"54795","Nsylvestris_NODE_17014_length_1356_cov_162","Ntome_NODE_27296_length_744_cov_2",95.302,745,25,7,534,1274,1,739,0,1173,740,738
"54801","Nsylvestris_NODE_17017_length_1356_cov_17","Ntome_NODE_10934_length_2082_cov_26",96.239,1356,49,1,1,1356,2061,708,0,2220,1355,1353
"54805","Nsylvestris_NODE_17019_length_1356_cov_10","Ntome_NODE_22353_length_1025_cov_291",97.917,48,1,0,1307,1354,677,724,3.72e-15,84.2,47,47
"54814","Nsylvestris_NODE_17023_length_1355_cov_201","Ntome_NODE_15795_length_1558_cov_277",91.753,1358,62,14,2,1328,157,1495,0,1842,1326,1338
"54828","Nsylvestris_NODE_17028_length_1355_cov_75","Ntome_NODE_18723_length_1298_cov_145",92.105,1178,83,6,180,1350,1253,79,0,1652,1170,1174
"54846","Nsylvestris_NODE_17034_length_1354_cov_124","Ntome_NODE_6402_length_2766_cov_252",92.442,1032,47,7,350,1351,19,1049,0,1445,1001,1030
"54847","Nsylvestris_NODE_17035_length_1354_cov_106","Ntome_NODE_20251_length_1173_cov_293",92.589,958,41,14,111,1038,7,964,0,1349,927,957
"54862","Nsylvestris_NODE_17041_length_1354_cov_24","Ntome_NODE_17421_length_1411_cov_111",95.174,1181,48,6,58,1235,1221,47,0,1857,1177,1174
"54870","Nsylvestris_NODE_17047_length_1353_cov_182","Ntome_NODE_19549_length_1229_cov_289",92.07,1198,65,9,25,1211,1,1179,0,1659,1186,1178
"54871","Nsylvestris_NODE_17048_length_1353_cov_56","Ntome_NODE_4396_length_3240_cov_43",81.792,1060,155,22,69,1114,1775,2810,0,854,1045,1035
"54900","Nsylvestris_NODE_17060_length_1352_cov_112","Ntome_NODE_11405_length_2025_cov_147",94.444,126,7,0,1018,1143,128,253,1.64e-48,195,125,125
"54901","Nsylvestris_NODE_17061_length_1352_cov_32","Ntome_NODE_13926_length_1744_cov_101",89.683,126,11,2,136,260,1565,1441,6e-38,159,124,124
"54921","Nsylvestris_NODE_17068_length_1351_cov_69","Ntome_NODE_31844_length_559_cov_5",92.308,559,22,7,291,828,1,559,0,774,537,558
"54922","Nsylvestris_NODE_17069_length_1351_cov_54","Ntome_NODE_32491_length_514_cov_140",95.882,340,8,2,1,334,504,165,3.94e-154,545,333,339
"54935","Nsylvestris_NODE_17074_length_1351_cov_38","Ntome_NODE_9398_length_2281_cov_196",93.395,1302,69,9,52,1348,956,2245,0,1912,1296,1289
"55044","Nsylvestris_NODE_17110_length_1349_cov_220","Ntome_NODE_4555_length_3195_cov_220",96.364,55,2,0,1,55,1003,949,2.21e-17,91.6,54,54
"55065","Nsylvestris_NODE_17118_length_1347_cov_42","Ntome_NODE_16447_length_1501_cov_154",91.205,1319,103,7,42,1347,67,1385,0,1781,1305,1318
"55072","Nsylvestris_NODE_17121_length_1347_cov_18","Ntome_NODE_17515_length_1402_cov_16",95.836,1345,49,3,4,1346,1341,2,0,2167,1342,1339
"55087","Nsylvestris_NODE_17128_length_1346_cov_182","Ntome_NODE_4703_length_3159_cov_160",90.872,734,51,7,344,1073,2392,3113,0,970,729,721
"55097","Nsylvestris_NODE_17131_length_1346_cov_105","Ntome_NODE_25023_length_862_cov_32",94.016,869,27,8,476,1326,1,862,0,1293,850,861
"55125","Nsylvestris_NODE_17141_length_1344_cov_214","Ntome_NODE_7688_length_2542_cov_268",94.098,1203,40,12,125,1313,1186,1,0,1799,1188,1185
"55128","Nsylvestris_NODE_17143_length_1344_cov_201","Ntome_NODE_7320_length_2600_cov_266",96.054,1267,49,1,1,1266,1319,53,0,2061,1265,1266
"55134","Nsylvestris_NODE_17146_length_1344_cov_160","Ntome_NODE_20208_length_1176_cov_224",96.237,1116,35,4,119,1227,44,1159,0,1821,1108,1115
"55139","Nsylvestris_NODE_17150_length_1344_cov_56","Ntome_NODE_5479_length_2967_cov_272",84.541,207,32,0,681,887,563,357,7.55e-52,206,206,206
"55152","Nsylvestris_NODE_17156_length_1343_cov_190","Ntome_NODE_1553_length_4494_cov_152",96.398,1055,35,1,231,1285,1008,2059,0,1735,1054,1051
"55158","Nsylvestris_NODE_17159_length_1343_cov_171","Ntome_NODE_10570_length_2124_cov_80",93.702,1302,57,10,1,1293,801,2086,0,1927,1292,1285
"55159","Nsylvestris_NODE_17160_length_1343_cov_170","Ntome_NODE_15715_length_1566_cov_270",80.471,594,89,18,317,892,378,962,4.11e-119,429,575,584
"55168","Nsylvestris_NODE_17164_length_1343_cov_65","Ntome_NODE_4102_length_3319_cov_113",91.817,1332,76,15,19,1339,1575,2884,0,1825,1320,1309
"55171","Nsylvestris_NODE_17166_length_1343_cov_12","Ntome_NODE_18209_length_1342_cov_15",94.273,1327,60,9,1,1315,20,1342,0,2015,1314,1322
"55172","Nsylvestris_NODE_17167_length_1343_cov_10","Ntome_NODE_19547_length_1230_cov_17",80.107,1126,166,33,63,1170,1086,1,0,785,1107,1085
"55173","Nsylvestris_NODE_17168_length_1343_cov_9","Ntome_NODE_3521_length_3509_cov_204",78.684,380,57,12,226,601,2384,2743,1.24e-59,231,375,359
"55180","Nsylvestris_NODE_17171_length_1342_cov_171","Ntome_NODE_26916_length_763_cov_12",90.064,312,21,8,1031,1340,240,543,4.17e-109,396,309,303
"55183","Nsylvestris_NODE_17173_length_1342_cov_93","Ntome_NODE_22970_length_985_cov_127",94.688,979,35,7,32,994,981,4,0,1504,962,977
"55186","Nsylvestris_NODE_17175_length_1342_cov_88","Ntome_NODE_18601_length_1308_cov_202",92.914,1129,54,14,57,1160,1258,131,0,1618,1103,1127
"55197","Nsylvestris_NODE_17180_length_1342_cov_31","Ntome_NODE_5868_length_2880_cov_74",96.568,437,15,0,210,646,2312,1876,0,725,436,436
"55202","Nsylvestris_NODE_17182_length_1342_cov_16","Ntome_NODE_12938_length_1848_cov_56",91.818,1320,106,2,23,1342,1750,433,0,1838,1319,1317
"55214","Nsylvestris_NODE_17186_length_1341_cov_216","Ntome_NODE_16411_length_1504_cov_238",95.138,1234,42,6,56,1278,1346,120,0,1930,1222,1226
"55215","Nsylvestris_NODE_17187_length_1341_cov_215","Ntome_NODE_18952_length_1280_cov_250",95.185,1163,52,2,63,1221,1209,47,0,1834,1158,1162
"55236","Nsylvestris_NODE_17195_length_1341_cov_9","Ntome_NODE_7777_length_2528_cov_63",92.132,1182,93,0,4,1185,2386,1205,0,1668,1181,1181
"55241","Nsylvestris_NODE_17197_length_1340_cov_198","Ntome_NODE_19387_length_1243_cov_254",95.522,871,30,4,124,994,1240,379,0,1384,870,861
"55265","Nsylvestris_NODE_17206_length_1341_cov_15","Ntome_NODE_31971_length_552_cov_23",86.364,352,43,3,467,815,188,537,4.19e-104,379,348,349
"55266","Nsylvestris_NODE_17207_length_1340_cov_5","Ntome_NODE_3656_length_3468_cov_47",72.348,528,122,12,427,930,2167,1640,1.66e-33,145,503,527
"55288","Nsylvestris_NODE_17216_length_1339_cov_37","Ntome_NODE_20482_length_1155_cov_16",92.514,1082,58,9,20,1086,1154,81,0,1528,1066,1073
"55289","Nsylvestris_NODE_17217_length_1339_cov_24","Ntome_NODE_22669_length_1005_cov_113",79.127,527,93,10,153,675,951,438,1.18e-94,348,522,513
"55290","Nsylvestris_NODE_17218_length_1339_cov_21","Ntome_NODE_2377_length_3972_cov_73",79.137,139,22,4,1,137,1473,1340,7.9e-17,89.8,136,133
"55291","Nsylvestris_NODE_17220_length_1339_cov_14","Ntome_NODE_6744_length_2705_cov_33",96.145,1297,49,1,43,1339,2072,777,0,2117,1296,1295
"55301","Nsylvestris_NODE_17224_length_1338_cov_206","Ntome_NODE_16803_length_1465_cov_263",94.829,1315,38,5,12,1297,1465,152,0,2025,1285,1313
"55306","Nsylvestris_NODE_17227_length_1338_cov_141","Ntome_NODE_19555_length_1229_cov_10",92.421,1227,56,10,127,1319,1224,1,0,1716,1192,1223
"55313","Nsylvestris_NODE_17230_length_1338_cov_40","Ntome_NODE_8529_length_2408_cov_202",80.67,776,102,28,1,751,969,217,5.01e-158,558,750,752
"55314","Nsylvestris_NODE_17231_length_1338_cov_20","Ntome_NODE_8508_length_2412_cov_61",91.969,635,51,0,3,637,315,949,0,891,634,634
"55327","Nsylvestris_NODE_17235_length_1337_cov_188","Ntome_NODE_18335_length_1331_cov_236",94.804,1251,59,3,1,1248,42,1289,0,1945,1247,1247
"55330","Nsylvestris_NODE_17237_length_1337_cov_135","Ntome_NODE_7365_length_2592_cov_69",91.736,1319,80,5,22,1337,2451,1159,0,1805,1315,1292
"55345","Nsylvestris_NODE_17243_length_1337_cov_22","Ntome_NODE_39072_length_266_cov_2",98.496,266,4,0,628,893,266,1,2.41e-131,470,265,265
"55365","Nsylvestris_NODE_17250_length_1336_cov_141","Ntome_NODE_1679_length_4403_cov_151",95.682,1019,43,1,165,1182,351,1369,0,1637,1017,1018
"55369","Nsylvestris_NODE_17252_length_1336_cov_60","Ntome_NODE_986_length_5110_cov_73",96.183,1336,51,0,1,1336,902,2237,0,2185,1335,1335
"55370","Nsylvestris_NODE_17254_length_1336_cov_29","Ntome_NODE_17119_length_1438_cov_33",78.723,376,62,10,758,1121,827,458,9.57e-61,235,363,369
"55388","Nsylvestris_NODE_17262_length_1335_cov_172","Ntome_NODE_24080_length_919_cov_263",95.517,870,23,3,54,922,872,18,0,1376,868,854
"55396","Nsylvestris_NODE_17265_length_1335_cov_104","Ntome_NODE_24088_length_919_cov_78",90.642,919,47,16,416,1304,10,919,0,1184,888,909
"55416","Nsylvestris_NODE_17272_length_1334_cov_218","Ntome_NODE_16262_length_1515_cov_224",91.673,1297,87,12,54,1334,124,1415,0,1777,1280,1291
"55419","Nsylvestris_NODE_17274_length_1334_cov_201","Ntome_NODE_18362_length_1329_cov_71",94.406,1287,64,4,15,1297,1,1283,0,1971,1282,1282
"55431","Nsylvestris_NODE_17278_length_1334_cov_173","Ntome_NODE_20271_length_1171_cov_240",96.233,1115,41,1,3,1117,1163,50,0,1825,1114,1113
"55443","Nsylvestris_NODE_17283_length_1333_cov_231","Ntome_NODE_15023_length_1632_cov_238",95.062,1053,42,6,50,1092,83,1135,0,1648,1042,1052
"55454","Nsylvestris_NODE_17287_length_1333_cov_149","Ntome_NODE_21514_length_1080_cov_230",95.022,924,43,2,152,1072,76,999,0,1448,920,923
"55472","Nsylvestris_NODE_17294_length_1332_cov_204","Ntome_NODE_19694_length_1218_cov_250",91.604,1072,72,10,118,1176,1109,43,0,1465,1058,1066
"55500","Nsylvestris_NODE_17305_length_1331_cov_164","Ntome_NODE_20683_length_1139_cov_209",96.269,1099,38,3,234,1331,1139,43,0,1799,1097,1096
"55511","Nsylvestris_NODE_17309_length_1331_cov_75","Ntome_NODE_2167_length_4077_cov_278",92.446,1112,50,12,1,1109,22,1102,0,1557,1108,1080
"55538","Nsylvestris_NODE_17319_length_1330_cov_208","Ntome_NODE_9530_length_2266_cov_181",90.648,1080,84,8,49,1114,1973,897,0,1419,1065,1076
"55545","Nsylvestris_NODE_17322_length_1330_cov_89","Ntome_NODE_5823_length_2890_cov_115",83.364,541,56,21,416,926,2567,2031,2.4e-131,470,510,536
"55573","Nsylvestris_NODE_17332_length_1329_cov_19","Ntome_NODE_2843_length_3759_cov_214",80.326,737,98,24,245,968,3353,2651,1.09e-144,514,723,702
"55594","Nsylvestris_NODE_17339_length_1328_cov_167","Ntome_NODE_16385_length_1506_cov_230",93.622,1270,50,6,88,1328,214,1481,0,1868,1240,1267
"55626","Nsylvestris_NODE_17351_length_1327_cov_134","Ntome_NODE_13615_length_1775_cov_152",92.95,1305,73,10,39,1325,1321,18,0,1882,1286,1303
"55629","Nsylvestris_NODE_17353_length_1327_cov_79","Ntome_NODE_17818_length_1373_cov_82",91.82,1308,61,20,43,1325,1287,1,0,1781,1282,1286
"55636","Nsylvestris_NODE_17356_length_1327_cov_16","Ntome_NODE_27591_length_728_cov_143",89.032,310,30,4,631,938,1,308,1.15e-104,381,307,307
"55664","Nsylvestris_NODE_17366_length_1325_cov_180","Ntome_NODE_19371_length_1245_cov_237",95.597,1113,44,5,1,1111,1240,131,0,1779,1110,1109
"55673","Nsylvestris_NODE_17370_length_1325_cov_121","Ntome_NODE_20444_length_1158_cov_96",93.043,1035,48,12,8,1034,1111,93,0,1491,1026,1018
"55674","Nsylvestris_NODE_17371_length_1325_cov_109","Ntome_NODE_33225_length_462_cov_3",80.851,141,19,7,1190,1325,448,311,2.79e-21,104,135,137
"55706","Nsylvestris_NODE_17382_length_1324_cov_114","Ntome_NODE_1665_length_4413_cov_205",91.013,1046,54,12,294,1318,3387,4413,0,1375,1024,1026
"55723","Nsylvestris_NODE_17388_length_1324_cov_51","Ntome_NODE_7245_length_2615_cov_215",79.769,173,34,1,697,869,1049,878,2.14e-27,124,172,171
"55731","Nsylvestris_NODE_17390_length_1324_cov_34","Ntome_NODE_16709_length_1475_cov_269",77.73,467,93,8,273,733,1225,764,5.59e-73,276,460,461
"55732","Nsylvestris_NODE_17391_length_1324_cov_22","Ntome_NODE_5271_length_3014_cov_123",81.567,906,141,15,286,1187,922,39,0,725,901,883
"55733","Nsylvestris_NODE_17392_length_1324_cov_16","Ntome_NODE_8395_length_2428_cov_92",81.851,1102,186,10,177,1269,1706,610,0,915,1092,1096
"55737","Nsylvestris_NODE_17394_length_1323_cov_169","Ntome_NODE_16226_length_1519_cov_32",88.63,1328,107,21,11,1322,1300,1,0,1576,1311,1299
"55744","Nsylvestris_NODE_17398_length_1323_cov_27","Ntome_NODE_1313_length_4714_cov_201",93.41,1305,65,5,13,1301,3382,4681,0,1914,1288,1299
"55748","Nsylvestris_NODE_17400_length_1322_cov_205","Ntome_NODE_38552_length_277_cov_3",97.112,277,8,0,838,1114,1,277,8.57e-131,468,276,276
"55764","Nsylvestris_NODE_17409_length_1322_cov_8","Ntome_NODE_35687_length_348_cov_5",94.737,38,1,1,862,898,187,224,2.2e-07,58.4,36,37
"55789","Nsylvestris_NODE_17419_length_1321_cov_77","Ntome_NODE_13468_length_1789_cov_183",93.75,944,41,7,323,1264,1737,810,0,1400,941,927
"55792","Nsylvestris_NODE_17421_length_1321_cov_31","Ntome_NODE_104_length_8461_cov_276",94.643,56,3,0,1,56,8123,8068,2.8e-16,87.9,55,55
"55811","Nsylvestris_NODE_17429_length_1320_cov_35","Ntome_NODE_17742_length_1380_cov_197",86.621,441,32,10,336,761,543,971,3.98e-129,462,425,428
"55843","Nsylvestris_NODE_17442_length_1319_cov_19","Ntome_NODE_14197_length_1715_cov_258",98.182,55,1,0,1265,1319,731,785,4.65e-19,97.1,54,54
"55847","Nsylvestris_NODE_17444_length_1319_cov_12","Ntome_NODE_17304_length_1420_cov_43",90,80,8,0,1240,1319,860,939,2.78e-21,104,79,79
"55854","Nsylvestris_NODE_17449_length_1318_cov_212","Ntome_NODE_19400_length_1242_cov_244",91.771,1118,63,15,30,1146,1233,144,0,1528,1116,1089
"55855","Nsylvestris_NODE_17450_length_1318_cov_203","Ntome_NODE_7376_length_2589_cov_275",94.418,1272,45,9,65,1318,19,1282,0,1932,1253,1263
"55856","Nsylvestris_NODE_17451_length_1318_cov_181","Ntome_NODE_17842_length_1371_cov_269",91.25,1280,53,16,27,1266,78,1338,0,1688,1239,1260
"55860","Nsylvestris_NODE_17453_length_1318_cov_63","Ntome_NODE_18946_length_1281_cov_69",86.809,1031,122,8,32,1062,1181,165,0,1138,1030,1016
"55865","Nsylvestris_NODE_17455_length_1318_cov_22","Ntome_NODE_5768_length_2904_cov_222",86.83,1306,91,33,40,1318,2853,1602,0,1384,1278,1251
"55886","Nsylvestris_NODE_17466_length_1317_cov_12","Ntome_NODE_3086_length_3663_cov_125",84.622,1203,178,5,117,1317,2126,3323,0,1190,1200,1197
"55900","Nsylvestris_NODE_17470_length_1316_cov_215","Ntome_NODE_9581_length_2256_cov_277",95.37,1231,34,12,107,1316,2150,922,0,1936,1209,1228
"55966","Nsylvestris_NODE_17483_length_1315_cov_190","Ntome_NODE_20654_length_1141_cov_162",92.231,1107,61,10,120,1222,2,1087,0,1544,1102,1085
"55978","Nsylvestris_NODE_17488_length_1314_cov_200","Ntome_NODE_17712_length_1382_cov_277",95.632,1099,47,1,169,1267,1336,239,0,1762,1098,1097
"55988","Nsylvestris_NODE_17494_length_1314_cov_6","Ntome_NODE_5635_length_2931_cov_213",94.733,1310,63,3,5,1314,433,1736,0,2032,1309,1303
"55993","Nsylvestris_NODE_17497_length_1313_cov_210","Ntome_NODE_14687_length_1667_cov_212",92.195,1089,55,19,7,1068,49,1134,0,1513,1061,1085
"56034","Nsylvestris_NODE_17510_length_1312_cov_202","Ntome_NODE_17465_length_1406_cov_253",93.71,1256,43,10,1,1220,101,1356,0,1849,1219,1255
"56038","Nsylvestris_NODE_17512_length_1312_cov_136","Ntome_NODE_16888_length_1457_cov_277",91.808,1294,88,11,26,1311,1351,68,0,1786,1285,1283
"56059","Nsylvestris_NODE_17521_length_1311_cov_61","Ntome_NODE_12476_length_1900_cov_119",93.548,1209,44,10,10,1186,1736,530,0,1770,1176,1206
"56060","Nsylvestris_NODE_17522_length_1311_cov_54","Ntome_NODE_3111_length_3655_cov_146",98.276,58,1,0,1254,1311,412,469,9.93e-21,102,57,57
"56067","Nsylvestris_NODE_17526_length_1311_cov_23","Ntome_NODE_17080_length_1441_cov_114",91.37,1321,73,21,1,1311,102,1391,0,1770,1310,1289
"56079","Nsylvestris_NODE_17532_length_1310_cov_52","Ntome_NODE_30083_length_624_cov_135",80,370,59,5,544,900,368,1,5.56e-68,259,356,367
"56102","Nsylvestris_NODE_17544_length_1309_cov_19","Ntome_NODE_22973_length_985_cov_104",90.37,893,65,9,429,1308,932,48,0,1153,879,884
"56118","Nsylvestris_NODE_17549_length_1308_cov_105","Ntome_NODE_13038_length_1837_cov_90",94.355,1240,70,0,21,1260,1785,546,0,1903,1239,1239
"56125","Nsylvestris_NODE_17553_length_1308_cov_38","Ntome_NODE_21865_length_1057_cov_14",95.902,1025,41,1,270,1294,1,1024,0,1659,1024,1023
"56129","Nsylvestris_NODE_17555_length_1308_cov_25","Ntome_NODE_21624_length_1073_cov_18",94.051,975,58,0,315,1289,997,23,0,1480,974,974
"56136","Nsylvestris_NODE_17558_length_1308_cov_5","Ntome_NODE_12181_length_1936_cov_58",80.716,503,97,0,748,1250,239,741,5.25e-108,392,502,502
"56149","Nsylvestris_NODE_17562_length_1307_cov_194","Ntome_NODE_19206_length_1259_cov_232",90.069,1158,62,13,21,1160,1198,76,0,1452,1139,1122
"56171","Nsylvestris_NODE_17572_length_1306_cov_219","Ntome_NODE_6568_length_2735_cov_210",97.75,889,20,0,1,889,1206,318,0,1531,888,888
"56196","Nsylvestris_NODE_17582_length_1305_cov_132","Ntome_NODE_18278_length_1335_cov_250",96.235,1089,34,3,172,1256,48,1133,0,1777,1084,1085
"56216","Nsylvestris_NODE_17590_length_1304_cov_159","Ntome_NODE_18197_length_1342_cov_286",93.475,1318,38,7,1,1293,48,1342,0,1914,1292,1294
"56217","Nsylvestris_NODE_17591_length_1304_cov_157","Ntome_NODE_17615_length_1392_cov_61",94.768,1166,59,2,96,1260,214,1378,0,1814,1164,1164
"56218","Nsylvestris_NODE_17592_length_1304_cov_96","Ntome_NODE_5929_length_2866_cov_161",92.922,1314,50,14,5,1304,18,1302,0,1871,1299,1284
"56234","Nsylvestris_NODE_17598_length_1302_cov_216","Ntome_NODE_8998_length_2339_cov_241",89.28,1222,86,16,50,1244,2265,1062,0,1489,1194,1203
"56239","Nsylvestris_NODE_17600_length_1303_cov_151","Ntome_NODE_6507_length_2747_cov_150",93.531,1144,61,6,6,1137,2635,1493,0,1690,1131,1142
"56240","Nsylvestris_NODE_17601_length_1303_cov_93","Ntome_NODE_19434_length_1239_cov_163",92.617,1192,68,14,116,1300,1191,13,0,1696,1184,1178
"56244","Nsylvestris_NODE_17603_length_1303_cov_29","Ntome_NODE_22040_length_1046_cov_2",95.92,1054,27,13,52,1100,1,1043,0,1694,1048,1042
"56245","Nsylvestris_NODE_17604_length_1302_cov_206","Ntome_NODE_24441_length_896_cov_212",95.764,897,32,4,103,994,1,896,0,1441,891,895
"56246","Nsylvestris_NODE_17606_length_1302_cov_185","Ntome_NODE_15018_length_1633_cov_196",93.497,1307,49,16,1,1302,316,1591,0,1910,1301,1275
"56280","Nsylvestris_NODE_17618_length_1301_cov_37","Ntome_NODE_12148_length_1940_cov_78",94.876,1132,56,2,70,1200,1940,810,0,1768,1130,1130
"56284","Nsylvestris_NODE_17620_length_1301_cov_31","Ntome_NODE_14874_length_1647_cov_27",96.583,556,19,0,4,559,864,1419,0,922,555,555
"56292","Nsylvestris_NODE_17623_length_1301_cov_17","Ntome_NODE_5315_length_3004_cov_184",90.155,1229,73,21,1,1226,1302,119,0,1555,1225,1183
"56293","Nsylvestris_NODE_17624_length_1301_cov_11","Ntome_NODE_22403_length_1023_cov_7",95.956,989,37,2,24,1009,30,1018,0,1602,985,988
"56316","Nsylvestris_NODE_17632_length_1300_cov_54","Ntome_NODE_8773_length_2374_cov_56",95.981,1269,45,2,1,1266,48,1313,0,2056,1265,1265
"56329","Nsylvestris_NODE_17638_length_1299_cov_104","Ntome_NODE_20956_length_1119_cov_119",94.041,772,44,2,483,1253,1085,315,0,1170,770,770
"56344","Nsylvestris_NODE_17643_length_1299_cov_17","Ntome_NODE_170_length_7622_cov_303",100,55,0,0,1245,1299,6932,6878,9.84e-21,102,54,54
"56357","Nsylvestris_NODE_17648_length_1298_cov_197","Ntome_NODE_29281_length_657_cov_15",81.771,192,27,5,532,723,116,299,2.68e-36,154,191,183
"56358","Nsylvestris_NODE_17649_length_1298_cov_182","Ntome_NODE_7814_length_2522_cov_176",96.185,1101,30,1,11,1111,1138,50,0,1790,1100,1088
"56364","Nsylvestris_NODE_17652_length_1298_cov_106","Ntome_NODE_18243_length_1339_cov_117",91.99,1261,68,21,44,1292,1251,12,0,1738,1248,1239
"56365","Nsylvestris_NODE_17653_length_1298_cov_81","Ntome_NODE_21025_length_1114_cov_24",90.877,1140,50,17,78,1189,1114,1,0,1480,1111,1113
"56393","Nsylvestris_NODE_17666_length_1297_cov_92","Ntome_NODE_30835_length_595_cov_7",96.866,351,7,2,450,797,595,246,8e-166,584,347,349
"56410","Nsylvestris_NODE_17674_length_1296_cov_219","Ntome_NODE_16083_length_1532_cov_261",83.102,864,129,12,249,1099,351,1210,0,771,850,859
"56447","Nsylvestris_NODE_17687_length_1295_cov_107","Ntome_NODE_20522_length_1152_cov_115",94.32,1074,60,1,11,1083,8,1081,0,1644,1072,1073
"56462","Nsylvestris_NODE_17692_length_1295_cov_16","Ntome_NODE_32743_length_495_cov_11",91.86,172,14,0,1096,1267,324,495,1.99e-62,241,171,171
"56486","Nsylvestris_NODE_17701_length_1294_cov_114","Ntome_NODE_13597_length_1777_cov_134",94.358,1223,64,5,51,1269,1288,67,0,1871,1218,1221
"56490","Nsylvestris_NODE_17703_length_1294_cov_59","Ntome_NODE_17467_length_1406_cov_172",93.937,1270,77,0,1,1270,105,1374,0,1919,1269,1269
"56491","Nsylvestris_NODE_17704_length_1294_cov_21","Ntome_NODE_6791_length_2696_cov_127",87.076,472,51,8,587,1054,2136,2601,4.91e-148,525,467,465
"56492","Nsylvestris_NODE_17705_length_1294_cov_20","Ntome_NODE_20113_length_1184_cov_9",84.9,1000,137,8,116,1101,45,1044,0,998,985,999
"56509","Nsylvestris_NODE_17711_length_1294_cov_7","Ntome_NODE_8174_length_2464_cov_56",93.148,1226,78,2,18,1243,1877,658,0,1794,1225,1219
"56528","Nsylvestris_NODE_17718_length_1293_cov_30","Ntome_NODE_15369_length_1596_cov_273",96.364,55,2,0,1,55,1107,1161,2.12e-17,91.6,54,54
"56535","Nsylvestris_NODE_17721_length_1292_cov_206","Ntome_NODE_18089_length_1350_cov_255",95.628,892,35,1,1,888,86,977,0,1428,887,891
"56539","Nsylvestris_NODE_17723_length_1292_cov_158","Ntome_NODE_18395_length_1326_cov_219",94.856,1283,50,6,10,1292,1289,23,0,1989,1282,1266
"56540","Nsylvestris_NODE_17725_length_1292_cov_117","Ntome_NODE_9877_length_2215_cov_283",94.824,483,24,1,217,699,1988,1507,0,752,482,481
"56548","Nsylvestris_NODE_17729_length_1292_cov_22","Ntome_NODE_2162_length_4079_cov_206",95.161,62,3,0,1,62,2810,2749,1.27e-19,99,61,61
"56549","Nsylvestris_NODE_17730_length_1292_cov_8","Ntome_NODE_35725_length_347_cov_4",94.509,346,19,0,695,1040,347,2,8.14e-151,534,345,345
"56573","Nsylvestris_NODE_17736_length_1291_cov_16","Ntome_NODE_9787_length_2227_cov_20",100,55,0,0,1,55,1297,1243,9.78e-21,102,54,54
"56585","Nsylvestris_NODE_17741_length_1290_cov_203","Ntome_NODE_379_length_6398_cov_181",93.661,1120,63,6,171,1288,6339,5226,0,1668,1117,1113
"56592","Nsylvestris_NODE_17743_length_1290_cov_182","Ntome_NODE_5492_length_2963_cov_180",94.946,1207,47,7,1,1202,2037,840,0,1879,1201,1197
"56593","Nsylvestris_NODE_17744_length_1290_cov_179","Ntome_NODE_8088_length_2476_cov_202",87.982,674,50,21,1,652,1734,2398,0,767,651,664
"56596","Nsylvestris_NODE_17746_length_1290_cov_101","Ntome_NODE_19123_length_1265_cov_283",97.222,36,0,1,1249,1283,88,53,5.96e-08,60.2,34,35
"56597","Nsylvestris_NODE_17747_length_1290_cov_63","Ntome_NODE_3269_length_3599_cov_229",93.722,1131,43,16,1,1108,2455,3580,0,1670,1107,1125
"56598","Nsylvestris_NODE_17749_length_1290_cov_33","Ntome_NODE_20301_length_1169_cov_44",90.21,858,42,12,133,951,239,1093,0,1081,818,854
"56605","Nsylvestris_NODE_17752_length_1289_cov_214","Ntome_NODE_20015_length_1191_cov_25",97.101,1104,32,0,136,1239,51,1154,0,1862,1103,1103
"56610","Nsylvestris_NODE_17755_length_1289_cov_183","Ntome_NODE_19163_length_1262_cov_195",92.074,1186,78,7,4,1175,1228,45,0,1655,1171,1183
"56618","Nsylvestris_NODE_17758_length_1289_cov_138","Ntome_NODE_4734_length_3151_cov_223",94.904,1099,55,1,75,1172,1156,58,0,1718,1097,1098
"56629","Nsylvestris_NODE_17762_length_1289_cov_48","Ntome_NODE_18779_length_1294_cov_26",96.364,55,2,0,1,55,698,644,2.11e-17,91.6,54,54
"56630","Nsylvestris_NODE_17763_length_1289_cov_15","Ntome_NODE_33709_length_434_cov_7",86.444,450,27,11,677,1108,434,1,3.89e-129,462,431,433
"56644","Nsylvestris_NODE_17769_length_1288_cov_194","Ntome_NODE_23030_length_981_cov_251",93.048,935,59,4,19,951,981,51,0,1362,932,930
"56647","Nsylvestris_NODE_17771_length_1288_cov_169","Ntome_NODE_13195_length_1821_cov_240",93.233,1197,60,7,96,1285,49,1231,0,1742,1189,1182
"56662","Nsylvestris_NODE_17777_length_1288_cov_25","Ntome_NODE_26785_length_768_cov_230",98.182,55,1,0,1,55,457,403,4.54e-19,97.1,54,54
"56666","Nsylvestris_NODE_17779_length_1287_cov_214","Ntome_NODE_2724_length_3803_cov_287",95.234,1154,32,10,6,1155,3798,2664,0,1805,1149,1134
"56683","Nsylvestris_NODE_17784_length_1287_cov_107","Ntome_NODE_18714_length_1299_cov_204",93.169,1215,63,7,9,1204,1,1214,0,1766,1195,1213
"56688","Nsylvestris_NODE_17788_length_1287_cov_62","Ntome_NODE_17764_length_1378_cov_201",94.798,1288,50,8,1,1287,1346,75,0,1991,1286,1271
"56691","Nsylvestris_NODE_17790_length_1287_cov_27","Ntome_NODE_2938_length_3722_cov_185",92.675,1297,71,10,1,1287,3260,1978,0,1847,1286,1282
"56695","Nsylvestris_NODE_17792_length_1287_cov_12","Ntome_NODE_18700_length_1301_cov_28",94.704,1284,43,12,4,1273,3,1275,0,1971,1269,1272
"56720","Nsylvestris_NODE_17800_length_1286_cov_154","Ntome_NODE_19604_length_1225_cov_236",93.644,1117,57,7,153,1260,1176,65,0,1657,1107,1111
"56724","Nsylvestris_NODE_17802_length_1286_cov_132","Ntome_NODE_26495_length_782_cov_250",97.5,40,0,1,1,40,471,509,3.55e-10,67.6,39,38
"56731","Nsylvestris_NODE_17805_length_1286_cov_57","Ntome_NODE_14311_length_1704_cov_115",92.827,1171,38,15,92,1239,1165,18,0,1655,1147,1147
"56732","Nsylvestris_NODE_17806_length_1286_cov_41","Ntome_NODE_21247_length_1099_cov_13",89.447,199,18,2,1048,1244,270,73,1.18e-64,248,196,197
"56751","Nsylvestris_NODE_17813_length_1285_cov_171","Ntome_NODE_18583_length_1309_cov_270",94.01,1202,61,7,89,1285,1257,62,0,1810,1196,1195
"56779","Nsylvestris_NODE_17824_length_1284_cov_70","Ntome_NODE_18638_length_1305_cov_106",95.133,1089,41,5,7,1092,1129,50,0,1707,1085,1079
"56820","Nsylvestris_NODE_17839_length_1283_cov_9","Ntome_NODE_1405_length_4626_cov_102",87.431,1265,92,29,44,1250,2641,3896,0,1393,1206,1255
"56824","Nsylvestris_NODE_17841_length_1282_cov_220","Ntome_NODE_15759_length_1562_cov_255",94.269,1204,49,11,51,1235,1289,87,0,1823,1184,1202
"56856","Nsylvestris_NODE_17852_length_1281_cov_218","Ntome_NODE_18630_length_1305_cov_278",96.822,1227,31,6,45,1264,1234,9,0,2043,1219,1225
"56865","Nsylvestris_NODE_17856_length_1281_cov_77","Ntome_NODE_22298_length_1028_cov_49",85.899,1007,84,19,289,1264,980,1,0,1020,975,979
"56870","Nsylvestris_NODE_17858_length_1281_cov_37","Ntome_NODE_8319_length_2439_cov_173",95.082,61,2,1,1222,1281,649,709,1.62e-18,95.3,59,60
"56886","Nsylvestris_NODE_17867_length_1279_cov_223","Ntome_NODE_9302_length_2294_cov_249",92.205,1270,45,13,1,1245,1035,2275,0,1748,1244,1240
"56918","Nsylvestris_NODE_17879_length_1278_cov_210","Ntome_NODE_17123_length_1437_cov_279",97.074,1128,27,5,133,1258,314,1437,0,1895,1125,1123
"56928","Nsylvestris_NODE_17883_length_1278_cov_156","Ntome_NODE_1507_length_4529_cov_202",96.624,1244,29,6,1,1234,1573,333,0,2052,1233,1240
"56936","Nsylvestris_NODE_17888_length_1278_cov_9","Ntome_NODE_818_length_5356_cov_235",75.845,799,138,20,134,917,3704,2946,6.73e-97,355,783,758
"56937","Nsylvestris_NODE_17889_length_1275_cov_226","Ntome_NODE_15676_length_1573_cov_263",98.129,1176,20,1,57,1232,1426,253,0,2049,1175,1173
"56938","Nsylvestris_NODE_17890_length_1277_cov_218","Ntome_NODE_17781_length_1376_cov_231",96.653,1255,42,0,1,1255,90,1344,0,2085,1254,1254
"56957","Nsylvestris_NODE_17896_length_1277_cov_114","Ntome_NODE_21810_length_1060_cov_105",92.373,944,42,11,281,1220,1012,95,0,1317,939,917
"56962","Nsylvestris_NODE_17899_length_1277_cov_58","Ntome_NODE_1242_length_4789_cov_105",93.878,49,2,1,732,779,4090,4138,7.58e-12,73.1,47,48
"56968","Nsylvestris_NODE_17903_length_1276_cov_186","Ntome_NODE_18771_length_1294_cov_231",92.054,1271,69,13,12,1276,1261,17,0,1759,1264,1244
"56982","Nsylvestris_NODE_17910_length_1276_cov_62","Ntome_NODE_22092_length_1042_cov_16",93.103,638,41,3,480,1116,1,636,0,931,636,635
"56986","Nsylvestris_NODE_17912_length_1276_cov_55","Ntome_NODE_33409_length_451_cov_4",91.814,452,35,2,574,1024,1,451,3.58e-179,628,450,450
"57002","Nsylvestris_NODE_17918_length_1275_cov_85","Ntome_NODE_15841_length_1554_cov_190",92.747,1227,54,10,68,1275,1269,59,0,1740,1207,1210
"57003","Nsylvestris_NODE_17919_length_1275_cov_69","Ntome_NODE_34421_length_399_cov_4",93.155,336,23,0,258,593,336,1,1.36e-138,494,335,335
"57004","Nsylvestris_NODE_17920_length_1275_cov_60","Ntome_NODE_13595_length_1777_cov_141",94.041,1225,71,2,1,1224,1591,368,0,1857,1223,1223
"57010","Nsylvestris_NODE_17922_length_1275_cov_39","Ntome_NODE_22569_length_1012_cov_1",86.537,1025,78,25,132,1131,1,990,0,1074,999,989
"57011","Nsylvestris_NODE_17923_length_1275_cov_35","Ntome_NODE_17597_length_1394_cov_18",93.064,1211,77,5,35,1239,2,1211,0,1764,1204,1209
"57016","Nsylvestris_NODE_17925_length_1275_cov_8","Ntome_NODE_8469_length_2417_cov_108",91.532,1240,86,13,48,1275,1613,381,0,1690,1227,1232
"57057","Nsylvestris_NODE_17938_length_1273_cov_69","Ntome_NODE_16966_length_1451_cov_236",92.47,1235,68,13,47,1273,184,1401,0,1742,1226,1217
"57060","Nsylvestris_NODE_17940_length_1273_cov_47","Ntome_NODE_493_length_6034_cov_144",93.122,1134,70,6,1,1126,4623,5756,0,1655,1125,1133
"57067","Nsylvestris_NODE_17943_length_1273_cov_28","Ntome_NODE_14229_length_1712_cov_85",97.174,1203,34,0,71,1273,394,1596,0,2034,1202,1202
"57073","Nsylvestris_NODE_17946_length_1272_cov_207","Ntome_NODE_19505_length_1233_cov_276",92.025,1141,75,11,22,1159,45,1172,0,1589,1137,1127
"57074","Nsylvestris_NODE_17947_length_1272_cov_207","Ntome_NODE_19696_length_1218_cov_229",93.043,1150,49,10,43,1178,83,1215,0,1652,1135,1132
"57104","Nsylvestris_NODE_17960_length_1271_cov_150","Ntome_NODE_16962_length_1451_cov_261",98.305,59,1,0,1,59,587,645,2.68e-21,104,58,58
"57105","Nsylvestris_NODE_17961_length_1271_cov_140","Ntome_NODE_17141_length_1436_cov_99",95.64,1078,31,4,25,1093,1207,137,0,1716,1068,1070
"57106","Nsylvestris_NODE_17962_length_1271_cov_138","Ntome_NODE_16887_length_1457_cov_278",92.389,1235,61,10,5,1227,1,1214,0,1729,1222,1213
"57107","Nsylvestris_NODE_17963_length_1271_cov_75","Ntome_NODE_16541_length_1493_cov_99",92.878,1011,53,5,81,1081,1368,367,0,1450,1000,1001
"57118","Nsylvestris_NODE_17966_length_1271_cov_13","Ntome_NODE_18971_length_1279_cov_6",95.094,795,36,1,1,792,795,1,0,1249,791,794
"57130","Nsylvestris_NODE_17973_length_1270_cov_108","Ntome_NODE_11896_length_1970_cov_196",92.982,57,2,1,1216,1270,1226,1282,1.25e-14,82.4,54,56
"57143","Nsylvestris_NODE_17979_length_1269_cov_222","Ntome_NODE_9578_length_2257_cov_104",92.506,894,55,5,66,959,2210,1329,0,1269,893,881
"57146","Nsylvestris_NODE_17981_length_1269_cov_209","Ntome_NODE_18014_length_1357_cov_287",95.336,1222,43,5,1,1222,1309,102,0,1929,1221,1207
"57147","Nsylvestris_NODE_17982_length_1269_cov_195","Ntome_NODE_19559_length_1227_cov_287",94.486,1215,54,8,60,1269,1,1207,0,1860,1209,1206
"57158","Nsylvestris_NODE_17987_length_1269_cov_143","Ntome_NODE_5857_length_2882_cov_92",89.63,405,20,12,770,1174,178,560,3.77e-139,496,404,382
"57189","Nsylvestris_NODE_17998_length_1268_cov_210","Ntome_NODE_22576_length_1011_cov_209",91.641,658,43,8,80,729,119,772,0,900,649,653
"57194","Nsylvestris_NODE_18001_length_1268_cov_191","Ntome_NODE_13845_length_1752_cov_77",94.434,1114,43,2,81,1193,249,1344,0,1696,1112,1095
"57210","Nsylvestris_NODE_18007_length_1268_cov_22","Ntome_NODE_11335_length_2033_cov_133",75.822,1125,187,53,124,1205,894,1976,4.88e-138,492,1081,1082
"57253","Nsylvestris_NODE_18023_length_1266_cov_76","Ntome_NODE_468_length_6109_cov_236",92.569,619,20,1,2,594,3866,3248,0,865,592,618
"57258","Nsylvestris_NODE_18025_length_1266_cov_21","Ntome_NODE_16202_length_1521_cov_39",94.239,1215,67,2,5,1219,1438,227,0,1853,1214,1211
"57271","Nsylvestris_NODE_18030_length_1265_cov_212","Ntome_NODE_16852_length_1460_cov_249",96.598,1205,37,2,50,1253,147,1348,0,1995,1203,1201
"57272","Nsylvestris_NODE_18031_length_1265_cov_167","Ntome_NODE_6847_length_2685_cov_193",97.865,281,5,1,823,1102,2405,2685,8.14e-136,484,279,280
"57281","Nsylvestris_NODE_18035_length_1265_cov_66","Ntome_NODE_16098_length_1531_cov_258",95.78,1256,36,11,1,1253,1288,47,0,2010,1252,1241
"57290","Nsylvestris_NODE_18038_length_1265_cov_41","Ntome_NODE_1936_length_4218_cov_84",90.603,1277,97,13,5,1265,1617,348,0,1672,1260,1269
"57301","Nsylvestris_NODE_18042_length_1265_cov_9","Ntome_NODE_388_length_6357_cov_117",94.387,1265,36,17,9,1258,298,1542,0,1910,1249,1244
"57309","Nsylvestris_NODE_18046_length_1264_cov_192","Ntome_NODE_20190_length_1177_cov_261",95.12,1045,40,4,9,1043,1146,103,0,1637,1034,1043
"57310","Nsylvestris_NODE_18047_length_1264_cov_189","Ntome_NODE_15046_length_1630_cov_240",93.486,1136,61,7,130,1255,1284,152,0,1676,1125,1132
"57313","Nsylvestris_NODE_18049_length_1264_cov_177","Ntome_NODE_6687_length_2715_cov_226",96.044,1264,47,1,1,1264,2087,827,0,2054,1263,1260
"57319","Nsylvestris_NODE_18052_length_1264_cov_24","Ntome_NODE_17920_length_1365_cov_30",93.967,1094,61,3,1,1089,38,1131,0,1650,1088,1093
"57336","Nsylvestris_NODE_18060_length_1263_cov_33","Ntome_NODE_27954_length_713_cov_6",94.72,322,12,3,1,321,391,708,3.75e-139,496,320,317
"57358","Nsylvestris_NODE_18069_length_1262_cov_103","Ntome_NODE_18939_length_1281_cov_209",96.548,956,29,2,263,1214,1147,192,0,1580,951,955
"57368","Nsylvestris_NODE_18073_length_1262_cov_11","Ntome_NODE_23961_length_927_cov_228",98.182,55,1,0,1,55,603,549,4.44e-19,97.1,54,54
"57378","Nsylvestris_NODE_18077_length_1261_cov_138","Ntome_NODE_16331_length_1510_cov_131",94.407,1180,54,8,1,1172,290,1465,0,1803,1171,1175
"57379","Nsylvestris_NODE_18078_length_1261_cov_133","Ntome_NODE_17393_length_1412_cov_142",95.563,1172,38,4,1,1159,1384,214,0,1864,1158,1170
"57380","Nsylvestris_NODE_18079_length_1261_cov_100","Ntome_NODE_2989_length_3703_cov_211",94.345,1008,33,10,153,1136,90,1097,0,1524,983,1007
"57390","Nsylvestris_NODE_18084_length_1261_cov_24","Ntome_NODE_13206_length_1819_cov_39",94.288,1068,58,1,93,1160,1307,243,0,1631,1067,1064
"57401","Nsylvestris_NODE_18088_length_1260_cov_203","Ntome_NODE_3453_length_3529_cov_265",90.433,1223,91,12,1,1200,3460,2241,0,1587,1199,1219
"57414","Nsylvestris_NODE_18093_length_1260_cov_64","Ntome_NODE_32977_length_480_cov_4",95.082,488,15,1,718,1205,1,479,0,760,487,478
"57415","Nsylvestris_NODE_18094_length_1260_cov_50","Ntome_NODE_36170_length_334_cov_3",87.179,156,20,0,818,973,10,165,1.54e-43,178,155,155
"57456","Nsylvestris_NODE_18109_length_1259_cov_10","Ntome_NODE_12508_length_1896_cov_155",96.364,55,2,0,1,55,1549,1495,2.06e-17,91.6,54,54
"57467","Nsylvestris_NODE_18113_length_1258_cov_29","Ntome_NODE_9720_length_2237_cov_296",100,55,0,0,1,55,1378,1432,9.52e-21,102,54,54
"57474","Nsylvestris_NODE_18116_length_1258_cov_21","Ntome_NODE_9828_length_2222_cov_31",94.167,240,14,0,69,308,2121,1882,3.06e-100,366,239,239
"57475","Nsylvestris_NODE_18117_length_1258_cov_9","Ntome_NODE_2553_length_3882_cov_255",98.182,55,1,0,1,55,2352,2298,4.43e-19,97.1,54,54
"57492","Nsylvestris_NODE_18125_length_1256_cov_159","Ntome_NODE_15338_length_1599_cov_272",93.252,1141,60,11,74,1207,260,1390,0,1664,1133,1130
"57495","Nsylvestris_NODE_18127_length_1256_cov_129","Ntome_NODE_19794_length_1211_cov_18",83.264,962,147,10,300,1256,1000,48,0,872,956,952
"57499","Nsylvestris_NODE_18129_length_1256_cov_59","Ntome_NODE_17769_length_1377_cov_115",89.168,1274,59,28,4,1233,107,1345,0,1515,1229,1238
"57506","Nsylvestris_NODE_18132_length_1256_cov_18","Ntome_NODE_4187_length_3300_cov_201",89.091,55,6,0,1202,1256,899,845,9.64e-11,69.4,54,54
"57522","Nsylvestris_NODE_18139_length_1255_cov_93","Ntome_NODE_562_length_5862_cov_205",91.667,96,5,3,596,690,3016,2923,4.36e-29,130,94,93
"57525","Nsylvestris_NODE_18142_length_1255_cov_16","Ntome_NODE_14694_length_1667_cov_37",93.503,1216,45,9,7,1198,138,1343,0,1777,1191,1205
"57530","Nsylvestris_NODE_18144_length_1255_cov_13","Ntome_NODE_18568_length_1311_cov_19",84.675,1292,119,28,1,1255,41,1290,0,1216,1254,1249
"57531","Nsylvestris_NODE_18145_length_1255_cov_7","Ntome_NODE_33887_length_425_cov_5",91.206,398,32,3,385,782,10,404,6.11e-152,538,397,394
"57537","Nsylvestris_NODE_18147_length_1254_cov_190","Ntome_NODE_18434_length_1322_cov_266",95.05,1212,45,10,36,1242,105,1306,0,1892,1206,1201
"57551","Nsylvestris_NODE_18154_length_1254_cov_73","Ntome_NODE_8862_length_2360_cov_134",94.545,55,3,0,1,55,1721,1775,9.56e-16,86.1,54,54
"57559","Nsylvestris_NODE_18157_length_1254_cov_42","Ntome_NODE_1172_length_4871_cov_174",96.471,1190,38,4,3,1191,3302,4488,0,1962,1188,1186
"57568","Nsylvestris_NODE_18163_length_1253_cov_177","Ntome_NODE_1791_length_4318_cov_199",93.776,1221,33,15,56,1239,3097,4311,0,1794,1183,1214
"57588","Nsylvestris_NODE_18170_length_1253_cov_18","Ntome_NODE_35257_length_364_cov_3",100,31,0,0,682,712,334,364,2.08e-07,58.4,30,30
"57591","Nsylvestris_NODE_18173_length_1253_cov_7","Ntome_NODE_8540_length_2407_cov_179",100,55,0,0,1199,1253,2271,2217,9.48e-21,102,54,54
"57605","Nsylvestris_NODE_18179_length_1252_cov_102","Ntome_NODE_24870_length_871_cov_5",95.519,848,31,4,105,950,846,4,0,1349,845,842
"57606","Nsylvestris_NODE_18180_length_1252_cov_82","Ntome_NODE_21271_length_1097_cov_26",90.578,1072,76,11,121,1189,38,1087,0,1397,1068,1049
"57623","Nsylvestris_NODE_18186_length_1251_cov_205","Ntome_NODE_17784_length_1376_cov_114",94.477,1195,54,6,16,1204,1241,53,0,1831,1188,1188
"57624","Nsylvestris_NODE_18187_length_1250_cov_202","Ntome_NODE_20237_length_1174_cov_289",92.737,1129,49,13,15,1136,1150,48,0,1600,1121,1102
"57630","Nsylvestris_NODE_18190_length_1251_cov_109","Ntome_NODE_8652_length_2392_cov_280",94.545,55,3,0,1,55,1693,1639,9.54e-16,86.1,54,54
"57637","Nsylvestris_NODE_18193_length_1251_cov_21","Ntome_NODE_20322_length_1167_cov_315",94.915,59,2,1,1194,1251,837,895,2.05e-17,91.6,57,58
"57650","Nsylvestris_NODE_18199_length_1250_cov_172","Ntome_NODE_14562_length_1679_cov_131",95.725,959,22,7,34,981,128,1078,0,1526,947,950
"57665","Nsylvestris_NODE_18203_length_1250_cov_45","Ntome_NODE_19319_length_1250_cov_110",94.01,384,22,1,170,552,1158,775,9.97e-165,580,382,383
"57681","Nsylvestris_NODE_18209_length_1249_cov_187","Ntome_NODE_1958_length_4205_cov_259",94.969,1133,44,8,121,1249,4062,2939,0,1764,1128,1123
"57691","Nsylvestris_NODE_18212_length_1249_cov_101","Ntome_NODE_21874_length_1045_cov_113",94.372,995,50,6,96,1086,2,994,0,1522,990,992
"57711","Nsylvestris_NODE_18219_length_1248_cov_176","Ntome_NODE_19963_length_1194_cov_100",89.681,1066,77,10,138,1200,46,1081,0,1328,1062,1035
"57714","Nsylvestris_NODE_18221_length_1248_cov_110","Ntome_NODE_7566_length_2559_cov_235",97.619,504,12,0,610,1113,611,108,0,865,503,503
"57721","Nsylvestris_NODE_18224_length_1248_cov_21","Ntome_NODE_1052_length_5017_cov_183",96.364,55,2,0,1194,1248,1609,1663,2.04e-17,91.6,54,54
"57727","Nsylvestris_NODE_18226_length_1248_cov_15","Ntome_NODE_27612_length_728_cov_5",95.524,715,22,4,12,724,707,1,0,1134,712,706
"57734","Nsylvestris_NODE_18229_length_1248_cov_9","Ntome_NODE_2222_length_4048_cov_134",90.257,1283,80,17,1,1248,2568,1296,0,1635,1247,1272
"57741","Nsylvestris_NODE_18232_length_1247_cov_205","Ntome_NODE_17276_length_1422_cov_248",94.599,1111,50,7,90,1198,1312,210,0,1711,1108,1102
"57750","Nsylvestris_NODE_18236_length_1247_cov_32","Ntome_NODE_1903_length_4234_cov_152",93.975,1029,60,2,155,1182,4234,3207,0,1555,1027,1027
"57751","Nsylvestris_NODE_18238_length_1247_cov_9","Ntome_NODE_23618_length_947_cov_267",100,55,0,0,1193,1247,550,496,9.44e-21,102,54,54
"57752","Nsylvestris_NODE_18239_length_1247_cov_8","Ntome_NODE_3282_length_3595_cov_146",95.242,1261,46,5,1,1247,3325,2065,0,1984,1246,1260
"57758","Nsylvestris_NODE_18241_length_1246_cov_194","Ntome_NODE_12246_length_1927_cov_211",96.225,1139,30,4,104,1242,754,1879,0,1853,1138,1125
"57769","Nsylvestris_NODE_18246_length_1246_cov_13","Ntome_NODE_17702_length_1384_cov_58",86.595,1119,133,16,137,1245,164,1275,0,1219,1108,1111
"57772","Nsylvestris_NODE_18248_length_1248_cov_6","Ntome_NODE_14925_length_1643_cov_41",92.693,1259,77,7,2,1248,89,1344,0,1801,1246,1255
"57791","Nsylvestris_NODE_18253_length_1245_cov_205","Ntome_NODE_20950_length_1119_cov_224",93.184,1027,40,10,2,999,1102,77,0,1482,997,1025
"57796","Nsylvestris_NODE_18255_length_1245_cov_186","Ntome_NODE_17811_length_1373_cov_162",93.996,916,44,6,46,957,18,926,0,1376,911,908
"57797","Nsylvestris_NODE_18256_length_1245_cov_130","Ntome_NODE_22601_length_1010_cov_25",93.794,999,50,7,176,1168,15,1007,0,1491,992,992
"57801","Nsylvestris_NODE_18258_length_1245_cov_20","Ntome_NODE_20864_length_1127_cov_35",94.605,1001,47,3,123,1117,1086,87,0,1543,994,999
"57813","Nsylvestris_NODE_18263_length_1244_cov_204","Ntome_NODE_14914_length_1643_cov_210",96.938,1241,29,2,4,1244,1607,376,0,2073,1240,1231
"57848","Nsylvestris_NODE_18275_length_1243_cov_132","Ntome_NODE_1420_length_4613_cov_67",91.72,314,14,8,917,1224,308,1,4.91e-118,425,307,307
"57876","Nsylvestris_NODE_18289_length_1242_cov_35","Ntome_NODE_17965_length_1361_cov_84",93.621,1160,35,11,2,1152,1350,221,0,1696,1150,1129
"57880","Nsylvestris_NODE_18291_length_1242_cov_8","Ntome_NODE_1787_length_4321_cov_168",92.308,182,14,0,290,471,2100,2281,5.27e-68,259,181,181
"57889","Nsylvestris_NODE_18295_length_1241_cov_170","Ntome_NODE_22668_length_1005_cov_123",95.9,878,36,0,232,1109,988,111,0,1423,877,877
"57905","Nsylvestris_NODE_18302_length_1241_cov_18","Ntome_NODE_15792_length_1559_cov_25",86.559,863,116,0,378,1240,318,1180,0,952,862,862
"57918","Nsylvestris_NODE_18307_length_1240_cov_233","Ntome_NODE_6012_length_2845_cov_131",95.547,1235,55,0,1,1235,2322,1088,0,1977,1234,1234
"57957","Nsylvestris_NODE_18322_length_1239_cov_177","Ntome_NODE_22160_length_1037_cov_64",86.847,555,72,1,154,708,320,873,2.09e-176,619,554,553
"57974","Nsylvestris_NODE_18331_length_1238_cov_227","Ntome_NODE_16533_length_1493_cov_234",93.955,1158,46,15,49,1204,1156,21,0,1729,1155,1135
"57981","Nsylvestris_NODE_18334_length_1238_cov_182","Ntome_NODE_18967_length_1279_cov_134",92.931,1061,48,6,3,1053,1262,219,0,1519,1050,1043
"57982","Nsylvestris_NODE_18335_length_1238_cov_181","Ntome_NODE_18078_length_1351_cov_233",94.246,1147,52,9,56,1195,1323,184,0,1740,1139,1139
"58018","Nsylvestris_NODE_18351_length_1236_cov_206","Ntome_NODE_19454_length_1237_cov_284",86.763,967,106,14,180,1129,67,1028,0,1057,949,961
"58021","Nsylvestris_NODE_18353_length_1235_cov_203","Ntome_NODE_19897_length_1201_cov_254",95.224,984,39,4,244,1225,155,1132,0,1550,981,977
"58027","Nsylvestris_NODE_18355_length_1236_cov_181","Ntome_NODE_17911_length_1365_cov_226",94.859,1167,53,4,75,1236,1365,201,0,1816,1161,1164
"58077","Nsylvestris_NODE_18377_length_1234_cov_201","Ntome_NODE_22556_length_1012_cov_254",96.624,859,28,1,194,1052,971,114,0,1424,858,857
"58081","Nsylvestris_NODE_18379_length_1234_cov_165","Ntome_NODE_14826_length_1653_cov_184",94.707,869,43,2,1,869,1190,325,0,1347,868,865
"58082","Nsylvestris_NODE_18380_length_1232_cov_96","Ntome_NODE_29195_length_660_cov_44",84.153,183,25,4,470,650,455,635,1.95e-42,174,180,180
"58085","Nsylvestris_NODE_18382_length_1234_cov_90","Ntome_NODE_21814_length_1060_cov_42",100,28,0,0,1007,1034,985,1012,9.54e-06,52.8,27,27
"58086","Nsylvestris_NODE_18383_length_1234_cov_32","Ntome_NODE_12101_length_1944_cov_225",92.014,1127,52,14,111,1234,1806,715,0,1548,1123,1091
"58087","Nsylvestris_NODE_18384_length_1234_cov_31","Ntome_NODE_2525_length_3897_cov_154",88.889,54,6,0,2,55,69,16,3.41e-10,67.6,53,53
"58088","Nsylvestris_NODE_18385_length_1234_cov_8","Ntome_NODE_12428_length_1905_cov_247",100,55,0,0,1180,1234,661,715,9.34e-21,102,54,54
"58097","Nsylvestris_NODE_18389_length_1232_cov_189","Ntome_NODE_19722_length_1217_cov_82",94.255,1201,58,5,41,1232,1,1199,0,1825,1191,1198
"58103","Nsylvestris_NODE_18392_length_1233_cov_56","Ntome_NODE_23615_length_948_cov_4",92.1,962,54,9,214,1167,1,948,0,1336,953,947
"58106","Nsylvestris_NODE_18394_length_1233_cov_53","Ntome_NODE_12226_length_1929_cov_297",96.167,287,10,1,1,287,390,105,7.98e-131,468,286,285
"58107","Nsylvestris_NODE_18395_length_1233_cov_25","Ntome_NODE_8977_length_2342_cov_116",93.35,1173,66,2,1,1173,2232,1072,0,1724,1172,1160
"58113","Nsylvestris_NODE_18398_length_1233_cov_9","Ntome_NODE_21949_length_1052_cov_157",81.237,469,81,7,769,1233,1052,587,6.44e-102,372,464,465
"58130","Nsylvestris_NODE_18407_length_1232_cov_79","Ntome_NODE_19814_length_1208_cov_276",92.047,1182,46,21,3,1180,1193,56,0,1618,1177,1137
"58163","Nsylvestris_NODE_18419_length_1231_cov_17","Ntome_NODE_9112_length_2322_cov_220",93.333,630,23,6,3,617,1693,2318,0,913,614,625
"58187","Nsylvestris_NODE_18428_length_1230_cov_7","Ntome_NODE_16360_length_1508_cov_83",88.333,180,18,2,642,818,558,379,4.12e-54,213,176,179
"58204","Nsylvestris_NODE_18434_length_1229_cov_162","Ntome_NODE_20273_length_1171_cov_140",94.854,1127,47,8,110,1228,44,1167,0,1749,1118,1123
"58215","Nsylvestris_NODE_18439_length_1229_cov_14","Ntome_NODE_9365_length_2287_cov_151",88.035,1262,106,26,1,1229,1567,318,0,1452,1228,1249
"58281","Nsylvestris_NODE_18467_length_1227_cov_86","Ntome_NODE_22046_length_1045_cov_79",80.03,661,101,21,492,1133,1006,358,1.33e-128,460,641,648
"58282","Nsylvestris_NODE_18468_length_1227_cov_82","Ntome_NODE_28645_length_682_cov_30",93.182,44,2,1,376,418,560,517,4.38e-09,63.9,42,43
"58283","Nsylvestris_NODE_18469_length_1227_cov_76","Ntome_NODE_5694_length_2920_cov_68",86.145,166,11,3,563,716,2399,2564,9.02e-41,169,153,165
"58332","Nsylvestris_NODE_18485_length_1225_cov_199","Ntome_NODE_22120_length_1040_cov_19",83.259,896,133,17,254,1141,990,104,0,808,887,886
"58347","Nsylvestris_NODE_18490_length_1225_cov_124","Ntome_NODE_14687_length_1667_cov_212",85.474,833,111,8,254,1082,1114,288,0,859,828,826
"58352","Nsylvestris_NODE_18493_length_1225_cov_28","Ntome_NODE_17853_length_1371_cov_12",79.391,1150,222,13,5,1145,131,1274,0,797,1140,1143
"58353","Nsylvestris_NODE_18494_length_1224_cov_237","Ntome_NODE_6617_length_2727_cov_10",87.025,316,31,4,702,1016,2056,1750,1.08e-94,348,314,306
"58361","Nsylvestris_NODE_18498_length_1224_cov_194","Ntome_NODE_23436_length_958_cov_190",94.137,921,40,8,161,1078,910,1,0,1389,917,909
"58362","Nsylvestris_NODE_18499_length_1224_cov_190","Ntome_NODE_18242_length_1339_cov_171",95.532,940,37,5,215,1151,85,1022,0,1498,936,937
"58366","Nsylvestris_NODE_18502_length_1224_cov_75","Ntome_NODE_1740_length_4352_cov_273",100,55,0,0,1170,1224,1073,1019,9.26e-21,102,54,54
"58373","Nsylvestris_NODE_18505_length_1224_cov_32","Ntome_NODE_11768_length_1985_cov_54",96.98,563,17,0,79,641,109,671,0,946,562,562
"58374","Nsylvestris_NODE_18506_length_1224_cov_31","Ntome_NODE_18874_length_1286_cov_12",91.076,381,26,2,589,961,645,265,4.67e-143,508,372,380
"58388","Nsylvestris_NODE_18512_length_1223_cov_190","Ntome_NODE_15498_length_1584_cov_229",94.113,1223,52,8,2,1222,1567,363,0,1842,1220,1204
"58404","Nsylvestris_NODE_18520_length_1222_cov_220","Ntome_NODE_13421_length_1794_cov_61",93.199,1191,46,8,67,1222,1,1191,0,1718,1155,1190
"58428","Nsylvestris_NODE_18527_length_1222_cov_23","Ntome_NODE_19198_length_1260_cov_41",91.424,1201,40,14,1,1168,1171,1,0,1589,1167,1170
"58455","Nsylvestris_NODE_18537_length_1221_cov_146","Ntome_NODE_12326_length_1918_cov_79",86.064,409,42,10,1,401,1230,1631,4.83e-118,425,400,401
"58458","Nsylvestris_NODE_18539_length_1221_cov_91","Ntome_NODE_20416_length_1160_cov_175",94.872,1053,51,2,172,1221,56,1108,0,1642,1049,1052
"58462","Nsylvestris_NODE_18542_length_1221_cov_16","Ntome_NODE_13176_length_1822_cov_102",87.589,701,56,19,1,700,609,1279,0,784,699,670
"58470","Nsylvestris_NODE_18546_length_1221_cov_7","Ntome_NODE_12002_length_1958_cov_118",96.903,1227,32,1,1,1221,1686,460,0,2050,1220,1226
"58474","Nsylvestris_NODE_18548_length_1220_cov_153","Ntome_NODE_22762_length_999_cov_16",93.089,955,46,6,201,1144,20,965,0,1380,943,945
"58505","Nsylvestris_NODE_18560_length_1219_cov_173","Ntome_NODE_24726_length_878_cov_107",94.759,725,38,0,240,964,113,837,0,1129,724,724
"58513","Nsylvestris_NODE_18564_length_1219_cov_53","Ntome_NODE_18398_length_1326_cov_21",93.437,1219,67,4,1,1219,23,1228,0,1796,1218,1205
"58529","Nsylvestris_NODE_18571_length_1219_cov_13","Ntome_NODE_7412_length_2583_cov_289",98.182,55,1,0,1,55,1412,1466,4.29e-19,97.1,54,54
"58548","Nsylvestris_NODE_18577_length_1218_cov_212","Ntome_NODE_10626_length_2115_cov_176",94.221,1021,50,6,156,1170,1891,874,0,1550,1014,1017
"58556","Nsylvestris_NODE_18581_length_1218_cov_170","Ntome_NODE_23559_length_951_cov_17",92.782,859,43,8,241,1087,100,951,0,1225,846,851
"58557","Nsylvestris_NODE_18582_length_1218_cov_165","Ntome_NODE_22071_length_1043_cov_32",82.683,820,132,8,244,1058,50,864,0,719,814,814
"58598","Nsylvestris_NODE_18600_length_1217_cov_129","Ntome_NODE_21954_length_1052_cov_54",90.819,708,56,3,58,765,10,708,0,939,707,698
"58602","Nsylvestris_NODE_18602_length_1217_cov_81","Ntome_NODE_23654_length_946_cov_15",92.209,783,33,11,323,1095,765,1,0,1083,772,764
"58615","Nsylvestris_NODE_18609_length_1217_cov_7","Ntome_NODE_14889_length_1645_cov_92",85.494,324,30,7,60,382,871,1178,6.49e-87,322,322,307
"58619","Nsylvestris_NODE_18611_length_1216_cov_197","Ntome_NODE_19293_length_1252_cov_242",95.207,1210,50,5,11,1213,3,1211,0,1906,1202,1208
"58629","Nsylvestris_NODE_18615_length_1216_cov_34","Ntome_NODE_11309_length_2036_cov_177",86.898,1183,114,28,1,1167,2036,879,0,1288,1166,1157
"58640","Nsylvestris_NODE_18620_length_1215_cov_178","Ntome_NODE_6151_length_2822_cov_281",84.65,671,100,3,546,1215,2338,1670,0,665,669,668
"58647","Nsylvestris_NODE_18623_length_1215_cov_118","Ntome_NODE_21375_length_1090_cov_41",95.281,1102,31,8,83,1183,7,1088,0,1727,1100,1081
"58660","Nsylvestris_NODE_18628_length_1215_cov_33","Ntome_NODE_10501_length_2132_cov_222",80.534,1012,193,3,127,1136,1326,317,0,774,1009,1009
"58693","Nsylvestris_NODE_18639_length_1214_cov_138","Ntome_NODE_19662_length_1221_cov_67",93.645,1133,46,14,54,1179,102,1215,0,1670,1125,1113
"58696","Nsylvestris_NODE_18641_length_1215_cov_86","Ntome_NODE_11074_length_2064_cov_290",94.776,402,21,0,812,1213,2042,1641,1.23e-178,627,401,401
"58702","Nsylvestris_NODE_18644_length_1214_cov_47","Ntome_NODE_17218_length_1428_cov_139",88.399,681,34,15,256,899,1054,382,0,778,643,672
"58715","Nsylvestris_NODE_18647_length_1214_cov_12","Ntome_NODE_15906_length_1547_cov_274",94.545,55,3,0,1160,1214,694,640,9.25e-16,86.1,54,54
"58733","Nsylvestris_NODE_18656_length_1213_cov_70","Ntome_NODE_19217_length_1258_cov_258",93.48,1043,50,8,95,1129,87,1119,0,1533,1034,1032
"58740","Nsylvestris_NODE_18659_length_1213_cov_31","Ntome_NODE_18405_length_1325_cov_43",92.938,1147,59,8,11,1150,1274,143,0,1650,1139,1131
"58754","Nsylvestris_NODE_18666_length_1212_cov_25","Ntome_NODE_8320_length_2439_cov_149",91.828,1236,53,20,1,1212,711,1922,0,1679,1211,1211
"58766","Nsylvestris_NODE_18670_length_1212_cov_16","Ntome_NODE_23334_length_963_cov_279",96.364,55,2,0,1158,1212,373,319,1.98e-17,91.6,54,54
"58771","Nsylvestris_NODE_18672_length_1212_cov_14","Ntome_NODE_24183_length_914_cov_9",88.144,835,71,14,349,1180,1,810,0,968,831,809
"58778","Nsylvestris_NODE_18675_length_1212_cov_7","Ntome_NODE_16931_length_1454_cov_11",90.122,1225,48,19,1,1183,258,1451,0,1524,1182,1193
"58797","Nsylvestris_NODE_18681_length_1211_cov_99","Ntome_NODE_26394_length_787_cov_151",100,33,0,0,1179,1211,46,78,1.55e-08,62.1,32,32
"58806","Nsylvestris_NODE_18684_length_1211_cov_25","Ntome_NODE_16815_length_1464_cov_198",81.79,961,156,11,186,1132,1120,165,0,787,946,955
"58826","Nsylvestris_NODE_18691_length_1210_cov_144","Ntome_NODE_181_length_7557_cov_70",90.869,1139,59,22,41,1138,1191,57,0,1485,1097,1134
"58829","Nsylvestris_NODE_18693_length_1210_cov_12","Ntome_NODE_2544_length_3887_cov_104",90.406,1084,38,18,154,1210,3760,2716,0,1365,1056,1044
"58832","Nsylvestris_NODE_18695_length_1209_cov_219","Ntome_NODE_18621_length_1306_cov_246",93.04,1092,44,17,124,1203,108,1179,0,1567,1079,1071
"58842","Nsylvestris_NODE_18699_length_1209_cov_151","Ntome_NODE_21039_length_1113_cov_50",94.408,1055,41,5,172,1209,1,1054,0,1605,1037,1053
"58848","Nsylvestris_NODE_18703_length_1209_cov_33","Ntome_NODE_10612_length_2118_cov_115",88.778,401,41,4,592,990,685,287,6.01e-137,488,398,398
"58853","Nsylvestris_NODE_18705_length_1209_cov_9","Ntome_NODE_2376_length_3973_cov_172",94.545,55,3,0,1155,1209,3140,3194,9.21e-16,86.1,54,54
"58860","Nsylvestris_NODE_18708_length_1208_cov_181","Ntome_NODE_11925_length_1967_cov_256",95.215,1233,34,8,1,1208,131,1363,0,1927,1207,1232
"58875","Nsylvestris_NODE_18714_length_1208_cov_95","Ntome_NODE_18773_length_1294_cov_101",91.852,1166,70,12,1,1159,1217,70,0,1604,1158,1147
"58897","Nsylvestris_NODE_18722_length_1208_cov_8","Ntome_NODE_11112_length_2059_cov_18",97.765,1208,27,0,1,1208,619,1826,0,2082,1207,1207
"58910","Nsylvestris_NODE_18726_length_1207_cov_202","Ntome_NODE_1730_length_4358_cov_210",94.405,983,45,6,112,1084,3268,4250,0,1502,972,982
"58923","Nsylvestris_NODE_18732_length_1207_cov_72","Ntome_NODE_34167_length_411_cov_4",89.448,417,36,1,27,443,3,411,2.13e-146,520,416,408
"58933","Nsylvestris_NODE_18738_length_1206_cov_180","Ntome_NODE_20879_length_1125_cov_242",93.624,894,40,8,285,1161,164,1057,0,1319,876,893
"58939","Nsylvestris_NODE_18741_length_1206_cov_152","Ntome_NODE_15024_length_1632_cov_203",90.992,988,47,13,1,955,255,1233,0,1293,954,978
"58942","Nsylvestris_NODE_18744_length_1206_cov_47","Ntome_NODE_17186_length_1431_cov_22",93.262,282,16,2,280,561,208,486,3.71e-114,412,281,278
"58950","Nsylvestris_NODE_18747_length_1206_cov_33","Ntome_NODE_15140_length_1619_cov_283",80.357,280,46,4,114,384,1409,1130,2.43e-51,204,270,279
"58951","Nsylvestris_NODE_18748_length_1206_cov_28","Ntome_NODE_17186_length_1431_cov_22",84,275,40,3,291,564,219,490,1.42e-68,261,273,271
"58952","Nsylvestris_NODE_18749_length_1206_cov_15","Ntome_NODE_4863_length_3120_cov_60",91.393,1220,69,19,1,1206,1386,189,0,1639,1205,1197
"58980","Nsylvestris_NODE_18758_length_1205_cov_187","Ntome_NODE_16355_length_1508_cov_229",96.231,902,30,3,266,1163,449,1350,0,1474,897,901
"58985","Nsylvestris_NODE_18761_length_1205_cov_167","Ntome_NODE_18312_length_1332_cov_277",93.451,1191,66,6,8,1197,1332,153,0,1757,1189,1179
"58986","Nsylvestris_NODE_18763_length_1205_cov_56","Ntome_NODE_10941_length_2080_cov_281",93.151,73,3,2,1134,1205,1037,1108,7.04e-22,106,71,71
"58987","Nsylvestris_NODE_18764_length_1205_cov_46","Ntome_NODE_443_length_6181_cov_115",90.028,1073,101,6,75,1144,3403,4472,0,1384,1069,1069
"58988","Nsylvestris_NODE_18766_length_1205_cov_28","Ntome_NODE_24385_length_900_cov_57",96.809,846,27,0,46,891,55,900,0,1413,845,845
"58994","Nsylvestris_NODE_18768_length_1205_cov_15","Ntome_NODE_4476_length_3215_cov_206",100,53,0,0,3,55,2542,2594,1.18e-19,99,52,52
"59017","Nsylvestris_NODE_18779_length_1204_cov_23","Ntome_NODE_3539_length_3504_cov_269",94.545,55,3,0,1,55,669,723,9.17e-16,86.1,54,54
"59022","Nsylvestris_NODE_18782_length_1203_cov_208","Ntome_NODE_19628_length_1223_cov_291",93.582,1044,55,3,117,1158,48,1081,0,1546,1041,1033
"59027","Nsylvestris_NODE_18784_length_1203_cov_191","Ntome_NODE_1945_length_4210_cov_152",97.738,840,19,0,75,914,3958,3119,0,1447,839,839
"59031","Nsylvestris_NODE_18786_length_1203_cov_159","Ntome_NODE_18034_length_1355_cov_149",94.587,1016,52,2,43,1057,1022,9,0,1568,1014,1013
"59032","Nsylvestris_NODE_18787_length_1203_cov_147","Ntome_NODE_18674_length_1302_cov_282",90.73,1165,50,19,51,1203,133,1251,0,1500,1152,1118
"59038","Nsylvestris_NODE_18792_length_1202_cov_225","Ntome_NODE_12207_length_1932_cov_101",92.754,1173,47,9,1,1141,765,1931,0,1661,1140,1166
"59045","Nsylvestris_NODE_18795_length_1202_cov_177","Ntome_NODE_16062_length_1534_cov_192",91.346,1144,47,9,50,1147,1302,165,0,1517,1097,1137
"59102","Nsylvestris_NODE_18821_length_1200_cov_71","Ntome_NODE_19519_length_1233_cov_12",94.976,1035,49,1,169,1200,116,1150,0,1620,1031,1034
"59115","Nsylvestris_NODE_18827_length_1200_cov_14","Ntome_NODE_16779_length_1468_cov_77",94.066,1146,57,6,66,1200,1220,75,0,1729,1134,1145
"59135","Nsylvestris_NODE_18834_length_1198_cov_30","Ntome_NODE_6487_length_2750_cov_195",93.75,112,4,1,1,112,718,826,1.14e-39,165,111,108
"59139","Nsylvestris_NODE_18836_length_1199_cov_9","Ntome_NODE_7340_length_2596_cov_133",92.63,1099,78,3,71,1167,1,1098,0,1578,1096,1097
"59147","Nsylvestris_NODE_18839_length_1198_cov_116","Ntome_NODE_19818_length_1208_cov_118",93.656,1198,54,11,9,1192,1,1190,0,1772,1183,1189
"59148","Nsylvestris_NODE_18840_length_1198_cov_100","Ntome_NODE_27357_length_740_cov_123",86.777,726,48,15,405,1120,51,738,0,765,715,687
"59157","Nsylvestris_NODE_18843_length_1198_cov_59","Ntome_NODE_10160_length_2176_cov_74",91.083,1200,58,7,1,1197,1021,2174,0,1578,1196,1153
"59161","Nsylvestris_NODE_18846_length_1198_cov_38","Ntome_NODE_5697_length_2919_cov_190",90.058,1207,50,33,1,1146,1645,448,0,1500,1145,1197
"59167","Nsylvestris_NODE_18849_length_1198_cov_10","Ntome_NODE_5143_length_3046_cov_34",96.368,936,31,1,1,936,982,50,0,1537,935,932
"59172","Nsylvestris_NODE_18853_length_1197_cov_71","Ntome_NODE_20444_length_1158_cov_96",85,60,9,0,1137,1196,387,328,1.54e-08,62.1,59,59
"59175","Nsylvestris_NODE_18855_length_1197_cov_24","Ntome_NODE_10858_length_2089_cov_295",95.588,68,2,1,1130,1197,1321,1255,1.95e-22,108,67,66
"59182","Nsylvestris_NODE_18858_length_1196_cov_210","Ntome_NODE_19158_length_1262_cov_276",93.069,1111,57,12,55,1157,11,1109,0,1607,1102,1098
"59187","Nsylvestris_NODE_18861_length_1196_cov_177","Ntome_NODE_22383_length_1024_cov_17",95.034,1027,35,5,58,1071,1024,1,0,1600,1013,1023
"59193","Nsylvestris_NODE_18864_length_1196_cov_86","Ntome_NODE_13909_length_1745_cov_176",94.132,1193,58,8,1,1191,1196,14,0,1805,1190,1182
"59199","Nsylvestris_NODE_18868_length_1196_cov_43","Ntome_NODE_26079_length_803_cov_20",94.403,804,34,8,33,829,1,800,0,1225,796,799
"59200","Nsylvestris_NODE_18869_length_1196_cov_26","Ntome_NODE_106_length_8402_cov_102",91.489,47,4,0,1150,1196,4052,4006,1.19e-09,65.8,46,46
"59201","Nsylvestris_NODE_18870_length_1196_cov_19","Ntome_NODE_9424_length_2277_cov_308",93.625,251,15,1,946,1196,166,415,1.74e-102,374,250,249
"59208","Nsylvestris_NODE_18872_length_1195_cov_188","Ntome_NODE_20856_length_1126_cov_288",92.537,1139,48,9,4,1123,6,1126,0,1598,1119,1120
"59264","Nsylvestris_NODE_18893_length_1193_cov_198","Ntome_NODE_21540_length_1078_cov_271",93.303,1090,40,13,26,1102,7,1076,0,1578,1076,1069
"59271","Nsylvestris_NODE_18897_length_1193_cov_18","Ntome_NODE_24143_length_916_cov_23",77.542,236,50,3,780,1013,208,442,6.87e-32,139,233,234
"59272","Nsylvestris_NODE_18898_length_1193_cov_16","Ntome_NODE_11581_length_2005_cov_47",95.39,1193,46,1,1,1193,1809,626,0,1890,1192,1183
"59275","Nsylvestris_NODE_18900_length_1192_cov_176","Ntome_NODE_22155_length_1037_cov_174",94.532,951,27,11,1,932,39,983,0,1445,931,944
"59276","Nsylvestris_NODE_18901_length_1192_cov_159","Ntome_NODE_20166_length_1179_cov_175",92.185,1190,57,13,8,1172,1179,1,0,1650,1164,1178
"59290","Nsylvestris_NODE_18907_length_1192_cov_43","Ntome_NODE_15318_length_1603_cov_72",96.86,860,24,1,105,964,1468,612,0,1435,859,856
"59291","Nsylvestris_NODE_18908_length_1192_cov_22","Ntome_NODE_53_length_9728_cov_180",95.142,1091,45,8,50,1135,4837,3750,0,1714,1085,1087
"59314","Nsylvestris_NODE_18918_length_1191_cov_19","Ntome_NODE_748_length_5463_cov_243",94.964,139,7,0,1053,1191,4768,4906,8.57e-56,219,138,138
"59320","Nsylvestris_NODE_18922_length_1190_cov_204","Ntome_NODE_21839_length_1058_cov_184",95.345,666,27,2,398,1061,724,61,0,1055,663,663
"59356","Nsylvestris_NODE_18936_length_1189_cov_34","Ntome_NODE_14352_length_1700_cov_64",95.979,1144,32,3,3,1144,1635,504,0,1845,1141,1131
"59371","Nsylvestris_NODE_18943_length_1188_cov_157","Ntome_NODE_3346_length_3570_cov_206",94.203,345,18,1,217,561,1812,2154,4.5e-148,525,344,342
"59380","Nsylvestris_NODE_18947_length_1188_cov_27","Ntome_NODE_7485_length_2573_cov_174",93.885,1063,45,9,110,1164,29,1079,0,1585,1054,1050
"59400","Nsylvestris_NODE_18954_length_1187_cov_125","Ntome_NODE_18302_length_1333_cov_293",100,34,0,0,1,34,1017,984,4.23e-09,63.9,33,33
"59401","Nsylvestris_NODE_18955_length_1187_cov_111","Ntome_NODE_1058_length_5010_cov_303",96.364,55,2,0,1133,1187,1709,1763,1.94e-17,91.6,54,54
"59402","Nsylvestris_NODE_18956_length_1187_cov_108","Ntome_NODE_20770_length_1133_cov_33",93.695,1142,49,12,58,1187,1,1131,0,1688,1129,1130
"59412","Nsylvestris_NODE_18960_length_1187_cov_35","Ntome_NODE_1979_length_4188_cov_187",95.506,89,4,0,149,237,3157,3069,5.29e-33,143,88,88
"59419","Nsylvestris_NODE_18963_length_1187_cov_9","Ntome_NODE_24577_length_887_cov_249",96.226,53,1,1,1133,1185,756,807,9.04e-16,86.1,52,51
"59439","Nsylvestris_NODE_18970_length_1186_cov_73","Ntome_NODE_3079_length_3666_cov_69",78.853,558,112,6,180,734,905,1459,6.19e-102,372,554,554
"59450","Nsylvestris_NODE_18976_length_1186_cov_14","Ntome_NODE_16833_length_1462_cov_56",93.328,1199,44,13,1,1184,1181,4,0,1738,1183,1177
"59451","Nsylvestris_NODE_18977_length_1186_cov_8","Ntome_NODE_15286_length_1606_cov_59",95.954,1038,42,0,146,1183,48,1085,0,1685,1037,1037
"59452","Nsylvestris_NODE_18978_length_1185_cov_221","Ntome_NODE_1121_length_4927_cov_151",96.545,1042,35,1,145,1185,2567,3608,0,1724,1040,1041
"59462","Nsylvestris_NODE_18982_length_1185_cov_181","Ntome_NODE_19790_length_1211_cov_156",85.493,1034,84,20,53,1049,149,1153,0,1018,996,1004
"59477","Nsylvestris_NODE_18988_length_1184_cov_10","Ntome_NODE_4845_length_3124_cov_51",81.019,1217,189,26,1,1184,57,1264,0,929,1183,1207
"59478","Nsylvestris_NODE_18989_length_1184_cov_214","Ntome_NODE_2998_length_3700_cov_71",96.959,1184,34,1,1,1184,104,1285,0,1986,1183,1181
"59493","Nsylvestris_NODE_18995_length_1184_cov_79","Ntome_NODE_11908_length_1969_cov_123",95.471,1082,44,4,61,1139,1230,151,0,1722,1078,1079
"59498","Nsylvestris_NODE_18998_length_1184_cov_27","Ntome_NODE_7485_length_2573_cov_174",96.364,55,2,0,1130,1184,1294,1240,1.94e-17,91.6,54,54
"59508","Nsylvestris_NODE_19004_length_1183_cov_111","Ntome_NODE_23485_length_956_cov_6",95.329,942,42,2,133,1073,956,16,0,1495,940,940
"59514","Nsylvestris_NODE_19007_length_1183_cov_32","Ntome_NODE_21156_length_1105_cov_29",89.119,772,57,4,318,1089,1073,329,0,935,771,744
"59533","Nsylvestris_NODE_19014_length_1182_cov_193","Ntome_NODE_19250_length_1255_cov_245",93.327,1079,50,7,60,1126,1209,141,0,1574,1066,1068
"59537","Nsylvestris_NODE_19016_length_1182_cov_181","Ntome_NODE_17302_length_1420_cov_129",96.614,945,26,6,115,1056,293,1234,0,1563,941,941
"59541","Nsylvestris_NODE_19018_length_1182_cov_168","Ntome_NODE_15571_length_1578_cov_181",94.806,1136,48,5,1,1126,427,1561,0,1760,1125,1134
"59552","Nsylvestris_NODE_19023_length_1182_cov_56","Ntome_NODE_8601_length_2399_cov_19",83.948,461,65,1,158,609,2106,1646,2.79e-120,433,451,460
"59553","Nsylvestris_NODE_19024_length_1182_cov_13","Ntome_NODE_8534_length_2408_cov_47",96.364,55,2,0,1125,1179,454,508,1.93e-17,91.6,54,54
"59559","Nsylvestris_NODE_19029_length_1181_cov_193","Ntome_NODE_19958_length_1195_cov_215",93.592,1108,49,10,87,1172,16,1123,0,1633,1085,1107
"59567","Nsylvestris_NODE_19032_length_1181_cov_80","Ntome_NODE_2120_length_4098_cov_170",89.2,1037,93,14,156,1180,1297,268,0,1277,1024,1029
"59568","Nsylvestris_NODE_19033_length_1181_cov_72","Ntome_NODE_20182_length_1178_cov_193",94.064,438,24,2,46,483,771,336,0,664,437,435
"59569","Nsylvestris_NODE_19034_length_1181_cov_56","Ntome_NODE_23624_length_947_cov_134",89.668,271,17,6,921,1181,550,281,8.09e-91,335,260,269
"59570","Nsylvestris_NODE_19036_length_1181_cov_13","Ntome_NODE_2014_length_4162_cov_157",79.819,332,52,9,864,1180,3556,3887,1.41e-58,228,316,331
"59571","Nsylvestris_NODE_19037_length_1180_cov_226","Ntome_NODE_18645_length_1304_cov_265",95.782,1138,37,3,53,1180,27,1163,0,1825,1127,1136
"59578","Nsylvestris_NODE_19040_length_1180_cov_100","Ntome_NODE_2475_length_3918_cov_227",91.879,1059,34,22,1,1029,1098,62,0,1432,1028,1036
"59590","Nsylvestris_NODE_19046_length_1180_cov_11","Ntome_NODE_6124_length_2827_cov_43",93.174,293,14,4,390,676,1130,1422,4.66e-118,425,286,292
"59593","Nsylvestris_NODE_19048_length_1179_cov_194","Ntome_NODE_23732_length_940_cov_177",90.551,889,63,6,1,889,913,46,0,1157,888,867
"59594","Nsylvestris_NODE_19049_length_1179_cov_185","Ntome_NODE_4211_length_3289_cov_258",95.055,991,33,7,143,1133,3118,2144,0,1544,990,974
"59595","Nsylvestris_NODE_19050_length_1179_cov_182","Ntome_NODE_18436_length_1322_cov_162",88.259,1252,48,28,4,1177,1257,27,0,1406,1173,1230
"59601","Nsylvestris_NODE_19052_length_1179_cov_128","Ntome_NODE_17947_length_1363_cov_48",95.88,267,10,1,1,267,652,387,1e-119,431,266,265
"59637","Nsylvestris_NODE_19065_length_1178_cov_26","Ntome_NODE_4675_length_3164_cov_272",100,55,0,0,1,55,2705,2651,8.9e-21,102,54,54
"59665","Nsylvestris_NODE_19077_length_1177_cov_112","Ntome_NODE_32951_length_481_cov_165",96.899,387,12,0,53,439,387,1,0,649,386,386
"59666","Nsylvestris_NODE_19078_length_1177_cov_79","Ntome_NODE_18931_length_1282_cov_8",93.678,949,48,2,106,1051,1236,297,0,1410,945,939
"59667","Nsylvestris_NODE_19079_length_1177_cov_26","Ntome_NODE_15271_length_1607_cov_201",94.216,1072,59,1,86,1157,1436,368,0,1633,1071,1068
"59673","Nsylvestris_NODE_19082_length_1177_cov_15","Ntome_NODE_20749_length_1135_cov_17",86.162,1149,119,21,55,1177,1135,1,0,1205,1122,1134
"59677","Nsylvestris_NODE_19084_length_1177_cov_8","Ntome_NODE_820_length_5345_cov_146",78.531,1048,193,23,82,1108,2650,3686,0,660,1026,1036
"59698","Nsylvestris_NODE_19091_length_1176_cov_167","Ntome_NODE_22567_length_1012_cov_22",94.244,1025,29,11,61,1068,1,1012,0,1539,1007,1011
"59709","Nsylvestris_NODE_19096_length_1176_cov_76","Ntome_NODE_1206_length_4831_cov_116",94.812,1118,50,3,61,1176,54,1165,0,1736,1115,1111
"59710","Nsylvestris_NODE_19097_length_1175_cov_50","Ntome_NODE_35881_length_342_cov_20",92.857,42,1,2,37,77,258,218,5.42e-08,60.2,40,40
"59718","Nsylvestris_NODE_19101_length_1176_cov_12","Ntome_NODE_1348_length_4679_cov_109",90.033,1214,63,28,1,1176,2967,1774,0,1519,1175,1193
"59744","Nsylvestris_NODE_19113_length_1175_cov_8","Ntome_NODE_1385_length_4647_cov_137",93.333,1200,42,8,1,1175,2789,3975,0,1738,1174,1186
"59760","Nsylvestris_NODE_19119_length_1174_cov_191","Ntome_NODE_21501_length_1081_cov_186",93.426,1004,41,11,71,1059,39,1032,0,1465,988,993
"59761","Nsylvestris_NODE_19120_length_1174_cov_158","Ntome_NODE_7785_length_2527_cov_124",81.618,136,19,6,1035,1168,1226,1095,1.91e-22,108,133,131
"59766","Nsylvestris_NODE_19122_length_1174_cov_45","Ntome_NODE_18977_length_1278_cov_200",94.332,1182,57,1,1,1172,1244,63,0,1803,1171,1181
"59767","Nsylvestris_NODE_19123_length_1170_cov_29","Ntome_NODE_3764_length_3434_cov_11",91.379,58,4,1,1,57,904,847,1.49e-13,78.7,56,57
"59779","Nsylvestris_NODE_19128_length_1173_cov_191","Ntome_NODE_21134_length_1106_cov_240",93.275,922,57,5,201,1122,177,1093,0,1354,921,916
"59796","Nsylvestris_NODE_19136_length_1172_cov_205","Ntome_NODE_21838_length_1058_cov_293",94.235,1006,43,6,58,1055,1,999,0,1522,997,998
"59808","Nsylvestris_NODE_19141_length_1172_cov_164","Ntome_NODE_19229_length_1257_cov_185",91.976,1159,59,11,1,1146,103,1240,0,1594,1145,1137
"59813","Nsylvestris_NODE_19144_length_1172_cov_71","Ntome_NODE_14385_length_1697_cov_87",93.043,115,8,0,937,1051,878,764,8.61e-41,169,114,114
"59814","Nsylvestris_NODE_19145_length_1172_cov_56","Ntome_NODE_29746_length_638_cov_189",97.297,37,1,0,262,298,111,75,4.18e-09,63.9,36,36
"59828","Nsylvestris_NODE_19153_length_1171_cov_105","Ntome_NODE_6525_length_2744_cov_113",91.123,1149,69,13,1,1119,1407,2552,0,1526,1118,1145
"59847","Nsylvestris_NODE_19164_length_1170_cov_183","Ntome_NODE_1779_length_4328_cov_231",94.655,1029,39,3,1,1029,3303,4315,0,1581,1028,1012
"59848","Nsylvestris_NODE_19165_length_1170_cov_179","Ntome_NODE_20114_length_1183_cov_254",92.445,1178,40,13,1,1133,1,1174,0,1637,1132,1173
"59858","Nsylvestris_NODE_19169_length_1170_cov_66","Ntome_NODE_32101_length_542_cov_171",90.625,288,18,5,835,1117,107,390,1.7e-102,374,282,283
"59869","Nsylvestris_NODE_19178_length_1169_cov_88","Ntome_NODE_20754_length_1134_cov_164",92.074,921,46,9,202,1120,237,1132,0,1271,918,895
"59883","Nsylvestris_NODE_19184_length_1169_cov_9","Ntome_NODE_14927_length_1643_cov_21",88.679,53,3,3,843,895,1081,1130,1.5e-08,62.1,52,49
"59884","Nsylvestris_NODE_19185_length_1169_cov_8","Ntome_NODE_4609_length_3181_cov_135",98.077,52,1,0,1116,1167,236,185,1.91e-17,91.6,51,51
"59885","Nsylvestris_NODE_19186_length_1169_cov_8","Ntome_NODE_19589_length_1227_cov_11",91.554,1184,77,13,2,1169,22,1198,0,1611,1167,1176
"59908","Nsylvestris_NODE_19195_length_1167_cov_55","Ntome_NODE_18427_length_1323_cov_126",95.45,1033,46,1,4,1035,49,1081,0,1646,1031,1032
"59909","Nsylvestris_NODE_19196_length_1168_cov_27","Ntome_NODE_64_length_9315_cov_92",94.595,37,2,0,1132,1168,7954,7990,1.94e-07,58.4,36,36
"59919","Nsylvestris_NODE_19201_length_1167_cov_228","Ntome_NODE_3994_length_3353_cov_253",95.725,1076,34,3,1,1075,1150,86,0,1722,1074,1064
"59933","Nsylvestris_NODE_19206_length_1167_cov_195","Ntome_NODE_18471_length_1319_cov_190",91.881,973,77,2,59,1030,1193,222,0,1358,971,971
"59934","Nsylvestris_NODE_19207_length_1167_cov_104","Ntome_NODE_20670_length_1140_cov_41",93.116,1104,54,17,31,1132,1140,57,0,1598,1101,1083
"59947","Nsylvestris_NODE_19213_length_1166_cov_215","Ntome_NODE_9233_length_2304_cov_208",93.22,1121,39,5,1,1121,1216,2299,0,1615,1120,1083
"59955","Nsylvestris_NODE_19217_length_1166_cov_207","Ntome_NODE_3526_length_3507_cov_282",95.33,1092,36,4,82,1161,1119,31,0,1720,1079,1088
"59956","Nsylvestris_NODE_19218_length_1166_cov_199","Ntome_NODE_22121_length_1039_cov_252",91.62,895,58,12,212,1098,48,933,0,1221,886,885
"59966","Nsylvestris_NODE_19221_length_1166_cov_78","Ntome_NODE_19138_length_1264_cov_203",87.903,1149,63,29,27,1114,93,1226,0,1282,1087,1133
"59967","Nsylvestris_NODE_19222_length_1166_cov_64","Ntome_NODE_4370_length_3245_cov_69",77.778,171,31,5,125,295,1714,1877,1.14e-19,99,170,163
"59968","Nsylvestris_NODE_19223_length_1166_cov_63","Ntome_NODE_19035_length_1273_cov_194",86.043,652,59,20,200,844,38,664,0,671,644,626
"60018","Nsylvestris_NODE_19241_length_1164_cov_191","Ntome_NODE_19297_length_1252_cov_39",94.578,1125,44,10,45,1163,1115,2,0,1724,1118,1113
"60038","Nsylvestris_NODE_19249_length_1164_cov_22","Ntome_NODE_16718_length_1475_cov_38",86.402,831,83,13,301,1122,995,186,0,881,821,809
"60054","Nsylvestris_NODE_19255_length_1163_cov_120","Ntome_NODE_3086_length_3663_cov_125",82.933,791,127,5,65,853,3453,2669,0,706,788,784
"60073","Nsylvestris_NODE_19261_length_1163_cov_11","Ntome_NODE_21426_length_1087_cov_5",95.698,1046,45,0,17,1062,42,1087,0,1683,1045,1045
"60103","Nsylvestris_NODE_19272_length_1162_cov_139","Ntome_NODE_20653_length_1141_cov_175",91.136,1083,63,21,48,1122,9,1066,0,1437,1074,1057
"60108","Nsylvestris_NODE_19274_length_1162_cov_79","Ntome_NODE_6179_length_2816_cov_81",94.643,56,3,0,636,691,415,470,2.46e-16,87.9,55,55
"60112","Nsylvestris_NODE_19276_length_1162_cov_21","Ntome_NODE_9165_length_2316_cov_17",85.304,1218,97,33,1,1161,1902,710,0,1182,1160,1192
"60119","Nsylvestris_NODE_19279_length_1162_cov_9","Ntome_NODE_5824_length_2890_cov_104",88.52,1176,86,13,1,1162,2223,1083,0,1378,1161,1140
"60135","Nsylvestris_NODE_19286_length_1161_cov_198","Ntome_NODE_21516_length_1080_cov_190",96.397,1027,30,3,142,1161,1028,2,0,1685,1019,1026
"60148","Nsylvestris_NODE_19289_length_1161_cov_182","Ntome_NODE_21433_length_1086_cov_90",90.167,956,61,18,126,1054,106,1055,0,1214,928,949
"60156","Nsylvestris_NODE_19292_length_1161_cov_122","Ntome_NODE_19986_length_1193_cov_74",89.5,1019,70,14,159,1141,1018,1,0,1254,982,1017
"60171","Nsylvestris_NODE_19298_length_1162_cov_40","Ntome_NODE_18334_length_1331_cov_266",91.358,243,19,2,726,967,294,53,1.03e-89,331,241,241
"60178","Nsylvestris_NODE_19301_length_1161_cov_18","Ntome_NODE_12637_length_1882_cov_225",98.077,52,1,0,1,52,1220,1271,1.9e-17,91.6,51,51
"60179","Nsylvestris_NODE_19302_length_1161_cov_8","Ntome_NODE_8838_length_2363_cov_106",95.71,1119,31,8,50,1161,1604,496,0,1784,1111,1108
"60190","Nsylvestris_NODE_19307_length_1160_cov_200","Ntome_NODE_20984_length_1117_cov_239",94.804,1020,46,4,82,1095,80,1098,0,1583,1013,1018
"60191","Nsylvestris_NODE_19308_length_1160_cov_166","Ntome_NODE_19098_length_1267_cov_223",93.643,1054,52,9,67,1109,143,1192,0,1561,1042,1049
"60192","Nsylvestris_NODE_19309_length_1160_cov_161","Ntome_NODE_10612_length_2118_cov_115",87.938,970,34,29,154,1077,936,4,0,1066,923,932
"60195","Nsylvestris_NODE_19311_length_1160_cov_82","Ntome_NODE_19609_length_1225_cov_124",87.874,1171,63,33,1,1122,43,1183,0,1303,1121,1140
"60198","Nsylvestris_NODE_19314_length_1160_cov_11","Ntome_NODE_7989_length_2492_cov_106",90.488,1167,84,12,2,1160,1169,22,0,1515,1158,1147
"60209","Nsylvestris_NODE_19318_length_1159_cov_173","Ntome_NODE_933_length_5188_cov_206",88.45,961,61,25,208,1133,999,54,0,1114,925,945
"60212","Nsylvestris_NODE_19320_length_1159_cov_99","Ntome_NODE_21596_length_1075_cov_24",90.653,1102,59,20,58,1142,1,1075,0,1424,1084,1074
"60218","Nsylvestris_NODE_19324_length_1159_cov_6","Ntome_NODE_7907_length_2505_cov_138",97.332,1162,27,3,1,1158,71,1232,0,1971,1157,1161
"60243","Nsylvestris_NODE_19335_length_1157_cov_180","Ntome_NODE_21725_length_1066_cov_200",91.848,871,39,7,45,883,45,915,0,1186,838,870
"60247","Nsylvestris_NODE_19337_length_1157_cov_20","Ntome_NODE_5371_length_2993_cov_59",89.474,76,6,2,722,796,2986,2912,1.46e-18,95.3,74,74
"60277","Nsylvestris_NODE_19348_length_1156_cov_8","Ntome_NODE_36764_length_317_cov_3",85.938,128,2,1,1,128,112,1,6.7e-27,122,127,111
"60282","Nsylvestris_NODE_19351_length_1155_cov_212","Ntome_NODE_13467_length_1789_cov_232",97.418,1123,23,2,1,1120,1167,48,0,1908,1119,1119
"60283","Nsylvestris_NODE_19352_length_1155_cov_167","Ntome_NODE_16083_length_1532_cov_261",97.368,38,1,0,1118,1155,755,718,1.14e-09,65.8,37,37
"60284","Nsylvestris_NODE_19353_length_1155_cov_165","Ntome_NODE_20491_length_1154_cov_215",89.651,918,46,13,1,897,222,1111,0,1123,896,889
"60308","Nsylvestris_NODE_19362_length_1154_cov_204","Ntome_NODE_20081_length_1185_cov_278",95.018,1104,41,9,53,1154,93,1184,0,1722,1101,1091
"60317","Nsylvestris_NODE_19365_length_1154_cov_190","Ntome_NODE_20649_length_1141_cov_251",94.703,944,47,3,146,1089,963,23,0,1463,943,940
"60323","Nsylvestris_NODE_19368_length_1154_cov_177","Ntome_NODE_20899_length_1123_cov_273",96.429,1064,38,0,85,1148,1074,11,0,1755,1063,1063
"60329","Nsylvestris_NODE_19372_length_1154_cov_92","Ntome_NODE_25340_length_841_cov_67",95.504,734,30,3,210,940,56,789,0,1170,730,733
"60339","Nsylvestris_NODE_19376_length_1154_cov_6","Ntome_NODE_32782_length_493_cov_5",81.457,151,26,2,73,221,6,156,6.69e-27,122,148,150
"60346","Nsylvestris_NODE_19379_length_1153_cov_199","Ntome_NODE_19095_length_1267_cov_247",94.961,1151,47,7,4,1153,1251,111,0,1794,1149,1140
"60347","Nsylvestris_NODE_19380_length_1153_cov_174","Ntome_NODE_20043_length_1188_cov_217",91.503,1071,44,14,102,1134,1164,103,0,1430,1032,1061
"60398","Nsylvestris_NODE_19403_length_1152_cov_21","Ntome_NODE_18441_length_1322_cov_32",93.138,1093,56,11,61,1152,1223,149,0,1585,1091,1074
"60422","Nsylvestris_NODE_19414_length_1151_cov_14","Ntome_NODE_27534_length_731_cov_3",91.787,694,54,3,323,1014,3,695,0,963,691,692
"60432","Nsylvestris_NODE_19420_length_1150_cov_213","Ntome_NODE_19316_length_1250_cov_251",94.306,1124,53,5,1,1113,82,1205,0,1711,1112,1123
"60457","Nsylvestris_NODE_19431_length_1150_cov_7","Ntome_NODE_9209_length_2308_cov_22",84.064,684,48,28,71,714,712,50,1.95e-171,603,643,662
"60466","Nsylvestris_NODE_19435_length_1149_cov_192","Ntome_NODE_15893_length_1548_cov_231",97.196,856,24,0,247,1102,293,1148,0,1448,855,855
"60467","Nsylvestris_NODE_19436_length_1149_cov_180","Ntome_NODE_17857_length_1370_cov_205",95.462,1146,44,5,1,1143,132,1272,0,1821,1142,1140
"60479","Nsylvestris_NODE_19443_length_1148_cov_203","Ntome_NODE_20310_length_1168_cov_258",92.398,1026,70,5,70,1094,1029,11,0,1456,1024,1018
"60480","Nsylvestris_NODE_19444_length_1148_cov_188","Ntome_NODE_20223_length_1175_cov_261",93.462,933,47,10,101,1021,50,980,0,1373,920,930
"60485","Nsylvestris_NODE_19446_length_1148_cov_92","Ntome_NODE_17989_length_1358_cov_217",93.46,1101,44,12,53,1148,73,1150,0,1609,1095,1077
"60486","Nsylvestris_NODE_19447_length_1148_cov_58","Ntome_NODE_18612_length_1307_cov_134",93.738,1038,61,4,1,1035,1085,49,0,1554,1034,1036
"60490","Nsylvestris_NODE_19449_length_1148_cov_46","Ntome_NODE_15805_length_1557_cov_188",74.266,579,103,34,157,716,227,778,8.31e-51,202,559,551
"60501","Nsylvestris_NODE_19453_length_1148_cov_27","Ntome_NODE_4055_length_3333_cov_129",89.758,908,62,8,8,891,2312,3212,0,1133,883,900
"60513","Nsylvestris_NODE_19458_length_1148_cov_7","Ntome_NODE_13312_length_1807_cov_56",93.49,1152,59,8,2,1148,1367,227,0,1698,1146,1140
"60544","Nsylvestris_NODE_19470_length_1146_cov_7","Ntome_NODE_907_length_5215_cov_113",87.421,954,115,5,178,1128,129,1080,0,1092,950,951
"60549","Nsylvestris_NODE_19472_length_1146_cov_76","Ntome_NODE_9578_length_2257_cov_104",80.325,493,66,17,13,489,851,1328,1.3e-93,344,476,477
"60559","Nsylvestris_NODE_19477_length_1145_cov_194","Ntome_NODE_22431_length_1020_cov_248",96.95,787,21,2,289,1073,786,1,0,1317,784,785
"60568","Nsylvestris_NODE_19482_length_1145_cov_30","Ntome_NODE_22648_length_1007_cov_19",96.142,1011,30,5,14,1019,1,1007,0,1642,1005,1006
"60569","Nsylvestris_NODE_19483_length_1145_cov_12","Ntome_NODE_5410_length_2984_cov_31",96.157,1145,44,0,1,1145,84,1228,0,1871,1144,1144
"60570","Nsylvestris_NODE_19484_length_1145_cov_11","Ntome_NODE_19450_length_1238_cov_23",95.494,1154,41,5,1,1145,1217,66,0,1832,1144,1151
"60573","Nsylvestris_NODE_19486_length_1145_cov_9","Ntome_NODE_11245_length_2043_cov_209",93.103,1160,65,4,1,1145,758,1917,0,1685,1144,1159
"60578","Nsylvestris_NODE_19489_length_1144_cov_201","Ntome_NODE_20042_length_1188_cov_250",87.433,1122,84,29,59,1144,50,1150,0,1238,1085,1100
"60593","Nsylvestris_NODE_19495_length_1144_cov_25","Ntome_NODE_18744_length_1296_cov_210",94.159,1147,37,14,1,1144,1236,117,0,1720,1143,1119
"60607","Nsylvestris_NODE_19499_length_1144_cov_7","Ntome_NODE_24472_length_894_cov_14",85.714,217,26,5,680,892,411,196,1.77e-57,224,212,215
"60608","Nsylvestris_NODE_19500_length_1143_cov_205","Ntome_NODE_13660_length_1771_cov_169",93.713,1002,45,8,110,1098,1766,770,0,1485,988,996
"60615","Nsylvestris_NODE_19503_length_1143_cov_197","Ntome_NODE_6713_length_2711_cov_177",93.231,783,41,8,199,975,331,1107,0,1142,776,776
"60618","Nsylvestris_NODE_19505_length_1143_cov_24","Ntome_NODE_11879_length_1972_cov_254",90.558,233,22,0,488,720,967,735,4.74e-83,309,232,232
"60629","Nsylvestris_NODE_19509_length_1142_cov_202","Ntome_NODE_22560_length_1012_cov_225",94.515,948,49,2,136,1080,1,948,0,1459,944,947
"60648","Nsylvestris_NODE_19516_length_1142_cov_16","Ntome_NODE_19418_length_1241_cov_57",92.681,1134,68,10,13,1142,1176,54,0,1620,1129,1122
"60653","Nsylvestris_NODE_19519_length_1141_cov_213","Ntome_NODE_20737_length_1135_cov_280",94.99,978,38,5,144,1115,1022,50,0,1524,971,972
"60654","Nsylvestris_NODE_19520_length_1141_cov_205","Ntome_NODE_12350_length_1915_cov_231",94.578,830,43,2,314,1141,1751,922,0,1282,827,829
"60715","Nsylvestris_NODE_19545_length_1140_cov_33","Ntome_NODE_22389_length_1023_cov_260",100,55,0,0,1086,1140,799,745,8.61e-21,102,54,54
"60731","Nsylvestris_NODE_19552_length_1139_cov_196","Ntome_NODE_20707_length_1137_cov_239",91.466,996,62,9,155,1139,1090,107,0,1347,984,983
"60737","Nsylvestris_NODE_19555_length_1139_cov_135","Ntome_NODE_30710_length_600_cov_4",97.487,557,14,0,187,743,557,1,0,952,556,556
"60770","Nsylvestris_NODE_19569_length_1137_cov_149","Ntome_NODE_21136_length_1106_cov_204",96.108,925,35,1,1,925,142,1065,0,1507,924,923
"60779","Nsylvestris_NODE_19572_length_1137_cov_47","Ntome_NODE_21096_length_1109_cov_19",93.939,1056,61,2,38,1093,1,1053,0,1592,1055,1052
"60822","Nsylvestris_NODE_19587_length_1135_cov_215","Ntome_NODE_20622_length_1143_cov_234",92.929,1089,58,8,20,1103,27,1101,0,1567,1083,1074
"60823","Nsylvestris_NODE_19588_length_1135_cov_207","Ntome_NODE_21387_length_1089_cov_269",90.173,519,51,0,322,840,825,307,0,676,518,518
"60828","Nsylvestris_NODE_19590_length_1135_cov_203","Ntome_NODE_21499_length_1081_cov_245",96.135,1035,32,5,35,1066,1038,9,0,1683,1031,1029
"60856","Nsylvestris_NODE_19604_length_1135_cov_9","Ntome_NODE_67_length_9239_cov_80",94.737,76,4,0,1,76,1918,1993,8.51e-26,119,75,75
"60895","Nsylvestris_NODE_19619_length_1134_cov_7","Ntome_NODE_384_length_6382_cov_235",100,55,0,0,1080,1134,2893,2839,8.56e-21,102,54,54
"60906","Nsylvestris_NODE_19623_length_1133_cov_200","Ntome_NODE_19254_length_1255_cov_159",94.218,1055,51,6,1,1048,75,1126,0,1602,1047,1051
"60907","Nsylvestris_NODE_19624_length_1133_cov_195","Ntome_NODE_16970_length_1451_cov_188",95.739,798,33,1,30,827,1415,619,0,1284,797,796
"60923","Nsylvestris_NODE_19630_length_1133_cov_8","Ntome_NODE_2112_length_4102_cov_138",93.398,1136,55,12,1,1133,928,2046,0,1664,1132,1118
"60927","Nsylvestris_NODE_19632_length_1132_cov_219","Ntome_NODE_19162_length_1262_cov_235",90.771,1116,81,10,1,1109,1101,1,0,1471,1108,1100
"60948","Nsylvestris_NODE_19639_length_1132_cov_11","Ntome_NODE_3225_length_3612_cov_104",81.778,225,36,5,909,1132,2240,2460,2.97e-45,183,223,220
"60949","Nsylvestris_NODE_19640_length_1132_cov_8","Ntome_NODE_9886_length_2215_cov_75",90.37,135,10,1,1,135,1435,1566,1.79e-42,174,134,131
"60950","Nsylvestris_NODE_19641_length_1132_cov_7","Ntome_NODE_19850_length_1205_cov_236",95,60,3,0,1,60,166,225,1.43e-18,95.3,59,59
"60953","Nsylvestris_NODE_19643_length_1131_cov_203","Ntome_NODE_29524_length_647_cov_123",91.068,571,25,9,124,684,4,558,0,749,560,554
"60960","Nsylvestris_NODE_19646_length_1131_cov_141","Ntome_NODE_19710_length_1217_cov_268",93.431,1096,47,12,3,1079,26,1115,0,1602,1076,1089
"60965","Nsylvestris_NODE_19649_length_1131_cov_33","Ntome_NODE_7993_length_2491_cov_269",98.182,55,1,0,1,55,486,432,3.97e-19,97.1,54,54
"60977","Nsylvestris_NODE_19656_length_1130_cov_207","Ntome_NODE_17604_length_1393_cov_221",94.711,1021,51,2,51,1068,1263,243,0,1583,1017,1020
"60982","Nsylvestris_NODE_19659_length_1130_cov_135","Ntome_NODE_1855_length_4268_cov_180",95.883,1093,31,3,1,1081,1144,54,0,1757,1080,1090
"60992","Nsylvestris_NODE_19663_length_1129_cov_10","Ntome_NODE_456_length_6137_cov_19",88.15,962,108,5,2,962,1263,307,0,1140,960,956
"60995","Nsylvestris_NODE_19665_length_1130_cov_9","Ntome_NODE_1793_length_4317_cov_274",93.939,66,1,3,1,64,3232,3296,3.97e-19,97.1,63,64
"60999","Nsylvestris_NODE_19667_length_1129_cov_236","Ntome_NODE_1748_length_4345_cov_298",98.406,1129,18,0,1,1129,2548,1420,0,1986,1128,1128
"61003","Nsylvestris_NODE_19669_length_1129_cov_192","Ntome_NODE_18526_length_1313_cov_150",94.444,774,38,2,135,907,33,802,0,1186,772,769
"61007","Nsylvestris_NODE_19671_length_1129_cov_68","Ntome_NODE_22088_length_1042_cov_62",95.938,1034,36,3,15,1042,1034,1,0,1672,1027,1033
"61012","Nsylvestris_NODE_19675_length_1129_cov_31","Ntome_NODE_4849_length_3122_cov_157",96.552,58,2,0,1,58,2315,2258,3.97e-19,97.1,57,57
"61013","Nsylvestris_NODE_19676_length_1129_cov_31","Ntome_NODE_7080_length_2642_cov_197",93.433,1142,54,13,1,1129,2530,1397,0,1674,1128,1133
"61019","Nsylvestris_NODE_19679_length_1128_cov_256","Ntome_NODE_2148_length_4084_cov_120",96.13,1137,35,1,1,1128,1132,2268,0,1847,1127,1136
"61031","Nsylvestris_NODE_19684_length_1128_cov_166","Ntome_NODE_22584_length_1011_cov_13",90.864,1018,70,6,65,1069,4,1011,0,1343,1004,1007
"61034","Nsylvestris_NODE_19686_length_1128_cov_119","Ntome_NODE_16776_length_1468_cov_182",93.607,1048,56,6,38,1078,3,1046,0,1554,1040,1043
"61044","Nsylvestris_NODE_19690_length_1128_cov_37","Ntome_NODE_4845_length_3124_cov_51",82.426,882,121,23,277,1128,387,1264,0,739,851,877
"61051","Nsylvestris_NODE_19692_length_1128_cov_34","Ntome_NODE_971_length_5124_cov_281",96.364,55,2,0,1,55,4617,4563,1.84e-17,91.6,54,54
"61071","Nsylvestris_NODE_19702_length_1127_cov_119","Ntome_NODE_23326_length_964_cov_19",88.599,921,59,23,44,954,20,904,0,1077,910,884
"61089","Nsylvestris_NODE_19710_length_1126_cov_178","Ntome_NODE_21554_length_1077_cov_195",92.5,880,30,12,29,889,60,922,0,1227,860,862
"61106","Nsylvestris_NODE_19716_length_1126_cov_9","Ntome_NODE_4136_length_3311_cov_161",93.392,1135,47,6,1,1126,291,1406,0,1655,1125,1115
"61110","Nsylvestris_NODE_19718_length_1125_cov_186","Ntome_NODE_22309_length_1027_cov_271",92.809,890,50,8,106,990,928,48,0,1277,884,880
"61111","Nsylvestris_NODE_19719_length_1125_cov_163","Ntome_NODE_23322_length_964_cov_28",86.462,879,58,22,145,998,62,904,0,907,853,842
"61115","Nsylvestris_NODE_19723_length_1125_cov_34","Ntome_NODE_2115_length_4101_cov_298",95.349,43,2,0,1083,1125,2278,2236,8.62e-11,69.4,42,42
"61128","Nsylvestris_NODE_19729_length_1124_cov_223","Ntome_NODE_17451_length_1407_cov_285",95.365,1122,48,2,6,1124,1378,258,0,1781,1118,1120
"61132","Nsylvestris_NODE_19731_length_1124_cov_181","Ntome_NODE_19193_length_1260_cov_193",91.949,1093,66,11,1,1080,1084,1,0,1511,1079,1083
"61133","Nsylvestris_NODE_19732_length_1124_cov_142","Ntome_NODE_21809_length_1060_cov_144",95.393,955,36,6,9,960,54,1003,0,1513,951,949
"61134","Nsylvestris_NODE_19734_length_1124_cov_100","Ntome_NODE_22189_length_1035_cov_50",89.458,1034,53,21,1,1028,1032,49,0,1254,1027,983
"61135","Nsylvestris_NODE_19736_length_1124_cov_12","Ntome_NODE_12657_length_1880_cov_109",88.889,1152,91,19,1,1124,738,1880,0,1384,1123,1142
"61136","Nsylvestris_NODE_19737_length_1124_cov_10","Ntome_NODE_564_length_5853_cov_98",91.413,920,63,7,87,1006,4639,5542,0,1247,919,903
"61157","Nsylvestris_NODE_19744_length_1123_cov_200","Ntome_NODE_21258_length_1097_cov_237",92.857,630,42,3,466,1093,728,100,0,911,627,628
"61172","Nsylvestris_NODE_19751_length_1123_cov_5","Ntome_NODE_5784_length_2899_cov_234",100,55,0,0,1,55,1519,1573,8.48e-21,102,54,54
"61173","Nsylvestris_NODE_19752_length_1122_cov_199","Ntome_NODE_19740_length_1215_cov_235",94.599,1111,42,8,7,1109,1108,8,0,1703,1102,1100
"61184","Nsylvestris_NODE_19755_length_1122_cov_58","Ntome_NODE_25200_length_851_cov_48",97.503,801,20,0,231,1031,49,849,0,1369,800,800
"61191","Nsylvestris_NODE_19759_length_1120_cov_13","Ntome_NODE_1308_length_4718_cov_41",88.636,176,19,1,819,994,4471,4645,3.74e-54,213,175,174
"61195","Nsylvestris_NODE_19761_length_1121_cov_213","Ntome_NODE_24483_length_893_cov_185",93.459,795,31,3,11,799,60,839,0,1160,788,779
"61196","Nsylvestris_NODE_19762_length_1121_cov_191","Ntome_NODE_20640_length_1142_cov_213",97.137,908,22,2,162,1069,1044,141,0,1530,907,903
"61201","Nsylvestris_NODE_19764_length_1121_cov_159","Ntome_NODE_19955_length_1195_cov_271",84.43,456,63,6,397,851,673,225,4.39e-123,442,454,448
"61206","Nsylvestris_NODE_19767_length_1121_cov_72","Ntome_NODE_15790_length_1559_cov_53",95.38,606,13,4,516,1121,324,914,0,950,605,590
"61219","Nsylvestris_NODE_19773_length_1120_cov_137","Ntome_NODE_21688_length_1068_cov_225",93.465,658,32,7,83,732,56,710,0,966,649,654
"61252","Nsylvestris_NODE_19783_length_1119_cov_43","Ntome_NODE_14095_length_1727_cov_116",98.182,55,1,0,1065,1119,1296,1350,3.93e-19,97.1,54,54
"61260","Nsylvestris_NODE_19787_length_1118_cov_220","Ntome_NODE_20197_length_1177_cov_107",92.222,1080,61,8,51,1118,1069,1,0,1507,1067,1068
"61277","Nsylvestris_NODE_19793_length_1118_cov_82","Ntome_NODE_8255_length_2449_cov_289",100,55,0,0,1064,1118,1389,1443,8.44e-21,102,54,54
"61289","Nsylvestris_NODE_19799_length_1117_cov_186","Ntome_NODE_19304_length_1250_cov_233",92.463,544,41,0,176,719,945,402,0,778,543,543
"61316","Nsylvestris_NODE_19810_length_1117_cov_14","Ntome_NODE_12712_length_1871_cov_258",100,55,0,0,1,55,1243,1297,8.43e-21,102,54,54
"61319","Nsylvestris_NODE_19812_length_1116_cov_210","Ntome_NODE_12631_length_1883_cov_190",91.548,1124,34,20,1,1111,806,1881,0,1493,1110,1075
"61324","Nsylvestris_NODE_19814_length_1116_cov_150","Ntome_NODE_5800_length_2894_cov_107",90,150,12,3,942,1090,2745,2892,1.75e-47,191,148,147
"61325","Nsylvestris_NODE_19815_length_1116_cov_122","Ntome_NODE_4410_length_3235_cov_185",96.364,55,2,0,1062,1116,1100,1046,1.82e-17,91.6,54,54
"61332","Nsylvestris_NODE_19818_length_1116_cov_27","Ntome_NODE_30310_length_616_cov_12",96.803,563,18,0,231,793,52,614,0,941,562,562
"61336","Nsylvestris_NODE_19820_length_1116_cov_20","Ntome_NODE_6130_length_2826_cov_61",92.52,1123,44,13,4,1116,1508,416,0,1572,1112,1092
"61353","Nsylvestris_NODE_19826_length_1114_cov_118","Ntome_NODE_13976_length_1740_cov_174",96.855,954,25,3,122,1070,1282,329,0,1591,948,953
"61383","Nsylvestris_NODE_19836_length_1115_cov_9","Ntome_NODE_1225_length_4807_cov_19",91.189,942,80,3,46,985,1313,373,0,1277,939,940
"61400","Nsylvestris_NODE_19845_length_1114_cov_99","Ntome_NODE_24128_length_917_cov_15",96.037,858,34,0,215,1072,917,60,0,1397,857,857
"61406","Nsylvestris_NODE_19847_length_1114_cov_76","Ntome_NODE_1621_length_4438_cov_170",98.182,55,1,0,1060,1114,3646,3592,3.91e-19,97.1,54,54
"61407","Nsylvestris_NODE_19848_length_1114_cov_12","Ntome_NODE_23990_length_925_cov_165",83.577,274,24,5,812,1079,259,1,2.21e-61,237,267,258
"61421","Nsylvestris_NODE_19853_length_1113_cov_205","Ntome_NODE_21708_length_1067_cov_214",93.207,1001,52,9,83,1078,51,1040,0,1458,995,989
"61447","Nsylvestris_NODE_19861_length_1113_cov_81","Ntome_NODE_977_length_5121_cov_115",86.454,251,22,5,789,1037,263,23,1.01e-69,265,248,240
"61448","Nsylvestris_NODE_19862_length_1113_cov_60","Ntome_NODE_22396_length_1023_cov_51",93.594,999,42,6,35,1032,1,978,0,1471,997,977
"61478","Nsylvestris_NODE_19874_length_1112_cov_44","Ntome_NODE_15678_length_1570_cov_232",96.201,1053,40,0,52,1104,197,1249,0,1724,1052,1052
"61479","Nsylvestris_NODE_19875_length_1112_cov_21","Ntome_NODE_143_length_7925_cov_49",100,55,0,0,1,55,5594,5648,8.39e-21,102,54,54
"61484","Nsylvestris_NODE_19878_length_1112_cov_11","Ntome_NODE_6220_length_2806_cov_263",100,31,0,0,1080,1110,167,197,1.84e-07,58.4,30,30
"61496","Nsylvestris_NODE_19881_length_1111_cov_211","Ntome_NODE_20803_length_1130_cov_271",93.025,1061,50,14,30,1087,1080,41,0,1528,1057,1039
"61502","Nsylvestris_NODE_19884_length_1111_cov_185","Ntome_NODE_20373_length_1163_cov_188",91.525,767,30,6,301,1061,807,70,0,1024,760,737
"61508","Nsylvestris_NODE_19887_length_1111_cov_74","Ntome_NODE_20417_length_1160_cov_164",92.968,967,60,6,14,974,1084,120,0,1402,960,964
"61512","Nsylvestris_NODE_19889_length_1111_cov_7","Ntome_NODE_9582_length_2256_cov_265",100,55,0,0,1,55,1508,1454,8.39e-21,102,54,54
"61522","Nsylvestris_NODE_19895_length_1110_cov_133","Ntome_NODE_25517_length_832_cov_88",89.682,785,52,8,188,954,50,823,0,974,766,773
"61532","Nsylvestris_NODE_19900_length_1110_cov_66","Ntome_NODE_7839_length_2518_cov_142",83.212,548,92,0,136,683,364,911,1.97e-141,503,547,547
"61539","Nsylvestris_NODE_19903_length_1110_cov_15","Ntome_NODE_13053_length_1836_cov_28",96.13,956,37,0,155,1110,1783,828,0,1561,955,955
"61549","Nsylvestris_NODE_19907_length_1110_cov_11","Ntome_NODE_3337_length_3572_cov_107",93.333,840,44,9,234,1066,973,1807,0,1230,832,834
"61556","Nsylvestris_NODE_19910_length_1109_cov_214","Ntome_NODE_18954_length_1280_cov_221",95.424,1027,39,5,36,1060,1240,220,0,1629,1024,1020
"61557","Nsylvestris_NODE_19911_length_1109_cov_196","Ntome_NODE_26518_length_781_cov_150",97.042,710,21,0,147,856,754,45,0,1195,709,709
"61558","Nsylvestris_NODE_19912_length_1109_cov_194","Ntome_NODE_20943_length_1120_cov_102",90.282,1029,70,22,90,1109,100,1107,0,1319,1019,1007
"61559","Nsylvestris_NODE_19913_length_1109_cov_190","Ntome_NODE_11816_length_1979_cov_152",97.196,856,23,1,46,901,1979,1125,0,1447,855,854
"61560","Nsylvestris_NODE_19914_length_1109_cov_162","Ntome_NODE_18682_length_1301_cov_51",95.718,1051,33,6,1,1047,1044,2,0,1681,1046,1042
"61565","Nsylvestris_NODE_19918_length_1109_cov_12","Ntome_NODE_32749_length_495_cov_6",87.952,83,7,3,998,1078,82,1,1.4e-18,95.3,80,81
"61588","Nsylvestris_NODE_19926_length_1108_cov_173","Ntome_NODE_21265_length_1097_cov_59",91.648,910,59,6,158,1055,973,69,0,1243,897,904
"61595","Nsylvestris_NODE_19929_length_1108_cov_63","Ntome_NODE_20341_length_1166_cov_84",93.569,1104,37,13,24,1108,1,1089,0,1615,1084,1088
"61596","Nsylvestris_NODE_19930_length_1108_cov_18","Ntome_NODE_20542_length_1150_cov_273",97.778,45,0,1,1,45,429,472,5.07e-13,76.8,44,43
"61603","Nsylvestris_NODE_19934_length_1107_cov_204","Ntome_NODE_16646_length_1482_cov_212",96.088,997,30,5,43,1038,46,1034,0,1616,995,988
"61604","Nsylvestris_NODE_19935_length_1107_cov_184","Ntome_NODE_22454_length_1019_cov_253",95.289,1019,38,4,51,1061,1019,3,0,1607,1010,1016
"61605","Nsylvestris_NODE_19936_length_1107_cov_160","Ntome_NODE_19758_length_1213_cov_242",94.713,1116,45,8,1,1107,71,1181,0,1722,1106,1110
"61606","Nsylvestris_NODE_19937_length_1107_cov_149","Ntome_NODE_19187_length_1260_cov_280",96.393,499,18,0,609,1107,63,561,0,822,498,498
"61626","Nsylvestris_NODE_19944_length_1107_cov_22","Ntome_NODE_19913_length_1199_cov_74",96.317,1059,38,1,46,1104,141,1198,0,1738,1058,1057
"61637","Nsylvestris_NODE_19949_length_1106_cov_225","Ntome_NODE_4620_length_3179_cov_299",97.649,1106,23,1,1,1106,1808,706,0,1895,1105,1102
"61654","Nsylvestris_NODE_19955_length_1106_cov_128","Ntome_NODE_27938_length_713_cov_134",90.259,657,41,8,287,921,55,710,0,837,634,655
"61723","Nsylvestris_NODE_19980_length_1100_cov_164","Ntome_NODE_5364_length_2995_cov_264",94.681,658,26,4,1,650,2228,2884,0,1013,649,656
"61726","Nsylvestris_NODE_19983_length_1104_cov_13","Ntome_NODE_19171_length_1262_cov_27",95.29,1104,52,0,1,1104,159,1262,0,1751,1103,1103
"61733","Nsylvestris_NODE_19987_length_1103_cov_198","Ntome_NODE_21578_length_1076_cov_126",94.489,998,44,4,92,1083,84,1076,0,1528,991,992
"61740","Nsylvestris_NODE_19990_length_1103_cov_176","Ntome_NODE_20245_length_1174_cov_53",90.706,1076,65,10,20,1085,1054,4,0,1400,1065,1050
"61741","Nsylvestris_NODE_19991_length_1103_cov_174","Ntome_NODE_5_length_14762_cov_269",97.086,755,22,0,346,1100,12542,13296,0,1273,754,754
"61744","Nsylvestris_NODE_19993_length_1103_cov_85","Ntome_NODE_3637_length_3473_cov_114",93.103,58,1,2,1,55,3311,3368,1.08e-14,82.4,54,57
"61751","Nsylvestris_NODE_19997_length_1103_cov_23","Ntome_NODE_22179_length_1036_cov_39",76.046,693,148,12,359,1039,843,157,1.25e-93,344,680,686
"61757","Nsylvestris_NODE_20000_length_1103_cov_5","Ntome_NODE_6847_length_2685_cov_193",82.185,595,72,19,241,802,1370,1963,9.15e-135,481,561,593
"61758","Nsylvestris_NODE_20001_length_1102_cov_219","Ntome_NODE_19969_length_1194_cov_280",96.211,1003,35,1,50,1052,1059,60,0,1639,1002,999
"61762","Nsylvestris_NODE_20003_length_1102_cov_217","Ntome_NODE_38077_length_287_cov_1",94.656,262,14,0,357,618,1,262,1.57e-112,407,261,261
"61780","Nsylvestris_NODE_20008_length_1102_cov_71","Ntome_NODE_10773_length_2099_cov_7",91.429,1085,87,5,1,1081,1017,2099,0,1483,1080,1082
"61783","Nsylvestris_NODE_20011_length_1102_cov_62","Ntome_NODE_10329_length_2154_cov_112",94.702,1057,47,6,1,1051,2128,1075,0,1633,1050,1053
"61805","Nsylvestris_NODE_20019_length_1101_cov_154","Ntome_NODE_11193_length_2050_cov_229",93.946,925,39,8,154,1077,1032,124,0,1382,923,908
"61814","Nsylvestris_NODE_20022_length_1101_cov_28","Ntome_NODE_5238_length_3020_cov_86",95.604,91,4,0,251,341,2085,1995,3.78e-34,147,90,90
"61831","Nsylvestris_NODE_20030_length_1100_cov_23","Ntome_NODE_30646_length_602_cov_33",92.857,56,4,0,4,59,482,537,1.08e-14,82.4,55,55
"61834","Nsylvestris_NODE_20032_length_1099_cov_195","Ntome_NODE_20179_length_1178_cov_230",89.583,912,44,24,200,1099,236,1108,0,1110,899,872
"61835","Nsylvestris_NODE_20033_length_1099_cov_180","Ntome_NODE_19659_length_1221_cov_212",90.909,902,52,18,134,1032,926,52,0,1184,898,874
"61838","Nsylvestris_NODE_20035_length_1099_cov_151","Ntome_NODE_17579_length_1395_cov_210",92.115,1078,42,12,1,1044,1069,1,0,1480,1043,1068
"61839","Nsylvestris_NODE_20036_length_1099_cov_88","Ntome_NODE_10376_length_2147_cov_285",100,55,0,0,1045,1099,352,298,8.29e-21,102,54,54
"61840","Nsylvestris_NODE_20037_length_1099_cov_64","Ntome_NODE_14900_length_1644_cov_222",94.568,902,48,1,67,968,1025,125,0,1393,901,900
"61855","Nsylvestris_NODE_20043_length_1098_cov_214","Ntome_NODE_19399_length_1242_cov_276",92.439,1111,68,5,1,1096,15,1124,0,1572,1095,1109
"61864","Nsylvestris_NODE_20048_length_1098_cov_98","Ntome_NODE_7722_length_2537_cov_221",92.844,1118,40,11,1,1098,1303,2400,0,1585,1097,1097
"61873","Nsylvestris_NODE_20053_length_1098_cov_9","Ntome_NODE_1564_length_4486_cov_83",95.802,786,21,5,1,774,3470,4255,0,1258,773,785
"61881","Nsylvestris_NODE_20057_length_1097_cov_196","Ntome_NODE_23591_length_949_cov_228",91.129,992,42,10,49,1037,949,1,0,1303,988,948
"61896","Nsylvestris_NODE_20062_length_1097_cov_8","Ntome_NODE_3471_length_3525_cov_176",82.726,741,124,4,355,1093,367,1105,0,656,738,738
"61911","Nsylvestris_NODE_20070_length_1096_cov_27","Ntome_NODE_8927_length_2349_cov_268",96.364,55,2,0,1042,1096,1576,1630,1.79e-17,91.6,54,54
"61916","Nsylvestris_NODE_20073_length_1096_cov_19","Ntome_NODE_6291_length_2789_cov_185",100,55,0,0,1,55,968,914,8.27e-21,102,54,54
"61949","Nsylvestris_NODE_20086_length_1095_cov_42","Ntome_NODE_15073_length_1628_cov_40",96,925,33,2,83,1007,1628,708,0,1500,924,920
"61953","Nsylvestris_NODE_20088_length_1095_cov_23","Ntome_NODE_7997_length_2491_cov_96",92.673,737,40,7,369,1092,1753,2488,0,1050,723,735
"61980","Nsylvestris_NODE_20101_length_1094_cov_10","Ntome_NODE_8687_length_2386_cov_286",100,55,0,0,1040,1094,813,867,8.25e-21,102,54,54
"61996","Nsylvestris_NODE_20107_length_1093_cov_181","Ntome_NODE_18651_length_1304_cov_216",92,1050,64,8,51,1093,1137,101,0,1456,1042,1036
"62002","Nsylvestris_NODE_20109_length_1093_cov_116","Ntome_NODE_17503_length_1403_cov_76",96.332,1036,34,2,13,1047,1,1033,0,1700,1034,1032
"62013","Nsylvestris_NODE_20114_length_1093_cov_31","Ntome_NODE_24460_length_895_cov_124",94.013,618,21,8,1,617,33,635,0,922,616,602
"62014","Nsylvestris_NODE_20116_length_1092_cov_222","Ntome_NODE_16356_length_1508_cov_222",93.923,1086,54,7,1,1079,1440,360,0,1629,1078,1080
"62021","Nsylvestris_NODE_20119_length_1092_cov_170","Ntome_NODE_19019_length_1274_cov_254",95.789,1045,39,4,6,1049,74,1114,0,1681,1043,1040
"62034","Nsylvestris_NODE_20125_length_1092_cov_24","Ntome_NODE_6009_length_2845_cov_156",93.154,1081,59,9,1,1074,1554,482,0,1572,1073,1072
"62040","Nsylvestris_NODE_20127_length_1092_cov_11","Ntome_NODE_26415_length_786_cov_72",75.83,542,90,20,49,586,218,722,2.16e-61,237,537,504
"62048","Nsylvestris_NODE_20130_length_1091_cov_210","Ntome_NODE_20123_length_1182_cov_279",91.937,1017,75,2,50,1059,1058,42,0,1417,1009,1016
"62054","Nsylvestris_NODE_20132_length_1091_cov_194","Ntome_NODE_20681_length_1139_cov_244",90.622,1013,77,15,14,1015,1109,104,0,1328,1001,1005
"62061","Nsylvestris_NODE_20136_length_1091_cov_69","Ntome_NODE_23594_length_949_cov_62",92.523,749,56,0,51,799,195,943,0,1074,748,748
"62062","Nsylvestris_NODE_20138_length_1091_cov_36","Ntome_NODE_23011_length_983_cov_16",95.214,982,43,3,15,992,2,983,0,1550,977,981
"62067","Nsylvestris_NODE_20142_length_1091_cov_20","Ntome_NODE_19084_length_1268_cov_225",84.254,851,130,4,153,1001,1118,270,0,826,848,848
"62073","Nsylvestris_NODE_20144_length_1091_cov_12","Ntome_NODE_10648_length_2113_cov_187",98.182,55,1,0,1,55,454,508,3.83e-19,97.1,54,54
"62091","Nsylvestris_NODE_20151_length_1090_cov_120","Ntome_NODE_21531_length_1079_cov_208",93.44,747,37,5,154,899,294,1029,0,1098,745,735
"62098","Nsylvestris_NODE_20155_length_1090_cov_40","Ntome_NODE_31416_length_574_cov_5",90.4,500,30,6,567,1060,545,58,0,641,493,487
"62111","Nsylvestris_NODE_20160_length_1089_cov_200","Ntome_NODE_22747_length_1000_cov_269",96.674,872,29,0,53,924,948,77,0,1450,871,871
"62112","Nsylvestris_NODE_20161_length_1089_cov_198","Ntome_NODE_19605_length_1225_cov_231",92.791,860,57,3,181,1037,50,907,0,1240,856,857
"62128","Nsylvestris_NODE_20168_length_1089_cov_36","Ntome_NODE_17014_length_1447_cov_234",94.545,55,3,0,1035,1089,1027,1081,8.27e-16,86.1,54,54
"62149","Nsylvestris_NODE_20176_length_1088_cov_106","Ntome_NODE_21260_length_1097_cov_173",94.387,1069,43,9,24,1078,25,1090,0,1626,1054,1065
"62150","Nsylvestris_NODE_20177_length_1088_cov_65","Ntome_NODE_22526_length_1014_cov_63",92.723,962,55,9,42,999,951,1,0,1375,957,950
"62151","Nsylvestris_NODE_20178_length_1088_cov_44","Ntome_NODE_5215_length_3026_cov_95",85.124,605,74,10,1,599,2285,2879,5.13e-172,604,598,594
"62154","Nsylvestris_NODE_20180_length_1088_cov_19","Ntome_NODE_36820_length_315_cov_7",96.97,33,1,0,891,923,45,13,6.48e-07,56.5,32,32
"62157","Nsylvestris_NODE_20182_length_1089_cov_4","Ntome_NODE_17626_length_1391_cov_28",92.979,527,31,4,566,1089,449,972,0,763,523,523
"62163","Nsylvestris_NODE_20185_length_1087_cov_200","Ntome_NODE_2048_length_4143_cov_216",93.234,1005,55,10,48,1042,2192,1191,0,1467,994,1001
"62164","Nsylvestris_NODE_20186_length_1087_cov_199","Ntome_NODE_5870_length_2879_cov_150",86.733,1010,84,26,31,1022,1161,184,0,1077,991,977
"62174","Nsylvestris_NODE_20189_length_1087_cov_176","Ntome_NODE_15631_length_1573_cov_204",89.871,1086,67,22,1,1051,231,1308,0,1356,1050,1077
"62177","Nsylvestris_NODE_20191_length_1087_cov_163","Ntome_NODE_2135_length_4090_cov_257",92.89,1097,42,3,27,1087,1,1097,0,1561,1060,1096
"62178","Nsylvestris_NODE_20192_length_1087_cov_140","Ntome_NODE_31805_length_560_cov_6",92.969,512,21,2,274,770,512,1,0,732,496,511
"62179","Nsylvestris_NODE_20193_length_1087_cov_46","Ntome_NODE_27280_length_744_cov_87",94.659,674,36,0,21,694,724,51,0,1046,673,673
"62180","Nsylvestris_NODE_20196_length_1087_cov_32","Ntome_NODE_18354_length_1329_cov_272",91.805,903,58,12,175,1076,292,1179,0,1243,901,887
"62186","Nsylvestris_NODE_20200_length_1087_cov_13","Ntome_NODE_21653_length_1071_cov_9",95.02,1024,51,0,7,1030,1027,4,0,1609,1023,1023
"62212","Nsylvestris_NODE_20211_length_1085_cov_171","Ntome_NODE_23519_length_954_cov_37",94.181,842,42,4,249,1084,917,77,0,1277,835,840
"62213","Nsylvestris_NODE_20212_length_1085_cov_153","Ntome_NODE_13185_length_1821_cov_159",94.598,870,41,5,1,867,47,913,0,1341,866,866
"62216","Nsylvestris_NODE_20214_length_1085_cov_49","Ntome_NODE_4386_length_3242_cov_137",96.044,1087,36,5,1,1085,1093,2174,0,1762,1084,1081
"62222","Nsylvestris_NODE_20218_length_1085_cov_11","Ntome_NODE_5903_length_2871_cov_197",92.709,1111,41,12,1,1083,1771,2869,0,1567,1082,1098
"62230","Nsylvestris_NODE_20222_length_1084_cov_157","Ntome_NODE_20126_length_1182_cov_228",95.759,1014,38,3,38,1049,114,1124,0,1629,1011,1010
"62231","Nsylvestris_NODE_20223_length_1084_cov_105","Ntome_NODE_19510_length_1233_cov_103",92.661,1090,64,12,2,1083,1233,152,0,1555,1081,1081
"62242","Nsylvestris_NODE_20228_length_1084_cov_17","Ntome_NODE_2470_length_3921_cov_253",90.431,209,13,4,656,858,3570,3777,7.62e-71,268,202,207
"62243","Nsylvestris_NODE_20229_length_1084_cov_12","Ntome_NODE_8286_length_2444_cov_18",81.935,858,137,11,236,1082,1541,691,0,710,846,850
"62248","Nsylvestris_NODE_20232_length_1083_cov_224","Ntome_NODE_5364_length_2995_cov_264",94.951,1030,49,1,1,1027,2282,1253,0,1611,1026,1029
"62249","Nsylvestris_NODE_20233_length_1083_cov_209","Ntome_NODE_22079_length_1042_cov_235",92.013,914,55,7,25,929,1,905,0,1267,904,904
"62253","Nsylvestris_NODE_20235_length_1083_cov_197","Ntome_NODE_38257_length_284_cov_4",92.982,57,4,0,620,676,144,200,2.96e-15,84.2,56,56
"62267","Nsylvestris_NODE_20240_length_1083_cov_89","Ntome_NODE_24904_length_869_cov_49",93.3,806,45,3,244,1041,814,10,0,1181,797,804
"62271","Nsylvestris_NODE_20242_length_1083_cov_62","Ntome_NODE_39457_length_259_cov_2",96.109,257,10,0,332,588,257,1,1.99e-116,420,256,256
"62289","Nsylvestris_NODE_20249_length_1083_cov_7","Ntome_NODE_37605_length_297_cov_6",84.513,226,34,1,18,242,226,1,6.01e-57,222,224,225
"62312","Nsylvestris_NODE_20258_length_1082_cov_67","Ntome_NODE_19764_length_1213_cov_65",94.1,1000,42,6,50,1032,1001,2,0,1504,982,999
"62313","Nsylvestris_NODE_20260_length_1082_cov_34","Ntome_NODE_17589_length_1394_cov_133",95.481,1018,40,4,69,1082,1229,214,0,1620,1013,1015
"62316","Nsylvestris_NODE_20262_length_1082_cov_20","Ntome_NODE_3168_length_3631_cov_144",100,55,0,0,1028,1082,2986,3040,8.16e-21,102,54,54
"62322","Nsylvestris_NODE_20264_length_1081_cov_193","Ntome_NODE_24729_length_878_cov_83",91.319,887,41,13,141,1001,878,2,0,1179,860,876
"62339","Nsylvestris_NODE_20270_length_1081_cov_14","Ntome_NODE_8176_length_2463_cov_304",89.394,66,7,0,1006,1071,2345,2410,2.95e-15,84.2,65,65
"62340","Nsylvestris_NODE_20271_length_1081_cov_10","Ntome_NODE_2010_length_4165_cov_244",80.777,1004,184,8,80,1077,136,1136,0,776,997,1000
"62341","Nsylvestris_NODE_20274_length_1080_cov_41","Ntome_NODE_22612_length_1009_cov_175",87.134,956,48,32,137,1080,47,939,0,1014,943,892
"62355","Nsylvestris_NODE_20279_length_1079_cov_187","Ntome_NODE_24513_length_891_cov_194",96.203,790,26,2,35,820,839,50,0,1290,785,789
"62395","Nsylvestris_NODE_20292_length_1078_cov_31","Ntome_NODE_33533_length_444_cov_8",94.595,444,24,0,163,606,1,444,0,688,443,443
"62396","Nsylvestris_NODE_20293_length_1078_cov_30","Ntome_NODE_17119_length_1438_cov_33",90.927,1014,47,11,60,1030,212,1223,0,1321,970,1011
"62409","Nsylvestris_NODE_20301_length_1077_cov_216","Ntome_NODE_17987_length_1358_cov_286",94.798,1038,24,6,60,1077,57,1084,0,1591,1017,1027
"62419","Nsylvestris_NODE_20307_length_1077_cov_40","Ntome_NODE_18663_length_1304_cov_261",91.935,124,7,2,877,997,1143,1266,2.2e-41,171,120,123
"62430","Nsylvestris_NODE_20313_length_1076_cov_220","Ntome_NODE_14435_length_1692_cov_142",91.197,1011,46,26,20,1021,1551,575,0,1334,1001,976
"62436","Nsylvestris_NODE_20316_length_1076_cov_201","Ntome_NODE_20020_length_1190_cov_199",92.516,1069,41,16,37,1075,1189,130,0,1495,1038,1059
"62458","Nsylvestris_NODE_20324_length_1076_cov_16","Ntome_NODE_3866_length_3399_cov_199",100,55,0,0,1022,1076,2143,2089,8.12e-21,102,54,54
"62459","Nsylvestris_NODE_20327_length_1076_cov_9","Ntome_NODE_3908_length_3384_cov_244",100,55,0,0,1,55,1420,1366,8.12e-21,102,54,54
"62463","Nsylvestris_NODE_20329_length_1075_cov_218","Ntome_NODE_18276_length_1335_cov_266",92,1050,52,12,48,1075,1250,211,0,1445,1027,1039
"62473","Nsylvestris_NODE_20333_length_1075_cov_190","Ntome_NODE_21923_length_1053_cov_269",96.681,693,17,3,338,1025,727,36,0,1147,687,691
"62482","Nsylvestris_NODE_20337_length_1075_cov_112","Ntome_NODE_4785_length_3137_cov_184",93.786,1030,39,4,1,1008,6,1032,0,1524,1007,1026
"62485","Nsylvestris_NODE_20339_length_1074_cov_68","Ntome_NODE_293_length_6755_cov_121",93.649,1055,46,8,1,1046,5429,6471,0,1557,1045,1042
"62491","Nsylvestris_NODE_20342_length_1075_cov_42","Ntome_NODE_4853_length_3121_cov_191",98,50,0,1,1026,1075,2241,2289,8.17e-16,86.1,49,48
"62492","Nsylvestris_NODE_20344_length_1075_cov_26","Ntome_NODE_3098_length_3658_cov_212",94.545,55,3,0,1021,1075,1958,2012,8.17e-16,86.1,54,54
"62498","Nsylvestris_NODE_20348_length_1074_cov_207","Ntome_NODE_19149_length_1263_cov_236",95.192,1040,32,8,36,1067,1074,45,0,1628,1031,1029
"62504","Nsylvestris_NODE_20351_length_1074_cov_185","Ntome_NODE_20115_length_1183_cov_215",94.931,947,33,7,141,1074,1142,198,0,1469,933,944
"62505","Nsylvestris_NODE_20352_length_1074_cov_181","Ntome_NODE_26093_length_802_cov_144",95.339,708,18,7,316,1008,47,754,0,1110,692,707
"62515","Nsylvestris_NODE_20354_length_1073_cov_157","Ntome_NODE_26534_length_780_cov_248",96.532,692,23,1,335,1026,35,725,0,1144,691,690
"62535","Nsylvestris_NODE_20360_length_1074_cov_12","Ntome_NODE_12527_length_1895_cov_19",94.27,1082,29,6,1,1074,836,1892,0,1624,1073,1056
"62536","Nsylvestris_NODE_20361_length_1074_cov_9","Ntome_NODE_16992_length_1449_cov_287",98.182,55,1,0,1020,1074,670,616,3.77e-19,97.1,54,54
"62541","Nsylvestris_NODE_20363_length_1073_cov_221","Ntome_NODE_11513_length_2013_cov_85",94.793,845,35,4,181,1023,846,9,0,1308,842,837
"62555","Nsylvestris_NODE_20371_length_1073_cov_52","Ntome_NODE_4386_length_3242_cov_137",96.157,1093,22,6,1,1073,1,1093,0,1768,1072,1092
"62568","Nsylvestris_NODE_20376_length_1073_cov_20","Ntome_NODE_33861_length_426_cov_6",92.471,425,22,6,93,507,2,426,2.35e-170,599,414,424
"62601","Nsylvestris_NODE_20390_length_1072_cov_31","Ntome_NODE_16281_length_1511_cov_47",92.982,57,3,1,175,231,1290,1235,1.05e-14,82.4,56,55
"62622","Nsylvestris_NODE_20398_length_1071_cov_83","Ntome_NODE_20318_length_1168_cov_26",94.358,1028,49,5,1,1023,2,1025,0,1568,1022,1023
"62623","Nsylvestris_NODE_20400_length_1071_cov_33","Ntome_NODE_20959_length_1119_cov_48",93.5,400,20,5,631,1025,399,1,1.41e-167,590,394,398
"62624","Nsylvestris_NODE_20401_length_1071_cov_29","Ntome_NODE_4244_length_3279_cov_109",93.103,464,17,5,60,523,3267,2819,0,665,463,448
"62625","Nsylvestris_NODE_20402_length_1071_cov_22","Ntome_NODE_21621_length_1073_cov_43",90.897,747,42,4,253,982,336,1073,0,979,729,737
"62629","Nsylvestris_NODE_20404_length_1071_cov_13","Ntome_NODE_1473_length_4557_cov_187",91.829,820,54,8,121,933,4105,3292,0,1131,812,813
"62637","Nsylvestris_NODE_20410_length_1070_cov_223","Ntome_NODE_6586_length_2732_cov_277",94.047,1075,22,11,1,1043,2084,1020,0,1592,1042,1064
"62640","Nsylvestris_NODE_20412_length_1070_cov_206","Ntome_NODE_1205_length_4831_cov_219",94.819,772,39,1,49,820,2321,1551,0,1203,771,770
"62654","Nsylvestris_NODE_20417_length_1070_cov_110","Ntome_NODE_18785_length_1293_cov_155",84.112,214,23,3,221,432,174,378,3.6e-49,196,211,204
"62659","Nsylvestris_NODE_20419_length_1070_cov_84","Ntome_NODE_18797_length_1292_cov_12",93.908,952,33,12,71,1021,247,1174,0,1413,950,927
"62663","Nsylvestris_NODE_20421_length_1070_cov_52","Ntome_NODE_38894_length_270_cov_2",98.864,88,1,0,280,367,163,76,1.7e-37,158,87,87
"62664","Nsylvestris_NODE_20422_length_1070_cov_44","Ntome_NODE_33736_length_432_cov_191",90.936,342,13,2,640,969,385,50,1.16e-123,444,329,335
"62665","Nsylvestris_NODE_20425_length_1070_cov_17","Ntome_NODE_20873_length_1126_cov_227",75.327,689,158,12,39,718,1110,425,2.05e-86,320,679,685
"62684","Nsylvestris_NODE_20433_length_1069_cov_57","Ntome_NODE_7167_length_2628_cov_103",88.824,850,43,22,1,850,7,804,0,996,849,797
"62695","Nsylvestris_NODE_20440_length_1069_cov_10","Ntome_NODE_20747_length_1135_cov_34",85.912,866,120,2,161,1025,265,1129,0,922,864,864
"62696","Nsylvestris_NODE_20442_length_1069_cov_8","Ntome_NODE_10872_length_2088_cov_80",96.364,55,2,0,1,55,819,873,1.75e-17,91.6,54,54
"62699","Nsylvestris_NODE_20444_length_1068_cov_207","Ntome_NODE_39779_length_253_cov_2",96.047,253,10,0,326,578,1,253,3.28e-114,412,252,252
"62702","Nsylvestris_NODE_20446_length_1068_cov_195","Ntome_NODE_22535_length_1013_cov_215",94.211,881,41,6,28,899,1013,134,0,1336,871,879
"62717","Nsylvestris_NODE_20452_length_1068_cov_96","Ntome_NODE_19896_length_1201_cov_263",99.306,432,3,0,1,432,687,256,0,782,431,431
"62718","Nsylvestris_NODE_20453_length_1068_cov_84","Ntome_NODE_33674_length_436_cov_3",93.721,430,15,5,216,636,436,10,0,634,420,426
"62723","Nsylvestris_NODE_20455_length_1068_cov_11","Ntome_NODE_6354_length_2775_cov_42",93.333,105,7,0,3,107,1330,1434,6.1e-37,156,104,104
"62734","Nsylvestris_NODE_20461_length_1067_cov_192","Ntome_NODE_21031_length_1113_cov_252",92.618,867,57,2,108,967,58,924,0,1240,859,866
"62745","Nsylvestris_NODE_20465_length_1067_cov_167","Ntome_NODE_7846_length_2517_cov_141",96.407,1002,28,4,21,1018,2517,1520,0,1644,997,997
"62748","Nsylvestris_NODE_20468_length_1067_cov_64","Ntome_NODE_14354_length_1699_cov_292",94.545,55,3,0,1013,1067,759,705,8.1e-16,86.1,54,54
"62768","Nsylvestris_NODE_20476_length_1066_cov_184","Ntome_NODE_21854_length_1057_cov_71",94.223,1004,44,8,46,1047,1020,29,0,1520,1001,991
"62769","Nsylvestris_NODE_20477_length_1066_cov_148","Ntome_NODE_17714_length_1382_cov_204",89.645,1043,72,12,57,1064,282,1323,0,1295,1007,1041
"62773","Nsylvestris_NODE_20479_length_1066_cov_35","Ntome_NODE_19619_length_1224_cov_41",81.757,148,25,2,522,668,739,885,6.17e-27,122,146,146
"62788","Nsylvestris_NODE_20485_length_1065_cov_201","Ntome_NODE_21988_length_1050_cov_179",91.52,967,41,17,79,1006,1050,86,0,1293,927,964
"62798","Nsylvestris_NODE_20489_length_1065_cov_65","Ntome_NODE_8721_length_2382_cov_64",90.909,176,16,0,544,719,2004,2179,2.11e-61,237,175,175
"62809","Nsylvestris_NODE_20495_length_1065_cov_22","Ntome_NODE_35051_length_372_cov_7",97.659,299,7,0,767,1065,372,74,8.7e-145,514,298,298
"62816","Nsylvestris_NODE_20498_length_1065_cov_8","Ntome_NODE_37141_length_308_cov_3",94.643,56,2,1,372,426,1,56,8.09e-16,86.1,54,55
"62817","Nsylvestris_NODE_20499_length_1065_cov_6","Ntome_NODE_6486_length_2750_cov_195",84.991,533,48,17,3,531,542,38,3.13e-144,512,528,504
"62818","Nsylvestris_NODE_20500_length_1064_cov_258","Ntome_NODE_18318_length_1332_cov_126",86.918,451,51,7,3,450,520,965,2.43e-140,499,447,445
"62821","Nsylvestris_NODE_20502_length_1064_cov_101","Ntome_NODE_29017_length_667_cov_179",96.6,500,15,2,389,886,615,116,0,828,497,499
"62822","Nsylvestris_NODE_20503_length_1064_cov_78","Ntome_NODE_33383_length_452_cov_156",97.222,360,10,0,441,800,46,405,1.08e-173,610,359,359
"62830","Nsylvestris_NODE_20507_length_1064_cov_24","Ntome_NODE_4483_length_3214_cov_146",83.01,206,23,9,781,978,2753,2552,4.66e-43,176,197,201
"62831","Nsylvestris_NODE_20508_length_1064_cov_22","Ntome_NODE_3253_length_3604_cov_143",100,54,0,0,1011,1064,3200,3253,2.89e-20,100,53,53
"62836","Nsylvestris_NODE_20512_length_1064_cov_4","Ntome_NODE_14750_length_1660_cov_242",94.545,55,3,0,1010,1064,595,541,8.08e-16,86.1,54,54
"62841","Nsylvestris_NODE_20514_length_1063_cov_212","Ntome_NODE_5203_length_3030_cov_268",96.86,860,17,4,204,1063,2975,2126,0,1430,859,849
"62857","Nsylvestris_NODE_20520_length_1063_cov_52","Ntome_NODE_29076_length_665_cov_13",95.786,617,24,2,271,886,665,50,0,994,615,615
"62860","Nsylvestris_NODE_20522_length_1063_cov_25","Ntome_NODE_8221_length_2456_cov_138",96.364,55,2,0,1009,1063,743,797,1.74e-17,91.6,54,54
"62878","Nsylvestris_NODE_20530_length_1070_cov_4","Ntome_NODE_14085_length_1729_cov_35",87.255,102,5,3,553,650,733,830,4.82e-23,110,97,97
"62892","Nsylvestris_NODE_20536_length_1062_cov_110","Ntome_NODE_13456_length_1790_cov_147",92.52,869,62,1,1,866,52,920,0,1242,865,868
"62896","Nsylvestris_NODE_20539_length_1062_cov_33","Ntome_NODE_16995_length_1449_cov_166",92.691,944,50,5,55,993,405,1334,0,1343,938,929
"62924","Nsylvestris_NODE_20551_length_1061_cov_14","Ntome_NODE_2075_length_4123_cov_201",86.691,278,9,4,711,987,316,66,2.66e-75,283,276,250
"62925","Nsylvestris_NODE_20552_length_1061_cov_13","Ntome_NODE_8571_length_2402_cov_63",92.613,1083,54,10,1,1061,665,1743,0,1533,1060,1078
"62940","Nsylvestris_NODE_20558_length_1060_cov_127","Ntome_NODE_31561_length_569_cov_8",87.029,239,26,5,246,479,1,239,9.63e-70,265,233,238
"62992","Nsylvestris_NODE_20580_length_1059_cov_10","Ntome_NODE_12568_length_1891_cov_140",82.124,923,93,34,1,870,574,1477,0,725,869,903
"62993","Nsylvestris_NODE_20581_length_1060_cov_6","Ntome_NODE_6376_length_2772_cov_65",85.281,231,33,1,430,660,371,600,2.1e-61,237,230,229
"63012","Nsylvestris_NODE_20588_length_1058_cov_147","Ntome_NODE_24931_length_867_cov_94",88.727,825,41,16,282,1057,46,867,0,961,775,821
"63013","Nsylvestris_NODE_20589_length_1058_cov_92","Ntome_NODE_24405_length_899_cov_7",96.138,751,29,0,155,905,139,889,0,1227,750,750
"63020","Nsylvestris_NODE_20592_length_1058_cov_48","Ntome_NODE_6288_length_2790_cov_101",89.931,576,46,6,328,894,1903,2475,0,732,566,572
"63035","Nsylvestris_NODE_20597_length_1058_cov_29","Ntome_NODE_3851_length_3404_cov_200",90.123,324,26,4,231,550,144,465,2.51e-115,416,319,321
"63036","Nsylvestris_NODE_20598_length_1057_cov_21","Ntome_NODE_634_length_5684_cov_130",100,29,0,0,149,177,2179,2207,2.26e-06,54.7,28,28
"63058","Nsylvestris_NODE_20607_length_1057_cov_142","Ntome_NODE_23714_length_942_cov_235",90.176,682,56,9,107,783,814,139,0,878,676,675
"63059","Nsylvestris_NODE_20608_length_1057_cov_121","Ntome_NODE_511_length_5989_cov_63",94.462,939,45,5,51,983,5013,5950,0,1439,932,937
"63064","Nsylvestris_NODE_20611_length_1057_cov_22","Ntome_NODE_14381_length_1697_cov_274",100,55,0,0,1003,1057,452,398,7.97e-21,102,54,54
"63065","Nsylvestris_NODE_20613_length_1057_cov_17","Ntome_NODE_1945_length_4210_cov_152",96.552,58,2,0,1000,1057,3249,3306,3.71e-19,97.1,57,57
"63066","Nsylvestris_NODE_20614_length_1057_cov_14","Ntome_NODE_4777_length_3139_cov_204",95.113,1064,39,5,1,1056,1339,2397,0,1664,1055,1058
"63067","Nsylvestris_NODE_20615_length_1057_cov_8","Ntome_NODE_13083_length_1832_cov_46",95.556,45,2,0,1,45,673,629,6.25e-12,73.1,44,44
"63103","Nsylvestris_NODE_20632_length_1056_cov_9","Ntome_NODE_18215_length_1341_cov_208",98.182,55,1,0,1002,1056,542,488,3.7e-19,97.1,54,54
"63112","Nsylvestris_NODE_20637_length_1055_cov_179","Ntome_NODE_25965_length_807_cov_195",93.3,791,40,6,212,997,25,807,0,1155,785,782
"63122","Nsylvestris_NODE_20642_length_1055_cov_36","Ntome_NODE_1981_length_4187_cov_148",95.082,244,10,2,753,995,321,563,2.54e-105,383,242,242
"63125","Nsylvestris_NODE_20644_length_1055_cov_12","Ntome_NODE_3593_length_3486_cov_138",90.244,164,14,2,429,590,1822,1985,3.52e-54,213,161,163
"63133","Nsylvestris_NODE_20649_length_1054_cov_149","Ntome_NODE_19137_length_1264_cov_215",87.454,813,82,8,55,867,1137,345,0,918,812,792
"63134","Nsylvestris_NODE_20650_length_1054_cov_85","Ntome_NODE_24612_length_885_cov_100",95.408,871,22,6,92,956,1,859,0,1371,864,858
"63141","Nsylvestris_NODE_20653_length_1054_cov_16","Ntome_NODE_30883_length_593_cov_9",81.319,91,15,2,260,349,436,525,6.23e-12,73.1,89,89
"63144","Nsylvestris_NODE_20655_length_1054_cov_11","Ntome_NODE_21958_length_1052_cov_30",83.254,1057,91,34,62,1046,5,1047,0,893,984,1042
"63156","Nsylvestris_NODE_20662_length_1053_cov_9","Ntome_NODE_20849_length_1128_cov_76",91.757,922,51,15,145,1053,155,1064,0,1258,908,909
"63164","Nsylvestris_NODE_20665_length_1052_cov_216","Ntome_NODE_184_length_7533_cov_278",95.995,799,23,3,263,1052,7510,6712,0,1290,789,798
"63165","Nsylvestris_NODE_20666_length_1052_cov_209","Ntome_NODE_20384_length_1162_cov_251",95.288,1040,40,6,19,1052,1162,126,0,1640,1033,1036
"63179","Nsylvestris_NODE_20671_length_1052_cov_65","Ntome_NODE_27316_length_742_cov_239",84.406,404,34,8,2,389,741,351,1.97e-101,370,387,390
"63185","Nsylvestris_NODE_20674_length_1052_cov_10","Ntome_NODE_5410_length_2984_cov_31",91.451,889,51,6,1,865,1584,2471,0,1197,864,887
"63190","Nsylvestris_NODE_20676_length_1052_cov_5","Ntome_NODE_2387_length_3967_cov_191",83.498,303,40,7,686,987,2367,2074,1.59e-72,274,301,293
"63191","Nsylvestris_NODE_20677_length_1052_cov_5","Ntome_NODE_12082_length_1947_cov_58",98.182,55,1,0,998,1052,1506,1560,3.69e-19,97.1,54,54
"63208","Nsylvestris_NODE_20685_length_1051_cov_34","Ntome_NODE_20512_length_1153_cov_28",89.512,1106,50,24,1,1051,1095,1,0,1339,1050,1094
"63215","Nsylvestris_NODE_20688_length_1051_cov_7","Ntome_NODE_13985_length_1740_cov_59",91.549,1065,66,15,3,1049,1139,81,0,1447,1046,1058
"63216","Nsylvestris_NODE_20689_length_1050_cov_197","Ntome_NODE_23274_length_966_cov_259",95.565,902,29,9,108,1006,919,26,0,1434,898,893
"63220","Nsylvestris_NODE_20691_length_1050_cov_159","Ntome_NODE_22798_length_996_cov_246",91.431,992,39,15,96,1049,984,1,0,1319,953,983
"63221","Nsylvestris_NODE_20692_length_1050_cov_147","Ntome_NODE_21021_length_1114_cov_182",95.642,826,31,3,1,822,41,865,0,1321,821,824
"63239","Nsylvestris_NODE_20700_length_1050_cov_10","Ntome_NODE_2696_length_3816_cov_44",86.719,1024,114,11,1,1022,1775,772,0,1118,1021,1003
"63242","Nsylvestris_NODE_20703_length_1049_cov_175","Ntome_NODE_25680_length_822_cov_243",92.871,505,24,7,385,878,732,229,0,723,493,503
"63246","Nsylvestris_NODE_20705_length_1049_cov_109","Ntome_NODE_31563_length_569_cov_6",86.466,133,18,0,819,951,137,269,3.6e-34,147,132,132
"63247","Nsylvestris_NODE_20706_length_1049_cov_68","Ntome_NODE_10944_length_2080_cov_197",83.746,929,130,11,1,914,943,1865,0,859,913,922
"63251","Nsylvestris_NODE_20708_length_1049_cov_35","Ntome_NODE_35895_length_342_cov_5",92,100,6,2,461,559,210,308,6.03e-32,139,98,98
"63269","Nsylvestris_NODE_20715_length_1048_cov_202","Ntome_NODE_8642_length_2393_cov_203",91.684,974,53,3,72,1045,1039,94,0,1325,973,945
"63270","Nsylvestris_NODE_20716_length_1048_cov_192","Ntome_NODE_24252_length_909_cov_229",95.398,804,34,3,79,882,62,862,0,1277,803,800
"63280","Nsylvestris_NODE_20720_length_1048_cov_118","Ntome_NODE_23009_length_983_cov_21",95.043,928,39,3,93,1020,926,6,0,1452,927,920
"63295","Nsylvestris_NODE_20725_length_1048_cov_10","Ntome_NODE_28298_length_698_cov_6",91.717,664,47,6,357,1013,1,663,0,915,656,662
"63302","Nsylvestris_NODE_20729_length_1047_cov_201","Ntome_NODE_21132_length_1106_cov_252",91.206,1012,72,13,5,1007,103,1106,0,1360,1002,1003
"63303","Nsylvestris_NODE_20730_length_1047_cov_148","Ntome_NODE_22881_length_991_cov_101",91.034,948,77,6,86,1029,46,989,0,1273,943,943
"63304","Nsylvestris_NODE_20731_length_1047_cov_124","Ntome_NODE_5912_length_2869_cov_140",93.964,994,36,3,51,1044,323,1292,0,1482,993,969
"63334","Nsylvestris_NODE_20742_length_1047_cov_13","Ntome_NODE_5375_length_2992_cov_207",95.338,1051,38,5,1,1047,643,1686,0,1659,1046,1043
"63344","Nsylvestris_NODE_20747_length_1046_cov_206","Ntome_NODE_17390_length_1413_cov_46",94.471,1049,51,4,1,1046,1408,364,0,1609,1045,1044
"63347","Nsylvestris_NODE_20749_length_1046_cov_185","Ntome_NODE_18724_length_1298_cov_127",93.361,964,42,11,28,983,38,987,0,1406,955,949
"63350","Nsylvestris_NODE_20751_length_1046_cov_140","Ntome_NODE_30624_length_603_cov_11",94.371,604,27,4,206,803,603,1,0,920,597,602
"63367","Nsylvestris_NODE_20758_length_1046_cov_10","Ntome_NODE_3232_length_3609_cov_134",86.801,644,40,18,333,939,1061,1696,0,676,606,635
"63373","Nsylvestris_NODE_20760_length_1046_cov_6","Ntome_NODE_23333_length_964_cov_5",97.297,111,3,0,936,1046,963,853,5.88e-47,189,110,110
"63374","Nsylvestris_NODE_20761_length_1045_cov_213","Ntome_NODE_25335_length_842_cov_274",98.207,725,12,1,19,743,63,786,0,1266,724,723
"63377","Nsylvestris_NODE_20763_length_1045_cov_203","Ntome_NODE_11904_length_1969_cov_248",93.318,883,50,6,113,993,878,3,0,1295,880,875
"63378","Nsylvestris_NODE_20764_length_1045_cov_201","Ntome_NODE_2890_length_3742_cov_187",93.589,1045,45,6,1,1037,1211,2241,0,1539,1036,1030
"63381","Nsylvestris_NODE_20766_length_1045_cov_116","Ntome_NODE_22554_length_1012_cov_274",91.322,968,57,13,81,1041,964,17,0,1297,960,947
"63403","Nsylvestris_NODE_20773_length_1045_cov_11","Ntome_NODE_35686_length_348_cov_5",94.224,277,16,0,767,1043,348,72,1.48e-117,424,276,276
"63410","Nsylvestris_NODE_20775_length_1045_cov_9","Ntome_NODE_20057_length_1187_cov_255",89.915,1061,67,29,4,1045,57,1096,0,1330,1041,1039
"63411","Nsylvestris_NODE_20777_length_1045_cov_7","Ntome_NODE_10601_length_2120_cov_18",81.609,1044,179,10,3,1041,828,1863,0,852,1038,1035
"63420","Nsylvestris_NODE_20781_length_1044_cov_163","Ntome_NODE_9914_length_2211_cov_215",93.265,683,34,7,323,994,1684,1003,0,996,671,681
"63429","Nsylvestris_NODE_20786_length_1044_cov_46","Ntome_NODE_8095_length_2475_cov_206",94.623,1060,37,7,1,1044,474,1529,0,1624,1043,1055
"63436","Nsylvestris_NODE_20789_length_1044_cov_29","Ntome_NODE_18641_length_1305_cov_40",93.39,1059,35,7,1,1030,195,1247,0,1535,1029,1052
"63453","Nsylvestris_NODE_20795_length_1043_cov_210","Ntome_NODE_9386_length_2283_cov_171",88.901,919,61,19,5,906,2245,1351,0,1094,901,894
"63467","Nsylvestris_NODE_20800_length_1042_cov_75","Ntome_NODE_35727_length_347_cov_3",86.93,329,18,7,143,468,345,39,3.29e-94,346,325,306
"63472","Nsylvestris_NODE_20803_length_1043_cov_14","Ntome_NODE_3722_length_3444_cov_115",97.378,801,20,1,6,805,123,923,0,1362,799,800
"63504","Nsylvestris_NODE_20815_length_1041_cov_203","Ntome_NODE_21204_length_1101_cov_280",92.685,998,31,16,22,992,1091,109,0,1400,970,982
"63507","Nsylvestris_NODE_20817_length_1041_cov_23","Ntome_NODE_2774_length_3778_cov_180",91.525,59,4,1,983,1041,329,386,3.68e-14,80.5,58,57
"63563","Nsylvestris_NODE_20837_length_1039_cov_83","Ntome_NODE_30169_length_621_cov_50",95.614,114,5,0,227,340,331,444,2.72e-45,183,113,113
"63575","Nsylvestris_NODE_20841_length_1039_cov_26","Ntome_NODE_19810_length_1209_cov_116",92.906,1029,35,14,1,1009,61,1071,0,1461,1008,1010
"63597","Nsylvestris_NODE_20851_length_1038_cov_218","Ntome_NODE_9975_length_2202_cov_264",96.078,969,34,4,73,1038,2202,1235,0,1576,965,967
"63606","Nsylvestris_NODE_20854_length_1038_cov_198","Ntome_NODE_18864_length_1286_cov_252",91.795,1036,40,22,11,1018,1090,72,0,1400,1007,1018
"63611","Nsylvestris_NODE_20856_length_1038_cov_175","Ntome_NODE_26355_length_789_cov_146",91.146,768,26,14,107,857,47,789,0,1003,750,742
"63619","Nsylvestris_NODE_20862_length_1038_cov_24","Ntome_NODE_39000_length_267_cov_5",89.256,121,11,2,457,576,206,87,2.75e-35,150,119,119
"63634","Nsylvestris_NODE_20868_length_1037_cov_168","Ntome_NODE_8044_length_2484_cov_258",98.246,1026,16,1,1,1026,1024,1,0,1794,1025,1023
"63637","Nsylvestris_NODE_20870_length_1037_cov_158","Ntome_NODE_21077_length_1110_cov_96",94.164,891,38,3,1,891,877,1,0,1345,890,876
"63644","Nsylvestris_NODE_20873_length_1037_cov_43","Ntome_NODE_19648_length_1222_cov_61",92.322,1042,51,11,21,1037,117,1154,0,1454,1016,1037
"63645","Nsylvestris_NODE_20874_length_1037_cov_31","Ntome_NODE_37182_length_307_cov_2",83.224,304,31,3,523,806,1,304,1.22e-68,261,283,303
"63656","Nsylvestris_NODE_20880_length_1037_cov_8","Ntome_NODE_34434_length_398_cov_6",94.595,37,1,1,188,223,175,211,6.17e-07,56.5,35,36
"63679","Nsylvestris_NODE_20888_length_1036_cov_86","Ntome_NODE_21581_length_1076_cov_91",93.825,1004,47,5,40,1036,1004,9,0,1496,996,995
"63691","Nsylvestris_NODE_20896_length_1035_cov_130","Ntome_NODE_12353_length_1915_cov_186",96.403,139,4,1,1,138,1282,1420,1.23e-58,228,137,138
"63708","Nsylvestris_NODE_20906_length_1035_cov_6","Ntome_NODE_33753_length_432_cov_3",96.759,432,14,0,565,996,1,432,0,721,431,431
"63709","Nsylvestris_NODE_20907_length_1034_cov_224","Ntome_NODE_22455_length_1019_cov_206",88.809,831,43,9,71,878,965,162,0,974,807,803
"63713","Nsylvestris_NODE_20909_length_1034_cov_210","Ntome_NODE_22705_length_1003_cov_166",93.722,908,47,7,42,949,945,48,0,1352,907,897
"63714","Nsylvestris_NODE_20910_length_1034_cov_201","Ntome_NODE_19306_length_1251_cov_116",86.879,1006,38,21,1,962,288,1243,0,1040,961,955
"63723","Nsylvestris_NODE_20914_length_1034_cov_131","Ntome_NODE_22127_length_1039_cov_158",89.474,988,52,30,12,972,74,1036,0,1201,960,962
"63727","Nsylvestris_NODE_20916_length_1034_cov_47","Ntome_NODE_18790_length_1294_cov_28",86.224,617,43,10,35,618,1181,574,8.04e-180,630,583,607
"63733","Nsylvestris_NODE_20918_length_1034_cov_36","Ntome_NODE_12389_length_1910_cov_50",93.472,965,48,7,80,1031,912,1874,0,1419,951,962
"63734","Nsylvestris_NODE_20919_length_1034_cov_33","Ntome_NODE_24175_length_914_cov_40",88.792,803,42,18,213,1004,79,844,0,941,791,765
"63735","Nsylvestris_NODE_20920_length_1034_cov_19","Ntome_NODE_20838_length_1129_cov_30",90.169,295,22,2,36,324,6,299,1.16e-103,377,288,293
"63736","Nsylvestris_NODE_20921_length_1034_cov_17","Ntome_NODE_8292_length_2442_cov_291",98.077,52,0,1,4,54,339,288,6.07e-17,89.8,50,51
"63737","Nsylvestris_NODE_20922_length_1034_cov_12","Ntome_NODE_11514_length_2012_cov_281",98.276,58,1,0,977,1034,681,738,7.79e-21,102,57,57
"63743","Nsylvestris_NODE_20925_length_1034_cov_6","Ntome_NODE_9523_length_2267_cov_61",84.919,988,147,2,30,1016,297,1283,0,998,986,986
"63744","Nsylvestris_NODE_20926_length_1033_cov_202","Ntome_NODE_18145_length_1347_cov_69",97.137,943,26,1,50,991,1184,242,0,1591,941,942
"63753","Nsylvestris_NODE_20930_length_1033_cov_88","Ntome_NODE_19923_length_1198_cov_259",96.61,59,2,0,973,1031,767,709,1.01e-19,99,58,58
"63757","Nsylvestris_NODE_20932_length_1033_cov_79","Ntome_NODE_10370_length_2149_cov_124",88.696,115,12,1,130,244,1362,1475,5.93e-32,139,114,113
"63760","Nsylvestris_NODE_20935_length_1033_cov_63","Ntome_NODE_18365_length_1329_cov_15",95.475,906,36,3,89,994,1280,380,0,1441,905,900
"63774","Nsylvestris_NODE_20943_length_1032_cov_214","Ntome_NODE_7761_length_2530_cov_275",94.076,979,34,10,65,1026,1521,2492,0,1465,961,971
"63780","Nsylvestris_NODE_20945_length_1032_cov_92","Ntome_NODE_22720_length_1002_cov_237",94.833,929,27,6,1,919,970,53,0,1430,918,917
"63781","Nsylvestris_NODE_20946_length_1032_cov_42","Ntome_NODE_3204_length_3621_cov_77",91.304,46,1,2,239,284,54,12,4.75e-08,60.2,45,42
"63785","Nsylvestris_NODE_20949_length_1032_cov_13","Ntome_NODE_1633_length_4432_cov_229",89.33,1059,62,25,1,1032,2027,993,0,1282,1031,1034
"63786","Nsylvestris_NODE_20950_length_1031_cov_209","Ntome_NODE_22572_length_1011_cov_269",94.513,893,37,6,68,948,92,984,0,1367,880,892
"63812","Nsylvestris_NODE_20959_length_1031_cov_30","Ntome_NODE_39774_length_253_cov_3",87.671,146,15,3,60,203,252,108,2.72e-40,167,143,144
"63815","Nsylvestris_NODE_20961_length_1031_cov_24","Ntome_NODE_23784_length_937_cov_76",94.703,774,36,3,1,770,119,891,0,1197,769,772
"63834","Nsylvestris_NODE_20966_length_1031_cov_9","Ntome_NODE_8590_length_2400_cov_42",98.182,55,1,0,977,1031,909,855,3.61e-19,97.1,54,54
"63835","Nsylvestris_NODE_20967_length_1030_cov_216","Ntome_NODE_28888_length_672_cov_32",80.383,209,14,16,548,729,464,672,2.75e-30,134,181,208
"63879","Nsylvestris_NODE_20986_length_1029_cov_9","Ntome_NODE_8767_length_2375_cov_60",90.374,883,58,12,172,1029,1381,2261,0,1134,857,880
"63893","Nsylvestris_NODE_20991_length_1028_cov_100","Ntome_NODE_2649_length_3838_cov_162",95.313,64,2,1,1,63,603,540,2.79e-20,100,62,63
"63894","Nsylvestris_NODE_20992_length_1028_cov_89","Ntome_NODE_22339_length_1026_cov_73",91.943,422,24,5,56,467,21,442,2.27e-165,582,411,421
"63900","Nsylvestris_NODE_20994_length_1028_cov_36","Ntome_NODE_649_length_5651_cov_29",91.529,909,66,4,1,900,4115,5021,0,1242,899,906
"63904","Nsylvestris_NODE_20997_length_1028_cov_32","Ntome_NODE_23319_length_964_cov_40",93.895,950,34,5,80,1028,8,934,0,1411,948,926
"63905","Nsylvestris_NODE_20998_length_1028_cov_29","Ntome_NODE_4275_length_3268_cov_72",82.432,74,13,0,724,797,876,949,1.02e-09,65.8,73,73
"63906","Nsylvestris_NODE_21000_length_1028_cov_9","Ntome_NODE_9141_length_2318_cov_227",98.182,55,1,0,974,1028,1185,1131,3.6e-19,97.1,54,54
"63936","Nsylvestris_NODE_21009_length_1027_cov_193","Ntome_NODE_22856_length_992_cov_266",89.883,939,58,17,1,922,956,38,0,1173,921,918
"63943","Nsylvestris_NODE_21012_length_1027_cov_145","Ntome_NODE_23208_length_971_cov_22",93.482,537,34,1,17,553,971,436,0,797,536,535
"63946","Nsylvestris_NODE_21015_length_1027_cov_73","Ntome_NODE_22659_length_1006_cov_27",92.807,862,54,3,17,872,996,137,0,1242,855,859
"63947","Nsylvestris_NODE_21017_length_1027_cov_17","Ntome_NODE_23534_length_953_cov_13",89.497,914,25,20,34,890,1,900,0,1090,856,899
"63948","Nsylvestris_NODE_21018_length_1027_cov_14","Ntome_NODE_38892_length_270_cov_3",95.911,269,11,0,108,376,270,2,1.87e-121,436,268,268
"63966","Nsylvestris_NODE_21025_length_1026_cov_104","Ntome_NODE_13512_length_1775_cov_67",85.276,163,22,2,619,781,622,782,2.7e-40,167,162,160
"63969","Nsylvestris_NODE_21028_length_1026_cov_30","Ntome_NODE_2195_length_4064_cov_31",93.013,916,25,19,119,1025,4064,3179,0,1301,906,885
"63985","Nsylvestris_NODE_21037_length_1026_cov_11","Ntome_NODE_17385_length_1413_cov_293",98.182,55,1,0,972,1026,440,386,3.6e-19,97.1,54,54
"63997","Nsylvestris_NODE_21041_length_1025_cov_189","Ntome_NODE_21320_length_1093_cov_262",92.5,560,40,2,1,560,306,863,0,800,559,557
"64002","Nsylvestris_NODE_21043_length_1025_cov_142","Ntome_NODE_28135_length_704_cov_46",83.453,139,19,4,14,149,702,565,4.58e-28,126,135,137
"64059","Nsylvestris_NODE_21064_length_1024_cov_61","Ntome_NODE_1247_length_4786_cov_213",82.745,510,77,10,122,623,125,631,1.11e-123,444,501,506
"64069","Nsylvestris_NODE_21069_length_1024_cov_3","Ntome_NODE_22581_length_1011_cov_42",93.866,864,52,1,109,971,955,92,0,1303,862,863
"64073","Nsylvestris_NODE_21071_length_1023_cov_215","Ntome_NODE_2578_length_3867_cov_151",94.903,824,36,3,6,827,3861,3042,0,1284,821,819
"64080","Nsylvestris_NODE_21075_length_1023_cov_161","Ntome_NODE_10083_length_2188_cov_95",93.662,710,35,7,150,857,1402,2103,0,1053,707,701
"64108","Nsylvestris_NODE_21087_length_1023_cov_10","Ntome_NODE_6968_length_2660_cov_266",100,55,0,0,969,1023,1267,1213,7.71e-21,102,54,54
"64128","Nsylvestris_NODE_21097_length_1022_cov_50","Ntome_NODE_20770_length_1133_cov_33",86.604,530,71,0,101,630,456,985,1.74e-166,586,529,529
"64129","Nsylvestris_NODE_21098_length_1022_cov_42","Ntome_NODE_4470_length_3216_cov_182",91.458,878,53,8,160,1016,2335,3211,0,1186,856,876
"64137","Nsylvestris_NODE_21102_length_1022_cov_8","Ntome_NODE_19264_length_1254_cov_102",90.809,816,62,6,173,978,1047,235,0,1079,805,812
"64143","Nsylvestris_NODE_21106_length_1021_cov_190","Ntome_NODE_897_length_5233_cov_251",96.261,936,27,5,88,1021,124,1053,0,1528,933,929
"64149","Nsylvestris_NODE_21111_length_1021_cov_23","Ntome_NODE_21280_length_1096_cov_201",88.015,267,17,5,188,440,568,303,7.06e-81,302,252,265
"64150","Nsylvestris_NODE_21112_length_1021_cov_23","Ntome_NODE_17004_length_1448_cov_192",87.053,587,36,20,1,553,581,1,1.03e-178,627,552,580
"64158","Nsylvestris_NODE_21115_length_1021_cov_10","Ntome_NODE_520_length_5966_cov_133",83.226,155,22,3,870,1021,1834,1681,5.86e-32,139,151,153
"64169","Nsylvestris_NODE_21119_length_1020_cov_167","Ntome_NODE_26901_length_763_cov_263",92.105,760,23,10,2,745,25,763,0,1037,743,738
"64172","Nsylvestris_NODE_21121_length_1020_cov_56","Ntome_NODE_27384_length_739_cov_9",81.818,132,21,2,1,132,261,389,1.65e-22,108,131,128
"64173","Nsylvestris_NODE_21122_length_1020_cov_47","Ntome_NODE_21023_length_1114_cov_68",92.818,919,54,6,63,972,145,1060,0,1321,909,915
"64174","Nsylvestris_NODE_21124_length_1020_cov_28","Ntome_NODE_28350_length_695_cov_8",95.54,695,30,1,100,793,1,695,0,1110,693,694
"64178","Nsylvestris_NODE_21127_length_1020_cov_4","Ntome_NODE_1466_length_4564_cov_172",71.358,405,99,14,452,849,3526,3920,5.98e-17,89.8,397,394
"64182","Nsylvestris_NODE_21129_length_1019_cov_220","Ntome_NODE_10486_length_2133_cov_262",96,975,29,4,51,1016,99,1072,0,1576,965,973
"64237","Nsylvestris_NODE_21151_length_1018_cov_183","Ntome_NODE_23694_length_943_cov_260",92.667,600,23,5,357,956,629,51,0,845,599,578
"64238","Nsylvestris_NODE_21152_length_1018_cov_130","Ntome_NODE_33407_length_451_cov_4",90.343,466,25,4,275,735,1,451,1.04e-168,593,460,450
"64239","Nsylvestris_NODE_21153_length_1018_cov_122","Ntome_NODE_32582_length_507_cov_73",89.443,521,31,15,65,576,1,506,0,636,511,505
"64240","Nsylvestris_NODE_21154_length_1018_cov_98","Ntome_NODE_26469_length_784_cov_16",92.83,795,36,7,119,903,1,784,0,1133,784,783
"64246","Nsylvestris_NODE_21156_length_1018_cov_66","Ntome_NODE_21140_length_1106_cov_106",90.467,986,69,12,41,1012,83,1057,0,1277,971,974
"64247","Nsylvestris_NODE_21157_length_1018_cov_62","Ntome_NODE_16819_length_1464_cov_71",94.824,966,49,1,54,1018,36,1001,0,1506,964,965
"64252","Nsylvestris_NODE_21160_length_1018_cov_8","Ntome_NODE_10961_length_2078_cov_136",93.969,1028,47,10,1,1018,71,1093,0,1541,1017,1022
"64253","Nsylvestris_NODE_21161_length_1017_cov_233","Ntome_NODE_7453_length_2577_cov_238",93.844,926,41,12,94,1017,50,961,0,1380,923,911
"64258","Nsylvestris_NODE_21163_length_1017_cov_201","Ntome_NODE_21402_length_1088_cov_264",98.14,968,15,2,42,1009,1022,58,0,1685,967,964
"64269","Nsylvestris_NODE_21168_length_1017_cov_132","Ntome_NODE_723_length_5522_cov_61",96.364,55,2,0,963,1017,4397,4343,1.66e-17,91.6,54,54
"64270","Nsylvestris_NODE_21169_length_1017_cov_80","Ntome_NODE_5923_length_2867_cov_165",90.433,554,53,0,246,799,190,743,0,730,553,553
"64275","Nsylvestris_NODE_21171_length_1017_cov_45","Ntome_NODE_11837_length_1970_cov_275",98.182,55,1,0,1,55,1510,1456,3.56e-19,97.1,54,54
"64288","Nsylvestris_NODE_21177_length_1016_cov_235","Ntome_NODE_1443_length_4585_cov_299",97.146,1016,23,1,1,1016,3046,4055,0,1711,1015,1009
"64306","Nsylvestris_NODE_21183_length_1016_cov_147","Ntome_NODE_1221_length_4811_cov_125",93.58,405,25,1,42,446,4811,4408,1.72e-171,603,404,403
"64332","Nsylvestris_NODE_21194_length_1015_cov_193","Ntome_NODE_22985_length_984_cov_151",86.358,865,37,14,123,962,84,892,0,869,839,808
"64369","Nsylvestris_NODE_21213_length_1013_cov_206","Ntome_NODE_9066_length_2328_cov_233",93.417,714,33,5,62,770,649,1353,0,1046,708,704
"64376","Nsylvestris_NODE_21216_length_1013_cov_105","Ntome_NODE_19957_length_1195_cov_245",89.242,818,76,9,70,883,342,1151,0,1013,813,809
"64377","Nsylvestris_NODE_21217_length_1013_cov_76","Ntome_NODE_20724_length_1136_cov_200",82.33,515,86,5,310,823,261,771,3.96e-123,442,513,510
"64397","Nsylvestris_NODE_21227_length_1012_cov_94","Ntome_NODE_22503_length_1016_cov_119",93.615,1018,50,6,4,1012,1012,1,0,1506,1008,1011
"64400","Nsylvestris_NODE_21229_length_1010_cov_82","Ntome_NODE_20861_length_1127_cov_179",84.653,821,115,9,117,933,189,1002,0,808,816,813
"64409","Nsylvestris_NODE_21232_length_1012_cov_35","Ntome_NODE_2920_length_3728_cov_187",86.256,211,28,1,600,809,3409,3199,1.21e-58,228,209,210
"64412","Nsylvestris_NODE_21236_length_1012_cov_18","Ntome_NODE_8435_length_2422_cov_233",92.924,749,34,7,276,1008,834,89,0,1072,732,745
"64415","Nsylvestris_NODE_21238_length_1012_cov_6","Ntome_NODE_6674_length_2717_cov_27",94.17,1012,59,0,1,1012,2295,1284,0,1543,1011,1011
"64452","Nsylvestris_NODE_21249_length_1011_cov_18","Ntome_NODE_22985_length_984_cov_151",82.5,240,24,4,376,597,385,624,1.22e-48,195,221,239
"64460","Nsylvestris_NODE_21251_length_1010_cov_241","Ntome_NODE_8754_length_2377_cov_203",98.614,1010,14,0,1,1010,682,1691,0,1788,1009,1009
"64463","Nsylvestris_NODE_21253_length_1010_cov_189","Ntome_NODE_21541_length_1078_cov_261",93.586,951,42,3,16,964,8,941,0,1400,948,933
"64467","Nsylvestris_NODE_21255_length_1010_cov_155","Ntome_NODE_24481_length_892_cov_247",92.494,826,53,9,72,888,826,1,0,1173,816,825
"64476","Nsylvestris_NODE_21260_length_1010_cov_39","Ntome_NODE_7660_length_2547_cov_37",100,55,0,0,1,55,224,278,7.61e-21,102,54,54
"64513","Nsylvestris_NODE_21275_length_1009_cov_5","Ntome_NODE_37963_length_289_cov_4",91.623,191,5,2,764,947,1,187,1.98e-66,254,183,186
"64520","Nsylvestris_NODE_21277_length_1008_cov_147","Ntome_NODE_12554_length_1892_cov_172",91.856,970,48,13,43,992,1018,60,0,1325,949,958
"64559","Nsylvestris_NODE_21297_length_1007_cov_12","Ntome_NODE_22378_length_1024_cov_38",94.863,915,40,4,93,1006,914,6,0,1423,913,908
"64560","Nsylvestris_NODE_21298_length_1007_cov_7","Ntome_NODE_18240_length_1339_cov_233",98.182,55,1,0,1,55,860,806,3.53e-19,97.1,54,54
"64565","Nsylvestris_NODE_21300_length_1007_cov_6","Ntome_NODE_19752_length_1214_cov_258",100,55,0,0,953,1007,607,661,7.58e-21,102,54,54
"64590","Nsylvestris_NODE_21313_length_1005_cov_56","Ntome_NODE_25642_length_825_cov_24",90.655,824,60,6,107,924,5,817,0,1079,817,812
"64608","Nsylvestris_NODE_21323_length_1005_cov_7","Ntome_NODE_6791_length_2696_cov_127",95.132,493,23,1,91,582,2623,2131,0,776,491,492
"64619","Nsylvestris_NODE_21327_length_1004_cov_183","Ntome_NODE_21320_length_1093_cov_262",91.47,891,57,9,112,999,73,947,0,1206,887,874
"64630","Nsylvestris_NODE_21331_length_1000_cov_127","Ntome_NODE_14613_length_1675_cov_178",96.048,911,30,4,47,954,502,1409,0,1478,907,907
"64635","Nsylvestris_NODE_21334_length_1004_cov_66","Ntome_NODE_309_length_6664_cov_209",96.326,1007,34,1,1,1004,2887,1881,0,1652,1003,1006
"64638","Nsylvestris_NODE_21337_length_1004_cov_20","Ntome_NODE_6270_length_2793_cov_261",100,56,0,0,1,56,1688,1633,2.1e-21,104,55,55
"64666","Nsylvestris_NODE_21348_length_1003_cov_117","Ntome_NODE_22185_length_1035_cov_222",94.905,1001,39,9,3,996,39,1034,0,1555,993,995
"64672","Nsylvestris_NODE_21350_length_1003_cov_39","Ntome_NODE_18461_length_1320_cov_195",100,55,0,0,949,1003,583,529,7.55e-21,102,54,54
"64673","Nsylvestris_NODE_21351_length_1003_cov_35","Ntome_NODE_21579_length_1076_cov_118",89.936,467,41,1,49,515,178,638,7.9e-170,597,466,460
"64674","Nsylvestris_NODE_21352_length_1003_cov_34","Ntome_NODE_470_length_6103_cov_272",93.269,104,7,0,900,1003,626,523,2.06e-36,154,103,103
"64675","Nsylvestris_NODE_21353_length_1003_cov_22","Ntome_NODE_631_length_5692_cov_189",89.72,107,11,0,848,954,4967,5073,2.07e-31,137,106,106
"64693","Nsylvestris_NODE_21360_length_1003_cov_8","Ntome_NODE_12348_length_1916_cov_18",96.528,1008,24,5,1,1003,78,1079,0,1657,1002,1001
"64694","Nsylvestris_NODE_21361_length_1004_cov_6","Ntome_NODE_38394_length_280_cov_4",80.695,259,37,9,606,853,263,7,5.64e-47,189,247,256
"64724","Nsylvestris_NODE_21375_length_1002_cov_173","Ntome_NODE_20046_length_1188_cov_98",95.238,714,25,1,28,732,101,814,0,1122,704,713
"64745","Nsylvestris_NODE_21383_length_1001_cov_5","Ntome_NODE_5784_length_2899_cov_234",100,55,0,0,947,1001,562,616,7.54e-21,102,54,54
"64765","Nsylvestris_NODE_21391_length_1000_cov_22","Ntome_NODE_4930_length_3103_cov_34",94.81,1002,49,3,1,1000,1088,2088,0,1559,999,1000
"64772","Nsylvestris_NODE_21395_length_999_cov_237","Ntome_NODE_5971_length_2855_cov_26",79.98,1004,171,23,5,999,1475,2457,0,713,994,982
"64782","Nsylvestris_NODE_21402_length_999_cov_13","Ntome_NODE_10793_length_2097_cov_78",88.694,628,53,13,385,999,2045,1423,0,750,614,622
"64786","Nsylvestris_NODE_21404_length_998_cov_197","Ntome_NODE_21083_length_1109_cov_238",93.564,808,43,5,104,908,195,996,0,1195,804,801
"64797","Nsylvestris_NODE_21408_length_998_cov_179","Ntome_NODE_23414_length_959_cov_219",91.762,789,43,11,50,832,820,48,0,1077,782,772
"64810","Nsylvestris_NODE_21413_length_998_cov_77","Ntome_NODE_10271_length_2160_cov_53",91.06,906,70,6,28,923,1327,423,0,1214,895,904
"64811","Nsylvestris_NODE_21414_length_998_cov_58","Ntome_NODE_30536_length_607_cov_11",93.053,619,25,10,380,992,1,607,0,889,612,606
"64812","Nsylvestris_NODE_21415_length_998_cov_22","Ntome_NODE_19346_length_1248_cov_20",93.918,1003,47,2,10,998,1033,31,0,1502,988,1002
"64817","Nsylvestris_NODE_21418_length_997_cov_206","Ntome_NODE_21771_length_1063_cov_175",97.314,968,23,2,17,983,966,1,0,1640,966,965
"64822","Nsylvestris_NODE_21421_length_997_cov_183","Ntome_NODE_22858_length_992_cov_262",93.246,918,41,7,66,963,30,946,0,1332,897,916
"64823","Nsylvestris_NODE_21422_length_997_cov_137","Ntome_NODE_8012_length_2489_cov_243",100,55,0,0,1,55,1822,1876,7.51e-21,102,54,54
"64826","Nsylvestris_NODE_21424_length_997_cov_81","Ntome_NODE_5227_length_3023_cov_133",98.182,55,1,0,1,55,2333,2279,3.49e-19,97.1,54,54
"64931","Nsylvestris_NODE_21433_length_997_cov_13","Ntome_NODE_6554_length_2737_cov_268",100,52,0,0,943,994,1053,1104,3.49e-19,97.1,51,51
"64939","Nsylvestris_NODE_21436_length_996_cov_208","Ntome_NODE_8244_length_2452_cov_198",98.762,727,9,0,270,996,60,786,0,1293,726,726
"64950","Nsylvestris_NODE_21441_length_996_cov_14","Ntome_NODE_6470_length_2754_cov_180",96.552,58,2,0,1,58,2380,2323,3.49e-19,97.1,57,57
"64967","Nsylvestris_NODE_21449_length_995_cov_87","Ntome_NODE_6469_length_2754_cov_222",92.388,959,27,12,7,937,92,1032,0,1325,930,940
"65013","Nsylvestris_NODE_21470_length_994_cov_2","Ntome_NODE_345_length_6539_cov_118",92.907,1001,54,7,1,989,476,1471,0,1439,988,995
"65016","Nsylvestris_NODE_21472_length_993_cov_216","Ntome_NODE_21668_length_1069_cov_280",96.366,963,32,3,1,962,44,1004,0,1581,961,960
"65017","Nsylvestris_NODE_21473_length_993_cov_210","Ntome_NODE_3936_length_3376_cov_295",95.298,957,30,11,39,993,1,944,0,1504,954,943
"65018","Nsylvestris_NODE_21474_length_993_cov_174","Ntome_NODE_24740_length_877_cov_219",90.995,744,54,8,40,778,784,49,0,990,738,735
"65019","Nsylvestris_NODE_21475_length_993_cov_123","Ntome_NODE_22938_length_987_cov_22",77.167,600,123,10,291,886,304,893,1.88e-91,337,595,589
"65034","Nsylvestris_NODE_21481_length_993_cov_15","Ntome_NODE_1492_length_4538_cov_94",95.798,119,5,0,1,119,430,312,4.31e-48,193,118,118
"65048","Nsylvestris_NODE_21487_length_992_cov_176","Ntome_NODE_11766_length_1985_cov_122",96.97,990,20,6,1,984,986,1971,0,1653,983,985
"65055","Nsylvestris_NODE_21494_length_992_cov_74","Ntome_NODE_22085_length_1042_cov_176",90.089,1009,37,19,6,990,1015,46,0,1251,984,969
"65059","Nsylvestris_NODE_21497_length_992_cov_55","Ntome_NODE_1018_length_5065_cov_167",93.475,705,39,3,237,937,4337,5038,0,1040,700,701
"65067","Nsylvestris_NODE_21505_length_992_cov_10","Ntome_NODE_16311_length_1511_cov_271",98.182,55,1,0,938,992,715,769,3.47e-19,97.1,54,54
"65079","Nsylvestris_NODE_21509_length_991_cov_169","Ntome_NODE_22172_length_1036_cov_264",92.688,930,47,11,6,922,5,926,0,1321,916,921
"65084","Nsylvestris_NODE_21511_length_991_cov_101","Ntome_NODE_23761_length_939_cov_104",93.455,825,47,7,165,988,50,868,0,1218,823,818
"65087","Nsylvestris_NODE_21513_length_991_cov_40","Ntome_NODE_18155_length_1346_cov_263",83.501,994,68,36,48,991,1118,171,0,839,943,947
"65088","Nsylvestris_NODE_21514_length_991_cov_39","Ntome_NODE_20852_length_1128_cov_22",95.037,947,41,4,5,946,1,946,0,1483,941,945
"65089","Nsylvestris_NODE_21515_length_991_cov_33","Ntome_NODE_20483_length_1155_cov_11",93.651,63,4,0,1,63,745,807,1.25e-18,95.3,62,62
"65099","Nsylvestris_NODE_21521_length_991_cov_7","Ntome_NODE_7004_length_2654_cov_25",95.122,82,4,0,5,86,2390,2471,3.42e-29,130,81,81
"65122","Nsylvestris_NODE_21529_length_989_cov_212","Ntome_NODE_19971_length_1194_cov_247",96.701,576,19,0,182,757,148,723,0,959,575,575
"65123","Nsylvestris_NODE_21530_length_989_cov_207","Ntome_NODE_904_length_5219_cov_299",93.931,758,17,10,49,804,194,924,0,1118,755,730
"65135","Nsylvestris_NODE_21535_length_989_cov_88","Ntome_NODE_21365_length_1090_cov_277",89.286,448,43,3,282,725,514,68,1.32e-157,556,443,446
"65138","Nsylvestris_NODE_21537_length_989_cov_32","Ntome_NODE_29087_length_664_cov_270",100,55,0,0,1,55,562,508,7.44e-21,102,54,54
"65147","Nsylvestris_NODE_21541_length_989_cov_16","Ntome_NODE_24107_length_918_cov_19",95.448,725,18,5,274,989,186,904,0,1142,715,718
"65171","Nsylvestris_NODE_21549_length_988_cov_78","Ntome_NODE_28705_length_680_cov_19",84.325,504,66,11,102,603,649,157,8.17e-135,481,501,492
"65175","Nsylvestris_NODE_21551_length_987_cov_34","Ntome_NODE_3377_length_3558_cov_122",95.359,237,10,1,552,787,2506,2270,3.96e-103,375,235,236
"65192","Nsylvestris_NODE_21559_length_987_cov_195","Ntome_NODE_9983_length_2201_cov_69",96.469,793,22,3,148,937,2197,1408,0,1304,789,789
"65199","Nsylvestris_NODE_21563_length_987_cov_167","Ntome_NODE_14558_length_1679_cov_211",94.728,588,28,1,92,676,1581,994,0,911,584,587
"65207","Nsylvestris_NODE_21566_length_987_cov_72","Ntome_NODE_24020_length_923_cov_139",86.761,846,42,20,33,844,1,810,0,878,811,809
"65229","Nsylvestris_NODE_21578_length_986_cov_144","Ntome_NODE_22860_length_992_cov_166",90.033,903,53,16,115,984,908,10,0,1134,869,898
"65237","Nsylvestris_NODE_21582_length_986_cov_75","Ntome_NODE_2408_length_3956_cov_144",96.552,58,2,0,929,986,859,916,3.45e-19,97.1,57,57
"65238","Nsylvestris_NODE_21583_length_986_cov_60","Ntome_NODE_12753_length_1867_cov_155",92.894,957,58,2,30,986,166,1112,0,1382,956,946
"65250","Nsylvestris_NODE_21589_length_986_cov_7","Ntome_NODE_15535_length_1575_cov_12",90.556,180,9,5,281,453,1,179,9.07e-60,231,172,178
"65267","Nsylvestris_NODE_21597_length_985_cov_91","Ntome_NODE_10364_length_2150_cov_167",87.446,462,10,11,1,441,484,50,4.87e-137,488,440,434
"65282","Nsylvestris_NODE_21605_length_984_cov_176","Ntome_NODE_21401_length_1088_cov_267",91.121,946,61,7,1,935,26,959,0,1260,934,933
"65300","Nsylvestris_NODE_21611_length_984_cov_20","Ntome_NODE_21417_length_1087_cov_73",92.128,686,39,5,284,966,364,1037,0,953,682,673
"65305","Nsylvestris_NODE_21613_length_984_cov_17","Ntome_NODE_10450_length_2139_cov_118",98.182,55,1,0,930,984,1875,1929,3.45e-19,97.1,54,54
"65306","Nsylvestris_NODE_21614_length_984_cov_10","Ntome_NODE_4118_length_3316_cov_177",92.843,992,59,9,1,984,1363,2350,0,1428,983,987
"65317","Nsylvestris_NODE_21618_length_983_cov_162","Ntome_NODE_28424_length_691_cov_238",85.38,171,24,1,702,872,265,96,4.3e-43,176,170,169
"65323","Nsylvestris_NODE_21620_length_983_cov_75","Ntome_NODE_22724_length_1002_cov_124",90.65,1016,46,15,2,982,1002,1,0,1304,980,1001
"65335","Nsylvestris_NODE_21625_length_983_cov_28","Ntome_NODE_24536_length_890_cov_8",94.111,849,49,1,1,849,883,36,0,1290,848,847
"65336","Nsylvestris_NODE_21626_length_984_cov_26","Ntome_NODE_35465_length_356_cov_3",83.333,330,33,10,165,476,356,31,6.85e-76,285,311,325
"65339","Nsylvestris_NODE_21628_length_983_cov_7","Ntome_NODE_545_length_5904_cov_75",88.86,386,38,5,3,386,4976,4594,1.76e-131,470,383,382
"65359","Nsylvestris_NODE_21635_length_982_cov_25","Ntome_NODE_4722_length_3154_cov_44",97.186,924,23,1,59,982,46,966,0,1559,923,920
"65367","Nsylvestris_NODE_21638_length_982_cov_14","Ntome_NODE_34092_length_415_cov_2",90.186,377,26,4,522,889,415,41,8.12e-135,481,367,374
"65368","Nsylvestris_NODE_21639_length_982_cov_12","Ntome_NODE_9458_length_2274_cov_104",88.688,442,23,5,139,554,906,466,8.01e-145,514,415,440
"65374","Nsylvestris_NODE_21642_length_982_cov_6","Ntome_NODE_15688_length_1569_cov_90",98.182,55,1,0,928,982,1067,1013,3.44e-19,97.1,54,54
"65381","Nsylvestris_NODE_21645_length_981_cov_218","Ntome_NODE_10584_length_2122_cov_162",96.788,903,27,1,55,957,1024,1924,0,1506,902,900
"65384","Nsylvestris_NODE_21647_length_981_cov_168","Ntome_NODE_23114_length_976_cov_60",87.056,958,64,27,55,981,975,47,0,1027,926,928
"65419","Nsylvestris_NODE_21661_length_980_cov_86","Ntome_NODE_1260_length_4770_cov_201",95.178,871,34,5,64,927,2,871,0,1369,863,869
"65458","Nsylvestris_NODE_21673_length_979_cov_116","Ntome_NODE_394_length_6328_cov_277",98.182,55,1,0,925,979,4187,4241,3.43e-19,97.1,54,54
"65494","Nsylvestris_NODE_21694_length_978_cov_31","Ntome_NODE_21396_length_1088_cov_12",91.463,164,12,2,258,421,717,556,1.51e-57,224,163,161
"65499","Nsylvestris_NODE_21698_length_978_cov_9","Ntome_NODE_4834_length_3125_cov_190",96.173,993,19,8,1,978,881,1869,0,1605,977,988
"65502","Nsylvestris_NODE_21700_length_977_cov_203","Ntome_NODE_22433_length_1020_cov_196",95.615,821,35,1,109,929,820,1,0,1315,820,819
"65503","Nsylvestris_NODE_21701_length_977_cov_172","Ntome_NODE_14004_length_1737_cov_290",94.616,873,22,8,127,977,1722,853,0,1328,850,869
"65504","Nsylvestris_NODE_21703_length_977_cov_123","Ntome_NODE_9559_length_2259_cov_215",92.194,679,33,4,248,925,1539,2198,0,942,677,659
"65518","Nsylvestris_NODE_21711_length_976_cov_206","Ntome_NODE_24151_length_915_cov_262",92.144,891,41,7,67,949,46,915,0,1230,882,869
"65525","Nsylvestris_NODE_21715_length_976_cov_70","Ntome_NODE_19012_length_1275_cov_75",94.365,976,42,7,2,976,54,1017,0,1485,974,963
"65526","Nsylvestris_NODE_21716_length_976_cov_47","Ntome_NODE_22920_length_988_cov_161",94.126,698,35,4,61,755,49,743,0,1057,694,694
"65529","Nsylvestris_NODE_21718_length_976_cov_18","Ntome_NODE_26079_length_803_cov_20",80.46,87,16,1,257,343,626,541,9.63e-10,65.8,86,85
"65537","Nsylvestris_NODE_21724_length_975_cov_206","Ntome_NODE_23618_length_947_cov_267",92.179,895,36,9,97,964,899,12,0,1234,867,887
"65538","Nsylvestris_NODE_21725_length_975_cov_198","Ntome_NODE_14250_length_1710_cov_181",95.601,932,29,5,47,975,1671,749,0,1483,928,922
"65539","Nsylvestris_NODE_21726_length_975_cov_178","Ntome_NODE_33651_length_437_cov_4",89.888,445,24,5,302,734,436,1,1.68e-156,553,432,435
"65542","Nsylvestris_NODE_21728_length_975_cov_151","Ntome_NODE_21987_length_1050_cov_217",91.014,957,41,17,18,959,927,1,0,1249,941,926
"65552","Nsylvestris_NODE_21733_length_975_cov_59","Ntome_NODE_1739_length_4353_cov_236",98.182,55,1,0,1,55,1436,1490,3.41e-19,97.1,54,54
"65567","Nsylvestris_NODE_21741_length_975_cov_21","Ntome_NODE_9361_length_2287_cov_215",85.023,434,42,10,556,973,1598,1172,1.78e-116,420,417,426
"65581","Nsylvestris_NODE_21746_length_974_cov_215","Ntome_NODE_18507_length_1316_cov_232",91.614,942,50,15,1,927,978,51,0,1275,926,927
"65584","Nsylvestris_NODE_21748_length_974_cov_116","Ntome_NODE_20601_length_1145_cov_212",93.696,920,53,4,11,925,50,969,0,1373,914,919
"65588","Nsylvestris_NODE_21750_length_973_cov_75","Ntome_NODE_24232_length_910_cov_257",94.978,677,34,0,123,799,863,187,0,1062,676,676
"65628","Nsylvestris_NODE_21762_length_973_cov_10","Ntome_NODE_21735_length_1066_cov_35",94.444,72,4,0,276,347,202,273,1.22e-23,111,71,71
"65634","Nsylvestris_NODE_21765_length_972_cov_214","Ntome_NODE_24394_length_899_cov_260",91.775,766,28,14,165,912,806,58,0,1033,747,748
"65642","Nsylvestris_NODE_21770_length_972_cov_77","Ntome_NODE_6598_length_2731_cov_76",87.075,147,18,1,309,455,2312,2457,9.19e-40,165,146,145
"65653","Nsylvestris_NODE_21774_length_971_cov_17","Ntome_NODE_17901_length_1366_cov_190",95.496,977,34,3,5,971,28,1004,0,1552,966,976
"65666","Nsylvestris_NODE_21779_length_971_cov_213","Ntome_NODE_22261_length_1030_cov_210",91.45,924,34,11,77,971,113,1020,0,1227,894,907
"65669","Nsylvestris_NODE_21781_length_971_cov_159","Ntome_NODE_23434_length_958_cov_200",94.543,733,38,2,187,918,751,20,0,1131,731,731
"65679","Nsylvestris_NODE_21786_length_970_cov_232","Ntome_NODE_5443_length_2974_cov_162",98.144,970,18,0,1,970,109,1078,0,1692,969,969
"65686","Nsylvestris_NODE_21789_length_970_cov_146","Ntome_NODE_3895_length_3389_cov_271",94.88,918,34,11,1,907,2469,3384,0,1423,906,915
"65690","Nsylvestris_NODE_21791_length_970_cov_44","Ntome_NODE_19735_length_1216_cov_47",90.541,222,20,1,1,221,1117,896,4.03e-78,292,220,221
"65691","Nsylvestris_NODE_21792_length_970_cov_35","Ntome_NODE_10039_length_2195_cov_41",88.353,249,28,1,612,859,329,81,8.67e-80,298,247,248
"65692","Nsylvestris_NODE_21793_length_970_cov_34","Ntome_NODE_22756_length_1000_cov_8",91.667,120,10,0,190,309,70,189,2.55e-40,167,119,119
"65710","Nsylvestris_NODE_21802_length_969_cov_102","Ntome_NODE_23076_length_978_cov_258",75.685,584,134,6,157,733,778,196,6.74e-76,285,576,582
"65729","Nsylvestris_NODE_21810_length_968_cov_195","Ntome_NODE_2829_length_3763_cov_250",97.523,888,22,0,81,968,2323,3210,0,1519,887,887
"65733","Nsylvestris_NODE_21812_length_968_cov_145","Ntome_NODE_26154_length_798_cov_174",88.933,750,55,11,44,775,762,23,0,900,731,739
"65734","Nsylvestris_NODE_21813_length_968_cov_124","Ntome_NODE_21182_length_1103_cov_220",91.413,722,49,8,170,881,130,848,0,977,711,718
"65735","Nsylvestris_NODE_21814_length_968_cov_117","Ntome_NODE_19947_length_1196_cov_237",90.987,932,37,19,53,944,1156,232,0,1212,891,924
"65753","Nsylvestris_NODE_21826_length_967_cov_217","Ntome_NODE_23589_length_949_cov_287",90.513,917,54,13,18,930,908,21,0,1181,912,887
"65760","Nsylvestris_NODE_21830_length_967_cov_144","Ntome_NODE_21307_length_1094_cov_163",94.305,878,26,11,45,908,999,132,0,1323,863,867
"65777","Nsylvestris_NODE_21837_length_967_cov_13","Ntome_NODE_4784_length_3137_cov_247",100,55,0,0,913,967,1531,1585,7.27e-21,102,54,54
"65780","Nsylvestris_NODE_21840_length_966_cov_203","Ntome_NODE_21236_length_1099_cov_241",90.351,912,64,6,41,951,120,1008,0,1175,910,888
"65785","Nsylvestris_NODE_21842_length_966_cov_190","Ntome_NODE_20352_length_1165_cov_250",93.841,893,26,6,45,915,1027,142,0,1317,870,885
"65800","Nsylvestris_NODE_21849_length_966_cov_70","Ntome_NODE_13901_length_1746_cov_88",95.459,969,31,4,1,966,418,1376,0,1533,965,958
"65808","Nsylvestris_NODE_21852_length_966_cov_36","Ntome_NODE_14394_length_1696_cov_165",91.345,751,36,10,110,844,836,1573,0,1000,734,737
"65816","Nsylvestris_NODE_21856_length_965_cov_195","Ntome_NODE_819_length_5354_cov_213",89.52,687,46,13,114,798,4644,5306,0,846,684,662
"65824","Nsylvestris_NODE_21859_length_965_cov_21","Ntome_NODE_20408_length_1161_cov_4",94.994,799,40,0,167,965,1159,361,0,1254,798,798
"65837","Nsylvestris_NODE_21866_length_964_cov_87","Ntome_NODE_10668_length_2110_cov_250",95.455,66,1,2,1,66,1065,1002,2.02e-21,104,65,63
"65846","Nsylvestris_NODE_21871_length_964_cov_22","Ntome_NODE_21801_length_1061_cov_17",87.268,377,26,16,263,628,582,947,1.06e-113,411,365,365
"65877","Nsylvestris_NODE_21887_length_963_cov_16","Ntome_NODE_1192_length_4847_cov_232",81.889,1027,88,43,7,963,2194,3192,0,776,956,998
"65881","Nsylvestris_NODE_21889_length_960_cov_206","Ntome_NODE_21115_length_1107_cov_274",94.607,853,35,9,62,911,979,135,0,1310,849,844
"65896","Nsylvestris_NODE_21894_length_962_cov_28","Ntome_NODE_2988_length_3704_cov_32",93.046,906,59,3,1,904,2801,3704,0,1321,903,903
"65906","Nsylvestris_NODE_21900_length_962_cov_7","Ntome_NODE_7836_length_2518_cov_184",91.04,971,42,8,1,962,1099,2033,0,1269,961,934
"65907","Nsylvestris_NODE_21901_length_962_cov_7","Ntome_NODE_11935_length_1966_cov_92",86.237,465,45,7,102,556,479,934,1.71e-136,486,454,455
"65930","Nsylvestris_NODE_21912_length_961_cov_30","Ntome_NODE_4691_length_3161_cov_201",81.287,684,83,20,305,961,1875,2540,2.82e-144,512,656,665
"65931","Nsylvestris_NODE_21913_length_961_cov_26","Ntome_NODE_27837_length_718_cov_9",94.868,721,34,1,162,882,718,1,0,1123,720,717
"65932","Nsylvestris_NODE_21914_length_961_cov_25","Ntome_NODE_23120_length_976_cov_20",89.801,804,64,7,12,806,976,182,0,1014,794,794
"65933","Nsylvestris_NODE_21915_length_961_cov_12","Ntome_NODE_388_length_6357_cov_117",83.636,220,12,14,49,256,2682,2889,6.98e-46,185,207,207
"65963","Nsylvestris_NODE_21927_length_960_cov_49","Ntome_NODE_19002_length_1276_cov_37",95.987,922,32,4,11,930,1273,355,0,1493,919,918
"65967","Nsylvestris_NODE_21929_length_960_cov_31","Ntome_NODE_22674_length_1005_cov_30",91.273,974,54,10,17,959,975,2,0,1299,942,973
"65972","Nsylvestris_NODE_21931_length_960_cov_20","Ntome_NODE_10890_length_2086_cov_159",97.59,83,2,0,878,960,1498,1416,4.25e-33,143,82,82
"65977","Nsylvestris_NODE_21933_length_960_cov_6","Ntome_NODE_1571_length_4479_cov_170",89.474,57,6,0,871,927,4049,4105,5.66e-12,73.1,56,56
"65978","Nsylvestris_NODE_21934_length_959_cov_222","Ntome_NODE_2107_length_4105_cov_296",94.143,922,38,7,44,959,4055,3144,0,1389,915,911
"65979","Nsylvestris_NODE_21935_length_959_cov_212","Ntome_NODE_16179_length_1523_cov_259",92.316,898,47,14,67,959,1476,596,0,1256,892,880
"66005","Nsylvestris_NODE_21948_length_959_cov_5","Ntome_NODE_10961_length_2078_cov_136",95.938,960,37,2,1,959,1077,2035,0,1555,958,958
"66006","Nsylvestris_NODE_21949_length_958_cov_229","Ntome_NODE_12563_length_1891_cov_288",96.581,468,16,0,1,468,617,150,0,776,467,467
"66015","Nsylvestris_NODE_21952_length_958_cov_209","Ntome_NODE_16089_length_1529_cov_63",95.57,903,21,4,74,958,7,908,0,1428,884,901
"66016","Nsylvestris_NODE_21953_length_958_cov_188","Ntome_NODE_22767_length_998_cov_249",92.731,963,39,11,1,940,955,1,0,1362,939,954
"66024","Nsylvestris_NODE_21956_length_958_cov_171","Ntome_NODE_4353_length_3249_cov_141",92.916,974,48,8,1,958,2,970,0,1397,957,968
"66033","Nsylvestris_NODE_21959_length_958_cov_148","Ntome_NODE_28573_length_685_cov_50",93.023,645,31,6,221,860,636,1,0,929,639,635
"66051","Nsylvestris_NODE_21968_length_958_cov_9","Ntome_NODE_24493_length_893_cov_31",92.742,744,45,4,4,747,775,41,0,1066,743,734
"66065","Nsylvestris_NODE_21974_length_957_cov_156","Ntome_NODE_317_length_6640_cov_140",98.015,957,19,0,1,957,3638,2682,0,1663,956,956
"66080","Nsylvestris_NODE_21980_length_957_cov_55","Ntome_NODE_16120_length_1529_cov_165",88.455,589,54,4,26,611,1054,477,0,699,585,577
"66086","Nsylvestris_NODE_21984_length_957_cov_12","Ntome_NODE_16277_length_1514_cov_191",98.077,52,1,0,1,52,951,1002,1.56e-17,91.6,51,51
"66090","Nsylvestris_NODE_21986_length_957_cov_8","Ntome_NODE_37961_length_289_cov_4",97.318,261,7,0,2,262,261,1,1.04e-123,444,260,260
"66132","Nsylvestris_NODE_22004_length_955_cov_190","Ntome_NODE_19133_length_1265_cov_27",85.795,352,35,5,415,762,764,424,3.86e-98,359,347,340
"66135","Nsylvestris_NODE_22006_length_955_cov_185","Ntome_NODE_21460_length_1084_cov_188",94.526,822,36,7,9,824,1034,216,0,1260,815,818
"66138","Nsylvestris_NODE_22008_length_955_cov_167","Ntome_NODE_23961_length_927_cov_228",89.341,713,33,15,174,866,762,73,0,856,692,689
"66139","Nsylvestris_NODE_22009_length_955_cov_137","Ntome_NODE_28391_length_693_cov_24",97.368,38,1,0,918,955,215,252,9.42e-10,65.8,37,37
"66147","Nsylvestris_NODE_22012_length_955_cov_76","Ntome_NODE_23514_length_954_cov_165",90.354,622,58,2,217,838,272,891,0,815,621,619
"66179","Nsylvestris_NODE_22025_length_954_cov_83","Ntome_NODE_31663_length_565_cov_56",93.822,518,25,2,139,649,518,1,0,773,510,517
"66222","Nsylvestris_NODE_22051_length_952_cov_234","Ntome_NODE_8255_length_2449_cov_289",91.22,877,35,11,1,842,1338,2207,0,1155,841,869
"66240","Nsylvestris_NODE_22055_length_952_cov_190","Ntome_NODE_23679_length_944_cov_225",93.985,798,32,4,129,911,821,25,0,1194,782,796
"66257","Nsylvestris_NODE_22064_length_952_cov_8","Ntome_NODE_34521_length_394_cov_11",92.416,356,23,3,551,906,394,43,4.67e-142,505,355,351
"66264","Nsylvestris_NODE_22068_length_951_cov_50","Ntome_NODE_25586_length_828_cov_142",84.305,223,21,4,119,328,275,54,5.3e-52,206,209,221
"66281","Nsylvestris_NODE_22075_length_951_cov_8","Ntome_NODE_31806_length_560_cov_6",84.122,296,42,4,66,357,264,558,8.56e-75,281,291,294
"66306","Nsylvestris_NODE_22086_length_950_cov_93","Ntome_NODE_1862_length_4264_cov_278",90.308,227,22,0,558,784,262,36,8.49e-80,298,226,226
"66340","Nsylvestris_NODE_22101_length_949_cov_118","Ntome_NODE_23003_length_983_cov_106",93.435,853,53,3,29,879,860,9,0,1262,850,851
"66345","Nsylvestris_NODE_22106_length_949_cov_23","Ntome_NODE_2893_length_3740_cov_226",94.077,287,17,0,1,287,2601,2315,1.72e-121,436,286,286
"66353","Nsylvestris_NODE_22110_length_949_cov_10","Ntome_NODE_5375_length_2992_cov_207",100,55,0,0,1,55,1755,1809,7.13e-21,102,54,54
"66366","Nsylvestris_NODE_22118_length_948_cov_15","Ntome_NODE_37293_length_304_cov_3",87.869,305,26,7,108,402,304,1,8.29e-95,348,294,303
"66367","Nsylvestris_NODE_22119_length_948_cov_14","Ntome_NODE_14966_length_1639_cov_124",90.836,873,52,11,27,896,595,1442,0,1144,869,847
"66398","Nsylvestris_NODE_22136_length_946_cov_48","Ntome_NODE_30438_length_611_cov_9",89.1,578,33,7,220,792,553,1,0,691,572,552
"66434","Nsylvestris_NODE_22147_length_945_cov_99","Ntome_NODE_7019_length_2652_cov_92",86.966,468,37,12,2,469,2135,1692,4.63e-142,505,467,443
"66439","Nsylvestris_NODE_22149_length_945_cov_80","Ntome_NODE_3483_length_3523_cov_35",79.577,142,18,9,780,918,3324,3457,1.54e-17,91.6,138,133
"66444","Nsylvestris_NODE_22152_length_945_cov_51","Ntome_NODE_15523_length_1582_cov_114",94.643,728,35,3,4,728,95,821,0,1125,724,726
"66445","Nsylvestris_NODE_22153_length_945_cov_39","Ntome_NODE_13092_length_1832_cov_95",88,350,38,4,110,457,1029,682,1.04e-113,411,347,347
"66449","Nsylvestris_NODE_22155_length_945_cov_31","Ntome_NODE_3112_length_3655_cov_38",90.278,72,7,0,49,120,3633,3562,1.19e-18,95.3,71,71
"66455","Nsylvestris_NODE_22158_length_945_cov_17","Ntome_NODE_39303_length_262_cov_3",82.117,274,34,7,624,897,3,261,1.88e-56,220,273,258
"66466","Nsylvestris_NODE_22164_length_944_cov_179","Ntome_NODE_24685_length_881_cov_222",95.626,823,21,6,43,851,825,4,0,1306,808,821
"66473","Nsylvestris_NODE_22167_length_944_cov_34","Ntome_NODE_456_length_6137_cov_19",87.736,212,26,0,732,943,1458,1247,8.61e-65,248,211,211
"66474","Nsylvestris_NODE_22168_length_944_cov_16","Ntome_NODE_32721_length_497_cov_2",95.976,497,20,0,256,752,1,497,0,808,496,496
"66487","Nsylvestris_NODE_22175_length_943_cov_205","Ntome_NODE_5250_length_3018_cov_79",92.599,608,37,2,70,670,2947,2341,0,867,600,606
"66491","Nsylvestris_NODE_22177_length_943_cov_146","Ntome_NODE_1852_length_4271_cov_85",89.125,800,50,20,171,943,1,790,0,961,772,789
"66495","Nsylvestris_NODE_22180_length_943_cov_39","Ntome_NODE_22645_length_1007_cov_164",89.879,494,25,6,447,935,701,228,2.65e-174,612,488,473
"66498","Nsylvestris_NODE_22182_length_943_cov_14","Ntome_NODE_11097_length_2061_cov_17",86.632,778,46,20,2,736,1994,1232,0,808,734,762
"66499","Nsylvestris_NODE_22183_length_943_cov_12","Ntome_NODE_35339_length_360_cov_8",97.382,191,5,0,753,943,1,191,3.86e-88,326,190,190
"66525","Nsylvestris_NODE_22194_length_942_cov_111","Ntome_NODE_9554_length_2260_cov_283",95.385,780,34,2,1,780,885,108,0,1240,779,777
"66538","Nsylvestris_NODE_22200_length_942_cov_30","Ntome_NODE_7561_length_2561_cov_169",91.813,513,27,3,240,746,182,685,0,701,506,503
"66539","Nsylvestris_NODE_22203_length_942_cov_10","Ntome_NODE_4762_length_3143_cov_173",83.317,1001,93,32,1,942,1701,716,0,856,941,985
"66543","Nsylvestris_NODE_22206_length_941_cov_223","Ntome_NODE_24465_length_894_cov_263",95.439,877,36,2,1,877,880,8,0,1395,876,872
"66544","Nsylvestris_NODE_22207_length_941_cov_215","Ntome_NODE_3346_length_3570_cov_206",93.563,901,44,4,44,941,955,66,0,1330,897,889
"66564","Nsylvestris_NODE_22213_length_941_cov_88","Ntome_NODE_14708_length_1665_cov_28",93.359,783,26,13,1,769,1371,601,0,1134,768,770
"66569","Nsylvestris_NODE_22216_length_939_cov_46","Ntome_NODE_26045_length_804_cov_106",93.026,717,33,6,8,718,2,707,0,1031,710,705
"66572","Nsylvestris_NODE_22218_length_941_cov_24","Ntome_NODE_23403_length_960_cov_56",92.841,866,49,11,52,909,73,933,0,1243,857,860
"66597","Nsylvestris_NODE_22228_length_940_cov_87","Ntome_NODE_25512_length_832_cov_244",96.774,62,2,0,879,940,559,620,1.96e-21,104,61,61
"66601","Nsylvestris_NODE_22230_length_940_cov_84","Ntome_NODE_11086_length_2063_cov_72",88.95,181,18,2,553,732,886,1065,5.2e-57,222,179,179
"66605","Nsylvestris_NODE_22232_length_940_cov_53","Ntome_NODE_4904_length_3110_cov_325",96.064,940,37,0,1,940,1905,966,0,1531,939,939
"66612","Nsylvestris_NODE_22235_length_940_cov_22","Ntome_NODE_24293_length_907_cov_12",94.099,322,11,1,1,322,491,804,2.16e-135,483,321,313
"66613","Nsylvestris_NODE_22236_length_940_cov_10","Ntome_NODE_10945_length_2080_cov_164",85.759,962,94,23,1,940,1109,169,0,977,939,940
"66614","Nsylvestris_NODE_22240_length_940_cov_4","Ntome_NODE_2353_length_3983_cov_169",93.757,945,52,5,1,940,2331,1389,0,1411,939,942
"66618","Nsylvestris_NODE_22242_length_939_cov_215","Ntome_NODE_21741_length_1065_cov_250",94.509,856,45,1,36,891,922,69,0,1319,855,853
"66636","Nsylvestris_NODE_22249_length_939_cov_107","Ntome_NODE_4979_length_3088_cov_115",83.562,292,42,6,652,939,2337,2048,6.57e-71,268,287,289
"66643","Nsylvestris_NODE_22255_length_939_cov_29","Ntome_NODE_3900_length_3386_cov_103",94.521,949,39,7,1,939,1816,871,0,1452,938,945
"66697","Nsylvestris_NODE_22279_length_937_cov_34","Ntome_NODE_11204_length_2049_cov_30",90.26,154,14,1,783,935,2032,1879,2.43e-50,200,152,153
"66715","Nsylvestris_NODE_22286_length_936_cov_216","Ntome_NODE_20591_length_1146_cov_99",93.456,596,36,3,296,888,651,56,0,881,592,595
"66730","Nsylvestris_NODE_22293_length_936_cov_15","Ntome_NODE_8002_length_2490_cov_287",98.182,55,1,0,882,936,340,394,3.27e-19,97.1,54,54
"66734","Nsylvestris_NODE_22295_length_936_cov_9","Ntome_NODE_6122_length_2827_cov_191",98.113,53,1,0,884,936,2601,2549,4.23e-18,93.5,52,52
"66735","Nsylvestris_NODE_22296_length_936_cov_8","Ntome_NODE_3214_length_3616_cov_80",100,55,0,0,1,55,1106,1160,7.03e-21,102,54,54
"66747","Nsylvestris_NODE_22302_length_935_cov_210","Ntome_NODE_23374_length_961_cov_261",91.746,630,14,12,125,754,1,592,0,841,629,591
"66758","Nsylvestris_NODE_22310_length_935_cov_19","Ntome_NODE_3913_length_3383_cov_14",100,55,0,0,1,55,2076,2130,7.03e-21,102,54,54
"66759","Nsylvestris_NODE_22311_length_935_cov_18","Ntome_NODE_19_length_11828_cov_48",94.286,35,2,0,831,865,316,350,2e-06,54.7,34,34
"66763","Nsylvestris_NODE_22314_length_935_cov_11","Ntome_NODE_23846_length_934_cov_31",89.546,947,74,16,1,935,1,934,0,1177,934,933
"66764","Nsylvestris_NODE_22315_length_935_cov_5","Ntome_NODE_18683_length_1302_cov_43",94.03,134,8,0,13,146,891,1024,1.87e-51,204,133,133
"66765","Nsylvestris_NODE_22316_length_934_cov_115","Ntome_NODE_7038_length_2648_cov_293",93.651,63,4,0,870,932,105,167,1.17e-18,95.3,62,62
"66766","Nsylvestris_NODE_22317_length_934_cov_64","Ntome_NODE_25875_length_811_cov_79",95.317,726,19,6,174,884,58,783,0,1138,710,725
"66767","Nsylvestris_NODE_22318_length_934_cov_49","Ntome_NODE_24940_length_867_cov_13",91.482,857,61,8,33,881,854,2,0,1168,848,852
"66768","Nsylvestris_NODE_22319_length_932_cov_35","Ntome_NODE_26415_length_786_cov_72",89.683,630,57,8,1,625,147,773,0,797,624,626
"66780","Nsylvestris_NODE_22324_length_933_cov_216","Ntome_NODE_13047_length_1836_cov_177",95.884,826,27,5,59,882,139,959,0,1330,823,820
"66784","Nsylvestris_NODE_22326_length_933_cov_187","Ntome_NODE_22281_length_1029_cov_207",91.505,930,54,13,16,924,926,1,0,1256,908,925
"66785","Nsylvestris_NODE_22327_length_933_cov_59","Ntome_NODE_26796_length_768_cov_6",93.447,763,41,1,172,925,1,763,0,1123,753,762
"66789","Nsylvestris_NODE_22330_length_933_cov_36","Ntome_NODE_24024_length_923_cov_27",95.599,818,35,1,66,883,923,107,0,1310,817,816
"66799","Nsylvestris_NODE_22337_length_933_cov_6","Ntome_NODE_15097_length_1624_cov_74",81.806,775,110,13,186,933,1433,663,4.35e-177,621,747,770
"66819","Nsylvestris_NODE_22343_length_932_cov_167","Ntome_NODE_7151_length_2630_cov_211",100,39,0,0,14,52,1990,1952,5.49e-12,73.1,38,38
"66820","Nsylvestris_NODE_22344_length_932_cov_162","Ntome_NODE_17662_length_1387_cov_135",92.632,570,31,4,1,567,703,1264,0,809,566,561
"66831","Nsylvestris_NODE_22350_length_932_cov_44","Ntome_NODE_21561_length_1077_cov_63",88.999,909,55,12,30,926,955,80,0,1083,896,875
"66832","Nsylvestris_NODE_22351_length_932_cov_44","Ntome_NODE_36323_length_330_cov_2",96.732,306,9,1,256,561,330,26,3.53e-143,508,305,304
"66833","Nsylvestris_NODE_22352_length_932_cov_29","Ntome_NODE_15266_length_1608_cov_146",92.093,645,43,4,3,643,26,666,0,902,640,640
"66840","Nsylvestris_NODE_22360_length_931_cov_204","Ntome_NODE_1628_length_4435_cov_264",97.465,868,17,2,1,864,3569,4435,0,1476,863,866
"66843","Nsylvestris_NODE_22363_length_931_cov_177","Ntome_NODE_498_length_6023_cov_257",94.737,57,2,1,1,56,1270,1326,1.96e-16,87.9,55,56
"66846","Nsylvestris_NODE_22365_length_931_cov_142","Ntome_NODE_5393_length_2987_cov_248",100,55,0,0,1,55,1775,1829,7e-21,102,54,54
"66850","Nsylvestris_NODE_22370_length_931_cov_72","Ntome_NODE_24038_length_922_cov_120",87.691,853,36,30,96,931,834,34,0,929,835,800
"66851","Nsylvestris_NODE_22372_length_931_cov_30","Ntome_NODE_12907_length_1851_cov_231",98.148,54,1,0,2,55,850,903,1.17e-18,95.3,53,53
"66862","Nsylvestris_NODE_22381_length_930_cov_230","Ntome_NODE_20155_length_1180_cov_99",95.685,927,34,2,1,927,234,1154,0,1485,926,920
"66865","Nsylvestris_NODE_22383_length_930_cov_211","Ntome_NODE_16063_length_1534_cov_160",95.912,685,22,4,119,798,804,1487,0,1105,679,683
"66870","Nsylvestris_NODE_22385_length_930_cov_189","Ntome_NODE_25614_length_826_cov_252",94.218,588,23,5,286,870,634,55,0,887,584,579
"66871","Nsylvestris_NODE_22386_length_930_cov_137","Ntome_NODE_25993_length_806_cov_90",92.846,643,32,5,196,834,729,97,0,920,638,632
"66885","Nsylvestris_NODE_22396_length_929_cov_11","Ntome_NODE_27974_length_712_cov_4",87.966,349,40,2,186,533,662,315,1.02e-113,411,347,347
"66888","Nsylvestris_NODE_22398_length_927_cov_143","Ntome_NODE_25350_length_841_cov_37",89.985,679,67,1,57,735,53,730,0,876,678,677
"66889","Nsylvestris_NODE_22399_length_928_cov_142","Ntome_NODE_13573_length_1779_cov_230",84.672,137,19,2,258,392,222,358,6.87e-31,135,134,136
"66890","Nsylvestris_NODE_22401_length_908_cov_30","Ntome_NODE_30475_length_610_cov_4",94.849,563,27,1,249,811,48,608,0,878,562,560
"66894","Nsylvestris_NODE_22403_length_928_cov_20","Ntome_NODE_7642_length_2549_cov_53",92.623,122,7,2,457,576,2246,2367,1.46e-42,174,119,121
"66897","Nsylvestris_NODE_22405_length_928_cov_12","Ntome_NODE_28847_length_674_cov_21",87.436,390,34,8,86,474,460,85,6.05e-121,435,388,375
"66910","Nsylvestris_NODE_22410_length_927_cov_204","Ntome_NODE_15360_length_1597_cov_170",93.431,822,25,7,1,821,19,812,0,1192,820,793
"66911","Nsylvestris_NODE_22411_length_927_cov_180","Ntome_NODE_24193_length_913_cov_24",81.545,233,32,9,359,588,689,465,8.7e-45,182,229,224
"66915","Nsylvestris_NODE_22414_length_927_cov_112","Ntome_NODE_18003_length_1357_cov_207",85.207,845,62,25,96,897,888,64,0,809,801,824
"66926","Nsylvestris_NODE_22417_length_927_cov_23","Ntome_NODE_411_length_6275_cov_224",100,55,0,0,873,927,1371,1317,6.96e-21,102,54,54
"66930","Nsylvestris_NODE_22420_length_927_cov_15","Ntome_NODE_10811_length_2094_cov_264",100,55,0,0,1,55,362,308,6.96e-21,102,54,54
"66934","Nsylvestris_NODE_22422_length_927_cov_12","Ntome_NODE_14504_length_1685_cov_183",98.182,55,1,0,1,55,974,1028,3.24e-19,97.1,54,54
"66935","Nsylvestris_NODE_22424_length_927_cov_9","Ntome_NODE_13239_length_1815_cov_249",96.154,52,1,1,873,924,1683,1633,2.52e-15,84.2,51,50
"66940","Nsylvestris_NODE_22427_length_926_cov_214","Ntome_NODE_27561_length_730_cov_6",92.539,697,44,5,49,744,690,1,0,992,695,689
"66941","Nsylvestris_NODE_22428_length_926_cov_203","Ntome_NODE_4616_length_3180_cov_203",94.138,853,44,2,39,888,973,124,0,1293,849,849
"66942","Nsylvestris_NODE_22429_length_926_cov_199","Ntome_NODE_14952_length_1640_cov_276",90.983,865,53,7,1,849,929,74,0,1142,848,855
"66946","Nsylvestris_NODE_22431_length_926_cov_183","Ntome_NODE_5460_length_2972_cov_87",94.174,841,29,14,44,869,1357,2192,0,1264,825,835
"66954","Nsylvestris_NODE_22437_length_926_cov_7","Ntome_NODE_3407_length_3544_cov_285",98.182,55,1,0,872,926,2287,2233,3.24e-19,97.1,54,54
"66955","Nsylvestris_NODE_22438_length_925_cov_7","Ntome_NODE_16180_length_1523_cov_124",92.308,221,16,1,641,861,280,61,2.95e-84,313,220,219
"66966","Nsylvestris_NODE_22444_length_925_cov_109","Ntome_NODE_4429_length_3227_cov_227",91.2,125,11,0,3,127,1538,1662,1.88e-41,171,124,124
"66969","Nsylvestris_NODE_22446_length_925_cov_80","Ntome_NODE_16076_length_1532_cov_40",81.882,287,42,8,375,656,670,951,2.36e-60,233,281,281
"66970","Nsylvestris_NODE_22448_length_925_cov_73","Ntome_NODE_21875_length_1056_cov_111",95.445,922,24,3,3,922,68,973,0,1454,919,905
"66971","Nsylvestris_NODE_22450_length_925_cov_45","Ntome_NODE_8965_length_2343_cov_260",96.364,55,2,0,1,55,913,967,1.5e-17,91.6,54,54
"66972","Nsylvestris_NODE_22451_length_925_cov_30","Ntome_NODE_21570_length_1077_cov_5",96.296,108,4,0,818,925,1077,970,1.12e-43,178,107,107
"66976","Nsylvestris_NODE_22453_length_925_cov_15","Ntome_NODE_14089_length_1728_cov_252",100,55,0,0,1,55,796,742,6.95e-21,102,54,54
"66977","Nsylvestris_NODE_22454_length_925_cov_9","Ntome_NODE_11865_length_1974_cov_202",100,55,0,0,871,925,393,447,6.95e-21,102,54,54
"66984","Nsylvestris_NODE_22460_length_924_cov_211","Ntome_NODE_23510_length_954_cov_219",91.259,858,63,5,52,907,895,48,0,1158,855,847
"66991","Nsylvestris_NODE_22464_length_924_cov_188","Ntome_NODE_23458_length_957_cov_148",94.645,859,31,8,1,852,99,949,0,1317,851,850
"66995","Nsylvestris_NODE_22466_length_924_cov_80","Ntome_NODE_1175_length_4866_cov_171",89.345,779,32,16,1,741,766,1,0,931,740,765
"67005","Nsylvestris_NODE_22471_length_924_cov_28","Ntome_NODE_19499_length_1234_cov_85",92.372,839,28,10,90,919,295,1106,0,1162,829,811
"67019","Nsylvestris_NODE_22479_length_923_cov_207","Ntome_NODE_14652_length_1672_cov_197",87.311,662,62,15,252,912,662,22,0,737,660,640
"67067","Nsylvestris_NODE_22505_length_922_cov_11","Ntome_NODE_1856_length_4267_cov_240",98.182,55,1,0,1,55,2895,2841,3.22e-19,97.1,54,54
"67092","Nsylvestris_NODE_22515_length_921_cov_22","Ntome_NODE_23165_length_973_cov_248",84.802,329,34,10,64,391,90,403,2.27e-85,316,327,313
"67093","Nsylvestris_NODE_22517_length_921_cov_13","Ntome_NODE_5280_length_3012_cov_52",100,55,0,0,867,921,2499,2445,6.92e-21,102,54,54
"67102","Nsylvestris_NODE_22523_length_920_cov_166","Ntome_NODE_23619_length_947_cov_225",93.85,878,47,6,45,920,70,942,0,1315,875,872
"67108","Nsylvestris_NODE_22526_length_916_cov_139","Ntome_NODE_27611_length_728_cov_6",85.874,269,21,6,1,254,369,103,1.78e-71,270,253,266
"67123","Nsylvestris_NODE_22537_length_920_cov_7","Ntome_NODE_23813_length_936_cov_62",85.177,479,69,2,155,632,137,614,1.26e-137,490,477,477
"67127","Nsylvestris_NODE_22539_length_920_cov_4","Ntome_NODE_16629_length_1484_cov_64",92.78,831,29,12,116,918,361,1188,0,1173,802,827
"67133","Nsylvestris_NODE_22542_length_919_cov_190","Ntome_NODE_23601_length_948_cov_249",95.838,913,36,2,8,919,1,912,0,1474,911,911
"67136","Nsylvestris_NODE_22544_length_919_cov_188","Ntome_NODE_4518_length_3206_cov_117",90.936,684,40,5,223,887,439,1119,0,900,664,680
"67139","Nsylvestris_NODE_22546_length_919_cov_80","Ntome_NODE_8912_length_2351_cov_265",88.72,328,26,6,16,336,2315,1992,1.32e-107,390,320,323
"67140","Nsylvestris_NODE_22547_length_919_cov_42","Ntome_NODE_23360_length_962_cov_65",94.301,737,40,2,49,784,850,115,0,1127,735,735
"67145","Nsylvestris_NODE_22550_length_919_cov_18","Ntome_NODE_5715_length_2914_cov_109",96.063,889,35,0,26,914,2242,1354,0,1448,888,888
"67146","Nsylvestris_NODE_22552_length_919_cov_10","Ntome_NODE_20168_length_1179_cov_45",82.322,758,62,24,2,706,93,831,3.36e-168,592,704,738
"67147","Nsylvestris_NODE_22554_length_918_cov_215","Ntome_NODE_22749_length_1000_cov_227",92.629,719,50,3,58,775,235,951,0,1031,717,716
"67148","Nsylvestris_NODE_22555_length_918_cov_200","Ntome_NODE_25212_length_850_cov_248",92.946,808,35,7,60,848,46,850,0,1157,788,804
"67161","Nsylvestris_NODE_22560_length_918_cov_111","Ntome_NODE_26648_length_775_cov_184",95.751,659,24,3,144,800,710,54,0,1059,656,656
"67173","Nsylvestris_NODE_22564_length_918_cov_11","Ntome_NODE_9595_length_2254_cov_61",92.157,51,3,1,261,311,1221,1172,1.94e-11,71.3,50,49
"67187","Nsylvestris_NODE_22570_length_917_cov_187","Ntome_NODE_16617_length_1485_cov_74",92.167,766,39,7,1,746,989,225,0,1062,745,764
"67193","Nsylvestris_NODE_22572_length_917_cov_163","Ntome_NODE_13375_length_1800_cov_129",93.698,603,36,2,268,869,724,123,0,902,601,601
"67207","Nsylvestris_NODE_22578_length_917_cov_26","Ntome_NODE_5813_length_2891_cov_280",86.826,167,22,0,343,509,571,737,1.85e-46,187,166,166
"67211","Nsylvestris_NODE_22580_length_917_cov_12","Ntome_NODE_35751_length_346_cov_9",92.197,346,26,1,293,637,1,346,4.52e-137,488,344,345
"67229","Nsylvestris_NODE_22588_length_916_cov_159","Ntome_NODE_21552_length_1077_cov_270",91.977,885,46,13,1,878,55,921,0,1218,877,866
"67230","Nsylvestris_NODE_22589_length_916_cov_134","Ntome_NODE_23926_length_929_cov_123",93.074,693,36,7,7,688,910,219,0,1003,681,691
"67231","Nsylvestris_NODE_22590_length_916_cov_131","Ntome_NODE_13860_length_1750_cov_69",97.917,48,1,0,244,291,851,804,2.49e-15,84.2,47,47
"67232","Nsylvestris_NODE_22591_length_916_cov_88","Ntome_NODE_20332_length_1166_cov_310",96.364,55,2,0,1,55,907,961,1.49e-17,91.6,54,54
"67233","Nsylvestris_NODE_22592_length_916_cov_77","Ntome_NODE_18960_length_1280_cov_17",94.483,870,47,1,48,916,976,107,0,1339,868,869
"67237","Nsylvestris_NODE_22595_length_916_cov_24","Ntome_NODE_199_length_7445_cov_140",77.232,224,34,13,652,860,1,222,8.84e-25,115,208,221
"67250","Nsylvestris_NODE_22599_length_916_cov_9","Ntome_NODE_10678_length_2109_cov_250",96.364,55,2,0,1,55,1389,1443,1.49e-17,91.6,54,54
"67251","Nsylvestris_NODE_22600_length_916_cov_7","Ntome_NODE_4382_length_3242_cov_281",98.182,55,1,0,862,916,1686,1632,3.2e-19,97.1,54,54
"67278","Nsylvestris_NODE_22611_length_915_cov_14","Ntome_NODE_10919_length_2083_cov_63",85.533,394,32,9,337,729,36,405,4.71e-107,388,392,369
"67279","Nsylvestris_NODE_22612_length_915_cov_12","Ntome_NODE_6136_length_2825_cov_87",94.962,913,40,6,5,915,2489,1581,0,1426,910,908
"67297","Nsylvestris_NODE_22620_length_914_cov_154","Ntome_NODE_23731_length_941_cov_179",89.939,815,41,12,52,830,898,89,0,1013,778,809
"67298","Nsylvestris_NODE_22621_length_914_cov_147","Ntome_NODE_32640_length_503_cov_117",84.466,515,34,15,266,753,503,8,2.11e-130,466,487,495
"67303","Nsylvestris_NODE_22623_length_916_cov_65","Ntome_NODE_6410_length_2765_cov_244",89.735,302,16,9,549,850,2172,1886,4.75e-102,372,301,286
"67319","Nsylvestris_NODE_22632_length_914_cov_11","Ntome_NODE_9131_length_2319_cov_286",98.182,55,1,0,1,55,815,869,3.19e-19,97.1,54,54
"67320","Nsylvestris_NODE_22633_length_914_cov_8","Ntome_NODE_1013_length_5071_cov_278",100,55,0,0,1,55,2754,2700,6.86e-21,102,54,54
"67324","Nsylvestris_NODE_22635_length_914_cov_8","Ntome_NODE_16891_length_1457_cov_144",96.364,55,2,0,860,914,977,923,1.49e-17,91.6,54,54
"67325","Nsylvestris_NODE_22636_length_914_cov_7","Ntome_NODE_19196_length_1260_cov_55",95.479,752,26,4,170,914,1175,425,0,1194,744,750
"67326","Nsylvestris_NODE_22638_length_914_cov_5","Ntome_NODE_25162_length_854_cov_7",78.109,603,59,22,3,600,747,213,8.1e-85,315,597,534
"67329","Nsylvestris_NODE_22640_length_913_cov_215","Ntome_NODE_21_length_11525_cov_123",92.929,792,53,3,48,838,2854,3643,0,1149,790,789
"67357","Nsylvestris_NODE_22652_length_912_cov_209","Ntome_NODE_1177_length_4863_cov_145",94.242,851,21,4,90,912,4805,3955,0,1275,822,850
"67360","Nsylvestris_NODE_22654_length_912_cov_166","Ntome_NODE_16984_length_1450_cov_204",96.42,810,26,3,105,912,34,842,0,1332,807,808
"67363","Nsylvestris_NODE_22656_length_912_cov_109","Ntome_NODE_14905_length_1644_cov_89",93.386,892,38,6,41,912,489,1379,0,1301,871,890
"67370","Nsylvestris_NODE_22660_length_912_cov_17","Ntome_NODE_11405_length_2025_cov_147",80.496,282,29,6,1,282,1621,1876,3.95e-48,193,281,255
"67374","Nsylvestris_NODE_22662_length_911_cov_11","Ntome_NODE_18886_length_1285_cov_15",90.698,129,11,1,490,618,1143,1016,1.85e-41,171,128,127
"67386","Nsylvestris_NODE_22666_length_911_cov_158","Ntome_NODE_23759_length_939_cov_146",94.248,904,37,4,16,907,920,20,0,1367,891,900
"67387","Nsylvestris_NODE_22667_length_911_cov_131","Ntome_NODE_30182_length_621_cov_12",90.741,54,5,0,102,155,600,547,5.36e-12,73.1,53,53
"67388","Nsylvestris_NODE_22669_length_911_cov_72","Ntome_NODE_27491_length_733_cov_21",87.483,751,53,25,133,875,16,733,0,828,742,717
"67391","Nsylvestris_NODE_22674_length_911_cov_14","Ntome_NODE_780_length_5417_cov_178",81.476,691,75,23,185,847,3332,2667,5.73e-146,518,662,665
"67396","Nsylvestris_NODE_22676_length_911_cov_9","Ntome_NODE_4214_length_3289_cov_86",96.678,903,18,8,1,894,2302,3201,0,1491,893,899
"67397","Nsylvestris_NODE_22677_length_910_cov_188","Ntome_NODE_11478_length_2016_cov_248",98.23,904,16,0,7,910,1886,983,0,1581,903,903
"67398","Nsylvestris_NODE_22678_length_910_cov_174","Ntome_NODE_23904_length_930_cov_205",94.032,687,27,7,4,688,842,168,0,1029,684,674
"67399","Nsylvestris_NODE_22679_length_910_cov_164","Ntome_NODE_20209_length_1176_cov_221",94.337,883,36,6,1,879,241,1113,0,1341,878,872
"67404","Nsylvestris_NODE_22684_length_910_cov_65","Ntome_NODE_6376_length_2772_cov_65",86.239,109,14,1,139,247,2681,2574,2.44e-25,117,108,107
"67407","Nsylvestris_NODE_22686_length_910_cov_11","Ntome_NODE_655_length_5643_cov_79",96.721,61,2,0,850,910,4464,4524,6.83e-21,102,60,60
"67413","Nsylvestris_NODE_22689_length_910_cov_6","Ntome_NODE_5437_length_2976_cov_201",96.364,55,2,0,856,910,823,769,1.48e-17,91.6,54,54
"67430","Nsylvestris_NODE_22698_length_909_cov_93","Ntome_NODE_22363_length_1025_cov_57",96.114,772,19,4,96,859,1018,250,0,1249,763,768
"67431","Nsylvestris_NODE_22699_length_909_cov_62","Ntome_NODE_24426_length_897_cov_138",93.24,858,45,6,54,904,46,897,0,1251,850,851
"67432","Nsylvestris_NODE_22701_length_909_cov_35","Ntome_NODE_22011_length_1048_cov_57",79.487,273,35,6,472,741,685,431,1.43e-42,174,269,254
"67435","Nsylvestris_NODE_22703_length_909_cov_20","Ntome_NODE_5197_length_3031_cov_276",100,80,0,0,505,584,510,431,8.64e-35,148,79,79
"67454","Nsylvestris_NODE_22710_length_908_cov_112","Ntome_NODE_13467_length_1789_cov_232",96.552,58,1,1,852,908,495,438,1.14e-18,95.3,56,57
"67468","Nsylvestris_NODE_22717_length_907_cov_193","Ntome_NODE_820_length_5345_cov_146",76.903,381,74,10,397,764,3687,3308,1.81e-51,204,367,379
"67469","Nsylvestris_NODE_22718_length_907_cov_185","Ntome_NODE_19150_length_1263_cov_144",90.843,688,38,11,220,891,690,12,0,898,671,678
"67470","Nsylvestris_NODE_22720_length_907_cov_64","Ntome_NODE_5522_length_2956_cov_209",93.22,295,19,1,614,907,2242,1948,2.13e-120,433,293,294
"67471","Nsylvestris_NODE_22722_length_907_cov_59","Ntome_NODE_168_length_7639_cov_65",92.945,893,61,2,1,891,6514,7406,0,1299,890,892
"67472","Nsylvestris_NODE_22723_length_907_cov_46","Ntome_NODE_20723_length_1136_cov_213",85.859,594,36,14,1,581,1055,497,4.29e-167,588,580,558
"67487","Nsylvestris_NODE_22731_length_906_cov_225","Ntome_NODE_1687_length_4391_cov_260",99.274,826,6,0,81,906,107,932,0,1493,825,825
"67497","Nsylvestris_NODE_22735_length_906_cov_157","Ntome_NODE_21198_length_1102_cov_138",89.677,930,50,9,11,900,61,984,0,1144,889,923
"67516","Nsylvestris_NODE_22742_length_906_cov_24","Ntome_NODE_24398_length_899_cov_61",93.206,839,45,3,29,856,866,29,0,1223,827,837
"67517","Nsylvestris_NODE_22743_length_906_cov_23","Ntome_NODE_12468_length_1901_cov_76",97.351,906,24,0,1,906,245,1150,0,1541,905,905
"67524","Nsylvestris_NODE_22746_length_906_cov_18","Ntome_NODE_24990_length_864_cov_22",96.356,686,24,1,1,686,765,81,0,1127,685,684
"67529","Nsylvestris_NODE_22749_length_906_cov_8","Ntome_NODE_2837_length_3761_cov_155",100,55,0,0,1,55,1437,1383,6.8e-21,102,54,54
"67530","Nsylvestris_NODE_22750_length_906_cov_6","Ntome_NODE_7807_length_2524_cov_19",72.674,849,208,23,16,852,1438,2274,1.06e-68,261,836,836
"67535","Nsylvestris_NODE_22754_length_905_cov_206","Ntome_NODE_23019_length_982_cov_212",95.357,883,30,5,1,876,879,1,0,1393,875,878
"67542","Nsylvestris_NODE_22757_length_905_cov_186","Ntome_NODE_24915_length_868_cov_224",92.875,814,32,12,51,841,857,47,0,1158,790,810
"67548","Nsylvestris_NODE_22760_length_905_cov_113","Ntome_NODE_34763_length_384_cov_5",100,30,0,0,851,880,157,186,5.36e-07,56.5,29,29
"67549","Nsylvestris_NODE_22761_length_905_cov_89","Ntome_NODE_736_length_5486_cov_290",81.659,229,19,10,13,218,24,252,6.6e-41,169,205,228
"67550","Nsylvestris_NODE_22762_length_905_cov_65","Ntome_NODE_3647_length_3471_cov_279",100,55,0,0,851,905,619,565,6.79e-21,102,54,54
"67555","Nsylvestris_NODE_22764_length_905_cov_51","Ntome_NODE_20905_length_1123_cov_141",90.721,916,33,14,23,905,945,49,0,1173,882,896
"67556","Nsylvestris_NODE_22766_length_905_cov_29","Ntome_NODE_21896_length_1055_cov_192",95.205,146,7,0,1,146,525,380,8.31e-60,231,145,145
"67557","Nsylvestris_NODE_22768_length_905_cov_22","Ntome_NODE_2377_length_3972_cov_73",90.171,234,22,1,1,233,907,674,1.74e-81,303,232,233
"67565","Nsylvestris_NODE_22771_length_905_cov_10","Ntome_NODE_6037_length_2841_cov_105",96.364,55,2,0,851,905,293,239,1.47e-17,91.6,54,54
"67569","Nsylvestris_NODE_22774_length_904_cov_217","Ntome_NODE_12708_length_1872_cov_126",96.121,696,22,3,128,820,1034,1727,0,1131,692,693
"67586","Nsylvestris_NODE_22781_length_904_cov_56","Ntome_NODE_22769_length_998_cov_164",92.224,823,46,9,71,876,895,74,0,1149,805,821
"67589","Nsylvestris_NODE_22783_length_904_cov_45","Ntome_NODE_6537_length_2741_cov_50",91.268,836,54,8,86,904,2617,1784,0,1122,818,833
"67590","Nsylvestris_NODE_22784_length_904_cov_29","Ntome_NODE_24271_length_908_cov_76",98.24,909,10,6,1,904,1,908,0,1585,903,907
"67600","Nsylvestris_NODE_22788_length_904_cov_5","Ntome_NODE_30316_length_616_cov_6",92.762,525,35,2,218,742,522,1,0,756,524,521
"67601","Nsylvestris_NODE_22789_length_904_cov_5","Ntome_NODE_8777_length_2373_cov_218",100,55,0,0,1,55,738,792,6.79e-21,102,54,54
"67615","Nsylvestris_NODE_22797_length_903_cov_28","Ntome_NODE_5135_length_3047_cov_141",100,45,0,0,1,45,97,53,2.46e-15,84.2,44,44
"67626","Nsylvestris_NODE_22803_length_902_cov_193","Ntome_NODE_26088_length_802_cov_253",87.801,705,56,16,179,859,732,34,0,798,680,698
"67633","Nsylvestris_NODE_22806_length_902_cov_148","Ntome_NODE_29043_length_666_cov_27",86.866,670,51,16,201,842,1,661,0,715,641,660
"67636","Nsylvestris_NODE_22809_length_902_cov_124","Ntome_NODE_22950_length_986_cov_76",91.685,914,37,10,2,900,986,97,0,1230,898,889
"67646","Nsylvestris_NODE_22816_length_902_cov_5","Ntome_NODE_2147_length_4084_cov_137",94.377,907,34,4,1,902,2687,1793,0,1376,901,894
"67647","Nsylvestris_NODE_22817_length_901_cov_240","Ntome_NODE_763_length_5444_cov_89",94.651,916,22,11,1,901,512,1415,0,1395,900,903
"67655","Nsylvestris_NODE_22821_length_901_cov_116","Ntome_NODE_24983_length_864_cov_200",91.218,706,28,9,46,729,171,864,0,929,683,693
"67659","Nsylvestris_NODE_22823_length_901_cov_77","Ntome_NODE_10088_length_2188_cov_171",95,60,3,0,519,578,343,284,1.13e-18,95.3,59,59
"67660","Nsylvestris_NODE_22824_length_901_cov_64","Ntome_NODE_25591_length_828_cov_23",92.019,827,48,10,74,894,14,828,0,1146,820,814
"67661","Nsylvestris_NODE_22826_length_901_cov_28","Ntome_NODE_30399_length_612_cov_18",96.236,611,22,1,204,813,612,2,0,1000,609,610
"67667","Nsylvestris_NODE_22830_length_901_cov_6","Ntome_NODE_30338_length_615_cov_13",96.364,55,2,0,847,901,561,507,1.46e-17,91.6,54,54
"67670","Nsylvestris_NODE_22832_length_900_cov_207","Ntome_NODE_6709_length_2712_cov_188",98.795,664,8,0,54,717,1993,2656,0,1182,663,663
"67675","Nsylvestris_NODE_22834_length_900_cov_189","Ntome_NODE_26072_length_803_cov_238",95.856,748,20,3,57,795,7,752,0,1199,738,745
"67676","Nsylvestris_NODE_22835_length_900_cov_185","Ntome_NODE_22845_length_990_cov_249",96.411,836,20,5,39,868,880,49,0,1369,829,831
"67680","Nsylvestris_NODE_22837_length_900_cov_180","Ntome_NODE_17172_length_1433_cov_199",93.284,804,35,9,35,829,839,46,0,1168,794,793
"67681","Nsylvestris_NODE_22838_length_900_cov_167","Ntome_NODE_19681_length_1219_cov_292",96.707,577,12,3,1,570,572,1148,0,953,569,576
"67689","Nsylvestris_NODE_22843_length_900_cov_129","Ntome_NODE_25436_length_836_cov_208",94.56,772,26,5,143,899,52,822,0,1179,756,770
"67690","Nsylvestris_NODE_22844_length_900_cov_121","Ntome_NODE_27135_length_751_cov_55",94.641,765,24,8,126,889,3,751,0,1170,763,748
"67715","Nsylvestris_NODE_22853_length_900_cov_31","Ntome_NODE_36611_length_321_cov_3",93.827,81,4,1,816,896,29,108,1.87e-26,121,80,79
"67723","Nsylvestris_NODE_22859_length_899_cov_214","Ntome_NODE_10984_length_2075_cov_182",94.428,682,32,4,68,747,1220,1897,0,1044,679,677
"67745","Nsylvestris_NODE_22868_length_899_cov_29","Ntome_NODE_2884_length_3745_cov_160",98.182,55,1,0,1,55,2105,2159,3.14e-19,97.1,54,54
"67750","Nsylvestris_NODE_22870_length_899_cov_22","Ntome_NODE_4108_length_3319_cov_129",95.424,896,41,0,1,896,2135,3030,0,1428,895,895
"67751","Nsylvestris_NODE_22871_length_899_cov_9","Ntome_NODE_5707_length_2916_cov_34",89.481,732,73,2,113,844,1506,2233,0,922,731,727
"67771","Nsylvestris_NODE_22878_length_898_cov_184","Ntome_NODE_23430_length_958_cov_261",92.279,816,39,14,60,856,95,905,0,1136,796,810
"67787","Nsylvestris_NODE_22885_length_898_cov_41","Ntome_NODE_24174_length_914_cov_110",84.012,688,70,25,17,696,824,169,3.23e-178,625,679,655
"67788","Nsylvestris_NODE_22887_length_898_cov_22","Ntome_NODE_32901_length_484_cov_3",83.431,513,46,18,295,799,482,1,1.26e-122,440,504,481
"67802","Nsylvestris_NODE_22895_length_897_cov_194","Ntome_NODE_26923_length_762_cov_78",90.741,594,46,6,79,668,683,95,0,784,589,588
"67803","Nsylvestris_NODE_22897_length_897_cov_177","Ntome_NODE_17289_length_1421_cov_203",92.692,821,41,7,80,885,817,1,0,1166,805,816
"67806","Nsylvestris_NODE_22899_length_897_cov_115","Ntome_NODE_22482_length_1017_cov_244",84.799,921,85,20,23,897,971,60,0,874,874,911
"67813","Nsylvestris_NODE_22902_length_897_cov_31","Ntome_NODE_9714_length_2238_cov_257",100,55,0,0,1,55,216,162,6.73e-21,102,54,54
"67814","Nsylvestris_NODE_22903_length_897_cov_30","Ntome_NODE_7893_length_2509_cov_184",100,29,0,0,114,142,83,111,1.91e-06,54.7,28,28
"67815","Nsylvestris_NODE_22904_length_897_cov_24","Ntome_NODE_28935_length_670_cov_137",98.276,58,1,0,1,58,608,551,6.73e-21,102,57,57
"67816","Nsylvestris_NODE_22905_length_897_cov_21","Ntome_NODE_5946_length_2862_cov_141",87.839,921,86,12,1,897,1082,2000,0,1057,896,918
"67826","Nsylvestris_NODE_22909_length_897_cov_6","Ntome_NODE_1492_length_4538_cov_94",100,55,0,0,843,897,550,496,6.73e-21,102,54,54
"67829","Nsylvestris_NODE_22911_length_896_cov_203","Ntome_NODE_24782_length_875_cov_231",86.063,861,38,34,7,842,18,821,0,850,835,803
"67841","Nsylvestris_NODE_22916_length_896_cov_131","Ntome_NODE_758_length_5450_cov_43",97.991,896,18,0,1,896,2465,3360,0,1555,895,895
"67842","Nsylvestris_NODE_22917_length_896_cov_58","Ntome_NODE_22608_length_1009_cov_276",94.344,831,35,4,43,867,160,984,0,1264,824,824
"67846","Nsylvestris_NODE_22919_length_896_cov_19","Ntome_NODE_28886_length_672_cov_52",94.669,619,23,6,1,611,1,617,0,952,610,616
"67847","Nsylvestris_NODE_22920_length_896_cov_18","Ntome_NODE_21777_length_1063_cov_29",89.243,911,82,7,2,896,107,1017,0,1125,894,910
"67848","Nsylvestris_NODE_22924_length_896_cov_10","Ntome_NODE_4423_length_3230_cov_209",98.182,55,1,0,1,55,1203,1257,3.13e-19,97.1,54,54
"67861","Nsylvestris_NODE_22930_length_895_cov_143","Ntome_NODE_34566_length_392_cov_191",98.05,359,6,1,1,359,358,1,1.16e-177,623,358,357
"67895","Nsylvestris_NODE_22942_length_895_cov_14","Ntome_NODE_28080_length_706_cov_254",98.182,55,1,0,1,55,498,552,3.13e-19,97.1,54,54
"67898","Nsylvestris_NODE_22944_length_895_cov_12","Ntome_NODE_503_length_5999_cov_53",77.985,268,47,10,568,829,1766,2027,1.41e-37,158,261,261
"67911","Nsylvestris_NODE_22949_length_895_cov_6","Ntome_NODE_4372_length_3244_cov_288",98.182,55,1,0,1,55,495,549,3.13e-19,97.1,54,54
"67912","Nsylvestris_NODE_22950_length_894_cov_212","Ntome_NODE_23397_length_960_cov_249",94.813,829,33,7,1,827,93,913,0,1284,826,820
"67918","Nsylvestris_NODE_22953_length_893_cov_164","Ntome_NODE_12686_length_1876_cov_154",87.613,888,68,20,1,859,956,1830,0,992,858,874
"67923","Nsylvestris_NODE_22956_length_894_cov_119","Ntome_NODE_24880_length_870_cov_207",91.436,794,47,15,47,828,810,26,0,1070,781,784
"67938","Nsylvestris_NODE_22964_length_894_cov_4","Ntome_NODE_7604_length_2553_cov_160",83.908,174,23,5,1,172,2471,2301,1.09e-38,161,171,170
"67951","Nsylvestris_NODE_22969_length_893_cov_103","Ntome_NODE_390_length_6347_cov_174",88.235,357,35,3,489,844,1768,2118,1.63e-116,420,355,350
"67954","Nsylvestris_NODE_22971_length_893_cov_83","Ntome_NODE_31452_length_573_cov_3",85.321,109,11,3,127,235,544,441,1.44e-22,108,108,103
"67964","Nsylvestris_NODE_22976_length_893_cov_33","Ntome_NODE_1119_length_4929_cov_195",96.296,54,2,0,840,893,4010,3957,5.22e-17,89.8,53,53
"67968","Nsylvestris_NODE_22978_length_893_cov_20","Ntome_NODE_9836_length_2221_cov_109",100,50,0,0,1,50,1936,1985,4.03e-18,93.5,49,49
"67975","Nsylvestris_NODE_22982_length_893_cov_14","Ntome_NODE_13739_length_1763_cov_252",97.674,215,5,0,679,893,215,1,1.66e-101,370,214,214
"68009","Nsylvestris_NODE_22993_length_892_cov_11","Ntome_NODE_6007_length_2845_cov_268",90.335,776,49,10,124,881,558,1325,0,994,757,767
"68013","Nsylvestris_NODE_22995_length_892_cov_5","Ntome_NODE_12417_length_1907_cov_17",96.97,33,1,0,3,35,1172,1204,5.29e-07,56.5,32,32
"68014","Nsylvestris_NODE_22996_length_891_cov_202","Ntome_NODE_8322_length_2439_cov_111",92.051,780,41,15,75,848,1624,2388,0,1077,773,764
"68015","Nsylvestris_NODE_22997_length_891_cov_139","Ntome_NODE_24964_length_865_cov_247",93.886,736,44,1,59,794,47,781,0,1109,735,734
"68022","Nsylvestris_NODE_23000_length_891_cov_56","Ntome_NODE_317_length_6640_cov_140",92.553,376,26,1,8,381,6265,6640,4.3e-152,538,373,375
"68023","Nsylvestris_NODE_23001_length_891_cov_45","Ntome_NODE_23309_length_965_cov_10",86.957,138,2,9,701,838,555,434,1.42e-32,141,137,121
"68060","Nsylvestris_NODE_23013_length_890_cov_225","Ntome_NODE_354_length_6487_cov_214",77.917,480,97,4,164,643,5750,5280,1.33e-77,291,479,470
"68072","Nsylvestris_NODE_23017_length_890_cov_75","Ntome_NODE_24052_length_921_cov_241",91.946,894,53,14,4,890,887,6,0,1234,886,881
"68073","Nsylvestris_NODE_23018_length_890_cov_58","Ntome_NODE_28968_length_669_cov_51",94.558,588,24,4,264,846,620,36,0,902,582,584
"68078","Nsylvestris_NODE_23020_length_889_cov_48","Ntome_NODE_17549_length_1398_cov_110",86.722,851,44,24,55,877,891,82,0,881,822,809
"68083","Nsylvestris_NODE_23023_length_890_cov_22","Ntome_NODE_14670_length_1669_cov_53",90.016,621,40,8,1,604,1054,1669,0,784,603,615
"68092","Nsylvestris_NODE_23028_length_890_cov_10","Ntome_NODE_8655_length_2392_cov_90",98.261,115,2,0,472,586,54,168,6.4e-51,202,114,114
"68113","Nsylvestris_NODE_23039_length_889_cov_11","Ntome_NODE_1963_length_4200_cov_73",96.245,506,17,2,385,889,4200,3696,0,828,504,504
"68120","Nsylvestris_NODE_23044_length_888_cov_190","Ntome_NODE_23608_length_948_cov_49",96.757,370,7,4,164,532,609,244,2.49e-174,612,368,365
"68135","Nsylvestris_NODE_23051_length_888_cov_20","Ntome_NODE_10934_length_2082_cov_26",92.905,888,63,0,1,888,1595,708,0,1291,887,887
"68146","Nsylvestris_NODE_23056_length_888_cov_11","Ntome_NODE_24907_length_869_cov_6",72.683,615,148,12,4,605,608,1,1.79e-46,187,601,607
"68150","Nsylvestris_NODE_23058_length_887_cov_209","Ntome_NODE_3660_length_3466_cov_271",94.398,839,29,8,54,887,232,1057,0,1273,833,825
"68174","Nsylvestris_NODE_23068_length_887_cov_14","Ntome_NODE_38327_length_282_cov_3",91.429,280,24,0,434,713,3,282,5.9e-106,385,279,279
"68175","Nsylvestris_NODE_23070_length_887_cov_7","Ntome_NODE_1687_length_4391_cov_260",100,55,0,0,833,887,877,823,6.65e-21,102,54,54
"68198","Nsylvestris_NODE_23078_length_886_cov_60","Ntome_NODE_27568_length_729_cov_100",91.107,506,32,6,76,575,27,525,0,673,499,498
"68210","Nsylvestris_NODE_23086_length_886_cov_13","Ntome_NODE_24165_length_915_cov_9",97.579,826,20,0,1,826,826,1,0,1415,825,825
"68226","Nsylvestris_NODE_23094_length_885_cov_79","Ntome_NODE_38109_length_286_cov_4",91.743,109,9,0,1,109,178,286,6.5e-36,152,108,108
"68227","Nsylvestris_NODE_23095_length_885_cov_77","Ntome_NODE_3595_length_3485_cov_38",90.566,106,9,1,447,551,3243,3348,5.06e-32,139,104,105
"68228","Nsylvestris_NODE_23096_length_885_cov_62","Ntome_NODE_456_length_6137_cov_19",87.245,196,25,0,685,880,1442,1247,1.36e-57,224,195,195
"68238","Nsylvestris_NODE_23100_length_885_cov_18","Ntome_NODE_7705_length_2539_cov_169",96.364,55,2,0,1,55,1399,1453,1.44e-17,91.6,54,54
"68252","Nsylvestris_NODE_23106_length_885_cov_9","Ntome_NODE_38776_length_272_cov_3",95.413,109,5,0,463,571,2,110,1.39e-42,174,108,108
"68263","Nsylvestris_NODE_23112_length_884_cov_199","Ntome_NODE_4690_length_3161_cov_225",98.182,55,1,0,1,55,2726,2672,3.09e-19,97.1,54,54
"68268","Nsylvestris_NODE_23115_length_884_cov_48","Ntome_NODE_21894_length_1055_cov_212",90.537,708,45,12,66,755,1003,300,0,917,689,703
"68269","Nsylvestris_NODE_23116_length_883_cov_47","Ntome_NODE_25239_length_848_cov_98",89.61,154,15,1,174,327,15,167,1.06e-48,195,153,152
"68281","Nsylvestris_NODE_23121_length_884_cov_5","Ntome_NODE_26233_length_796_cov_3",93.509,647,37,4,237,882,1,643,0,957,645,642
"68300","Nsylvestris_NODE_23127_length_883_cov_151","Ntome_NODE_14359_length_1699_cov_170",93.723,701,20,12,42,719,195,894,0,1029,677,699
"68305","Nsylvestris_NODE_23131_length_883_cov_56","Ntome_NODE_26462_length_784_cov_36",93.182,440,25,5,328,762,204,643,0,641,434,439
"68310","Nsylvestris_NODE_23134_length_883_cov_17","Ntome_NODE_26313_length_792_cov_13",87.294,787,63,21,103,883,792,37,0,865,780,755
"68318","Nsylvestris_NODE_23137_length_883_cov_10","Ntome_NODE_8549_length_2406_cov_125",91.473,903,57,4,1,883,299,1201,0,1223,882,902
"68334","Nsylvestris_NODE_23145_length_882_cov_174","Ntome_NODE_20141_length_1181_cov_252",91.627,836,30,14,1,807,18,842,0,1120,806,824
"68335","Nsylvestris_NODE_23146_length_882_cov_149","Ntome_NODE_25635_length_825_cov_137",93.282,774,28,11,32,798,4,760,0,1120,766,756
"68345","Nsylvestris_NODE_23152_length_882_cov_35","Ntome_NODE_23431_length_958_cov_240",100,55,0,0,828,882,734,680,6.62e-21,102,54,54
"68351","Nsylvestris_NODE_23155_length_882_cov_22","Ntome_NODE_30169_length_621_cov_50",87.363,182,10,5,617,787,442,621,2.95e-49,196,170,179
"68352","Nsylvestris_NODE_23156_length_882_cov_9","Ntome_NODE_21144_length_1106_cov_33",87.412,850,68,14,1,823,1,838,0,941,822,837
"68353","Nsylvestris_NODE_23157_length_882_cov_7","Ntome_NODE_13496_length_1786_cov_275",96.97,33,1,0,850,882,449,481,5.22e-07,56.5,32,32
"68357","Nsylvestris_NODE_23159_length_881_cov_210","Ntome_NODE_19458_length_1237_cov_263",96.595,881,30,0,1,881,1,881,0,1461,880,880
"68358","Nsylvestris_NODE_23160_length_881_cov_170","Ntome_NODE_25276_length_845_cov_140",90.675,815,36,10,93,880,802,1,0,1048,787,801
"68371","Nsylvestris_NODE_23166_length_881_cov_8","Ntome_NODE_4173_length_3303_cov_163",88,900,38,32,1,881,135,983,0,1000,880,848
"68382","Nsylvestris_NODE_23171_length_880_cov_109","Ntome_NODE_29895_length_632_cov_22",90.769,650,34,4,190,839,1,624,0,845,649,623
"68383","Nsylvestris_NODE_23172_length_880_cov_74","Ntome_NODE_1448_length_4580_cov_122",92.727,55,4,0,1,55,4245,4191,3.09e-14,80.5,54,54
"68391","Nsylvestris_NODE_23176_length_880_cov_46","Ntome_NODE_24832_length_873_cov_8",93.443,854,42,5,41,880,1,854,0,1254,839,853
"68403","Nsylvestris_NODE_23183_length_880_cov_8","Ntome_NODE_18201_length_1342_cov_168",94.815,135,7,0,531,665,311,445,1.05e-53,211,134,134
"68404","Nsylvestris_NODE_23184_length_880_cov_8","Ntome_NODE_10270_length_2160_cov_167",78.008,773,157,5,48,808,1051,280,1.21e-132,473,760,771
"68411","Nsylvestris_NODE_23186_length_879_cov_220","Ntome_NODE_30643_length_602_cov_46",81.447,318,44,8,280,588,270,581,2.88e-64,246,308,311
"68418","Nsylvestris_NODE_23189_length_879_cov_185","Ntome_NODE_4536_length_3200_cov_203",96.364,55,2,0,825,879,250,196,1.43e-17,91.6,54,54
"68425","Nsylvestris_NODE_23192_length_879_cov_133","Ntome_NODE_26786_length_768_cov_169",92.056,642,17,5,198,821,1,626,0,872,623,625
"68452","Nsylvestris_NODE_23203_length_878_cov_42","Ntome_NODE_34951_length_376_cov_9",92.308,351,24,3,73,421,376,27,2.59e-139,496,348,349
"68459","Nsylvestris_NODE_23206_length_878_cov_27","Ntome_NODE_18990_length_1277_cov_32",91.383,824,49,9,72,878,459,1277,0,1109,806,818
"68460","Nsylvestris_NODE_23208_length_878_cov_20","Ntome_NODE_23779_length_937_cov_134",92.781,748,39,4,7,751,142,877,0,1068,744,735
"68477","Nsylvestris_NODE_23215_length_877_cov_221","Ntome_NODE_24198_length_913_cov_17",96.8,625,20,0,13,637,913,289,0,1044,624,624
"68478","Nsylvestris_NODE_23216_length_877_cov_218","Ntome_NODE_10678_length_2109_cov_250",95.542,830,33,2,1,830,1101,1926,0,1325,829,825
"68493","Nsylvestris_NODE_23221_length_877_cov_100","Ntome_NODE_29666_length_641_cov_205",88.324,531,18,10,1,512,588,83,6.88e-170,597,511,505
"68501","Nsylvestris_NODE_23226_length_877_cov_41","Ntome_NODE_20808_length_1131_cov_159",92.639,557,41,0,46,602,271,827,0,802,556,556
"68505","Nsylvestris_NODE_23228_length_877_cov_26","Ntome_NODE_16257_length_1516_cov_98",92.281,881,44,6,1,877,233,1093,0,1229,876,860
"68516","Nsylvestris_NODE_23234_length_877_cov_9","Ntome_NODE_33059_length_473_cov_10",87.805,451,52,1,213,663,1,448,3.29e-148,525,450,447
"68534","Nsylvestris_NODE_23242_length_876_cov_46","Ntome_NODE_3263_length_3601_cov_173",92.067,416,20,7,101,513,664,1069,1.16e-162,573,412,405
"68535","Nsylvestris_NODE_23243_length_876_cov_44","Ntome_NODE_30273_length_617_cov_121",93.778,225,14,0,27,251,564,340,4.6e-92,339,224,224
"68536","Nsylvestris_NODE_23244_length_877_cov_39","Ntome_NODE_26212_length_796_cov_264",92.105,152,8,3,1,152,75,222,1.05e-53,211,151,147
"68539","Nsylvestris_NODE_23247_length_876_cov_23","Ntome_NODE_9560_length_2257_cov_132",83.916,143,17,4,130,269,552,691,8.38e-30,132,139,139
"68555","Nsylvestris_NODE_23255_length_875_cov_206","Ntome_NODE_24280_length_907_cov_267",94.493,799,28,10,35,833,862,80,0,1218,798,782
"68567","Nsylvestris_NODE_23260_length_875_cov_155","Ntome_NODE_16807_length_1465_cov_185",96.192,604,19,4,181,782,623,22,0,985,601,601
"68568","Nsylvestris_NODE_23261_length_875_cov_155","Ntome_NODE_3316_length_3579_cov_149",90.972,432,25,4,1,423,3145,3571,1.5e-161,569,422,426
"68595","Nsylvestris_NODE_23272_length_875_cov_6","Ntome_NODE_14392_length_1696_cov_292",91.379,58,5,0,818,875,341,284,3.07e-14,80.5,57,57
"68596","Nsylvestris_NODE_23273_length_874_cov_219","Ntome_NODE_20834_length_1129_cov_268",83.902,615,71,18,18,613,1117,512,2.5e-159,562,595,605
"68625","Nsylvestris_NODE_23286_length_873_cov_77","Ntome_NODE_2399_length_3960_cov_123",93.609,266,12,4,1,262,3156,3420,3.47e-108,392,261,264
"68629","Nsylvestris_NODE_23290_length_873_cov_24","Ntome_NODE_9080_length_2327_cov_19",85.496,131,17,2,225,355,592,464,6.45e-31,135,130,128
"68646","Nsylvestris_NODE_23298_length_872_cov_172","Ntome_NODE_22750_length_1000_cov_174",96.256,828,24,4,48,872,157,980,0,1351,824,823
"68652","Nsylvestris_NODE_23301_length_872_cov_144","Ntome_NODE_10525_length_2129_cov_93",94.961,774,35,4,2,775,842,73,0,1210,773,769
"68657","Nsylvestris_NODE_23306_length_872_cov_81","Ntome_NODE_4632_length_3176_cov_97",84.697,379,21,16,1,343,984,1361,9.84e-94,344,342,377
"68683","Nsylvestris_NODE_23317_length_872_cov_9","Ntome_NODE_15372_length_1596_cov_210",94.47,868,47,1,6,872,1,868,0,1336,866,867
"68684","Nsylvestris_NODE_23318_length_872_cov_8","Ntome_NODE_3316_length_3579_cov_149",94.694,867,37,4,1,866,2540,1682,0,1338,865,858
"68698","Nsylvestris_NODE_23325_length_871_cov_174","Ntome_NODE_9066_length_2328_cov_233",97.561,656,16,0,201,856,671,16,0,1123,655,655
"68704","Nsylvestris_NODE_23330_length_871_cov_27","Ntome_NODE_3066_length_3671_cov_245",84.34,894,100,27,1,871,1388,512,0,839,870,876
"68705","Nsylvestris_NODE_23332_length_872_cov_16","Ntome_NODE_12713_length_1871_cov_191",93.593,874,53,3,1,872,806,1678,0,1301,871,872
"68706","Nsylvestris_NODE_23334_length_871_cov_5","Ntome_NODE_5766_length_2904_cov_249",98.077,52,1,0,820,871,249,198,1.41e-17,91.6,51,51
"68726","Nsylvestris_NODE_23344_length_870_cov_12","Ntome_NODE_8564_length_2404_cov_90",86.788,386,33,7,493,870,2029,2404,7.38e-115,414,377,375
"68729","Nsylvestris_NODE_23346_length_868_cov_208","Ntome_NODE_24914_length_868_cov_235",95.735,680,27,2,122,799,1,680,0,1094,677,679
"68747","Nsylvestris_NODE_23353_length_869_cov_84","Ntome_NODE_7778_length_2528_cov_60",96.226,53,1,1,815,866,2310,2362,6.56e-16,86.1,51,52
"68748","Nsylvestris_NODE_23354_length_869_cov_81","Ntome_NODE_13184_length_1821_cov_172",96.61,59,1,1,812,869,532,590,3.03e-19,97.1,57,58
"68754","Nsylvestris_NODE_23357_length_869_cov_19","Ntome_NODE_17112_length_1438_cov_106",80.944,551,90,7,264,808,979,438,4.4e-117,422,544,541
"68759","Nsylvestris_NODE_23360_length_869_cov_6","Ntome_NODE_8906_length_2352_cov_276",100,55,0,0,1,55,1204,1258,6.52e-21,102,54,54
"68760","Nsylvestris_NODE_23361_length_869_cov_5","Ntome_NODE_32034_length_548_cov_5",96.907,291,9,0,1,291,258,548,4.28e-137,488,290,290
"68765","Nsylvestris_NODE_23363_length_868_cov_188","Ntome_NODE_13973_length_1740_cov_221",92.218,861,45,12,15,868,89,934,0,1199,853,845
"68766","Nsylvestris_NODE_23364_length_868_cov_154","Ntome_NODE_27317_length_742_cov_103",91.726,701,34,8,88,775,738,49,0,952,687,689
"68767","Nsylvestris_NODE_23365_length_868_cov_148","Ntome_NODE_26322_length_791_cov_30",90.254,749,41,9,111,827,2,750,0,950,716,748
"68768","Nsylvestris_NODE_23366_length_868_cov_131","Ntome_NODE_12116_length_1943_cov_79",95.752,612,22,2,136,747,13,620,0,983,611,607
"68775","Nsylvestris_NODE_23369_length_868_cov_77","Ntome_NODE_90_length_8702_cov_259",95.376,865,35,1,2,861,6811,7675,0,1371,859,864
"68778","Nsylvestris_NODE_23371_length_868_cov_17","Ntome_NODE_17466_length_1406_cov_197",83.284,341,40,11,337,661,824,485,7.73e-80,298,324,339
"68785","Nsylvestris_NODE_23374_length_868_cov_11","Ntome_NODE_4239_length_3280_cov_239",92.099,886,43,15,1,868,2093,1217,0,1223,867,876
"68786","Nsylvestris_NODE_23375_length_868_cov_8","Ntome_NODE_26159_length_799_cov_28",88.679,530,46,10,307,825,527,1,0,634,518,526
"68805","Nsylvestris_NODE_23381_length_867_cov_188","Ntome_NODE_21446_length_1085_cov_221",90.931,849,37,11,48,867,979,142,0,1105,819,837
"68812","Nsylvestris_NODE_23384_length_867_cov_103","Ntome_NODE_24390_length_900_cov_8",97.846,557,12,0,311,867,899,343,0,963,556,556
"68813","Nsylvestris_NODE_23385_length_867_cov_53","Ntome_NODE_4953_length_3096_cov_172",85.714,56,5,3,812,867,245,193,5.13e-07,56.5,55,52
"68814","Nsylvestris_NODE_23386_length_867_cov_29","Ntome_NODE_16461_length_1500_cov_76",94.499,818,39,3,5,819,230,1044,0,1256,814,814
"68818","Nsylvestris_NODE_23388_length_867_cov_25","Ntome_NODE_8157_length_2467_cov_19",91.667,96,8,0,767,862,233,328,2.31e-30,134,95,95
"68819","Nsylvestris_NODE_23389_length_867_cov_21","Ntome_NODE_21706_length_1067_cov_226",88.623,879,42,14,8,864,70,912,0,1016,856,842
"68840","Nsylvestris_NODE_23398_length_866_cov_188","Ntome_NODE_15217_length_1612_cov_193",95.958,866,26,2,1,866,657,1513,0,1397,865,856
"68841","Nsylvestris_NODE_23399_length_866_cov_188","Ntome_NODE_14968_length_1639_cov_112",95.449,769,26,4,101,866,494,1256,0,1218,765,762
"68850","Nsylvestris_NODE_23404_length_866_cov_66","Ntome_NODE_21927_length_1053_cov_119",91.638,873,58,6,1,861,929,60,0,1194,860,869
"68851","Nsylvestris_NODE_23405_length_866_cov_51","Ntome_NODE_20313_length_1168_cov_137",87.5,688,82,3,136,821,964,279,0,791,685,685
"68859","Nsylvestris_NODE_23408_length_866_cov_38","Ntome_NODE_10229_length_2166_cov_64",83.52,892,94,23,1,853,1808,931,0,784,852,877
"68860","Nsylvestris_NODE_23409_length_866_cov_18","Ntome_NODE_5803_length_2894_cov_68",99.571,699,3,0,1,699,8,706,0,1275,698,698
"68861","Nsylvestris_NODE_23412_length_866_cov_5","Ntome_NODE_22661_length_1006_cov_16",95.04,867,23,7,1,866,128,975,0,1345,865,847
"68862","Nsylvestris_NODE_23413_length_865_cov_210","Ntome_NODE_2844_length_3758_cov_290",94.226,814,28,5,46,859,2948,3742,0,1225,813,794
"68863","Nsylvestris_NODE_23415_length_865_cov_198","Ntome_NODE_26878_length_764_cov_193",90.401,698,28,17,126,817,723,59,0,881,691,664
"68871","Nsylvestris_NODE_23419_length_865_cov_114","Ntome_NODE_834_length_5337_cov_207",94.954,872,21,10,1,865,2165,1310,0,1345,864,855
"68883","Nsylvestris_NODE_23424_length_865_cov_19","Ntome_NODE_5799_length_2894_cov_298",98.113,53,1,0,1,53,2483,2535,3.9e-18,93.5,52,52
"68890","Nsylvestris_NODE_23428_length_864_cov_174","Ntome_NODE_19371_length_1245_cov_237",86.486,185,12,5,181,362,128,302,1.34e-47,191,181,174
"68895","Nsylvestris_NODE_23431_length_864_cov_124","Ntome_NODE_19215_length_1258_cov_319",86.598,97,8,4,3,98,905,813,6.48e-21,102,95,92
"68901","Nsylvestris_NODE_23434_length_864_cov_51","Ntome_NODE_23262_length_967_cov_120",89.386,782,42,10,20,791,1,751,0,946,771,750
"68902","Nsylvestris_NODE_23435_length_864_cov_30","Ntome_NODE_4098_length_3321_cov_273",98.319,119,2,0,746,864,1674,1792,3.71e-53,209,118,118
"68915","Nsylvestris_NODE_23443_length_864_cov_4","Ntome_NODE_12933_length_1848_cov_222",100,33,0,0,495,527,1756,1788,1.1e-08,62.1,32,32
"68944","Nsylvestris_NODE_23453_length_863_cov_26","Ntome_NODE_32794_length_492_cov_27",83.516,182,28,2,396,576,289,469,6.29e-41,169,180,180
"68950","Nsylvestris_NODE_23457_length_863_cov_11","Ntome_NODE_2262_length_4027_cov_241",93.179,865,41,9,1,863,911,1759,0,1254,862,848
"68954","Nsylvestris_NODE_23460_length_863_cov_5","Ntome_NODE_1039_length_5030_cov_156",100,55,0,0,1,55,4233,4179,6.47e-21,102,54,54
"68958","Nsylvestris_NODE_23462_length_862_cov_186","Ntome_NODE_1803_length_4306_cov_135",95.752,306,12,1,122,426,3496,3191,3.28e-138,492,304,305
"68964","Nsylvestris_NODE_23465_length_862_cov_85","Ntome_NODE_13427_length_1793_cov_131",94.98,757,31,3,84,840,9,758,0,1181,756,749
"68973","Nsylvestris_NODE_23470_length_862_cov_14","Ntome_NODE_19085_length_1268_cov_213",89,100,7,4,69,168,1035,940,1.78e-26,121,99,95
"68974","Nsylvestris_NODE_23471_length_862_cov_8","Ntome_NODE_30958_length_590_cov_168",83.601,311,47,4,501,809,532,224,4.62e-77,289,308,308
"68975","Nsylvestris_NODE_23472_length_862_cov_6","Ntome_NODE_1820_length_4294_cov_267",100,55,0,0,1,55,3326,3272,6.46e-21,102,54,54
"68987","Nsylvestris_NODE_23476_length_861_cov_172","Ntome_NODE_25530_length_831_cov_175",85.407,836,44,26,1,801,818,26,0,797,800,792
"68990","Nsylvestris_NODE_23478_length_861_cov_78","Ntome_NODE_13263_length_1813_cov_15",97.647,85,2,0,1,85,81,165,2.94e-34,147,84,84
"68991","Nsylvestris_NODE_23479_length_861_cov_48","Ntome_NODE_21295_length_1095_cov_45",91.847,785,50,8,3,786,939,168,0,1083,783,771
"69022","Nsylvestris_NODE_23493_length_860_cov_54","Ntome_NODE_21173_length_1104_cov_33",95.167,807,25,5,12,812,9,807,0,1262,800,798
"69028","Nsylvestris_NODE_23497_length_860_cov_10","Ntome_NODE_18689_length_1302_cov_20",96.035,807,32,0,1,807,809,3,0,1314,806,806
"69037","Nsylvestris_NODE_23502_length_859_cov_186","Ntome_NODE_6050_length_2839_cov_130",94.425,861,38,5,1,856,856,1,0,1315,855,855
"69040","Nsylvestris_NODE_23504_length_859_cov_119","Ntome_NODE_18083_length_1351_cov_21",93.765,834,37,8,14,837,983,155,0,1238,823,828
"69044","Nsylvestris_NODE_23506_length_859_cov_70","Ntome_NODE_29127_length_663_cov_17",91.259,675,44,9,49,720,1,663,0,905,671,662
"69049","Nsylvestris_NODE_23511_length_859_cov_9","Ntome_NODE_13683_length_1768_cov_139",92.638,163,11,1,697,859,1015,1176,2.19e-60,233,162,161
"69066","Nsylvestris_NODE_23518_length_857_cov_86","Ntome_NODE_16720_length_1474_cov_281",97.222,36,1,0,822,857,532,497,1.09e-08,62.1,35,35
"69098","Nsylvestris_NODE_23532_length_858_cov_5","Ntome_NODE_38457_length_279_cov_3",90.253,277,24,2,505,779,1,276,3.46e-98,359,274,275
"69105","Nsylvestris_NODE_23536_length_857_cov_208","Ntome_NODE_26210_length_796_cov_276",94.645,691,34,3,114,802,53,742,0,1068,688,689
"69111","Nsylvestris_NODE_23539_length_857_cov_158","Ntome_NODE_16715_length_1475_cov_149",92.516,628,32,2,90,702,77,704,0,885,612,627
"69114","Nsylvestris_NODE_23541_length_857_cov_43","Ntome_NODE_17588_length_1394_cov_205",87.04,571,64,8,198,763,1254,689,0,636,565,565
"69115","Nsylvestris_NODE_23542_length_856_cov_43","Ntome_NODE_12951_length_1846_cov_104",87.05,139,14,4,261,398,1345,1480,1.75e-36,154,137,135
"69116","Nsylvestris_NODE_23543_length_857_cov_37","Ntome_NODE_24627_length_884_cov_202",92.697,671,32,9,166,831,48,706,0,952,665,658
"69120","Nsylvestris_NODE_23545_length_857_cov_12","Ntome_NODE_8489_length_2414_cov_159",93.116,857,31,13,1,857,1304,2132,0,1230,856,828
"69128","Nsylvestris_NODE_23549_length_842_cov_195","Ntome_NODE_20741_length_1135_cov_175",94.768,669,24,5,55,713,867,200,0,1031,658,667
"69152","Nsylvestris_NODE_23557_length_856_cov_39","Ntome_NODE_22591_length_1010_cov_206",87.769,883,53,24,9,856,51,913,0,981,847,862
"69156","Nsylvestris_NODE_23560_length_856_cov_13","Ntome_NODE_28857_length_674_cov_8",85.985,685,66,14,7,677,674,6,0,706,670,668
"69157","Nsylvestris_NODE_23561_length_856_cov_12","Ntome_NODE_21296_length_1095_cov_33",89.356,808,56,9,49,856,956,179,0,989,807,777
"69158","Nsylvestris_NODE_23563_length_856_cov_9","Ntome_NODE_609_length_5750_cov_80",100,55,0,0,802,856,5172,5118,6.42e-21,102,54,54
"69162","Nsylvestris_NODE_23565_length_856_cov_6","Ntome_NODE_9463_length_2273_cov_269",98.182,55,1,0,802,856,994,1048,2.98e-19,97.1,54,54
"69178","Nsylvestris_NODE_23574_length_855_cov_43","Ntome_NODE_5450_length_2972_cov_250",91.654,671,29,11,86,739,2972,2312,0,904,653,660
"69199","Nsylvestris_NODE_23584_length_855_cov_11","Ntome_NODE_17001_length_1448_cov_266",98.182,55,1,0,1,55,286,340,2.98e-19,97.1,54,54
"69212","Nsylvestris_NODE_23593_length_854_cov_147","Ntome_NODE_518_length_5974_cov_235",100,55,0,0,1,55,4023,4077,6.4e-21,102,54,54
"69227","Nsylvestris_NODE_23600_length_854_cov_40","Ntome_NODE_3212_length_3617_cov_247",91.695,879,41,13,1,854,1578,2449,0,1190,853,871
"69242","Nsylvestris_NODE_23608_length_854_cov_8","Ntome_NODE_21401_length_1088_cov_267",100,55,0,0,1,55,544,598,6.4e-21,102,54,54
"69243","Nsylvestris_NODE_23609_length_853_cov_246","Ntome_NODE_385_length_6379_cov_149",98.359,853,14,0,1,853,1882,2734,0,1498,852,852
"69249","Nsylvestris_NODE_23612_length_853_cov_201","Ntome_NODE_4220_length_3286_cov_301",94.476,525,20,3,328,849,2742,3260,0,800,521,518
"69250","Nsylvestris_NODE_23613_length_853_cov_193","Ntome_NODE_656_length_5642_cov_276",92.868,645,31,10,106,741,686,48,0,922,635,638
"69257","Nsylvestris_NODE_23616_length_853_cov_159","Ntome_NODE_26647_length_775_cov_227",94.35,761,22,10,28,783,31,775,0,1147,755,744
"69273","Nsylvestris_NODE_23624_length_853_cov_9","Ntome_NODE_12089_length_1946_cov_247",96.154,52,2,0,802,853,1569,1518,6.44e-16,86.1,51,51
"69274","Nsylvestris_NODE_23626_length_853_cov_8","Ntome_NODE_27034_length_757_cov_9",83.471,363,43,13,297,645,360,1,4.51e-87,322,348,359
"69278","Nsylvestris_NODE_23628_length_853_cov_5","Ntome_NODE_11374_length_2028_cov_132",100,55,0,0,1,55,1589,1643,6.39e-21,102,54,54
"69279","Nsylvestris_NODE_23629_length_853_cov_3","Ntome_NODE_2711_length_3809_cov_121",93.51,832,45,4,24,853,3516,2692,0,1229,829,824
"69292","Nsylvestris_NODE_23634_length_852_cov_166","Ntome_NODE_14608_length_1675_cov_275",95.238,63,3,0,1,63,677,739,2.3e-20,100,62,62
"69302","Nsylvestris_NODE_23641_length_852_cov_72","Ntome_NODE_22819_length_995_cov_157",95.921,858,26,7,3,852,131,987,0,1382,849,856
"69315","Nsylvestris_NODE_23648_length_852_cov_7","Ntome_NODE_13876_length_1748_cov_177",86.575,365,38,5,495,852,510,870,3.38e-108,392,357,360
"69316","Nsylvestris_NODE_23649_length_852_cov_5","Ntome_NODE_622_length_5719_cov_37",87.22,626,74,3,10,635,5220,4601,0,708,625,619
"69323","Nsylvestris_NODE_23653_length_851_cov_166","Ntome_NODE_27239_length_746_cov_234",92.197,628,38,7,3,621,700,75,0,878,618,625
"69332","Nsylvestris_NODE_23657_length_851_cov_24","Ntome_NODE_17273_length_1422_cov_273",97.297,37,0,1,816,851,590,554,1.08e-08,62.1,35,36
"69333","Nsylvestris_NODE_23658_length_851_cov_19","Ntome_NODE_10726_length_2104_cov_280",92.409,303,23,0,549,851,1242,1544,1.99e-120,433,302,302
"69334","Nsylvestris_NODE_23660_length_851_cov_18","Ntome_NODE_21040_length_1113_cov_26",87.3,874,61,26,1,851,147,993,0,953,850,846
"69340","Nsylvestris_NODE_23666_length_851_cov_6","Ntome_NODE_1112_length_4935_cov_285",100,55,0,0,797,851,1923,1869,6.38e-21,102,54,54
"69350","Nsylvestris_NODE_23670_length_850_cov_160","Ntome_NODE_4728_length_3152_cov_296",100,29,0,0,1,29,2203,2231,1.81e-06,54.7,28,28
"69351","Nsylvestris_NODE_23671_length_850_cov_76","Ntome_NODE_24186_length_913_cov_167",81.838,457,74,6,159,613,827,378,3.4e-103,375,454,449
"69354","Nsylvestris_NODE_23673_length_850_cov_58","Ntome_NODE_37114_length_308_cov_6",93.399,303,17,1,328,627,305,3,2.55e-124,446,299,302
"69357","Nsylvestris_NODE_23675_length_850_cov_39","Ntome_NODE_31231_length_580_cov_29",93.497,569,25,6,17,578,1,564,0,835,561,563
"69366","Nsylvestris_NODE_23680_length_850_cov_6","Ntome_NODE_17221_length_1428_cov_97",83.242,364,48,7,337,699,1386,1035,4.49e-87,322,362,351
"69373","Nsylvestris_NODE_23684_length_849_cov_193","Ntome_NODE_10255_length_2162_cov_148",97.582,579,7,2,1,572,1203,625,0,985,571,578
"69374","Nsylvestris_NODE_23685_length_849_cov_190","Ntome_NODE_26692_length_773_cov_100",97.426,544,14,0,306,849,51,594,0,928,543,543
"69382","Nsylvestris_NODE_23690_length_849_cov_35","Ntome_NODE_22708_length_999_cov_68",89.213,788,45,20,1,760,34,809,0,948,759,775
"69383","Nsylvestris_NODE_23692_length_849_cov_29","Ntome_NODE_14864_length_1648_cov_17",90.92,815,44,10,1,799,51,851,0,1068,798,800
"69386","Nsylvestris_NODE_23695_length_849_cov_19","Ntome_NODE_9788_length_2227_cov_16",92.099,405,31,1,322,726,1889,1486,1.45e-161,569,404,403
"69389","Nsylvestris_NODE_23700_length_849_cov_9","Ntome_NODE_18554_length_1311_cov_189",93.27,847,51,6,4,849,980,139,0,1243,845,841
"69390","Nsylvestris_NODE_23702_length_849_cov_5","Ntome_NODE_9657_length_2245_cov_37",97.281,846,23,0,4,849,1642,797,0,1435,845,845
"69417","Nsylvestris_NODE_23713_length_848_cov_8","Ntome_NODE_23657_length_946_cov_10",95.226,398,11,3,109,500,412,17,1.1e-177,623,391,395
"69427","Nsylvestris_NODE_23718_length_847_cov_185","Ntome_NODE_24919_length_868_cov_51",92.521,829,54,5,1,829,832,12,0,1181,828,820
"69428","Nsylvestris_NODE_23719_length_847_cov_175","Ntome_NODE_22032_length_1046_cov_249",87.224,634,65,10,227,847,648,18,0,708,620,630
"69429","Nsylvestris_NODE_23720_length_847_cov_162","Ntome_NODE_975_length_5123_cov_110",86.846,707,64,14,152,847,842,1530,0,763,695,688
"69430","Nsylvestris_NODE_23722_length_847_cov_49","Ntome_NODE_23194_length_972_cov_63",93.814,679,33,4,29,700,140,816,0,1013,671,676
"69444","Nsylvestris_NODE_23729_length_847_cov_8","Ntome_NODE_601_length_5770_cov_253",100,49,0,0,799,847,5035,5083,1.37e-17,91.6,48,48
"69461","Nsylvestris_NODE_23736_length_846_cov_178","Ntome_NODE_24967_length_865_cov_170",93.162,819,40,12,32,846,15,821,0,1188,814,806
"69462","Nsylvestris_NODE_23737_length_846_cov_172","Ntome_NODE_27446_length_735_cov_185",98.182,55,1,0,211,265,643,589,2.95e-19,97.1,54,54
"69463","Nsylvestris_NODE_23738_length_846_cov_126","Ntome_NODE_31646_length_566_cov_7",96.481,540,19,0,263,802,562,23,0,893,539,539
"69466","Nsylvestris_NODE_23740_length_846_cov_96","Ntome_NODE_3194_length_3623_cov_188",93.294,850,50,5,1,846,1565,2411,0,1247,845,846
"69485","Nsylvestris_NODE_23749_length_846_cov_7","Ntome_NODE_4509_length_3207_cov_179",94.242,851,33,7,1,839,1037,191,0,1286,838,846
"69498","Nsylvestris_NODE_23754_length_845_cov_58","Ntome_NODE_25874_length_811_cov_120",93.944,677,39,1,102,778,137,811,0,1022,676,674
"69502","Nsylvestris_NODE_23758_length_845_cov_39","Ntome_NODE_26601_length_777_cov_99",92.037,653,34,11,17,663,686,46,0,902,646,640
"69509","Nsylvestris_NODE_23761_length_845_cov_8","Ntome_NODE_4072_length_3328_cov_199",91.549,71,6,0,1,71,493,423,8.2e-20,99,70,70
"69514","Nsylvestris_NODE_23764_length_844_cov_196","Ntome_NODE_11771_length_1984_cov_300",100,55,0,0,790,844,1032,978,6.33e-21,102,54,54
"69526","Nsylvestris_NODE_23769_length_844_cov_155","Ntome_NODE_38337_length_281_cov_77",90.674,193,12,4,219,405,193,1,5.94e-66,252,186,192
"69527","Nsylvestris_NODE_23770_length_844_cov_134","Ntome_NODE_25405_length_838_cov_184",87.376,808,29,18,66,838,50,819,0,859,772,769
"69541","Nsylvestris_NODE_23778_length_844_cov_19","Ntome_NODE_21165_length_1104_cov_144",96.135,828,22,5,23,844,1041,218,0,1343,821,823
"69564","Nsylvestris_NODE_23786_length_843_cov_204","Ntome_NODE_13612_length_1775_cov_250",94.484,834,31,6,14,842,1,824,0,1271,828,823
"69576","Nsylvestris_NODE_23791_length_843_cov_159","Ntome_NODE_30051_length_625_cov_272",89.031,547,31,16,193,726,49,579,0,651,533,530
"69583","Nsylvestris_NODE_23795_length_843_cov_135","Ntome_NODE_35629_length_350_cov_127",90.778,347,10,3,365,689,1,347,9.13e-124,444,324,346
"69593","Nsylvestris_NODE_23799_length_841_cov_74","Ntome_NODE_29126_length_663_cov_22",84.483,232,29,5,496,725,229,3,4.64e-57,222,229,226
"69596","Nsylvestris_NODE_23805_length_843_cov_14","Ntome_NODE_23488_length_955_cov_175",92.475,598,33,7,254,843,320,913,0,845,589,593
"69597","Nsylvestris_NODE_23806_length_843_cov_12","Ntome_NODE_14699_length_1666_cov_10",80.62,516,85,9,281,796,1,501,5.61e-106,385,515,500
"69598","Nsylvestris_NODE_23807_length_843_cov_6","Ntome_NODE_24143_length_916_cov_23",73.034,267,66,6,10,273,431,168,4.93e-17,89.8,263,263
"69599","Nsylvestris_NODE_23808_length_843_cov_6","Ntome_NODE_29760_length_638_cov_8",84.95,598,70,8,3,598,580,1,3.98e-167,588,595,579
"69605","Nsylvestris_NODE_23812_length_842_cov_215","Ntome_NODE_3679_length_3457_cov_252",98.374,492,8,0,351,842,758,267,0,865,491,491
"69608","Nsylvestris_NODE_23814_length_842_cov_178","Ntome_NODE_22099_length_1041_cov_246",94.762,630,24,1,54,674,123,752,0,972,620,629
"69611","Nsylvestris_NODE_23817_length_842_cov_91","Ntome_NODE_24853_length_871_cov_224",87.427,684,36,17,168,805,162,841,0,741,637,679
"69612","Nsylvestris_NODE_23819_length_842_cov_65","Ntome_NODE_24396_length_899_cov_99",90.943,806,34,20,1,791,782,1,0,1048,790,781
"69618","Nsylvestris_NODE_23822_length_842_cov_30","Ntome_NODE_1341_length_4691_cov_248",97.368,38,0,1,1,38,3777,3813,2.98e-09,63.9,37,36
"69631","Nsylvestris_NODE_23827_length_842_cov_12","Ntome_NODE_18749_length_1296_cov_29",80.534,262,49,2,439,698,378,117,2.18e-50,200,259,261
"69632","Nsylvestris_NODE_23828_length_842_cov_10","Ntome_NODE_1149_length_4899_cov_130",100,55,0,0,788,842,4313,4367,6.32e-21,102,54,54
"69641","Nsylvestris_NODE_23832_length_841_cov_224","Ntome_NODE_13785_length_1759_cov_149",94.452,739,31,5,1,738,934,1663,0,1129,737,729
"69666","Nsylvestris_NODE_23841_length_841_cov_34","Ntome_NODE_10772_length_2099_cov_39",88.596,228,26,0,157,384,2011,1784,9.77e-74,278,227,227
"69672","Nsylvestris_NODE_23844_length_841_cov_10","Ntome_NODE_2987_length_3704_cov_294",100,55,0,0,787,841,1634,1688,6.31e-21,102,54,54
"69678","Nsylvestris_NODE_23847_length_841_cov_7","Ntome_NODE_15890_length_1549_cov_13",79.848,526,94,7,316,833,824,303,1.21e-102,374,517,521
"69679","Nsylvestris_NODE_23848_length_841_cov_6","Ntome_NODE_38552_length_277_cov_3",100,55,0,0,787,841,256,202,6.31e-21,102,54,54
"69704","Nsylvestris_NODE_23858_length_840_cov_142","Ntome_NODE_27197_length_748_cov_188",94.331,688,24,8,138,815,687,5,0,1040,677,682
"69717","Nsylvestris_NODE_23863_length_840_cov_32","Ntome_NODE_2601_length_3860_cov_17",96.283,807,24,1,1,807,801,1,0,1319,806,800
"69720","Nsylvestris_NODE_23866_length_840_cov_13","Ntome_NODE_22203_length_1034_cov_18",91.965,809,47,4,50,840,195,1003,0,1118,790,808
"69724","Nsylvestris_NODE_23870_length_840_cov_7","Ntome_NODE_16135_length_1528_cov_30",97.541,488,12,0,1,488,988,1475,0,835,487,487
"69725","Nsylvestris_NODE_23873_length_840_cov_6","Ntome_NODE_22053_length_1045_cov_32",98.182,55,1,0,1,55,517,571,2.93e-19,97.1,54,54
"69726","Nsylvestris_NODE_23874_length_843_cov_5","Ntome_NODE_19506_length_1233_cov_250",80.576,278,28,10,183,436,880,605,1.31e-47,191,253,275
"69738","Nsylvestris_NODE_23880_length_839_cov_173","Ntome_NODE_26905_length_763_cov_167",96.828,725,22,1,72,795,753,29,0,1210,723,724
"69744","Nsylvestris_NODE_23883_length_839_cov_98","Ntome_NODE_39228_length_263_cov_4",96.774,62,2,0,778,839,97,158,1.75e-21,104,61,61
"69757","Nsylvestris_NODE_23888_length_839_cov_9","Ntome_NODE_5486_length_2965_cov_79",88.312,77,8,1,754,830,2112,2187,1.36e-17,91.6,76,75
"69758","Nsylvestris_NODE_23889_length_839_cov_5","Ntome_NODE_4738_length_3150_cov_44",93.373,845,43,8,1,839,2196,3033,0,1238,838,837
"69770","Nsylvestris_NODE_23896_length_838_cov_9","Ntome_NODE_7412_length_2583_cov_289",98.182,55,1,0,784,838,1463,1517,2.93e-19,97.1,54,54
"69779","Nsylvestris_NODE_23900_length_837_cov_190","Ntome_NODE_25362_length_840_cov_259",91.716,845,46,12,1,833,840,8,0,1151,832,832
"69783","Nsylvestris_NODE_23902_length_837_cov_169","Ntome_NODE_23168_length_973_cov_110",89.207,593,18,11,1,575,401,965,0,699,574,564
"69794","Nsylvestris_NODE_23905_length_837_cov_60","Ntome_NODE_23377_length_961_cov_139",90.965,819,48,11,7,807,863,53,0,1079,800,810
"69812","Nsylvestris_NODE_23915_length_837_cov_10","Ntome_NODE_17346_length_1416_cov_288",98.182,55,1,0,783,837,724,670,2.92e-19,97.1,54,54
"69813","Nsylvestris_NODE_23916_length_837_cov_9","Ntome_NODE_34265_length_407_cov_3",96.337,273,9,1,451,723,1,272,7e-125,448,272,271
"69820","Nsylvestris_NODE_23920_length_836_cov_198","Ntome_NODE_22593_length_1010_cov_187",95.954,791,27,3,7,797,197,982,0,1279,790,785
"69829","Nsylvestris_NODE_23924_length_836_cov_66","Ntome_NODE_33947_length_422_cov_1",98.182,55,1,0,782,836,203,257,2.92e-19,97.1,54,54
"69830","Nsylvestris_NODE_23925_length_836_cov_49","Ntome_NODE_20022_length_1190_cov_91",89.367,884,41,23,1,836,879,1,0,1062,835,878
"69833","Nsylvestris_NODE_23927_length_836_cov_36","Ntome_NODE_8229_length_2454_cov_220",98.148,54,1,0,2,55,946,893,1.05e-18,95.3,53,53
"69834","Nsylvestris_NODE_23928_length_836_cov_35","Ntome_NODE_3698_length_3452_cov_116",86.325,117,16,0,312,428,1586,1470,1.03e-28,128,116,116
"69849","Nsylvestris_NODE_23935_length_836_cov_15","Ntome_NODE_22073_length_1043_cov_21",96.287,835,27,2,6,836,886,52,0,1367,830,834
"69850","Nsylvestris_NODE_23936_length_836_cov_14","Ntome_NODE_3470_length_3525_cov_199",96.61,59,1,1,1,59,2834,2891,2.92e-19,97.1,58,57
"69856","Nsylvestris_NODE_23940_length_836_cov_11","Ntome_NODE_752_length_5453_cov_230",91.786,840,61,6,1,834,1834,2671,0,1162,833,837
"69861","Nsylvestris_NODE_23944_length_836_cov_4","Ntome_NODE_17600_length_1394_cov_7",96.292,836,31,0,1,836,1108,273,0,1373,835,835
"69874","Nsylvestris_NODE_23952_length_835_cov_80","Ntome_NODE_16049_length_1535_cov_134",93.145,248,17,0,460,707,360,113,7.24e-100,364,247,247
"69875","Nsylvestris_NODE_23953_length_835_cov_76","Ntome_NODE_2702_length_3812_cov_108",98.182,55,1,0,1,55,963,909,2.91e-19,97.1,54,54
"69876","Nsylvestris_NODE_23955_length_835_cov_42","Ntome_NODE_559_length_5874_cov_114",93.333,45,3,0,11,55,4533,4577,2.29e-10,67.6,44,44
"69882","Nsylvestris_NODE_23958_length_835_cov_5","Ntome_NODE_4501_length_3209_cov_91",96.364,55,2,0,1,55,510,564,1.36e-17,91.6,54,54
"69883","Nsylvestris_NODE_23960_length_834_cov_177","Ntome_NODE_26070_length_803_cov_257",94.453,649,30,4,135,779,111,757,0,994,644,646
"69902","Nsylvestris_NODE_23967_length_834_cov_42","Ntome_NODE_4754_length_3145_cov_274",96.364,55,2,0,780,834,635,581,1.35e-17,91.6,54,54
"69912","Nsylvestris_NODE_23971_length_834_cov_10","Ntome_NODE_17827_length_1372_cov_282",98.182,55,1,0,780,834,995,941,2.91e-19,97.1,54,54
"69936","Nsylvestris_NODE_23982_length_833_cov_21","Ntome_NODE_4110_length_3318_cov_109",81.001,679,114,10,153,830,666,1330,3.13e-148,525,677,664
"69940","Nsylvestris_NODE_23985_length_833_cov_10","Ntome_NODE_4125_length_3315_cov_100",96.51,831,28,1,1,830,1147,1977,0,1373,829,830
"69950","Nsylvestris_NODE_23990_length_832_cov_202","Ntome_NODE_20575_length_1147_cov_222",97.716,832,19,0,1,832,223,1054,0,1432,831,831
"69960","Nsylvestris_NODE_23995_length_832_cov_77","Ntome_NODE_782_length_5408_cov_260",100,55,0,0,778,832,4932,4878,6.24e-21,102,54,54
"69963","Nsylvestris_NODE_23997_length_832_cov_57","Ntome_NODE_28207_length_701_cov_11",96.724,702,21,2,86,786,1,701,0,1168,700,700
"69966","Nsylvestris_NODE_24000_length_832_cov_37","Ntome_NODE_18457_length_1320_cov_262",91.379,58,5,0,775,832,916,973,2.92e-14,80.5,57,57
"69967","Nsylvestris_NODE_24001_length_832_cov_23","Ntome_NODE_21261_length_1097_cov_167",92.497,853,38,11,1,832,994,147,0,1197,831,847
"69968","Nsylvestris_NODE_24002_length_832_cov_22","Ntome_NODE_26858_length_765_cov_122",90.674,697,29,10,91,757,12,702,0,894,666,690
"69969","Nsylvestris_NODE_24003_length_832_cov_22","Ntome_NODE_2455_length_3928_cov_106",98.182,55,1,0,778,832,277,223,2.9e-19,97.1,54,54
"69970","Nsylvestris_NODE_24004_length_832_cov_22","Ntome_NODE_14965_length_1639_cov_181",98.182,55,1,0,778,832,1446,1392,2.9e-19,97.1,54,54
"69971","Nsylvestris_NODE_24005_length_832_cov_18","Ntome_NODE_14275_length_1706_cov_50",83.824,136,10,6,119,246,566,697,6.2e-26,119,127,131
"69974","Nsylvestris_NODE_24008_length_832_cov_7","Ntome_NODE_37905_length_290_cov_7",93.284,268,18,0,84,351,268,1,2.56e-109,396,267,267
"69987","Nsylvestris_NODE_24015_length_831_cov_46","Ntome_NODE_13081_length_1833_cov_114",93.151,73,4,1,1,73,690,761,4.82e-22,106,72,71
"70004","Nsylvestris_NODE_24021_length_831_cov_12","Ntome_NODE_14923_length_1643_cov_99",96.364,55,2,0,1,55,734,680,1.35e-17,91.6,54,54
"70005","Nsylvestris_NODE_24023_length_831_cov_10","Ntome_NODE_20914_length_1122_cov_59",93.544,790,39,8,49,831,785,1,0,1166,782,784
"70010","Nsylvestris_NODE_24026_length_830_cov_228","Ntome_NODE_16656_length_1481_cov_254",96.292,836,24,1,2,830,148,983,0,1365,828,835
"70011","Nsylvestris_NODE_24027_length_830_cov_213","Ntome_NODE_25128_length_855_cov_270",91.513,813,31,20,1,788,849,50,0,1085,787,799
"70015","Nsylvestris_NODE_24030_length_830_cov_146","Ntome_NODE_32289_length_529_cov_141",93.045,532,31,2,20,548,1,529,0,773,528,528
"70019","Nsylvestris_NODE_24032_length_830_cov_131","Ntome_NODE_12430_length_1905_cov_192",92.92,226,16,0,291,516,1690,1465,2.62e-89,329,225,225
"70023","Nsylvestris_NODE_24034_length_830_cov_61","Ntome_NODE_17862_length_1370_cov_72",93.564,606,36,1,50,655,668,1270,0,900,605,602
"70027","Nsylvestris_NODE_24036_length_830_cov_58","Ntome_NODE_2991_length_3703_cov_192",95.122,820,22,7,4,817,984,177,0,1277,813,807
"70028","Nsylvestris_NODE_24037_length_830_cov_40","Ntome_NODE_153_length_7810_cov_151",95.922,515,21,0,71,585,6394,6908,0,835,514,514
"70031","Nsylvestris_NODE_24039_length_830_cov_8","Ntome_NODE_5518_length_2957_cov_215",88.889,279,27,3,1,279,2633,2907,1.21e-92,340,278,274
"70037","Nsylvestris_NODE_24042_length_829_cov_215","Ntome_NODE_20545_length_1150_cov_210",94.094,762,38,3,1,761,855,100,0,1151,760,755
"70042","Nsylvestris_NODE_24044_length_829_cov_149","Ntome_NODE_5583_length_2943_cov_226",90.562,445,29,7,140,574,754,313,8.48e-164,577,434,441
"70043","Nsylvestris_NODE_24045_length_829_cov_141","Ntome_NODE_8946_length_2346_cov_237",85.355,437,30,13,1,408,2300,1869,4.2e-117,422,407,431
"70055","Nsylvestris_NODE_24051_length_829_cov_12","Ntome_NODE_27211_length_747_cov_260",98.182,55,1,0,1,55,416,362,2.89e-19,97.1,54,54
"70073","Nsylvestris_NODE_24061_length_828_cov_24","Ntome_NODE_25607_length_827_cov_34",92.09,708,38,12,63,762,795,98,0,981,699,697
"70078","Nsylvestris_NODE_24064_length_828_cov_10","Ntome_NODE_287_length_6801_cov_270",100,38,0,0,791,828,6309,6346,1.75e-11,71.3,37,37
"70090","Nsylvestris_NODE_24069_length_827_cov_187","Ntome_NODE_24056_length_921_cov_114",91.603,786,43,14,44,827,841,77,0,1064,783,764
"70091","Nsylvestris_NODE_24070_length_827_cov_183","Ntome_NODE_26274_length_793_cov_224",93.234,739,37,6,19,748,786,52,0,1075,729,734
"70101","Nsylvestris_NODE_24074_length_827_cov_62","Ntome_NODE_20427_length_1159_cov_174",88.406,69,7,1,703,770,339,271,8.08e-15,82.4,67,68
"70105","Nsylvestris_NODE_24077_length_827_cov_34","Ntome_NODE_63_length_9368_cov_144",91.333,300,13,8,1,295,3934,4225,7.06e-110,398,294,291
"70111","Nsylvestris_NODE_24079_length_827_cov_21","Ntome_NODE_2497_length_3909_cov_109",92.429,634,33,8,1,631,2304,2925,0,891,630,621
"70117","Nsylvestris_NODE_24082_length_827_cov_5","Ntome_NODE_637_length_5673_cov_130",81.766,872,61,46,1,827,181,999,0,640,826,818
"70123","Nsylvestris_NODE_24085_length_826_cov_201","Ntome_NODE_22610_length_1009_cov_217",87.835,411,44,4,59,466,793,386,8.81e-134,477,407,407
"70131","Nsylvestris_NODE_24088_length_826_cov_39","Ntome_NODE_21833_length_1059_cov_16",86.726,339,45,0,437,775,394,56,9.19e-104,377,338,338
"70132","Nsylvestris_NODE_24090_length_826_cov_21","Ntome_NODE_2603_length_3859_cov_188",100,55,0,0,1,55,2757,2811,6.2e-21,102,54,54
"70133","Nsylvestris_NODE_24092_length_826_cov_12","Ntome_NODE_1772_length_4332_cov_106",94.545,55,3,0,772,826,402,456,6.24e-16,86.1,54,54
"70136","Nsylvestris_NODE_24095_length_826_cov_9","Ntome_NODE_30204_length_620_cov_15",97.802,91,2,0,736,826,431,341,1.3e-37,158,90,90
"70145","Nsylvestris_NODE_24098_length_826_cov_5","Ntome_NODE_7123_length_2635_cov_89",96.727,825,27,0,1,825,917,1741,0,1375,824,824
"70163","Nsylvestris_NODE_24109_length_825_cov_27","Ntome_NODE_30458_length_610_cov_12",91.005,567,33,2,138,686,1,567,0,749,548,566
"70164","Nsylvestris_NODE_24110_length_825_cov_7","Ntome_NODE_17007_length_1448_cov_44",83.908,174,26,2,106,279,993,822,7.78e-40,165,173,171
"70171","Nsylvestris_NODE_24114_length_824_cov_199","Ntome_NODE_21043_length_1112_cov_256",90.326,827,50,13,7,824,860,55,0,1057,817,805
"70172","Nsylvestris_NODE_24115_length_824_cov_198","Ntome_NODE_25809_length_815_cov_248",95.107,797,24,4,13,799,792,1,0,1242,786,791
"70176","Nsylvestris_NODE_24117_length_824_cov_103","Ntome_NODE_1200_length_4835_cov_222",98.113,53,1,0,772,824,1958,2010,3.72e-18,93.5,52,52
"70189","Nsylvestris_NODE_24123_length_824_cov_32","Ntome_NODE_11307_length_2036_cov_211",96.296,54,2,0,771,824,807,754,4.81e-17,89.8,53,53
"70201","Nsylvestris_NODE_24130_length_824_cov_13","Ntome_NODE_23781_length_937_cov_112",91.296,517,39,4,1,516,899,388,0,701,515,511
"70210","Nsylvestris_NODE_24134_length_824_cov_9","Ntome_NODE_9268_length_2300_cov_257",94.828,58,3,0,767,824,1102,1159,1.34e-17,91.6,57,57
"70211","Nsylvestris_NODE_24135_length_824_cov_8","Ntome_NODE_18040_length_1354_cov_263",100,55,0,0,1,55,947,893,6.18e-21,102,54,54
"70221","Nsylvestris_NODE_24142_length_823_cov_60","Ntome_NODE_46_length_9810_cov_171",84.211,247,34,3,552,794,4903,5148,5.83e-61,235,242,245
"70224","Nsylvestris_NODE_24145_length_823_cov_32","Ntome_NODE_21711_length_1067_cov_73",92.987,827,25,13,21,821,925,106,0,1175,800,819
"70225","Nsylvestris_NODE_24146_length_823_cov_27","Ntome_NODE_14398_length_1696_cov_55",90.698,43,4,0,41,83,349,391,1.36e-07,58.4,42,42
"70228","Nsylvestris_NODE_24148_length_823_cov_15","Ntome_NODE_19771_length_1213_cov_5",96,75,3,0,749,823,999,1073,4.74e-27,122,74,74
"70229","Nsylvestris_NODE_24149_length_823_cov_12","Ntome_NODE_693_length_5574_cov_304",100,55,0,0,769,823,922,868,6.17e-21,102,54,54
"70235","Nsylvestris_NODE_24153_length_823_cov_4","Ntome_NODE_1275_length_4754_cov_106",90.281,463,41,4,174,634,2749,2289,1.39e-171,603,460,460
"70236","Nsylvestris_NODE_24154_length_823_cov_3","Ntome_NODE_6789_length_2696_cov_149",87.986,849,58,14,1,820,1210,2043,0,963,819,833
"70247","Nsylvestris_NODE_24159_length_822_cov_83","Ntome_NODE_22704_length_1003_cov_186",92.326,821,50,6,2,822,891,84,0,1155,820,807
"70251","Nsylvestris_NODE_24162_length_822_cov_25","Ntome_NODE_34721_length_386_cov_4",90.769,390,19,10,40,416,386,1,4.02e-142,505,376,385
"70268","Nsylvestris_NODE_24170_length_821_cov_219","Ntome_NODE_29764_length_638_cov_6",93.74,639,20,2,39,661,1,635,0,941,622,634
"70274","Nsylvestris_NODE_24174_length_821_cov_64","Ntome_NODE_31714_length_563_cov_271",96.774,62,2,0,1,62,487,426,1.71e-21,104,61,61
"70278","Nsylvestris_NODE_24177_length_821_cov_16","Ntome_NODE_27603_length_728_cov_11",92.17,728,31,9,65,766,728,1,0,1005,701,727
"70279","Nsylvestris_NODE_24178_length_821_cov_7","Ntome_NODE_5200_length_3031_cov_81",100,55,0,0,1,55,506,452,6.16e-21,102,54,54
"70283","Nsylvestris_NODE_24180_length_820_cov_192","Ntome_NODE_4198_length_3296_cov_116",95.658,691,30,0,38,728,3026,2336,0,1110,690,690
"70291","Nsylvestris_NODE_24184_length_820_cov_81","Ntome_NODE_34030_length_418_cov_6",89.806,412,18,2,173,572,2,401,1.12e-142,507,399,399
"70296","Nsylvestris_NODE_24186_length_820_cov_23","Ntome_NODE_29384_length_653_cov_12",95.918,49,2,0,544,592,97,49,2.88e-14,80.5,48,48
"70297","Nsylvestris_NODE_24187_length_820_cov_18","Ntome_NODE_7974_length_2494_cov_220",100,55,0,0,1,55,1833,1779,6.15e-21,102,54,54
"70298","Nsylvestris_NODE_24188_length_820_cov_11","Ntome_NODE_2770_length_3781_cov_207",93.152,847,25,8,1,820,3143,2303,0,1212,819,840
"70299","Nsylvestris_NODE_24190_length_820_cov_9","Ntome_NODE_32351_length_524_cov_130",98.182,55,1,0,766,820,429,375,2.86e-19,97.1,54,54
"70307","Nsylvestris_NODE_24194_length_819_cov_165","Ntome_NODE_3188_length_3625_cov_108",94.602,741,29,6,1,740,2844,3574,0,1136,739,730
"70315","Nsylvestris_NODE_24197_length_819_cov_36","Ntome_NODE_3439_length_3533_cov_241",81,200,17,9,206,386,96,293,4.68e-32,139,180,197
"70328","Nsylvestris_NODE_24204_length_819_cov_7","Ntome_NODE_12527_length_1895_cov_19",93.171,820,33,12,1,819,853,56,0,1182,818,797
"70329","Nsylvestris_NODE_24205_length_818_cov_240","Ntome_NODE_8812_length_2368_cov_206",97.188,818,23,0,1,818,340,1157,0,1384,817,817
"70332","Nsylvestris_NODE_24208_length_818_cov_152","Ntome_NODE_28620_length_683_cov_44",86.877,381,42,5,27,405,683,309,1.49e-116,420,378,374
"70335","Nsylvestris_NODE_24210_length_818_cov_91","Ntome_NODE_17148_length_1435_cov_303",96.364,55,2,0,764,818,413,359,1.33e-17,91.6,54,54
"70336","Nsylvestris_NODE_24211_length_818_cov_55","Ntome_NODE_5163_length_3041_cov_232",93.878,49,3,0,64,112,1483,1531,1.34e-12,75,48,48
"70337","Nsylvestris_NODE_24212_length_818_cov_43","Ntome_NODE_5212_length_3027_cov_297",98.148,54,1,0,1,54,2793,2846,1.03e-18,95.3,53,53
"70338","Nsylvestris_NODE_24213_length_818_cov_36","Ntome_NODE_3099_length_3658_cov_70",95.039,766,38,0,1,766,2596,3361,0,1205,765,765
"70346","Nsylvestris_NODE_24219_length_818_cov_6","Ntome_NODE_27210_length_748_cov_6",92.727,275,13,3,506,779,748,480,1.17e-107,390,273,268
"70355","Nsylvestris_NODE_24224_length_817_cov_159","Ntome_NODE_12826_length_1859_cov_119",92.193,807,42,15,8,810,24,813,0,1122,802,789
"70356","Nsylvestris_NODE_24225_length_817_cov_155","Ntome_NODE_21857_length_1057_cov_35",86.071,481,64,3,225,705,468,945,6.64e-145,514,480,477
"70371","Nsylvestris_NODE_24232_length_817_cov_9","Ntome_NODE_264_length_6990_cov_236",92.995,828,39,11,1,814,2282,3104,0,1190,813,822
"70372","Nsylvestris_NODE_24234_length_817_cov_7","Ntome_NODE_1602_length_4452_cov_92",98.182,55,1,0,1,55,1165,1111,2.85e-19,97.1,54,54
"70397","Nsylvestris_NODE_24248_length_815_cov_196","Ntome_NODE_25613_length_826_cov_256",91.905,803,51,4,6,800,797,1,0,1110,794,796
"70402","Nsylvestris_NODE_24252_length_814_cov_50","Ntome_NODE_21695_length_1067_cov_49",90.141,71,2,2,148,213,999,929,1.71e-16,87.9,65,70
"70405","Nsylvestris_NODE_24254_length_815_cov_29","Ntome_NODE_24172_length_914_cov_173",89.878,820,36,12,24,815,88,888,0,1011,791,800
"70408","Nsylvestris_NODE_24259_length_815_cov_11","Ntome_NODE_3998_length_3353_cov_55",92.231,399,20,5,427,815,386,783,3.9e-157,555,388,397
"70417","Nsylvestris_NODE_24263_length_814_cov_205","Ntome_NODE_25045_length_860_cov_268",95.52,692,28,1,123,814,796,108,0,1103,691,688
"70421","Nsylvestris_NODE_24265_length_814_cov_172","Ntome_NODE_22406_length_1022_cov_169",94.643,728,31,5,6,728,916,192,0,1122,722,724
"70429","Nsylvestris_NODE_24268_length_814_cov_59","Ntome_NODE_575_length_5820_cov_204",96.364,55,2,0,1,55,2721,2667,1.32e-17,91.6,54,54
"70430","Nsylvestris_NODE_24269_length_814_cov_37","Ntome_NODE_28454_length_690_cov_43",90.359,612,51,6,140,744,611,1,0,797,604,610
"70435","Nsylvestris_NODE_24272_length_814_cov_30","Ntome_NODE_1687_length_4391_cov_260",100,55,0,0,760,814,3269,3215,6.1e-21,102,54,54
"70445","Nsylvestris_NODE_24276_length_814_cov_22","Ntome_NODE_3509_length_3514_cov_224",91.458,679,46,3,83,761,2534,3200,0,922,678,666
"70449","Nsylvestris_NODE_24278_length_814_cov_20","Ntome_NODE_9234_length_2304_cov_199",96.721,61,1,1,755,814,622,562,2.19e-20,100,59,60
"70459","Nsylvestris_NODE_24283_length_813_cov_41","Ntome_NODE_8221_length_2456_cov_138",100,55,0,0,759,813,536,482,6.09e-21,102,54,54
"70462","Nsylvestris_NODE_24285_length_813_cov_27","Ntome_NODE_11862_length_1974_cov_246",96.573,817,24,3,1,813,1,817,0,1351,812,816
"70476","Nsylvestris_NODE_24290_length_813_cov_14","Ntome_NODE_18281_length_1335_cov_191",98.182,55,1,0,759,813,923,869,2.84e-19,97.1,54,54
"70480","Nsylvestris_NODE_24292_length_813_cov_8","Ntome_NODE_14357_length_1699_cov_249",98.182,55,1,0,1,55,1319,1373,2.84e-19,97.1,54,54
"70481","Nsylvestris_NODE_24293_length_813_cov_5","Ntome_NODE_9260_length_2301_cov_136",100,32,0,0,436,467,1279,1310,3.72e-08,60.2,31,31
"70496","Nsylvestris_NODE_24301_length_812_cov_62","Ntome_NODE_27004_length_758_cov_30",91.344,774,42,12,45,810,1,757,0,1035,765,756
"70497","Nsylvestris_NODE_24302_length_812_cov_37","Ntome_NODE_33510_length_445_cov_17",92.511,454,17,4,70,515,445,1,0,634,445,444
"70500","Nsylvestris_NODE_24305_length_812_cov_23","Ntome_NODE_185_length_7514_cov_277",100,55,0,0,1,55,6169,6115,6.09e-21,102,54,54
"70503","Nsylvestris_NODE_24308_length_812_cov_12","Ntome_NODE_184_length_7533_cov_278",98.182,55,1,0,758,812,6766,6712,2.83e-19,97.1,54,54
"70506","Nsylvestris_NODE_24310_length_812_cov_10","Ntome_NODE_14770_length_1659_cov_60",94.317,827,27,1,3,809,650,1476,0,1249,806,826
"70519","Nsylvestris_NODE_24316_length_812_cov_5","Ntome_NODE_26494_length_783_cov_5",96.028,705,21,2,115,812,1,705,0,1140,697,704
"70561","Nsylvestris_NODE_24318_length_811_cov_217","Ntome_NODE_23661_length_945_cov_239",95.412,741,27,6,27,764,127,863,0,1173,737,736
"70570","Nsylvestris_NODE_24323_length_811_cov_141","Ntome_NODE_3118_length_3652_cov_24",91.25,80,3,1,730,809,3636,3561,4.7e-22,106,79,75
"70581","Nsylvestris_NODE_24331_length_811_cov_31","Ntome_NODE_5649_length_2927_cov_199",89.778,812,43,18,1,811,613,1385,0,1003,810,772
"70584","Nsylvestris_NODE_24333_length_810_cov_242","Ntome_NODE_9103_length_2323_cov_132",96.919,714,22,0,1,714,1364,2077,0,1197,713,713
"70606","Nsylvestris_NODE_24343_length_810_cov_19","Ntome_NODE_6592_length_2732_cov_160",87.586,290,23,4,205,493,2113,2390,1.19e-87,324,288,277
"70618","Nsylvestris_NODE_24348_length_810_cov_3","Ntome_NODE_5549_length_2949_cov_163",93.75,64,3,1,747,810,1682,1620,1.02e-18,95.3,63,62
"70622","Nsylvestris_NODE_24350_length_809_cov_195","Ntome_NODE_26250_length_794_cov_248",91.512,648,47,7,104,748,22,664,0,885,644,642
"70623","Nsylvestris_NODE_24351_length_809_cov_189","Ntome_NODE_29148_length_662_cov_36",89.916,476,40,5,275,743,534,60,1.05e-172,606,468,474
"70631","Nsylvestris_NODE_24354_length_809_cov_154","Ntome_NODE_28697_length_680_cov_210",92.748,524,24,5,153,674,595,84,0,745,521,511
"70641","Nsylvestris_NODE_24362_length_809_cov_31","Ntome_NODE_25317_length_844_cov_6",100,28,0,0,305,332,573,546,6.19e-06,52.8,27,27
"70642","Nsylvestris_NODE_24363_length_809_cov_22","Ntome_NODE_27012_length_758_cov_3",95.994,724,29,0,85,808,746,23,0,1177,723,723
"70643","Nsylvestris_NODE_24364_length_809_cov_18","Ntome_NODE_1341_length_4691_cov_248",94.188,757,34,5,1,757,849,103,0,1146,756,746
"70650","Nsylvestris_NODE_24367_length_809_cov_7","Ntome_NODE_6193_length_2813_cov_31",95.443,812,31,5,1,809,1473,665,0,1290,808,808
"70658","Nsylvestris_NODE_24370_length_808_cov_203","Ntome_NODE_27277_length_744_cov_269",96.226,477,17,1,257,733,525,50,0,780,476,475
"70671","Nsylvestris_NODE_24375_length_808_cov_176","Ntome_NODE_24322_length_904_cov_207",94.351,655,28,4,84,737,849,203,0,996,653,646
"70672","Nsylvestris_NODE_24376_length_808_cov_123","Ntome_NODE_30008_length_627_cov_22",86.458,576,57,10,129,685,627,54,2.26e-174,612,556,573
"70675","Nsylvestris_NODE_24382_length_808_cov_17","Ntome_NODE_7572_length_2558_cov_187",94.915,59,2,1,750,808,1984,1927,1.31e-17,91.6,58,57
"70678","Nsylvestris_NODE_24384_length_808_cov_13","Ntome_NODE_2941_length_3721_cov_279",98.077,52,1,0,1,52,275,326,1.31e-17,91.6,51,51
"70682","Nsylvestris_NODE_24386_length_808_cov_9","Ntome_NODE_26872_length_765_cov_8",96.372,689,24,1,1,689,688,1,0,1133,688,687
"70683","Nsylvestris_NODE_24387_length_808_cov_6","Ntome_NODE_6664_length_2718_cov_178",100,51,0,0,754,804,1213,1163,1.01e-18,95.3,50,50
"70694","Nsylvestris_NODE_24393_length_807_cov_52","Ntome_NODE_7971_length_2495_cov_44",90.566,53,4,1,748,800,1904,1955,6.13e-11,69.4,52,51
"70695","Nsylvestris_NODE_24394_length_807_cov_28","Ntome_NODE_14359_length_1699_cov_170",76.58,538,92,19,142,648,336,870,7.29e-70,265,506,534
"70707","Nsylvestris_NODE_24399_length_807_cov_8","Ntome_NODE_3346_length_3570_cov_206",98.148,54,1,0,754,807,366,419,1.01e-18,95.3,53,53
"70708","Nsylvestris_NODE_24400_length_807_cov_6","Ntome_NODE_1756_length_4337_cov_201",100,55,0,0,753,807,3852,3798,6.05e-21,102,54,54
"70724","Nsylvestris_NODE_24411_length_806_cov_41","Ntome_NODE_36160_length_334_cov_5",90.882,340,16,3,350,680,334,1,3.13e-123,442,330,333
"70733","Nsylvestris_NODE_24416_length_806_cov_16","Ntome_NODE_456_length_6137_cov_19",84.34,811,119,6,1,805,2515,1707,0,787,804,808
"70737","Nsylvestris_NODE_24418_length_806_cov_10","Ntome_NODE_7695_length_2542_cov_13",88.235,544,60,4,1,542,1386,1927,0,647,541,541
"70738","Nsylvestris_NODE_24419_length_806_cov_8","Ntome_NODE_3551_length_3500_cov_79",95.455,66,1,1,743,806,637,702,1.68e-21,104,63,65
"70741","Nsylvestris_NODE_24422_length_805_cov_223","Ntome_NODE_4975_length_3090_cov_165",93.147,715,40,4,100,805,1121,407,0,1040,705,714
"70749","Nsylvestris_NODE_24425_length_805_cov_183","Ntome_NODE_25878_length_811_cov_53",89.429,700,47,14,52,748,136,811,0,857,696,675
"70753","Nsylvestris_NODE_24427_length_805_cov_79","Ntome_NODE_13468_length_1789_cov_183",94.379,765,28,11,46,805,815,61,0,1160,759,754
"70754","Nsylvestris_NODE_24428_length_805_cov_56","Ntome_NODE_15579_length_1578_cov_15",94.286,70,4,0,603,672,1561,1492,1.3e-22,108,69,69
"70755","Nsylvestris_NODE_24429_length_805_cov_39","Ntome_NODE_11280_length_2040_cov_183",93.846,65,4,0,741,805,680,616,7.8e-20,99,64,64
"70759","Nsylvestris_NODE_24432_length_805_cov_27","Ntome_NODE_4441_length_3224_cov_61",86.878,221,27,2,293,511,2550,2330,2.63e-64,246,218,220
"70768","Nsylvestris_NODE_24438_length_803_cov_8","Ntome_NODE_3385_length_3556_cov_15",89.122,809,82,5,1,803,740,1548,0,1002,802,808
"70774","Nsylvestris_NODE_24443_length_804_cov_213","Ntome_NODE_14954_length_1640_cov_174",96.552,667,17,3,121,781,877,1543,0,1099,660,666
"70786","Nsylvestris_NODE_24448_length_804_cov_128","Ntome_NODE_23169_length_973_cov_58",92.257,762,38,5,2,757,973,227,0,1061,755,746
"70787","Nsylvestris_NODE_24449_length_804_cov_52","Ntome_NODE_7068_length_2643_cov_269",92.424,198,13,2,236,431,1827,2024,7.21e-75,281,195,197
"70788","Nsylvestris_NODE_24450_length_804_cov_17","Ntome_NODE_22240_length_1032_cov_177",90.123,810,56,3,7,804,970,173,0,1031,797,797
"70789","Nsylvestris_NODE_24451_length_804_cov_14","Ntome_NODE_1645_length_4425_cov_149",94.375,160,6,1,157,313,104,263,3.4e-63,243,156,159
"70805","Nsylvestris_NODE_24457_length_804_cov_5","Ntome_NODE_10889_length_2086_cov_179",89.011,182,7,5,636,804,1400,1581,2.67e-54,213,168,181
"70823","Nsylvestris_NODE_24464_length_803_cov_137","Ntome_NODE_22592_length_1010_cov_201",86.69,849,38,23,1,789,8,841,0,872,788,833
"70859","Nsylvestris_NODE_24481_length_802_cov_6","Ntome_NODE_35650_length_350_cov_3",97.569,288,4,2,516,802,1,286,1.1e-137,490,286,285
"70860","Nsylvestris_NODE_24482_length_801_cov_229","Ntome_NODE_1579_length_4469_cov_265",96.392,582,21,0,220,801,4421,3840,0,959,581,581
"70872","Nsylvestris_NODE_24486_length_801_cov_178","Ntome_NODE_3321_length_3578_cov_95",95.43,744,26,4,62,801,2,741,0,1179,739,739
"70873","Nsylvestris_NODE_24487_length_801_cov_107","Ntome_NODE_33406_length_451_cov_5",95.362,345,14,2,273,615,17,361,6.41e-155,547,342,344
"70874","Nsylvestris_NODE_24488_length_801_cov_104","Ntome_NODE_30646_length_602_cov_33",94.362,337,19,0,415,751,533,197,5.03e-146,518,336,336
"70877","Nsylvestris_NODE_24491_length_801_cov_68","Ntome_NODE_15287_length_1606_cov_37",88.636,88,7,2,396,482,1559,1474,1.67e-21,104,86,85
"70883","Nsylvestris_NODE_24495_length_801_cov_32","Ntome_NODE_25004_length_863_cov_38",95.185,810,29,6,1,801,3,811,0,1271,800,808
"70884","Nsylvestris_NODE_24497_length_801_cov_26","Ntome_NODE_27042_length_756_cov_156",93.694,111,6,1,692,801,596,706,7.55e-40,165,109,110
"70888","Nsylvestris_NODE_24500_length_801_cov_15","Ntome_NODE_23788_length_937_cov_43",95.844,409,12,1,53,456,636,228,0,656,403,408
"70895","Nsylvestris_NODE_24506_length_800_cov_192","Ntome_NODE_3235_length_3608_cov_280",93.026,803,44,8,3,800,2,797,0,1162,797,795
"70905","Nsylvestris_NODE_24510_length_800_cov_62","Ntome_NODE_6271_length_2793_cov_138",98.182,55,1,0,1,55,301,355,2.79e-19,97.1,54,54
"70914","Nsylvestris_NODE_24514_length_800_cov_13","Ntome_NODE_18613_length_1307_cov_129",88.942,832,42,19,1,800,1,814,0,981,799,813
"70917","Nsylvestris_NODE_24516_length_800_cov_11","Ntome_NODE_4957_length_3095_cov_244",88.123,261,20,5,1,257,2522,2269,1.98e-80,300,256,253
"70928","Nsylvestris_NODE_24523_length_799_cov_117","Ntome_NODE_1796_length_4312_cov_93",94.937,158,8,0,588,745,993,1150,7.27e-65,248,157,157
"70929","Nsylvestris_NODE_24525_length_799_cov_102","Ntome_NODE_34788_length_383_cov_5",90.289,381,35,2,69,448,1,380,6.53e-140,497,379,379
"70933","Nsylvestris_NODE_24527_length_799_cov_69","Ntome_NODE_15457_length_1588_cov_133",91.391,755,38,13,49,799,756,25,0,1009,750,731
"70934","Nsylvestris_NODE_24528_length_799_cov_69","Ntome_NODE_6689_length_2715_cov_92",94.545,55,3,0,1,55,421,475,6.03e-16,86.1,54,54
"70950","Nsylvestris_NODE_24537_length_799_cov_13","Ntome_NODE_416_length_6249_cov_53",87.767,703,40,10,3,697,4503,5167,0,780,694,664
"70960","Nsylvestris_NODE_24541_length_799_cov_6","Ntome_NODE_5012_length_3076_cov_289",98.182,55,1,0,1,55,1480,1534,2.79e-19,97.1,54,54
"70967","Nsylvestris_NODE_24544_length_798_cov_155","Ntome_NODE_16152_length_1526_cov_126",95.659,645,28,0,1,645,822,1466,0,1037,644,644
"70976","Nsylvestris_NODE_24551_length_798_cov_39","Ntome_NODE_9013_length_2337_cov_80",96.42,419,11,4,366,784,46,460,0,688,418,414
"70993","Nsylvestris_NODE_24560_length_798_cov_11","Ntome_NODE_27560_length_730_cov_6",85.449,701,55,25,1,673,49,730,0,686,672,681
"70994","Nsylvestris_NODE_24561_length_798_cov_10","Ntome_NODE_22027_length_1047_cov_28",94.005,784,42,4,1,782,218,998,0,1182,781,780
"71008","Nsylvestris_NODE_24568_length_797_cov_166","Ntome_NODE_24374_length_901_cov_139",89.844,768,42,16,1,734,73,838,0,953,733,765
"71021","Nsylvestris_NODE_24574_length_797_cov_18","Ntome_NODE_5751_length_2906_cov_294",100,55,0,0,1,55,1970,1916,5.97e-21,102,54,54
"71030","Nsylvestris_NODE_24578_length_797_cov_8","Ntome_NODE_4248_length_3278_cov_124",91.192,772,48,13,1,765,2049,2807,0,1031,764,758
"71035","Nsylvestris_NODE_24581_length_796_cov_184","Ntome_NODE_14018_length_1736_cov_118",94.947,752,21,3,48,787,747,1,0,1162,739,746
"71036","Nsylvestris_NODE_24582_length_796_cov_181","Ntome_NODE_23604_length_948_cov_154",94.11,781,32,4,27,796,37,814,0,1175,769,777
"71052","Nsylvestris_NODE_24594_length_796_cov_8","Ntome_NODE_2875_length_3747_cov_277",94.737,57,3,0,740,796,3452,3508,4.64e-17,89.8,56,56
"71060","Nsylvestris_NODE_24598_length_795_cov_210","Ntome_NODE_18400_length_1325_cov_253",92.393,723,31,12,85,795,1,711,0,1009,710,710
"71063","Nsylvestris_NODE_24600_length_795_cov_167","Ntome_NODE_12620_length_1884_cov_225",95.532,761,21,4,35,795,21,768,0,1205,760,747
"71070","Nsylvestris_NODE_24604_length_795_cov_12","Ntome_NODE_6976_length_2659_cov_28",83.594,256,32,6,1,255,497,251,7.28e-60,231,254,246
"71071","Nsylvestris_NODE_24608_length_794_cov_216","Ntome_NODE_714_length_5535_cov_177",95.878,752,20,2,1,741,2663,3414,0,1206,740,751
"71080","Nsylvestris_NODE_24615_length_794_cov_22","Ntome_NODE_8223_length_2455_cov_193",100,29,0,0,579,607,2317,2289,1.69e-06,54.7,28,28
"71092","Nsylvestris_NODE_24621_length_793_cov_200","Ntome_NODE_25599_length_827_cov_279",88.86,781,53,9,36,787,46,821,0,929,751,775
"71111","Nsylvestris_NODE_24630_length_793_cov_17","Ntome_NODE_11889_length_1971_cov_42",79.621,422,44,17,407,793,405,819,7.16e-70,265,386,414
"71122","Nsylvestris_NODE_24636_length_792_cov_218","Ntome_NODE_25824_length_814_cov_146",94.965,576,27,2,125,699,49,623,0,902,574,574
"71128","Nsylvestris_NODE_24639_length_792_cov_77","Ntome_NODE_512_length_5988_cov_133",98.276,58,1,0,735,792,4302,4359,5.93e-21,102,57,57
"71169","Nsylvestris_NODE_24659_length_791_cov_47","Ntome_NODE_30571_length_605_cov_34",92.487,559,31,5,74,625,556,2,0,789,551,554
"71170","Nsylvestris_NODE_24662_length_791_cov_32","Ntome_NODE_1265_length_4767_cov_126",93.074,693,23,6,110,790,681,2,0,990,680,679
"71179","Nsylvestris_NODE_24667_length_791_cov_15","Ntome_NODE_525_length_5956_cov_260",93.182,44,3,0,127,170,367,410,7.77e-10,65.8,43,43
"71183","Nsylvestris_NODE_24670_length_791_cov_5","Ntome_NODE_27955_length_713_cov_5",94.286,280,16,0,5,284,388,667,2.39e-119,429,279,279
"71184","Nsylvestris_NODE_24671_length_790_cov_229","Ntome_NODE_9776_length_2228_cov_268",95.449,791,25,3,1,790,1448,2228,0,1251,789,780
"71185","Nsylvestris_NODE_24672_length_790_cov_220","Ntome_NODE_25475_length_834_cov_263",93.974,780,35,8,3,777,777,5,0,1170,774,772
"71186","Nsylvestris_NODE_24673_length_790_cov_215","Ntome_NODE_4107_length_3319_cov_136",96.774,62,1,1,730,790,1822,1883,5.92e-21,102,60,61
"71187","Nsylvestris_NODE_24674_length_790_cov_71","Ntome_NODE_26986_length_759_cov_48",91.304,759,30,6,23,745,759,1,0,1003,722,758
"71191","Nsylvestris_NODE_24676_length_790_cov_61","Ntome_NODE_23000_length_983_cov_167",92.985,670,29,5,137,790,50,717,0,961,653,667
"71194","Nsylvestris_NODE_24680_length_790_cov_16","Ntome_NODE_21374_length_1090_cov_63",89.189,777,81,3,4,778,980,205,0,966,774,775
"71199","Nsylvestris_NODE_24686_length_790_cov_4","Ntome_NODE_12106_length_1944_cov_60",92.462,796,52,6,1,790,1241,448,0,1131,789,793
"71221","Nsylvestris_NODE_24696_length_789_cov_56","Ntome_NODE_28519_length_688_cov_17",93.353,692,31,7,58,739,1,687,0,1009,681,686
"71225","Nsylvestris_NODE_24699_length_789_cov_16","Ntome_NODE_11041_length_2067_cov_199",98.182,55,1,0,735,789,1051,1105,2.75e-19,97.1,54,54
"71252","Nsylvestris_NODE_24712_length_788_cov_62","Ntome_NODE_27346_length_741_cov_10",72.688,703,163,23,3,693,38,723,1.22e-52,207,690,685
"71260","Nsylvestris_NODE_24719_length_788_cov_14","Ntome_NODE_2258_length_4029_cov_251",98.182,55,1,0,1,55,976,1030,2.75e-19,97.1,54,54
"71266","Nsylvestris_NODE_24724_length_788_cov_5","Ntome_NODE_4232_length_3283_cov_37",89.205,528,42,3,261,788,2700,2188,0,645,527,512
"71270","Nsylvestris_NODE_24726_length_787_cov_139","Ntome_NODE_7117_length_2636_cov_15",94.409,787,44,0,1,787,2404,1618,0,1210,786,786
"71277","Nsylvestris_NODE_24731_length_787_cov_18","Ntome_NODE_9156_length_2317_cov_246",98.333,60,0,1,728,787,1698,1640,1.64e-21,104,59,58
"71287","Nsylvestris_NODE_24736_length_786_cov_220","Ntome_NODE_10645_length_2113_cov_298",95.379,779,33,2,1,779,1280,2055,0,1236,778,775
"71288","Nsylvestris_NODE_24737_length_786_cov_199","Ntome_NODE_4361_length_3248_cov_37",88.918,388,24,12,180,567,2074,1706,8.43e-129,460,387,368
"71289","Nsylvestris_NODE_24738_length_786_cov_197","Ntome_NODE_2317_length_3999_cov_229",94.505,637,25,4,1,637,2268,2894,0,974,636,626
"71319","Nsylvestris_NODE_24751_length_786_cov_13","Ntome_NODE_2603_length_3859_cov_188",96.61,59,1,1,4,61,2861,2803,2.74e-19,97.1,57,58
"71320","Nsylvestris_NODE_24752_length_786_cov_10","Ntome_NODE_36986_length_311_cov_4",91.011,89,6,1,483,569,223,311,5.84e-26,119,86,88
"71321","Nsylvestris_NODE_24753_length_786_cov_7","Ntome_NODE_33059_length_473_cov_10",84.746,236,33,1,549,784,473,241,2e-60,233,235,232
"71330","Nsylvestris_NODE_24759_length_785_cov_222","Ntome_NODE_26298_length_792_cov_158",94.58,738,32,2,48,785,730,1,0,1134,737,729
"71331","Nsylvestris_NODE_24760_length_785_cov_208","Ntome_NODE_24219_length_911_cov_230",94.583,683,18,2,27,708,171,835,0,1038,681,664
"71342","Nsylvestris_NODE_24768_length_785_cov_9","Ntome_NODE_9091_length_2325_cov_13",91.948,621,50,0,165,785,2320,1700,0,870,620,620
"71343","Nsylvestris_NODE_24769_length_785_cov_8","Ntome_NODE_18728_length_1298_cov_20",84.533,653,68,20,2,642,383,1014,1.7e-175,616,640,631
"71346","Nsylvestris_NODE_24772_length_784_cov_200","Ntome_NODE_11128_length_2057_cov_12",88.485,165,16,3,186,347,320,484,2.62e-49,196,161,164
"71347","Nsylvestris_NODE_24773_length_784_cov_195","Ntome_NODE_1641_length_4426_cov_284",96.173,784,29,1,1,784,4155,3373,0,1280,783,782
"71348","Nsylvestris_NODE_24774_length_784_cov_137","Ntome_NODE_24071_length_920_cov_148",79.775,712,59,42,53,755,66,701,3.94e-122,438,702,635
"71349","Nsylvestris_NODE_24775_length_784_cov_136","Ntome_NODE_25896_length_810_cov_177",91.379,290,13,5,389,677,511,789,1.45e-106,387,288,278
"71350","Nsylvestris_NODE_24777_length_784_cov_73","Ntome_NODE_21301_length_1094_cov_316",98.182,55,1,0,730,784,893,839,2.73e-19,97.1,54,54
"71362","Nsylvestris_NODE_24784_length_784_cov_20","Ntome_NODE_19891_length_1202_cov_70",96.875,64,1,1,722,784,509,572,4.54e-22,106,62,63
"71370","Nsylvestris_NODE_24788_length_784_cov_11","Ntome_NODE_38392_length_280_cov_5",88.776,294,16,6,447,739,280,3,8.83e-94,344,292,277
"71374","Nsylvestris_NODE_24790_length_784_cov_7","Ntome_NODE_33224_length_462_cov_3",94.231,468,20,4,264,730,462,1,0,708,466,461
"71375","Nsylvestris_NODE_24791_length_784_cov_7","Ntome_NODE_4518_length_3206_cov_117",98.182,55,1,0,1,55,744,798,2.73e-19,97.1,54,54
"71376","Nsylvestris_NODE_24792_length_784_cov_4","Ntome_NODE_6141_length_2824_cov_73",95.672,439,19,0,345,783,2348,1910,0,706,438,438
"71377","Nsylvestris_NODE_24793_length_784_cov_4","Ntome_NODE_24268_length_908_cov_171",91.338,785,46,12,1,783,824,60,0,1053,782,764
"71389","Nsylvestris_NODE_24798_length_783_cov_141","Ntome_NODE_19349_length_1247_cov_245",95.152,165,7,1,88,251,703,867,3.29e-68,259,163,164
"71393","Nsylvestris_NODE_24800_length_783_cov_109","Ntome_NODE_24173_length_914_cov_141",94.057,774,44,2,10,783,782,11,0,1173,773,771
"71394","Nsylvestris_NODE_24801_length_783_cov_93","Ntome_NODE_23805_length_936_cov_231",89.088,614,42,12,14,625,56,646,0,739,611,590
"71412","Nsylvestris_NODE_24808_length_783_cov_23","Ntome_NODE_9752_length_2231_cov_284",89.183,416,45,0,35,450,2083,1668,1.37e-146,520,415,415
"71421","Nsylvestris_NODE_24814_length_783_cov_4","Ntome_NODE_1877_length_4255_cov_296",100,55,0,0,1,55,2459,2405,5.86e-21,102,54,54
"71422","Nsylvestris_NODE_24816_length_783_cov_3","Ntome_NODE_16_length_12024_cov_84",83.75,400,49,2,384,783,2507,2124,6.77e-100,364,399,383
"71429","Nsylvestris_NODE_24819_length_782_cov_51","Ntome_NODE_9966_length_2204_cov_50",100,36,0,0,22,57,2038,2003,2.14e-10,67.6,35,35
"71430","Nsylvestris_NODE_24821_length_780_cov_21","Ntome_NODE_14749_length_1660_cov_257",92.857,70,5,0,349,418,468,399,5.84e-21,102,69,69
"71434","Nsylvestris_NODE_24823_length_782_cov_17","Ntome_NODE_11870_length_1973_cov_297",100,55,0,0,728,782,442,496,5.85e-21,102,54,54
"71435","Nsylvestris_NODE_24824_length_782_cov_12","Ntome_NODE_6796_length_2695_cov_152",90.689,784,49,9,1,782,1046,1807,0,1022,781,761
"71439","Nsylvestris_NODE_24827_length_782_cov_7","Ntome_NODE_1153_length_4896_cov_305",98.182,55,1,0,1,55,1941,1995,2.72e-19,97.1,54,54
"71440","Nsylvestris_NODE_24829_length_782_cov_6","Ntome_NODE_18944_length_1281_cov_85",100,55,0,0,728,782,642,696,5.85e-21,102,54,54
"71449","Nsylvestris_NODE_24832_length_781_cov_169","Ntome_NODE_2620_length_3850_cov_137",91.239,468,14,5,77,536,88,536,2.18e-174,612,459,448
"71452","Nsylvestris_NODE_24834_length_781_cov_94","Ntome_NODE_23175_length_973_cov_21",91.222,581,25,11,158,728,754,190,0,767,570,564
"71455","Nsylvestris_NODE_24836_length_781_cov_38","Ntome_NODE_23831_length_935_cov_101",87.105,760,69,12,1,734,769,13,0,833,733,756
"71456","Nsylvestris_NODE_24837_length_781_cov_38","Ntome_NODE_16009_length_1538_cov_119",98.182,55,1,0,727,781,709,763,2.72e-19,97.1,54,54
"71460","Nsylvestris_NODE_24839_length_781_cov_35","Ntome_NODE_16545_length_1492_cov_295",100,55,0,0,1,55,541,487,5.85e-21,102,54,54
"71464","Nsylvestris_NODE_24841_length_781_cov_21","Ntome_NODE_17901_length_1366_cov_190",95.745,47,2,0,340,386,637,683,3.54e-13,76.8,46,46
"71465","Nsylvestris_NODE_24843_length_781_cov_16","Ntome_NODE_26183_length_800_cov_30",93.525,695,32,9,11,705,732,51,0,1022,694,681
"71470","Nsylvestris_NODE_24846_length_779_cov_11","Ntome_NODE_9771_length_2229_cov_143",89.706,68,7,0,709,776,1956,2023,1.63e-16,87.9,67,67
"71489","Nsylvestris_NODE_24854_length_780_cov_159","Ntome_NODE_24575_length_887_cov_280",92.593,675,32,10,36,695,827,156,0,953,659,671
"71496","Nsylvestris_NODE_24859_length_780_cov_24","Ntome_NODE_28598_length_684_cov_105",85.437,103,9,4,254,354,150,248,5.84e-21,102,100,98
"71506","Nsylvestris_NODE_24864_length_779_cov_189","Ntome_NODE_23964_length_927_cov_215",90.116,688,34,13,110,779,771,100,0,863,669,671
"71519","Nsylvestris_NODE_24869_length_779_cov_21","Ntome_NODE_30772_length_597_cov_86",93.038,158,11,0,162,319,60,217,7.13e-60,231,157,157
"71520","Nsylvestris_NODE_24870_length_779_cov_13","Ntome_NODE_837_length_5325_cov_68",85.852,311,38,2,290,600,2147,1843,3.18e-88,326,310,304
"71524","Nsylvestris_NODE_24872_length_779_cov_9","Ntome_NODE_7406_length_2584_cov_244",89.128,791,52,17,1,779,769,1537,0,953,778,768
"71525","Nsylvestris_NODE_24873_length_779_cov_8","Ntome_NODE_21391_length_1089_cov_51",90.409,636,44,11,88,716,315,940,0,821,628,625
"71529","Nsylvestris_NODE_24878_length_778_cov_239","Ntome_NODE_3872_length_3396_cov_292",96.272,778,29,0,1,778,1275,498,0,1277,777,777
"71545","Nsylvestris_NODE_24885_length_778_cov_37","Ntome_NODE_16821_length_1464_cov_13",89.939,328,32,1,60,387,329,3,3.94e-117,422,327,326
"71566","Nsylvestris_NODE_24893_length_777_cov_225","Ntome_NODE_21946_length_1052_cov_255",94.872,741,22,5,50,777,236,973,0,1144,727,737
"71578","Nsylvestris_NODE_24898_length_777_cov_9","Ntome_NODE_6058_length_2837_cov_256",92.142,789,28,13,1,777,1028,1794,0,1083,776,766
"71593","Nsylvestris_NODE_24906_length_776_cov_95","Ntome_NODE_7068_length_2643_cov_269",96.296,54,2,0,1,54,2469,2416,4.52e-17,89.8,53,53
"71606","Nsylvestris_NODE_24913_length_776_cov_11","Ntome_NODE_6101_length_2830_cov_197",84.728,478,41,9,329,774,629,1106,1.8e-125,449,445,477
"71607","Nsylvestris_NODE_24917_length_775_cov_253","Ntome_NODE_702_length_5556_cov_237",97.806,775,17,0,1,775,5301,4527,0,1338,774,774
"71623","Nsylvestris_NODE_24922_length_775_cov_143","Ntome_NODE_2734_length_3799_cov_248",95.842,457,14,3,273,728,831,1283,0,734,455,452
"71626","Nsylvestris_NODE_24924_length_775_cov_85","Ntome_NODE_25663_length_823_cov_254",92.5,640,19,11,35,662,136,758,0,889,627,622
"71629","Nsylvestris_NODE_24926_length_775_cov_45","Ntome_NODE_20836_length_1129_cov_140",79.817,109,16,3,373,481,510,408,1.26e-12,75,108,102
"71643","Nsylvestris_NODE_24932_length_775_cov_17","Ntome_NODE_23197_length_972_cov_35",93.659,205,12,1,1,205,453,250,4.12e-82,305,204,203
"71644","Nsylvestris_NODE_24933_length_775_cov_14","Ntome_NODE_6810_length_2693_cov_83",95.016,622,30,1,155,775,2176,1555,0,976,620,621
"71649","Nsylvestris_NODE_24935_length_775_cov_14","Ntome_NODE_14874_length_1647_cov_27",92.612,758,38,1,18,775,125,864,0,1074,757,739
"71650","Nsylvestris_NODE_24936_length_775_cov_10","Ntome_NODE_13239_length_1815_cov_249",100,32,0,0,721,752,1683,1714,3.54e-08,60.2,31,31
"71653","Nsylvestris_NODE_24938_length_775_cov_9","Ntome_NODE_1821_length_4294_cov_206",86.5,200,14,4,2,196,817,1008,1.19e-52,207,194,191
"71654","Nsylvestris_NODE_24939_length_775_cov_7","Ntome_NODE_12985_length_1843_cov_285",77.038,736,165,3,42,775,1656,923,1.41e-116,420,733,733
"71667","Nsylvestris_NODE_24947_length_774_cov_46","Ntome_NODE_10443_length_2140_cov_105",92.857,56,3,1,720,774,1532,1477,2.71e-14,80.5,54,55
"71668","Nsylvestris_NODE_24948_length_774_cov_33","Ntome_NODE_39812_length_252_cov_4",94.8,250,13,0,400,649,3,252,1.1e-107,390,249,249
"71677","Nsylvestris_NODE_24952_length_774_cov_20","Ntome_NODE_6062_length_2837_cov_50",95.758,165,7,0,525,689,1460,1296,1.94e-70,267,164,164
"71678","Nsylvestris_NODE_24953_length_774_cov_14","Ntome_NODE_19586_length_1227_cov_53",84.359,569,80,8,11,573,231,796,1.72e-155,549,562,565
"71682","Nsylvestris_NODE_24956_length_774_cov_8","Ntome_NODE_8989_length_2340_cov_170",93.536,789,26,11,1,774,428,1206,0,1151,773,778
"71683","Nsylvestris_NODE_24957_length_774_cov_6","Ntome_NODE_1362_length_4664_cov_148",96.268,777,25,2,1,774,2316,1541,0,1271,773,775
"71689","Nsylvestris_NODE_24960_length_773_cov_206","Ntome_NODE_32246_length_532_cov_16",85.829,374,49,2,189,562,154,523,8.52e-109,394,373,369
"71697","Nsylvestris_NODE_24964_length_773_cov_135","Ntome_NODE_2493_length_3912_cov_143",89.007,282,19,3,49,323,5,281,4.05e-92,339,274,276
"71712","Nsylvestris_NODE_24976_length_773_cov_6","Ntome_NODE_8170_length_2465_cov_87",92.587,688,45,3,88,772,1414,730,0,983,684,684
"71727","Nsylvestris_NODE_24984_length_772_cov_33","Ntome_NODE_27611_length_728_cov_6",85.266,319,33,10,454,763,1,314,1.9e-85,316,309,313
"71732","Nsylvestris_NODE_24987_length_772_cov_19","Ntome_NODE_6243_length_2799_cov_140",92.113,672,40,4,2,671,125,785,0,935,669,660
"71742","Nsylvestris_NODE_24993_length_772_cov_13","Ntome_NODE_20713_length_1137_cov_33",91.332,773,51,7,15,772,366,1137,0,1042,757,771
"71743","Nsylvestris_NODE_24995_length_772_cov_9","Ntome_NODE_8534_length_2408_cov_47",100,55,0,0,1,55,405,459,5.78e-21,102,54,54
"71753","Nsylvestris_NODE_24999_length_771_cov_191","Ntome_NODE_32026_length_548_cov_21",95.463,551,20,3,19,569,548,3,0,874,550,545
"71767","Nsylvestris_NODE_25005_length_771_cov_30","Ntome_NODE_6652_length_2720_cov_231",91.398,93,8,0,290,382,232,324,9.52e-29,128,92,92
"71768","Nsylvestris_NODE_25006_length_771_cov_23","Ntome_NODE_33539_length_444_cov_3",92.747,455,17,11,31,480,444,1,0,643,449,443
"71776","Nsylvestris_NODE_25010_length_771_cov_11","Ntome_NODE_10518_length_2130_cov_121",92.405,79,5,1,594,672,1441,1364,9.59e-24,111,78,77
"71780","Nsylvestris_NODE_25012_length_771_cov_8","Ntome_NODE_18574_length_1310_cov_171",85.327,443,51,6,7,447,1104,674,2.31e-124,446,440,430
"71781","Nsylvestris_NODE_25013_length_771_cov_8","Ntome_NODE_17968_length_1361_cov_30",89.535,774,46,15,1,771,81,822,0,948,770,741
"71789","Nsylvestris_NODE_25017_length_770_cov_200","Ntome_NODE_3430_length_3537_cov_166",96.364,770,19,3,1,770,1840,2600,0,1258,769,760
"71790","Nsylvestris_NODE_25018_length_770_cov_193","Ntome_NODE_6109_length_2829_cov_200",94.025,636,29,6,137,770,225,853,0,955,633,628
"71791","Nsylvestris_NODE_25019_length_770_cov_41","Ntome_NODE_13262_length_1813_cov_33",98.214,56,1,0,1,56,1803,1748,7.45e-20,99,55,55
"71805","Nsylvestris_NODE_25025_length_770_cov_12","Ntome_NODE_24907_length_869_cov_6",80.634,568,87,15,25,572,295,859,5.04e-116,418,547,564
"71806","Nsylvestris_NODE_25026_length_770_cov_9","Ntome_NODE_8365_length_2432_cov_262",98.182,55,1,0,1,55,685,631,2.68e-19,97.1,54,54
"71807","Nsylvestris_NODE_25027_length_770_cov_9","Ntome_NODE_33567_length_442_cov_4",92.551,443,18,8,236,665,441,1,3.58e-177,621,429,440
"71808","Nsylvestris_NODE_25028_length_770_cov_9","Ntome_NODE_25449_length_836_cov_5",87.562,201,25,0,569,769,1,201,1.96e-60,233,200,200
"71809","Nsylvestris_NODE_25029_length_770_cov_9","Ntome_NODE_15607_length_1575_cov_57",91.23,764,52,7,3,754,560,1320,0,1026,751,760
"71824","Nsylvestris_NODE_25036_length_770_cov_4","Ntome_NODE_17521_length_1401_cov_63",81.996,561,95,5,201,758,661,1218,3.81e-132,472,557,557
"71831","Nsylvestris_NODE_25040_length_769_cov_144","Ntome_NODE_17017_length_1447_cov_89",96.715,274,5,3,218,491,875,606,1.38e-126,453,273,269
"71838","Nsylvestris_NODE_25044_length_769_cov_50","Ntome_NODE_441_length_6188_cov_61",88.285,239,18,6,541,769,5973,5735,8.91e-74,278,228,238
"71839","Nsylvestris_NODE_25045_length_769_cov_47","Ntome_NODE_28154_length_703_cov_52",83.333,168,10,6,373,522,471,638,4.39e-32,139,149,167
"71891","Nsylvestris_NODE_25065_length_768_cov_17","Ntome_NODE_7877_length_2511_cov_56",98.113,53,1,0,716,768,913,965,3.46e-18,93.5,52,52
"71894","Nsylvestris_NODE_25067_length_768_cov_6","Ntome_NODE_7523_length_2567_cov_58",96.252,747,28,0,22,768,14,760,0,1225,746,746
"71904","Nsylvestris_NODE_25071_length_767_cov_105","Ntome_NODE_27262_length_745_cov_94",86.329,395,41,12,331,715,742,351,5.02e-116,418,384,391
"71907","Nsylvestris_NODE_25075_length_767_cov_26","Ntome_NODE_6168_length_2818_cov_188",82.032,807,85,17,1,767,2176,1390,1.65e-180,632,766,786
"71923","Nsylvestris_NODE_25083_length_765_cov_17","Ntome_NODE_15531_length_1581_cov_134",100,52,0,0,475,526,139,190,2.66e-19,97.1,51,51
"71931","Nsylvestris_NODE_25088_length_767_cov_11","Ntome_NODE_1059_length_5009_cov_156",93.79,773,30,8,1,767,2463,3223,0,1146,766,760
"71937","Nsylvestris_NODE_25091_length_767_cov_4","Ntome_NODE_14165_length_1720_cov_38",98.148,54,1,0,2,55,823,876,9.6e-19,95.3,53,53
"71945","Nsylvestris_NODE_25094_length_766_cov_195","Ntome_NODE_24284_length_907_cov_200",92.398,684,22,12,60,728,707,39,0,948,668,668
"71946","Nsylvestris_NODE_25095_length_766_cov_170","Ntome_NODE_4605_length_3181_cov_286",89.32,103,10,1,196,298,67,168,9.46e-29,128,102,101
"71947","Nsylvestris_NODE_25096_length_766_cov_131","Ntome_NODE_28818_length_675_cov_68",87.561,619,39,16,98,683,671,58,0,682,585,613
"71948","Nsylvestris_NODE_25097_length_766_cov_93","Ntome_NODE_2387_length_3967_cov_191",92.259,788,34,6,1,765,49,832,0,1092,764,783
"71961","Nsylvestris_NODE_25103_length_766_cov_7","Ntome_NODE_16680_length_1478_cov_72",98.182,55,1,0,712,766,581,527,2.67e-19,97.1,54,54
"71962","Nsylvestris_NODE_25104_length_766_cov_7","Ntome_NODE_30047_length_626_cov_4",98.333,60,1,0,1,60,479,538,4.43e-22,106,59,59
"71963","Nsylvestris_NODE_25106_length_765_cov_252","Ntome_NODE_977_length_5121_cov_115",89.955,448,41,2,288,731,753,306,2.81e-163,575,443,447
"71975","Nsylvestris_NODE_25111_length_765_cov_127","Ntome_NODE_18996_length_1276_cov_243",98.182,55,1,0,1,55,753,699,2.66e-19,97.1,54,54
"71980","Nsylvestris_NODE_25113_length_765_cov_93","Ntome_NODE_21638_length_1072_cov_40",89.063,128,12,1,373,500,503,378,1.2e-37,158,127,125
"71981","Nsylvestris_NODE_25114_length_765_cov_70","Ntome_NODE_34013_length_419_cov_2",93.478,230,15,0,51,280,230,1,3.1e-93,342,229,229
"71982","Nsylvestris_NODE_25115_length_765_cov_69","Ntome_NODE_21824_length_1059_cov_255",97.175,708,20,0,9,716,4,711,0,1197,707,707
"71989","Nsylvestris_NODE_25119_length_765_cov_15","Ntome_NODE_20395_length_1161_cov_290",98.182,55,1,0,1,55,347,401,2.66e-19,97.1,54,54
"72008","Nsylvestris_NODE_25131_length_764_cov_82","Ntome_NODE_5280_length_3012_cov_52",97.076,513,15,0,252,764,2957,2445,0,865,512,512
"72023","Nsylvestris_NODE_25138_length_764_cov_13","Ntome_NODE_15783_length_1559_cov_268",100,55,0,0,1,55,1056,1002,5.72e-21,102,54,54
"72026","Nsylvestris_NODE_25141_length_764_cov_8","Ntome_NODE_18244_length_1339_cov_60",82.906,351,60,0,414,764,418,768,1.88e-85,316,350,350
"72037","Nsylvestris_NODE_25146_length_763_cov_61","Ntome_NODE_2753_length_3787_cov_256",87.933,779,66,18,1,763,3543,2777,0,893,762,766
"72038","Nsylvestris_NODE_25147_length_763_cov_55","Ntome_NODE_18110_length_1349_cov_226",94.163,651,31,6,1,645,701,52,0,985,644,649
"72039","Nsylvestris_NODE_25148_length_763_cov_43","Ntome_NODE_420_length_6242_cov_30",94.889,763,39,0,1,763,3705,2943,0,1194,762,762
"72062","Nsylvestris_NODE_25157_length_763_cov_9","Ntome_NODE_29994_length_628_cov_7",97.963,589,12,0,1,589,37,625,0,1022,588,588
"72080","Nsylvestris_NODE_25164_length_762_cov_177","Ntome_NODE_27080_length_754_cov_224",91.867,750,47,7,27,762,752,3,0,1035,735,749
"72081","Nsylvestris_NODE_25165_length_762_cov_165","Ntome_NODE_28671_length_681_cov_190",92.193,538,41,1,137,674,635,99,0,760,537,536
"72085","Nsylvestris_NODE_25168_length_762_cov_35","Ntome_NODE_3914_length_3383_cov_119",82.143,196,30,4,145,337,611,418,2.58e-39,163,192,193
"72091","Nsylvestris_NODE_25170_length_762_cov_23","Ntome_NODE_10187_length_2173_cov_68",88.889,72,8,0,497,568,1468,1397,4.44e-17,89.8,71,71
"72095","Nsylvestris_NODE_25172_length_762_cov_12","Ntome_NODE_10542_length_2127_cov_40",90.658,471,39,5,1,467,6,475,3.54e-177,621,466,469
"72099","Nsylvestris_NODE_25174_length_762_cov_10","Ntome_NODE_19626_length_1224_cov_4",87.522,569,50,11,205,762,98,656,0,638,557,558
"72119","Nsylvestris_NODE_25182_length_761_cov_163","Ntome_NODE_5343_length_2998_cov_65",87.952,498,36,14,253,743,2498,2978,1.68e-160,566,490,480
"72120","Nsylvestris_NODE_25183_length_761_cov_157","Ntome_NODE_2494_length_3912_cov_126",90.031,642,39,11,32,655,3265,3899,0,808,623,634
"72123","Nsylvestris_NODE_25186_length_761_cov_43","Ntome_NODE_2075_length_4123_cov_201",97.143,140,4,0,50,189,518,379,1.5e-61,237,139,139
"72124","Nsylvestris_NODE_25187_length_761_cov_28","Ntome_NODE_1959_length_4204_cov_186",99.091,110,1,0,1,110,2179,2288,7.06e-50,198,109,109
"72125","Nsylvestris_NODE_25188_length_761_cov_19","Ntome_NODE_3203_length_3621_cov_181",86.082,661,56,18,73,726,3532,2901,0,678,653,631
"72130","Nsylvestris_NODE_25190_length_761_cov_12","Ntome_NODE_27032_length_756_cov_12",79.909,662,121,7,16,673,60,713,2.91e-133,475,657,653
"72142","Nsylvestris_NODE_25197_length_760_cov_219","Ntome_NODE_2660_length_3832_cov_153",98.421,760,12,0,1,760,3321,2562,0,1338,759,759
"72154","Nsylvestris_NODE_25202_length_760_cov_57","Ntome_NODE_14982_length_1638_cov_78",91.553,367,17,3,359,711,600,234,8.03e-139,494,352,366
"72159","Nsylvestris_NODE_25206_length_760_cov_19","Ntome_NODE_26969_length_760_cov_49",94.362,745,36,3,1,742,19,760,0,1138,741,741
"72164","Nsylvestris_NODE_25209_length_760_cov_9","Ntome_NODE_24632_length_884_cov_85",91.146,768,58,7,1,760,54,819,0,1033,759,765
"72174","Nsylvestris_NODE_25214_length_759_cov_133","Ntome_NODE_108_length_8380_cov_158",95.313,64,2,1,1,64,1420,1358,2.04e-20,100,63,62
"72175","Nsylvestris_NODE_25215_length_759_cov_120","Ntome_NODE_28571_length_685_cov_119",89.739,536,35,10,151,685,111,627,0,667,534,516
"72184","Nsylvestris_NODE_25220_length_759_cov_28","Ntome_NODE_965_length_5139_cov_257",81.414,764,87,31,1,759,1558,845,1e-162,573,758,713
"72185","Nsylvestris_NODE_25221_length_759_cov_25","Ntome_NODE_4607_length_3181_cov_213",96.051,709,26,2,1,708,2709,2002,0,1153,707,707
"72190","Nsylvestris_NODE_25224_length_759_cov_11","Ntome_NODE_21495_length_1081_cov_292",98.182,55,1,0,1,55,688,634,2.64e-19,97.1,54,54
"72213","Nsylvestris_NODE_25233_length_758_cov_70","Ntome_NODE_23890_length_931_cov_211",93.908,476,27,1,90,565,56,529,0,717,475,473
"72220","Nsylvestris_NODE_25237_length_758_cov_20","Ntome_NODE_5130_length_3048_cov_225",96.721,61,2,0,1,61,2097,2037,5.67e-21,102,60,60
"72230","Nsylvestris_NODE_25241_length_758_cov_9","Ntome_NODE_910_length_5214_cov_141",79.346,765,144,13,1,758,787,30,2.84e-148,525,757,757
"72233","Nsylvestris_NODE_25244_length_758_cov_6","Ntome_NODE_30211_length_620_cov_5",83.621,348,38,6,1,338,349,11,3.11e-83,309,337,338
"72234","Nsylvestris_NODE_25245_length_758_cov_5","Ntome_NODE_6898_length_2674_cov_271",100,55,0,0,704,758,332,278,5.67e-21,102,54,54
"72254","Nsylvestris_NODE_25253_length_757_cov_127","Ntome_NODE_1498_length_4534_cov_264",87.965,565,44,11,36,597,3906,4449,0,645,561,543
"72257","Nsylvestris_NODE_25256_length_757_cov_75","Ntome_NODE_8741_length_2379_cov_207",94.401,768,32,2,1,757,2324,1557,0,1170,756,767
"72258","Nsylvestris_NODE_25257_length_757_cov_60","Ntome_NODE_1196_length_4846_cov_250",92.447,331,10,11,400,720,4612,4287,2.92e-128,459,320,325
"72263","Nsylvestris_NODE_25260_length_757_cov_29","Ntome_NODE_15362_length_1597_cov_122",97.5,40,1,0,4,43,311,272,5.74e-11,69.4,39,39
"72271","Nsylvestris_NODE_25268_length_756_cov_189","Ntome_NODE_12122_length_1936_cov_6",95.455,44,2,0,1,44,1637,1680,1.59e-11,71.3,43,43
"72272","Nsylvestris_NODE_25269_length_756_cov_144","Ntome_NODE_29442_length_650_cov_64",90.476,462,29,6,239,690,457,1,2.13e-169,595,451,456
"72303","Nsylvestris_NODE_25284_length_755_cov_100","Ntome_NODE_22768_length_998_cov_209",90.878,581,32,6,130,709,42,602,0,760,579,560
"72317","Nsylvestris_NODE_25294_length_755_cov_16","Ntome_NODE_38389_length_280_cov_5",92.908,282,15,5,477,755,1,280,3.84e-112,405,278,279
"72335","Nsylvestris_NODE_25303_length_755_cov_6","Ntome_NODE_1560_length_4487_cov_116",91.293,758,57,7,1,754,3381,4133,0,1026,753,752
"72345","Nsylvestris_NODE_25309_length_754_cov_91","Ntome_NODE_27404_length_738_cov_5",89.009,646,43,13,47,684,65,690,0,774,637,625
"72346","Nsylvestris_NODE_25310_length_754_cov_49","Ntome_NODE_38503_length_278_cov_3",97.143,280,5,1,130,409,277,1,1.34e-131,470,279,276
"72364","Nsylvestris_NODE_25317_length_754_cov_8","Ntome_NODE_16656_length_1481_cov_254",96.364,55,2,0,1,55,554,500,1.22e-17,91.6,54,54
"72384","Nsylvestris_NODE_25329_length_753_cov_33","Ntome_NODE_32232_length_533_cov_20",92.25,529,24,10,219,744,515,1,0,734,525,514
"72385","Nsylvestris_NODE_25330_length_753_cov_30","Ntome_NODE_9855_length_2218_cov_45",92,75,5,1,335,408,2107,2181,1.57e-21,104,73,74
"72389","Nsylvestris_NODE_25335_length_753_cov_9","Ntome_NODE_3573_length_3493_cov_193",92.308,52,4,0,1,52,815,764,1.23e-12,75,51,51
"72397","Nsylvestris_NODE_25341_length_752_cov_223","Ntome_NODE_11177_length_2051_cov_295",95.857,700,29,0,53,752,2006,1307,0,1133,699,699
"72401","Nsylvestris_NODE_25343_length_752_cov_188","Ntome_NODE_15116_length_1622_cov_234",97.685,648,15,0,105,752,198,845,0,1114,647,647
"72402","Nsylvestris_NODE_25344_length_752_cov_185","Ntome_NODE_2887_length_3744_cov_90",94.526,548,27,1,101,648,48,592,0,843,547,544
"72405","Nsylvestris_NODE_25347_length_752_cov_74","Ntome_NODE_23804_length_936_cov_233",94.459,758,26,10,1,752,84,831,0,1153,751,747
"72452","Nsylvestris_NODE_25366_length_751_cov_29","Ntome_NODE_4781_length_3138_cov_205",90.363,716,29,8,1,695,2644,1948,0,904,694,696
"72456","Nsylvestris_NODE_25370_length_751_cov_11","Ntome_NODE_22181_length_1036_cov_6",92.418,699,44,5,52,748,118,809,0,989,696,691
"72457","Nsylvestris_NODE_25372_length_751_cov_8","Ntome_NODE_18512_length_1316_cov_14",96.296,54,2,0,697,750,1186,1133,4.37e-17,89.8,53,53
"72468","Nsylvestris_NODE_25378_length_750_cov_157","Ntome_NODE_11100_length_2060_cov_246",98.182,55,1,0,1,55,873,819,2.61e-19,97.1,54,54
"72476","Nsylvestris_NODE_25383_length_750_cov_11","Ntome_NODE_5908_length_2870_cov_263",98.182,55,1,0,1,55,2522,2576,2.61e-19,97.1,54,54
"72490","Nsylvestris_NODE_25392_length_749_cov_33","Ntome_NODE_1635_length_4431_cov_50",88.095,210,17,4,528,730,1655,1447,3.16e-63,243,202,208
"72491","Nsylvestris_NODE_25393_length_749_cov_27","Ntome_NODE_32595_length_506_cov_22",85.855,509,46,9,103,589,505,1,4.69e-146,518,486,504
"72492","Nsylvestris_NODE_25394_length_749_cov_23","Ntome_NODE_1906_length_4233_cov_204",94.915,59,2,1,1,58,1584,1642,1.21e-17,91.6,57,58
"72498","Nsylvestris_NODE_25396_length_749_cov_18","Ntome_NODE_8800_length_2370_cov_163",98.276,58,0,1,691,748,1411,1355,2.01e-20,100,57,56
"72499","Nsylvestris_NODE_25397_length_749_cov_17","Ntome_NODE_5381_length_2989_cov_210",96.364,55,2,0,1,55,2310,2256,1.21e-17,91.6,54,54
"72516","Nsylvestris_NODE_25405_length_749_cov_6","Ntome_NODE_5102_length_3054_cov_99",94.681,752,27,7,1,749,223,964,0,1155,748,741
"72531","Nsylvestris_NODE_25411_length_748_cov_179","Ntome_NODE_1697_length_4384_cov_204",95.989,748,30,0,1,748,2217,1470,0,1216,747,747
"72534","Nsylvestris_NODE_25413_length_748_cov_94","Ntome_NODE_609_length_5750_cov_80",93.681,633,24,8,1,633,5118,5734,0,933,632,616
"72535","Nsylvestris_NODE_25414_length_748_cov_90","Ntome_NODE_28722_length_679_cov_58",92.251,684,30,4,34,717,14,674,0,948,683,660
"72536","Nsylvestris_NODE_25415_length_748_cov_47","Ntome_NODE_17482_length_1405_cov_95",93.605,516,31,1,81,594,53,568,0,769,513,515
"72537","Nsylvestris_NODE_25416_length_748_cov_44","Ntome_NODE_10387_length_2147_cov_145",96.364,55,2,0,694,748,777,723,1.21e-17,91.6,54,54
"72538","Nsylvestris_NODE_25417_length_748_cov_44","Ntome_NODE_3685_length_3456_cov_169",96.447,197,7,0,317,513,2604,2800,3.05e-88,326,196,196
"72539","Nsylvestris_NODE_25418_length_747_cov_42","Ntome_NODE_22771_length_998_cov_99",89.826,688,46,13,11,691,721,51,0,861,680,670
"72553","Nsylvestris_NODE_25424_length_748_cov_12","Ntome_NODE_23766_length_939_cov_36",82.823,751,77,29,23,748,724,1,2.68e-178,625,725,723
"72554","Nsylvestris_NODE_25427_length_748_cov_6","Ntome_NODE_13053_length_1836_cov_28",89.831,767,53,15,1,743,841,76,0,961,742,765
"72577","Nsylvestris_NODE_25437_length_747_cov_39","Ntome_NODE_9040_length_2331_cov_202",96.371,744,22,2,1,742,1194,454,0,1219,741,740
"72578","Nsylvestris_NODE_25439_length_747_cov_31","Ntome_NODE_17605_length_1393_cov_143",90.265,113,9,2,635,747,111,1,2.54e-34,147,112,110
"72584","Nsylvestris_NODE_25445_length_747_cov_15","Ntome_NODE_1910_length_4228_cov_172",98.182,55,1,0,693,747,3726,3780,2.6e-19,97.1,54,54
"72585","Nsylvestris_NODE_25446_length_747_cov_11","Ntome_NODE_7209_length_2620_cov_261",100,55,0,0,1,55,1875,1821,5.58e-21,102,54,54
"72595","Nsylvestris_NODE_25452_length_746_cov_221","Ntome_NODE_2937_length_3722_cov_224",98.525,746,8,1,1,746,2100,1358,0,1314,745,742
"72599","Nsylvestris_NODE_25454_length_746_cov_189","Ntome_NODE_557_length_5878_cov_117",98,50,1,0,1,50,5726,5677,1.56e-16,87.9,49,49
"72608","Nsylvestris_NODE_25458_length_746_cov_83","Ntome_NODE_30124_length_623_cov_16",89.54,631,43,13,79,696,623,3,0,778,617,620
"72614","Nsylvestris_NODE_25463_length_746_cov_30","Ntome_NODE_23831_length_935_cov_101",89.7,767,53,10,1,742,862,97,0,955,741,765
"72615","Nsylvestris_NODE_25464_length_746_cov_16","Ntome_NODE_6897_length_2674_cov_311",100,52,0,0,692,743,2202,2253,2.59e-19,97.1,51,51
"72622","Nsylvestris_NODE_25467_length_746_cov_11","Ntome_NODE_3110_length_3655_cov_236",100,52,0,0,4,55,2351,2300,2.59e-19,97.1,51,51
"72623","Nsylvestris_NODE_25468_length_746_cov_8","Ntome_NODE_8378_length_2430_cov_215",91.045,737,44,8,1,729,1459,737,0,976,728,722
"72627","Nsylvestris_NODE_25470_length_746_cov_7","Ntome_NODE_11578_length_2005_cov_161",98.182,55,1,0,1,55,1016,1070,2.59e-19,97.1,54,54
"72637","Nsylvestris_NODE_25476_length_745_cov_55","Ntome_NODE_14855_length_1648_cov_295",93.478,92,6,0,443,534,991,900,1.53e-31,137,91,91
"72638","Nsylvestris_NODE_25479_length_745_cov_16","Ntome_NODE_21401_length_1088_cov_267",96.552,58,2,0,1,58,651,594,2.59e-19,97.1,57,57
"72642","Nsylvestris_NODE_25484_length_745_cov_6","Ntome_NODE_11221_length_2047_cov_89",85.484,186,24,3,460,644,1726,1909,1.16e-47,191,184,183
"72643","Nsylvestris_NODE_25485_length_745_cov_5","Ntome_NODE_4215_length_3289_cov_68",90.047,633,54,9,118,745,1579,951,0,811,627,628
"72647","Nsylvestris_NODE_25487_length_744_cov_138","Ntome_NODE_12945_length_1847_cov_99",96.635,743,25,0,2,744,314,1056,0,1234,742,742
"72663","Nsylvestris_NODE_25494_length_744_cov_22","Ntome_NODE_10763_length_2099_cov_272",96.364,55,2,0,690,744,601,547,1.2e-17,91.6,54,54
"72680","Nsylvestris_NODE_25502_length_744_cov_10","Ntome_NODE_11914_length_1967_cov_235",96.341,82,2,1,346,427,1298,1378,1.97e-30,134,81,80
"72681","Nsylvestris_NODE_25504_length_744_cov_8","Ntome_NODE_23994_length_925_cov_28",88.764,178,19,1,567,744,393,569,1.9e-55,217,177,176
"72682","Nsylvestris_NODE_25506_length_744_cov_6","Ntome_NODE_23764_length_939_cov_44",94.519,748,27,10,1,744,1,738,0,1142,743,737
"72692","Nsylvestris_NODE_25510_length_743_cov_84","Ntome_NODE_3874_length_3396_cov_118",100,55,0,0,689,743,528,582,5.55e-21,102,54,54
"72693","Nsylvestris_NODE_25511_length_743_cov_48","Ntome_NODE_27449_length_735_cov_56",91.213,569,25,8,80,643,706,158,0,750,563,548
"72704","Nsylvestris_NODE_25516_length_743_cov_23","Ntome_NODE_1749_length_4344_cov_220",87.437,398,21,13,59,430,3731,3337,6.24e-120,431,371,394
"72707","Nsylvestris_NODE_25523_length_743_cov_7","Ntome_NODE_24046_length_922_cov_13",98.305,59,1,0,1,59,542,600,1.54e-21,104,58,58
"72708","Nsylvestris_NODE_25526_length_743_cov_4","Ntome_NODE_20690_length_1139_cov_13",94.342,760,24,4,1,743,287,1044,0,1147,742,757
"72709","Nsylvestris_NODE_25527_length_742_cov_192","Ntome_NODE_19861_length_1204_cov_154",96.349,493,18,0,31,523,1138,646,0,811,492,492
"72721","Nsylvestris_NODE_25531_length_742_cov_69","Ntome_NODE_8693_length_2386_cov_154",92.194,679,48,4,66,742,53,728,0,955,676,675
"72722","Nsylvestris_NODE_25533_length_742_cov_38","Ntome_NODE_21288_length_1095_cov_223",88.633,695,54,11,58,733,930,242,0,822,675,688
"72726","Nsylvestris_NODE_25538_length_742_cov_15","Ntome_NODE_26928_length_762_cov_31",89.909,773,36,15,1,742,762,1,0,957,741,761
"72727","Nsylvestris_NODE_25539_length_742_cov_11","Ntome_NODE_5538_length_2953_cov_143",92.349,745,54,1,1,742,2735,1991,0,1057,741,744
"72728","Nsylvestris_NODE_25542_length_742_cov_7","Ntome_NODE_29616_length_643_cov_254",100,55,0,0,1,55,186,132,5.55e-21,102,54,54
"72729","Nsylvestris_NODE_25544_length_742_cov_6","Ntome_NODE_24594_length_886_cov_199",96.364,55,2,0,688,742,207,261,1.2e-17,91.6,54,54
"72733","Nsylvestris_NODE_25546_length_741_cov_179","Ntome_NODE_6906_length_2673_cov_255",92.982,57,4,0,1,57,1588,1532,2.01e-15,84.2,56,56
"72741","Nsylvestris_NODE_25549_length_741_cov_105","Ntome_NODE_25839_length_813_cov_204",95,740,30,4,4,741,744,10,0,1155,737,734
"72755","Nsylvestris_NODE_25555_length_741_cov_52","Ntome_NODE_22725_length_1002_cov_94",94.838,678,23,5,74,740,751,75,0,1048,666,676
"72777","Nsylvestris_NODE_25562_length_741_cov_13","Ntome_NODE_3025_length_3689_cov_260",100,55,0,0,1,55,3063,3009,5.54e-21,102,54,54
"72778","Nsylvestris_NODE_25563_length_741_cov_12","Ntome_NODE_9779_length_2228_cov_195",96.364,55,2,0,687,741,1238,1184,1.2e-17,91.6,54,54
"72779","Nsylvestris_NODE_25564_length_741_cov_12","Ntome_NODE_3964_length_3366_cov_196",84.497,587,61,18,172,741,1628,1055,1.27e-156,553,569,573
"72780","Nsylvestris_NODE_25565_length_741_cov_8","Ntome_NODE_37694_length_295_cov_3",90.268,298,22,5,382,675,1,295,1.77e-105,383,293,294
"72790","Nsylvestris_NODE_25571_length_740_cov_214","Ntome_NODE_7928_length_2500_cov_290",92.272,647,21,8,29,659,48,681,0,891,630,633
"72803","Nsylvestris_NODE_25577_length_740_cov_86","Ntome_NODE_5124_length_3049_cov_197",98.182,55,1,0,1,55,138,84,2.57e-19,97.1,54,54
"72808","Nsylvestris_NODE_25580_length_740_cov_66","Ntome_NODE_524_length_5958_cov_138",89.655,58,5,1,48,104,5441,5498,4.34e-12,73.1,56,57
"72814","Nsylvestris_NODE_25583_length_740_cov_12","Ntome_NODE_24773_length_876_cov_27",87.773,229,26,2,135,362,587,814,1.85e-70,267,227,227
"72818","Nsylvestris_NODE_25585_length_740_cov_11","Ntome_NODE_11341_length_2032_cov_223",98.182,55,1,0,686,740,1517,1463,2.57e-19,97.1,54,54
"72819","Nsylvestris_NODE_25586_length_740_cov_11","Ntome_NODE_2811_length_3768_cov_78",75.89,730,173,3,1,729,1897,1170,1.37e-101,370,728,727
"72820","Nsylvestris_NODE_25590_length_740_cov_4","Ntome_NODE_38322_length_282_cov_3",100,31,0,0,19,49,252,222,1.21e-07,58.4,30,30
"72821","Nsylvestris_NODE_25591_length_740_cov_3","Ntome_NODE_125_length_8087_cov_115",87.838,74,7,2,1,74,6331,6260,5.57e-16,86.1,73,71
"72822","Nsylvestris_NODE_25592_length_740_cov_2","Ntome_NODE_11550_length_2008_cov_199",100,55,0,0,686,740,815,761,5.53e-21,102,54,54
"72829","Nsylvestris_NODE_25595_length_739_cov_161","Ntome_NODE_24220_length_911_cov_223",90.449,691,42,8,28,697,4,691,0,889,669,687
"72833","Nsylvestris_NODE_25598_length_739_cov_62","Ntome_NODE_13330_length_1805_cov_17",93.324,704,47,0,36,739,1702,999,0,1040,703,703
"72837","Nsylvestris_NODE_25602_length_739_cov_49","Ntome_NODE_32465_length_516_cov_256",80.061,326,21,15,378,682,362,60,5.29e-51,202,304,302
"72838","Nsylvestris_NODE_25603_length_739_cov_34","Ntome_NODE_33198_length_463_cov_25",79.57,279,43,10,303,577,86,354,1.48e-46,187,274,268
"72839","Nsylvestris_NODE_25604_length_739_cov_28","Ntome_NODE_10676_length_2110_cov_57",89.247,465,30,7,1,446,1470,1007,5.86e-160,564,445,463
"72848","Nsylvestris_NODE_25610_length_739_cov_13","Ntome_NODE_9113_length_2321_cov_304",94.737,57,1,1,685,739,2083,2139,1.55e-16,87.9,54,56
"72854","Nsylvestris_NODE_25615_length_739_cov_7","Ntome_NODE_19835_length_1207_cov_15",97.429,739,19,0,1,739,1163,425,0,1260,738,738
"72855","Nsylvestris_NODE_25617_length_739_cov_5","Ntome_NODE_7821_length_2520_cov_291",98.182,55,1,0,685,739,1381,1435,2.57e-19,97.1,54,54
"72864","Nsylvestris_NODE_25622_length_738_cov_120","Ntome_NODE_2895_length_3738_cov_123",98.182,55,1,0,684,738,1086,1140,2.57e-19,97.1,54,54
"72867","Nsylvestris_NODE_25626_length_738_cov_35","Ntome_NODE_11790_length_1982_cov_85",87.342,79,2,1,660,738,138,68,2e-15,84.2,78,70
"72868","Nsylvestris_NODE_25628_length_738_cov_24","Ntome_NODE_27392_length_738_cov_64",94.436,683,37,1,1,682,683,1,0,1050,681,682
"72869","Nsylvestris_NODE_25629_length_738_cov_23","Ntome_NODE_22588_length_1010_cov_251",76.838,544,95,14,39,556,133,671,8.54e-74,278,517,538
"72870","Nsylvestris_NODE_25632_length_738_cov_17","Ntome_NODE_11067_length_2065_cov_91",96.364,55,2,0,684,738,1669,1615,1.19e-17,91.6,54,54
"72874","Nsylvestris_NODE_25634_length_738_cov_13","Ntome_NODE_20714_length_1137_cov_25",91.644,730,40,9,13,729,722,1,0,990,716,721
"72877","Nsylvestris_NODE_25636_length_738_cov_8","Ntome_NODE_25061_length_860_cov_17",94.03,737,44,0,2,738,79,815,0,1118,736,736
"72888","Nsylvestris_NODE_25644_length_737_cov_100","Ntome_NODE_21209_length_1101_cov_192",92.069,580,23,8,63,635,843,280,0,795,572,563
"72918","Nsylvestris_NODE_25658_length_736_cov_159","Ntome_NODE_29177_length_661_cov_52",89.44,625,39,8,92,715,601,3,0,763,623,598
"72929","Nsylvestris_NODE_25665_length_736_cov_17","Ntome_NODE_39244_length_263_cov_3",82.209,163,21,4,571,732,46,201,1.95e-30,134,161,155
"72963","Nsylvestris_NODE_25687_length_735_cov_12","Ntome_NODE_30207_length_620_cov_10",96.075,535,21,0,201,735,1,535,0,872,534,534
"72966","Nsylvestris_NODE_25689_length_735_cov_8","Ntome_NODE_5531_length_2954_cov_282",96.552,58,2,0,1,58,1877,1820,2.55e-19,97.1,57,57
"72974","Nsylvestris_NODE_25696_length_734_cov_201","Ntome_NODE_758_length_5450_cov_43",97.275,734,18,2,1,734,4088,3357,0,1243,733,731
"72980","Nsylvestris_NODE_25699_length_734_cov_176","Ntome_NODE_29440_length_650_cov_68",92.892,408,28,1,27,433,1,408,2.67e-168,592,406,407
"72983","Nsylvestris_NODE_25702_length_734_cov_39","Ntome_NODE_32676_length_500_cov_6",95.8,500,21,0,193,692,1,500,0,808,499,499
"72992","Nsylvestris_NODE_25706_length_734_cov_8","Ntome_NODE_12488_length_1898_cov_256",100,55,0,0,680,734,779,833,5.48e-21,102,54,54
"72993","Nsylvestris_NODE_25707_length_734_cov_5","Ntome_NODE_18166_length_1346_cov_7",87.302,252,17,6,47,285,879,630,1.1e-72,274,238,249
"73001","Nsylvestris_NODE_25711_length_733_cov_100","Ntome_NODE_8835_length_2363_cov_173",98.182,55,1,0,679,733,2328,2274,2.55e-19,97.1,54,54
"73002","Nsylvestris_NODE_25712_length_733_cov_98","Ntome_NODE_11767_length_1985_cov_117",95.238,63,3,0,671,733,428,490,1.97e-20,100,62,62
"73003","Nsylvestris_NODE_25714_length_733_cov_19","Ntome_NODE_2657_length_3834_cov_260",100,55,0,0,679,733,2751,2697,5.48e-21,102,54,54
"73004","Nsylvestris_NODE_25715_length_733_cov_16","Ntome_NODE_18841_length_1288_cov_19",94.058,690,26,2,1,678,1059,373,0,1033,677,686
"73005","Nsylvestris_NODE_25717_length_733_cov_11","Ntome_NODE_31165_length_583_cov_12",93.46,581,38,0,65,645,1,581,0,863,580,580
"73006","Nsylvestris_NODE_25721_length_733_cov_6","Ntome_NODE_21004_length_1116_cov_19",93.467,750,26,6,2,733,277,1021,0,1092,731,744
"73009","Nsylvestris_NODE_25723_length_732_cov_151","Ntome_NODE_29527_length_647_cov_72",89.465,617,45,7,31,645,2,600,0,761,614,598
"73014","Nsylvestris_NODE_25725_length_732_cov_87","Ntome_NODE_25553_length_830_cov_79",88.538,253,26,3,270,521,471,721,1.4e-81,303,251,250
"73020","Nsylvestris_NODE_25728_length_732_cov_28","Ntome_NODE_15565_length_1578_cov_276",100,55,0,0,1,55,931,877,5.47e-21,102,54,54
"73029","Nsylvestris_NODE_25734_length_732_cov_6","Ntome_NODE_29127_length_663_cov_17",87.407,135,10,6,367,498,131,1,6.92e-35,148,131,130
"73041","Nsylvestris_NODE_25739_length_731_cov_194","Ntome_NODE_3181_length_3626_cov_155",89.714,700,44,13,51,724,3573,2876,0,869,673,697
"73047","Nsylvestris_NODE_25743_length_731_cov_50","Ntome_NODE_8557_length_2404_cov_319",100,55,0,0,1,55,221,167,5.46e-21,102,54,54
"73057","Nsylvestris_NODE_25746_length_731_cov_22","Ntome_NODE_19211_length_1259_cov_24",92.185,691,42,4,50,730,698,10,0,966,680,688
"73058","Nsylvestris_NODE_25747_length_731_cov_18","Ntome_NODE_13737_length_1763_cov_308",100,55,0,0,677,731,1111,1165,5.46e-21,102,54,54
"73061","Nsylvestris_NODE_25749_length_731_cov_15","Ntome_NODE_1885_length_4247_cov_241",74.342,456,102,14,25,473,1086,639,2.45e-44,180,448,447
"73079","Nsylvestris_NODE_25759_length_731_cov_4","Ntome_NODE_8978_length_2342_cov_84",98.02,101,2,0,631,731,2288,2188,3.17e-43,176,100,100
"73080","Nsylvestris_NODE_25760_length_731_cov_4","Ntome_NODE_33502_length_446_cov_5",94.515,237,12,1,495,731,1,236,6.31e-100,364,236,235
"73090","Nsylvestris_NODE_25766_length_732_cov_52","Ntome_NODE_114_length_8248_cov_183",95.082,61,0,2,1,60,7209,7151,3.29e-18,93.5,59,58
"73091","Nsylvestris_NODE_25768_length_730_cov_38","Ntome_NODE_6816_length_2690_cov_171",94.545,55,3,0,1,55,2493,2439,5.49e-16,86.1,54,54
"73092","Nsylvestris_NODE_25769_length_730_cov_31","Ntome_NODE_1588_length_4464_cov_133",97.436,624,16,0,107,730,4173,3550,0,1064,623,623
"73096","Nsylvestris_NODE_25771_length_730_cov_23","Ntome_NODE_28436_length_691_cov_25",92.89,661,34,5,1,655,30,683,0,948,654,653
"73101","Nsylvestris_NODE_25775_length_730_cov_7","Ntome_NODE_4685_length_3162_cov_137",94.203,414,19,4,126,538,412,3,7.28e-179,627,412,409
"73102","Nsylvestris_NODE_25776_length_729_cov_205","Ntome_NODE_170_length_7622_cov_303",94.818,714,27,9,1,709,6878,7586,0,1105,708,708
"73112","Nsylvestris_NODE_25781_length_729_cov_82","Ntome_NODE_34476_length_396_cov_10",96.154,52,2,0,1,52,152,203,5.48e-16,86.1,51,51
"73121","Nsylvestris_NODE_25785_length_729_cov_28","Ntome_NODE_16763_length_1469_cov_216",94.737,57,3,0,8,64,389,333,4.24e-17,89.8,56,56
"73124","Nsylvestris_NODE_25789_length_729_cov_7","Ntome_NODE_1397_length_4635_cov_201",100,55,0,0,1,55,1356,1410,5.44e-21,102,54,54
"73128","Nsylvestris_NODE_25792_length_728_cov_191","Ntome_NODE_26497_length_782_cov_131",87.755,686,35,22,1,659,758,95,0,756,658,663
"73129","Nsylvestris_NODE_25793_length_728_cov_183","Ntome_NODE_30821_length_595_cov_47",94.843,543,28,0,112,654,50,592,0,848,542,542
"73133","Nsylvestris_NODE_25795_length_728_cov_93","Ntome_NODE_2691_length_3818_cov_231",89.828,698,45,10,16,699,741,56,0,872,683,685
"73142","Nsylvestris_NODE_25799_length_728_cov_86","Ntome_NODE_32410_length_520_cov_19",92.471,518,31,3,56,565,520,3,0,734,509,517
"73157","Nsylvestris_NODE_25806_length_728_cov_12","Ntome_NODE_26592_length_778_cov_4",88.01,417,29,9,109,525,765,370,1e-132,473,416,395
"73158","Nsylvestris_NODE_25807_length_728_cov_11","Ntome_NODE_18127_length_1348_cov_226",96.364,55,2,0,1,55,613,667,1.18e-17,91.6,54,54
"73167","Nsylvestris_NODE_25811_length_727_cov_7","Ntome_NODE_21387_length_1089_cov_269",100,36,0,0,692,727,379,414,1.98e-10,67.6,35,35
"73168","Nsylvestris_NODE_25812_length_728_cov_7","Ntome_NODE_20108_length_1184_cov_25",100,31,0,0,86,116,740,710,1.19e-07,58.4,30,30
"73169","Nsylvestris_NODE_25813_length_728_cov_7","Ntome_NODE_21484_length_1083_cov_20",95.742,728,31,0,1,728,134,861,0,1173,727,727
"73175","Nsylvestris_NODE_25815_length_728_cov_4","Ntome_NODE_38470_length_278_cov_7",86.364,88,6,6,88,171,273,188,1.18e-17,91.6,83,85
"73187","Nsylvestris_NODE_25820_length_727_cov_103","Ntome_NODE_37023_length_310_cov_6",89.198,324,21,2,264,587,310,1,2.88e-108,392,323,309
"73193","Nsylvestris_NODE_25823_length_727_cov_31","Ntome_NODE_28565_length_686_cov_5",97.727,44,1,0,684,727,611,568,3.29e-13,76.8,43,43
"73197","Nsylvestris_NODE_25825_length_727_cov_20","Ntome_NODE_14050_length_1732_cov_285",84.665,313,48,0,95,407,963,1275,2.3e-84,313,312,312
"73203","Nsylvestris_NODE_25828_length_727_cov_14","Ntome_NODE_14087_length_1729_cov_7",88.462,52,6,0,645,696,1638,1689,2.56e-09,63.9,51,51
"73211","Nsylvestris_NODE_25833_length_727_cov_8","Ntome_NODE_15474_length_1586_cov_55",77.778,675,127,15,28,686,905,238,8e-109,394,658,667
"73221","Nsylvestris_NODE_25837_length_726_cov_135","Ntome_NODE_2008_length_4169_cov_231",96.364,55,2,0,672,726,3117,3063,1.17e-17,91.6,54,54
"73222","Nsylvestris_NODE_25839_length_726_cov_93","Ntome_NODE_17000_length_1448_cov_275",88.643,678,71,1,49,726,479,1150,0,821,677,671
"73232","Nsylvestris_NODE_25846_length_726_cov_31","Ntome_NODE_21542_length_1078_cov_238",98.182,55,1,0,1,55,593,647,2.52e-19,97.1,54,54
"73241","Nsylvestris_NODE_25853_length_726_cov_10","Ntome_NODE_207_length_7386_cov_127",90.278,72,5,2,656,726,544,474,3.26e-18,93.5,70,70
"73252","Nsylvestris_NODE_25858_length_726_cov_4","Ntome_NODE_14010_length_1737_cov_12",89.441,161,9,6,562,718,1198,1354,2.42e-49,196,156,156
"73253","Nsylvestris_NODE_25859_length_725_cov_188","Ntome_NODE_15316_length_1603_cov_140",85.948,427,31,10,52,449,117,543,2.19e-119,429,397,426
"73258","Nsylvestris_NODE_25861_length_725_cov_133","Ntome_NODE_8319_length_2439_cov_173",94.354,673,38,0,1,673,709,37,0,1033,672,672
"73259","Nsylvestris_NODE_25862_length_725_cov_125","Ntome_NODE_26626_length_776_cov_90",90.698,645,16,14,104,722,110,736,0,819,618,626
"73268","Nsylvestris_NODE_25866_length_725_cov_45","Ntome_NODE_20709_length_1137_cov_134",91.803,610,25,6,116,721,420,1008,0,826,605,588
"73274","Nsylvestris_NODE_25869_length_725_cov_40","Ntome_NODE_35385_length_358_cov_317",100,55,0,0,1,55,235,289,5.41e-21,102,54,54
"73279","Nsylvestris_NODE_25871_length_725_cov_12","Ntome_NODE_37699_length_295_cov_3",96.61,295,10,0,209,503,1,295,9.89e-138,490,294,294
"73282","Nsylvestris_NODE_25873_length_725_cov_11","Ntome_NODE_3974_length_3363_cov_83",90.297,639,30,16,1,638,609,2,0,808,637,607
"73283","Nsylvestris_NODE_25874_length_725_cov_9","Ntome_NODE_2646_length_3840_cov_116",96.364,55,2,0,671,725,2650,2596,1.17e-17,91.6,54,54
"73292","Nsylvestris_NODE_25878_length_725_cov_6","Ntome_NODE_30620_length_603_cov_12",86.433,457,27,22,278,725,603,173,4.63e-131,468,447,430
"73305","Nsylvestris_NODE_25883_length_724_cov_107","Ntome_NODE_10147_length_2178_cov_232",94.444,666,34,1,62,724,57,722,0,1022,662,665
"73306","Nsylvestris_NODE_25884_length_721_cov_105","Ntome_NODE_23854_length_933_cov_201",83.673,392,48,9,332,715,433,50,3.74e-97,355,383,383
"73307","Nsylvestris_NODE_25886_length_724_cov_66","Ntome_NODE_14711_length_1665_cov_9",88.98,608,66,1,1,607,907,1514,0,750,606,607
"73311","Nsylvestris_NODE_25888_length_724_cov_37","Ntome_NODE_27737_length_723_cov_6",95.696,697,29,1,28,724,723,28,0,1120,696,695
"73315","Nsylvestris_NODE_25890_length_724_cov_20","Ntome_NODE_22850_length_993_cov_38",92.683,41,1,2,93,131,897,857,1.19e-07,58.4,38,40
"73344","Nsylvestris_NODE_25906_length_723_cov_44","Ntome_NODE_27650_length_726_cov_27",89.45,673,46,8,25,689,664,9,0,826,664,655
"73347","Nsylvestris_NODE_25911_length_723_cov_12","Ntome_NODE_395_length_6322_cov_124",86.999,723,94,0,1,723,2933,2211,0,815,722,722
"73358","Nsylvestris_NODE_25916_length_723_cov_10","Ntome_NODE_2536_length_3891_cov_197",98.182,55,1,0,669,723,964,1018,2.51e-19,97.1,54,54
"73375","Nsylvestris_NODE_25925_length_722_cov_79","Ntome_NODE_8908_length_2352_cov_134",91.429,70,4,2,466,534,1725,1793,9.02e-19,95.3,68,68
"73376","Nsylvestris_NODE_25926_length_722_cov_76","Ntome_NODE_18667_length_1303_cov_132",94.345,672,38,0,1,672,1150,479,0,1031,671,671
"73377","Nsylvestris_NODE_25927_length_722_cov_61","Ntome_NODE_10722_length_2105_cov_75",98.068,207,4,0,1,207,1085,879,8.06e-99,361,206,206
"73396","Nsylvestris_NODE_25940_length_721_cov_237","Ntome_NODE_4942_length_3099_cov_246",89.331,703,40,5,1,669,1961,1260,0,850,668,701
"73414","Nsylvestris_NODE_25946_length_721_cov_167","Ntome_NODE_31765_length_561_cov_227",90.98,510,35,4,1,507,11,512,0,676,506,501
"73418","Nsylvestris_NODE_25948_length_721_cov_85","Ntome_NODE_30064_length_625_cov_23",93.849,634,22,8,28,657,621,1,0,939,629,620
"73419","Nsylvestris_NODE_25950_length_721_cov_38","Ntome_NODE_456_length_6137_cov_19",85.714,196,28,0,521,716,1442,1247,1.11e-52,207,195,195
"73426","Nsylvestris_NODE_25954_length_721_cov_9","Ntome_NODE_16297_length_1512_cov_142",100,55,0,0,667,721,811,757,5.38e-21,102,54,54
"73427","Nsylvestris_NODE_25957_length_721_cov_6","Ntome_NODE_1680_length_4402_cov_293",85.897,156,20,2,514,667,400,245,6.77e-40,165,153,155
"73428","Nsylvestris_NODE_25958_length_721_cov_5","Ntome_NODE_21856_length_1057_cov_35",96.296,54,2,0,2,55,561,508,4.19e-17,89.8,53,53
"73445","Nsylvestris_NODE_25966_length_720_cov_44","Ntome_NODE_5393_length_2987_cov_248",94.498,727,31,7,1,720,743,1467,0,1112,719,724
"73453","Nsylvestris_NODE_25970_length_720_cov_33","Ntome_NODE_7908_length_2505_cov_33",85.849,106,12,3,2,105,1696,1800,3.21e-23,110,103,104
"73454","Nsylvestris_NODE_25971_length_720_cov_30","Ntome_NODE_12157_length_1939_cov_84",93.304,672,41,2,48,719,975,308,0,989,671,667
"73465","Nsylvestris_NODE_25977_length_720_cov_6","Ntome_NODE_21425_length_1087_cov_10",86.316,95,13,0,471,565,1079,985,1.49e-21,104,94,94
"73466","Nsylvestris_NODE_25978_length_720_cov_6","Ntome_NODE_2897_length_3737_cov_145",93.465,658,22,6,1,652,680,1322,0,957,651,642
"73469","Nsylvestris_NODE_25980_length_720_cov_6","Ntome_NODE_7725_length_2537_cov_115",98.182,55,1,0,666,720,1868,1922,2.5e-19,97.1,54,54
"73480","Nsylvestris_NODE_25984_length_719_cov_200","Ntome_NODE_865_length_5279_cov_273",95.627,686,22,5,36,719,5247,4568,0,1094,683,679
"73484","Nsylvestris_NODE_25986_length_719_cov_193","Ntome_NODE_25213_length_850_cov_237",93.724,733,29,3,1,719,109,838,0,1083,718,729
"73485","Nsylvestris_NODE_25987_length_719_cov_184","Ntome_NODE_36425_length_326_cov_167",92.593,162,11,1,559,719,53,214,6.56e-60,231,160,161
"73497","Nsylvestris_NODE_25993_length_719_cov_32","Ntome_NODE_4436_length_3225_cov_209",86.254,582,78,2,1,581,2247,2827,5.54e-180,630,580,580
"73518","Nsylvestris_NODE_26002_length_719_cov_6","Ntome_NODE_2925_length_3726_cov_166",98.182,55,1,0,1,55,3022,2968,2.5e-19,97.1,54,54
"73519","Nsylvestris_NODE_26003_length_718_cov_231","Ntome_NODE_3235_length_3608_cov_280",96.379,718,26,0,1,718,1460,743,0,1182,717,717
"73520","Nsylvestris_NODE_26004_length_718_cov_217","Ntome_NODE_29489_length_648_cov_290",92.054,516,40,1,154,668,627,112,0,725,514,515
"73552","Nsylvestris_NODE_26017_length_717_cov_11","Ntome_NODE_557_length_5878_cov_117",94.258,714,35,4,3,714,5077,5786,0,1086,711,709
"73560","Nsylvestris_NODE_26023_length_718_cov_3","Ntome_NODE_18178_length_1344_cov_130",98.305,59,1,0,1,59,938,880,1.49e-21,104,58,58
"73564","Nsylvestris_NODE_26025_length_717_cov_126","Ntome_NODE_23182_length_973_cov_6",87.135,171,18,4,220,390,820,654,1.11e-47,191,170,166
"73576","Nsylvestris_NODE_26030_length_717_cov_33","Ntome_NODE_26417_length_786_cov_36",93.494,707,43,3,1,705,1,706,0,1048,704,705
"73577","Nsylvestris_NODE_26033_length_717_cov_16","Ntome_NODE_8090_length_2476_cov_128",94.545,55,3,0,663,717,279,225,5.39e-16,86.1,54,54
"73578","Nsylvestris_NODE_26036_length_717_cov_10","Ntome_NODE_25324_length_843_cov_91",87.934,605,58,11,38,636,728,133,0,699,598,595
"73585","Nsylvestris_NODE_26041_length_717_cov_6","Ntome_NODE_34180_length_410_cov_12",92.464,345,23,3,247,590,1,343,9.78e-138,490,343,342
"73602","Nsylvestris_NODE_26047_length_716_cov_191","Ntome_NODE_1149_length_4899_cov_130",96.483,654,19,3,64,716,3471,4121,0,1077,652,650
"73618","Nsylvestris_NODE_26053_length_718_cov_54","Ntome_NODE_2479_length_3916_cov_171",97.826,92,2,0,1,92,3323,3232,3.14e-38,159,91,91
"73628","Nsylvestris_NODE_26057_length_716_cov_24","Ntome_NODE_5047_length_3066_cov_236",76.63,552,97,19,1,542,1631,1102,2.98e-73,276,541,529
"73632","Nsylvestris_NODE_26061_length_716_cov_11","Ntome_NODE_26095_length_802_cov_123",83.163,683,58,24,1,661,790,143,3.39e-162,571,660,647
"73638","Nsylvestris_NODE_26064_length_715_cov_6","Ntome_NODE_24862_length_871_cov_20",90.875,526,33,9,196,715,517,1,0,691,519,516
"73713","Nsylvestris_NODE_26067_length_716_cov_4","Ntome_NODE_21782_length_1063_cov_8",90.682,719,47,7,1,716,1,702,0,939,715,701
"73726","Nsylvestris_NODE_26075_length_715_cov_39","Ntome_NODE_31292_length_578_cov_28",92.885,506,23,4,19,517,1,500,0,723,498,499
"73738","Nsylvestris_NODE_26079_length_715_cov_24","Ntome_NODE_2118_length_4100_cov_113",96.226,53,2,0,1,53,759,811,1.49e-16,87.9,52,52
"73743","Nsylvestris_NODE_26081_length_715_cov_13","Ntome_NODE_28168_length_703_cov_11",94.034,704,38,2,2,702,1,703,0,1064,700,702
"73757","Nsylvestris_NODE_26089_length_714_cov_226","Ntome_NODE_20413_length_1160_cov_217",89.497,676,39,11,51,714,955,300,0,826,663,655
"73760","Nsylvestris_NODE_26092_length_714_cov_122","Ntome_NODE_168_length_7639_cov_65",91.136,722,56,3,1,714,6514,7235,0,972,713,721
"73770","Nsylvestris_NODE_26098_length_714_cov_14","Ntome_NODE_5637_length_2931_cov_188",90.759,725,48,10,4,714,1556,837,0,950,710,719
"73786","Nsylvestris_NODE_26107_length_714_cov_8","Ntome_NODE_15222_length_1612_cov_12",91.907,729,32,14,8,714,1510,787,0,994,706,723
"73791","Nsylvestris_NODE_26110_length_714_cov_4","Ntome_NODE_5063_length_3061_cov_24",91.875,160,12,1,555,714,1536,1694,3.92e-57,222,159,158
"73799","Nsylvestris_NODE_26116_length_713_cov_136","Ntome_NODE_30821_length_595_cov_47",96.639,595,20,0,48,642,1,595,0,989,594,594
"73810","Nsylvestris_NODE_26123_length_713_cov_28","Ntome_NODE_24854_length_871_cov_188",94.052,538,30,2,13,549,130,666,0,815,536,536
"73838","Nsylvestris_NODE_26136_length_713_cov_4","Ntome_NODE_23274_length_966_cov_259",94.545,55,3,0,1,55,708,654,5.36e-16,86.1,54,54
"73850","Nsylvestris_NODE_26140_length_712_cov_52","Ntome_NODE_5363_length_2995_cov_285",100,49,0,0,1,49,2377,2425,1.15e-17,91.6,48,48
"73853","Nsylvestris_NODE_26147_length_712_cov_17","Ntome_NODE_24900_length_869_cov_216",94.792,576,19,7,89,663,247,812,0,887,574,565
"73854","Nsylvestris_NODE_26148_length_712_cov_16","Ntome_NODE_27161_length_750_cov_18",94.608,612,32,1,100,711,86,696,0,946,611,610
"73869","Nsylvestris_NODE_26154_length_712_cov_7","Ntome_NODE_18731_length_1298_cov_8",92.556,712,24,10,1,709,308,993,0,994,708,685
"73870","Nsylvestris_NODE_26155_length_712_cov_6","Ntome_NODE_12823_length_1859_cov_180",92.837,712,51,0,1,712,864,1575,0,1033,711,711
"73876","Nsylvestris_NODE_26160_length_712_cov_4","Ntome_NODE_9444_length_2276_cov_106",89.145,433,40,6,283,712,1664,1236,1.59e-150,532,429,428
"73884","Nsylvestris_NODE_26163_length_711_cov_208","Ntome_NODE_31309_length_577_cov_262",89.532,449,29,8,204,652,67,497,1.22e-156,553,448,430
"73892","Nsylvestris_NODE_26167_length_711_cov_131","Ntome_NODE_6638_length_2723_cov_82",85.646,209,29,1,353,561,293,86,5.05e-56,219,208,207
"73893","Nsylvestris_NODE_26168_length_713_cov_120","Ntome_NODE_542_length_5906_cov_220",87.766,188,18,3,202,385,295,109,6.55e-55,215,183,186
"73896","Nsylvestris_NODE_26170_length_711_cov_98","Ntome_NODE_13944_length_1743_cov_19",87.255,714,83,4,1,708,193,904,0,808,707,711
"73900","Nsylvestris_NODE_26172_length_711_cov_51","Ntome_NODE_1532_length_4512_cov_85",97.009,468,14,0,1,468,521,54,0,787,467,467
"73910","Nsylvestris_NODE_26178_length_711_cov_7","Ntome_NODE_1358_length_4670_cov_231",100,55,0,0,657,711,3580,3526,5.31e-21,102,54,54
"73914","Nsylvestris_NODE_26181_length_711_cov_6","Ntome_NODE_20815_length_1131_cov_24",91.321,265,21,2,448,711,809,1072,7.93e-99,361,263,263
"73915","Nsylvestris_NODE_26185_length_710_cov_196","Ntome_NODE_27258_length_745_cov_231",95.03,664,30,3,1,662,27,689,0,1040,661,662
"73920","Nsylvestris_NODE_26187_length_710_cov_164","Ntome_NODE_27867_length_716_cov_68",90.274,658,43,9,6,657,693,51,0,841,651,642
"73921","Nsylvestris_NODE_26188_length_710_cov_117","Ntome_NODE_8840_length_2363_cov_38",95.125,718,26,4,1,710,815,1531,0,1123,709,716
"73935","Nsylvestris_NODE_26198_length_710_cov_7","Ntome_NODE_27255_length_746_cov_8",94.722,701,35,1,2,700,704,4,0,1088,698,700
"73939","Nsylvestris_NODE_26200_length_710_cov_6","Ntome_NODE_8872_length_2359_cov_25",96.078,51,2,0,656,706,968,918,1.92e-15,84.2,50,50
"73940","Nsylvestris_NODE_26201_length_710_cov_5","Ntome_NODE_14073_length_1728_cov_154",95.082,61,2,1,650,709,1503,1443,8.87e-19,95.3,59,60
"73944","Nsylvestris_NODE_26205_length_710_cov_4","Ntome_NODE_24264_length_908_cov_301",95,60,3,0,1,60,426,367,8.87e-19,95.3,59,59
"73949","Nsylvestris_NODE_26207_length_709_cov_99","Ntome_NODE_7223_length_2618_cov_210",89.972,718,37,15,16,709,2618,1912,0,894,693,706
"73952","Nsylvestris_NODE_26209_length_709_cov_56","Ntome_NODE_13665_length_1771_cov_117",98.182,55,1,0,655,709,1267,1321,2.46e-19,97.1,54,54
"73956","Nsylvestris_NODE_26211_length_709_cov_42","Ntome_NODE_732_length_5498_cov_277",100,71,0,0,1,71,845,775,6.75e-30,132,70,70
"73957","Nsylvestris_NODE_26213_length_709_cov_29","Ntome_NODE_2125_length_4095_cov_252",98.182,55,1,0,1,55,2993,3047,2.46e-19,97.1,54,54
"73968","Nsylvestris_NODE_26221_length_709_cov_10","Ntome_NODE_33863_length_426_cov_6",88.969,417,41,4,46,458,8,423,7.42e-144,510,412,415
"73974","Nsylvestris_NODE_26225_length_709_cov_5","Ntome_NODE_4864_length_3120_cov_35",76.226,530,116,8,179,703,580,1104,3.81e-72,272,524,524
"73988","Nsylvestris_NODE_26232_length_708_cov_32","Ntome_NODE_8298_length_2441_cov_297",95.745,47,2,0,654,700,296,250,3.2e-13,76.8,46,46
"73989","Nsylvestris_NODE_26233_length_708_cov_31","Ntome_NODE_17307_length_1419_cov_304",96.61,59,2,0,1,59,90,148,6.83e-20,99,58,58
"73993","Nsylvestris_NODE_26235_length_708_cov_27","Ntome_NODE_27744_length_722_cov_184",94.961,635,25,2,1,635,628,1,0,989,634,627
"73994","Nsylvestris_NODE_26236_length_708_cov_27","Ntome_NODE_35787_length_345_cov_8",97.345,339,9,0,138,476,7,345,7.2e-164,577,338,338
"73999","Nsylvestris_NODE_26239_length_708_cov_15","Ntome_NODE_8029_length_2486_cov_207",90.217,184,16,2,1,182,2303,2486,3.86e-62,239,181,183
"74004","Nsylvestris_NODE_26242_length_708_cov_9","Ntome_NODE_14639_length_1673_cov_196",96.364,55,2,0,1,55,1027,1081,1.14e-17,91.6,54,54
"74030","Nsylvestris_NODE_26255_length_708_cov_5","Ntome_NODE_16001_length_1539_cov_23",95.077,711,24,4,1,708,537,1239,0,1109,707,702
"74031","Nsylvestris_NODE_26256_length_708_cov_4","Ntome_NODE_16591_length_1487_cov_245",96.364,55,2,0,1,55,1103,1157,1.14e-17,91.6,54,54
"74051","Nsylvestris_NODE_26265_length_707_cov_151","Ntome_NODE_35017_length_374_cov_3",83.158,190,19,11,410,595,18,198,8.58e-39,161,185,180
"74056","Nsylvestris_NODE_26270_length_707_cov_32","Ntome_NODE_14246_length_1710_cov_267",98.305,59,0,1,1,59,455,398,5.27e-21,102,58,57
"74064","Nsylvestris_NODE_26274_length_707_cov_15","Ntome_NODE_11427_length_2022_cov_247",98.148,54,1,0,2,55,1332,1279,8.83e-19,95.3,53,53
"74069","Nsylvestris_NODE_26279_length_707_cov_8","Ntome_NODE_11058_length_2066_cov_95",95.021,703,35,0,3,705,642,1344,0,1105,702,702
"74075","Nsylvestris_NODE_26282_length_706_cov_111","Ntome_NODE_24897_length_869_cov_303",98.182,55,1,0,1,55,177,231,2.45e-19,97.1,54,54
"74076","Nsylvestris_NODE_26283_length_706_cov_109","Ntome_NODE_779_length_5422_cov_68",95.455,66,3,0,1,66,790,855,4.07e-22,106,65,65
"74077","Nsylvestris_NODE_26284_length_706_cov_94","Ntome_NODE_32777_length_493_cov_19",80.519,231,29,11,188,416,247,31,2.38e-39,163,228,216
"74081","Nsylvestris_NODE_26286_length_706_cov_26","Ntome_NODE_32566_length_508_cov_9",82.749,342,44,12,373,703,168,505,1.05e-77,291,330,337
"74086","Nsylvestris_NODE_26290_length_706_cov_19","Ntome_NODE_18094_length_1350_cov_161",96.322,707,24,2,1,706,1062,357,0,1160,705,705
"74089","Nsylvestris_NODE_26292_length_706_cov_8","Ntome_NODE_284_length_6829_cov_194",96.364,55,2,0,1,55,473,527,1.14e-17,91.6,54,54
"74104","Nsylvestris_NODE_26300_length_705_cov_57","Ntome_NODE_25104_length_857_cov_87",93.523,633,26,5,1,618,6,638,0,928,617,632
"74105","Nsylvestris_NODE_26301_length_705_cov_44","Ntome_NODE_29215_length_659_cov_192",89.247,651,23,18,72,687,21,659,0,771,615,638
"74118","Nsylvestris_NODE_26312_length_704_cov_211","Ntome_NODE_30143_length_622_cov_72",92.388,578,34,2,19,594,1,570,0,815,575,569
"74119","Nsylvestris_NODE_26313_length_704_cov_204","Ntome_NODE_9178_length_2312_cov_173",97.959,49,1,0,1,49,1301,1349,5.29e-16,86.1,48,48
"74124","Nsylvestris_NODE_26315_length_704_cov_101","Ntome_NODE_5138_length_3047_cov_21",94.545,55,3,0,650,704,2664,2718,5.29e-16,86.1,54,54
"74127","Nsylvestris_NODE_26317_length_704_cov_34","Ntome_NODE_33534_length_444_cov_7",90.948,232,21,0,243,474,1,232,2.23e-84,313,231,231
"74128","Nsylvestris_NODE_26319_length_704_cov_28","Ntome_NODE_3528_length_3506_cov_255",98.182,55,1,0,1,55,2986,2932,2.44e-19,97.1,54,54
"74129","Nsylvestris_NODE_26321_length_704_cov_25","Ntome_NODE_5223_length_3023_cov_273",98.182,55,1,0,650,704,915,861,2.44e-19,97.1,54,54
"74130","Nsylvestris_NODE_26322_length_704_cov_25","Ntome_NODE_3193_length_3620_cov_296",94.444,54,3,0,650,703,2999,2946,1.9e-15,84.2,53,53
"74133","Nsylvestris_NODE_26324_length_704_cov_15","Ntome_NODE_6099_length_2830_cov_239",96.987,531,16,0,1,531,2042,2572,0,893,530,530
"74149","Nsylvestris_NODE_26333_length_703_cov_201","Ntome_NODE_12553_length_1893_cov_195",92.599,608,24,2,99,703,1373,784,0,854,604,589
"74153","Nsylvestris_NODE_26335_length_703_cov_170","Ntome_NODE_34019_length_418_cov_261",94.753,324,16,1,81,403,49,372,1.23e-141,503,322,323
"74171","Nsylvestris_NODE_26344_length_703_cov_22","Ntome_NODE_6839_length_2687_cov_191",85.083,724,70,18,1,703,1147,441,0,704,702,706
"74176","Nsylvestris_NODE_26346_length_703_cov_20","Ntome_NODE_10590_length_2121_cov_248",96.364,55,2,0,649,703,899,845,1.14e-17,91.6,54,54
"74177","Nsylvestris_NODE_26348_length_703_cov_14","Ntome_NODE_10671_length_2110_cov_195",92.571,700,49,2,5,703,224,921,0,1002,698,697
"74183","Nsylvestris_NODE_26351_length_703_cov_9","Ntome_NODE_9302_length_2294_cov_249",96.364,55,2,0,1,55,1758,1812,1.14e-17,91.6,54,54
"74189","Nsylvestris_NODE_26354_length_703_cov_6","Ntome_NODE_5286_length_3011_cov_58",93.16,614,33,2,91,703,2331,2936,0,893,612,605
"74195","Nsylvestris_NODE_26360_length_702_cov_84","Ntome_NODE_18852_length_1287_cov_127",86.364,374,21,7,257,627,420,74,6.01e-105,381,370,346
"74214","Nsylvestris_NODE_26374_length_701_cov_217","Ntome_NODE_23248_length_968_cov_118",92.758,649,28,7,64,701,4,644,0,920,637,640
"74215","Nsylvestris_NODE_26375_length_701_cov_204","Ntome_NODE_20952_length_1119_cov_188",92.157,663,27,6,1,663,640,3,0,913,662,637
"74219","Nsylvestris_NODE_26378_length_701_cov_89","Ntome_NODE_633_length_5687_cov_135",96.721,61,1,1,1,61,2469,2528,1.88e-20,100,60,59
"74220","Nsylvestris_NODE_26379_length_701_cov_65","Ntome_NODE_4203_length_3293_cov_232",98.529,68,1,0,1,68,1350,1283,1.44e-26,121,67,67
"74224","Nsylvestris_NODE_26381_length_701_cov_32","Ntome_NODE_17042_length_1444_cov_135",96.364,55,2,0,647,701,684,738,1.13e-17,91.6,54,54
"74225","Nsylvestris_NODE_26382_length_701_cov_24","Ntome_NODE_17743_length_1380_cov_169",97.185,604,15,2,1,602,1,604,0,1020,601,603
"74226","Nsylvestris_NODE_26383_length_701_cov_11","Ntome_NODE_5221_length_3024_cov_45",96.341,82,3,0,31,112,1094,1013,5.15e-31,135,81,81
"74233","Nsylvestris_NODE_26386_length_701_cov_10","Ntome_NODE_3857_length_3402_cov_252",98.182,55,1,0,1,55,1231,1177,2.43e-19,97.1,54,54
"74238","Nsylvestris_NODE_26391_length_701_cov_7","Ntome_NODE_11180_length_2051_cov_237",98.182,55,1,0,1,55,767,713,2.43e-19,97.1,54,54
"74239","Nsylvestris_NODE_26392_length_703_cov_5","Ntome_NODE_18459_length_1320_cov_232",98.182,55,1,0,649,703,556,610,2.44e-19,97.1,54,54
"74240","Nsylvestris_NODE_26394_length_701_cov_5","Ntome_NODE_15684_length_1570_cov_10",95.191,707,24,4,3,700,717,12,0,1109,697,705
"74241","Nsylvestris_NODE_26395_length_701_cov_4","Ntome_NODE_3354_length_3567_cov_136",78.517,391,54,24,319,699,2479,2109,2.3e-59,230,380,370
"74254","Nsylvestris_NODE_26401_length_700_cov_68","Ntome_NODE_30859_length_594_cov_6",94.727,550,29,0,11,560,41,590,0,856,549,549
"74270","Nsylvestris_NODE_26407_length_700_cov_39","Ntome_NODE_456_length_6137_cov_19",86.733,701,91,2,1,700,3200,3899,0,778,699,699
"74288","Nsylvestris_NODE_26423_length_700_cov_3","Ntome_NODE_13155_length_1824_cov_212",97.917,48,1,0,653,700,157,110,1.89e-15,84.2,47,47
"74291","Nsylvestris_NODE_26425_length_699_cov_165","Ntome_NODE_13289_length_1809_cov_256",94.266,436,20,3,123,554,171,605,0,662,431,434
"74318","Nsylvestris_NODE_26436_length_699_cov_11","Ntome_NODE_21560_length_1077_cov_63",94.965,715,20,1,1,699,68,782,0,1107,698,714
"74324","Nsylvestris_NODE_26439_length_699_cov_5","Ntome_NODE_1721_length_4366_cov_178",96.364,55,2,0,1,55,2398,2344,1.13e-17,91.6,54,54
"74327","Nsylvestris_NODE_26441_length_699_cov_4","Ntome_NODE_364_length_6448_cov_107",100,55,0,0,645,699,5379,5433,5.21e-21,102,54,54
"74333","Nsylvestris_NODE_26444_length_698_cov_173","Ntome_NODE_27644_length_726_cov_84",92.427,647,36,3,35,668,712,66,0,911,633,646
"74334","Nsylvestris_NODE_26445_length_698_cov_170","Ntome_NODE_28533_length_687_cov_165",93.294,686,29,5,13,698,6,674,0,996,685,668
"74337","Nsylvestris_NODE_26448_length_698_cov_84","Ntome_NODE_29375_length_653_cov_202",93.186,587,25,14,2,582,18,595,0,848,580,577
"74338","Nsylvestris_NODE_26451_length_698_cov_52","Ntome_NODE_4086_length_3324_cov_132",95.833,48,2,0,651,698,1443,1396,8.77e-14,78.7,47,47
"74345","Nsylvestris_NODE_26453_length_698_cov_33","Ntome_NODE_10941_length_2080_cov_281",95.652,46,2,0,210,255,1744,1699,1.13e-12,75,45,45
"74346","Nsylvestris_NODE_26454_length_698_cov_33","Ntome_NODE_32370_length_523_cov_20",92.593,54,2,2,290,341,247,194,3.15e-13,76.8,51,53
"74347","Nsylvestris_NODE_26455_length_698_cov_19","Ntome_NODE_9384_length_2284_cov_165",87.179,624,42,24,62,675,619,24,0,676,613,595
"74348","Nsylvestris_NODE_26456_length_698_cov_14","Ntome_NODE_22917_length_988_cov_211",83.838,594,70,18,91,667,262,846,2.59e-153,542,576,584
"74349","Nsylvestris_NODE_26457_length_698_cov_12","Ntome_NODE_11167_length_2053_cov_64",98.585,424,6,0,1,424,1235,1658,0,750,423,423
"74354","Nsylvestris_NODE_26460_length_698_cov_8","Ntome_NODE_13843_length_1752_cov_230",100,55,0,0,644,698,1369,1423,5.21e-21,102,54,54
"74357","Nsylvestris_NODE_26463_length_697_cov_179","Ntome_NODE_31952_length_553_cov_86",91.147,497,21,8,24,513,553,73,0,652,489,480
"74358","Nsylvestris_NODE_26464_length_697_cov_149","Ntome_NODE_27117_length_752_cov_76",97.951,244,4,1,408,651,386,628,3.51e-117,422,243,242
"74362","Nsylvestris_NODE_26466_length_697_cov_107","Ntome_NODE_8013_length_2489_cov_196",80.796,578,85,18,137,696,659,90,2.1e-119,429,559,569
"74365","Nsylvestris_NODE_26468_length_697_cov_89","Ntome_NODE_22969_length_985_cov_127",96.364,55,2,0,643,697,183,237,1.13e-17,91.6,54,54
"74373","Nsylvestris_NODE_26474_length_697_cov_21","Ntome_NODE_22862_length_991_cov_125",93.851,683,39,1,18,697,937,255,0,1026,679,682
"74377","Nsylvestris_NODE_26476_length_697_cov_15","Ntome_NODE_19956_length_1195_cov_261",98.182,55,1,0,1,55,541,487,2.42e-19,97.1,54,54
"74382","Nsylvestris_NODE_26478_length_697_cov_10","Ntome_NODE_2604_length_3858_cov_141",90.374,696,46,5,5,696,2579,3257,0,894,691,678
"74393","Nsylvestris_NODE_26484_length_697_cov_6","Ntome_NODE_4215_length_3289_cov_68",92.608,717,29,11,3,697,2705,1991,0,1009,694,714
"74402","Nsylvestris_NODE_26488_length_695_cov_185","Ntome_NODE_14729_length_1662_cov_136",96.075,637,20,3,59,695,677,46,0,1033,636,631
"74411","Nsylvestris_NODE_26493_length_696_cov_54","Ntome_NODE_3272_length_3598_cov_282",92.593,54,4,0,277,330,1466,1413,8.75e-14,78.7,53,53
"74416","Nsylvestris_NODE_26495_length_696_cov_19","Ntome_NODE_14439_length_1692_cov_101",90.435,115,11,0,202,316,732,846,5.08e-36,152,114,114
"74417","Nsylvestris_NODE_26496_length_696_cov_19","Ntome_NODE_4152_length_3306_cov_303",100,52,0,0,645,696,1188,1137,2.41e-19,97.1,51,51
"74428","Nsylvestris_NODE_26504_length_696_cov_6","Ntome_NODE_4286_length_3265_cov_57",93.713,668,18,3,51,696,2053,2718,0,979,645,665
"74445","Nsylvestris_NODE_26519_length_695_cov_17","Ntome_NODE_21741_length_1065_cov_250",91.964,112,7,2,318,427,1058,947,3.92e-37,156,109,111
"74446","Nsylvestris_NODE_26520_length_695_cov_15","Ntome_NODE_9828_length_2222_cov_31",94,150,8,1,274,423,1320,1468,2.95e-58,226,149,148
"74458","Nsylvestris_NODE_26527_length_695_cov_8","Ntome_NODE_12881_length_1853_cov_171",100,51,0,0,4,54,936,886,8.67e-19,95.3,50,50
"74459","Nsylvestris_NODE_26529_length_695_cov_6","Ntome_NODE_17775_length_1377_cov_27",85.317,647,48,23,1,620,738,1364,2.49e-178,625,619,626
"74467","Nsylvestris_NODE_26534_length_694_cov_168","Ntome_NODE_27098_length_753_cov_230",94.839,620,32,0,62,681,672,53,0,968,619,619
"74471","Nsylvestris_NODE_26536_length_694_cov_60","Ntome_NODE_141_length_7936_cov_227",96.154,78,0,1,1,75,6833,6910,1.1e-27,124,74,77
"74500","Nsylvestris_NODE_26550_length_694_cov_2","Ntome_NODE_1120_length_4928_cov_86",86.813,91,8,2,310,399,3645,3732,6.69e-20,99,89,87
"74506","Nsylvestris_NODE_26553_length_693_cov_207","Ntome_NODE_12475_length_1900_cov_190",97.23,686,18,1,1,686,1185,1869,0,1160,685,684
"74507","Nsylvestris_NODE_26554_length_692_cov_190","Ntome_NODE_10979_length_2076_cov_52",82.609,184,30,2,438,620,885,1067,8.39e-39,161,182,182
"74508","Nsylvestris_NODE_26555_length_693_cov_184","Ntome_NODE_4728_length_3152_cov_296",100,55,0,0,1,55,2026,1972,5.17e-21,102,54,54
"74521","Nsylvestris_NODE_26562_length_693_cov_53","Ntome_NODE_9691_length_2241_cov_72",90.415,386,21,7,129,506,1,378,7.3e-139,494,377,377
"74524","Nsylvestris_NODE_26565_length_693_cov_29","Ntome_NODE_10238_length_2165_cov_118",100,55,0,0,1,55,385,331,5.17e-21,102,54,54
"74525","Nsylvestris_NODE_26567_length_693_cov_18","Ntome_NODE_34834_length_381_cov_5",88.221,416,10,9,3,414,1,381,7.4e-129,460,411,380
"74540","Nsylvestris_NODE_26573_length_693_cov_11","Ntome_NODE_2804_length_3770_cov_109",96.364,55,2,0,639,693,2330,2276,1.12e-17,91.6,54,54
"74541","Nsylvestris_NODE_26574_length_693_cov_6","Ntome_NODE_25704_length_821_cov_7",78.862,369,40,25,287,626,396,37,6.36e-55,215,339,359
"74542","Nsylvestris_NODE_26575_length_693_cov_5","Ntome_NODE_9704_length_2239_cov_220",95.313,64,2,1,630,692,1751,1814,1.86e-20,100,62,63
"74549","Nsylvestris_NODE_26578_length_693_cov_3","Ntome_NODE_13970_length_1740_cov_255",94.545,55,3,0,639,693,586,640,5.2e-16,86.1,54,54
"74561","Nsylvestris_NODE_26583_length_692_cov_27","Ntome_NODE_9920_length_2210_cov_227",100,54,0,0,2,55,514,567,1.86e-20,100,53,53
"74569","Nsylvestris_NODE_26586_length_692_cov_16","Ntome_NODE_28562_length_686_cov_7",88.235,357,37,3,109,464,294,646,3.49e-117,422,355,352
"74573","Nsylvestris_NODE_26591_length_692_cov_8","Ntome_NODE_20761_length_1134_cov_32",86.235,603,56,12,6,582,161,762,1.91e-179,628,576,601
"74601","Nsylvestris_NODE_26606_length_691_cov_29","Ntome_NODE_4466_length_3217_cov_136",85.567,97,14,0,498,594,2489,2393,5.15e-21,102,96,96
"74602","Nsylvestris_NODE_26607_length_691_cov_27","Ntome_NODE_28241_length_699_cov_51",95.17,704,16,4,1,691,1,699,0,1096,690,698
"74607","Nsylvestris_NODE_26610_length_691_cov_16","Ntome_NODE_19124_length_1265_cov_261",96.364,55,2,0,637,691,541,595,1.11e-17,91.6,54,54
"74608","Nsylvestris_NODE_26611_length_691_cov_10","Ntome_NODE_1670_length_4409_cov_147",92.812,473,19,9,231,691,2332,2801,0,671,460,469
"74617","Nsylvestris_NODE_26615_length_691_cov_6","Ntome_NODE_450_length_6157_cov_220",94.545,55,3,0,637,691,5528,5474,5.19e-16,86.1,54,54
"74618","Nsylvestris_NODE_26616_length_691_cov_5","Ntome_NODE_11429_length_2022_cov_225",90.883,702,50,8,1,691,369,1067,0,929,690,698
"74619","Nsylvestris_NODE_26617_length_691_cov_5","Ntome_NODE_17508_length_1403_cov_6",90.259,657,61,1,1,654,440,1096,0,856,653,656
"74626","Nsylvestris_NODE_26621_length_690_cov_215","Ntome_NODE_20088_length_1185_cov_88",96.38,221,8,0,1,221,781,1001,5.94e-100,364,220,220
"74635","Nsylvestris_NODE_26625_length_690_cov_94","Ntome_NODE_411_length_6275_cov_224",93.846,65,4,0,626,690,2944,2880,6.65e-20,99,64,64
"74642","Nsylvestris_NODE_26631_length_690_cov_17","Ntome_NODE_6291_length_2789_cov_185",98.182,55,1,0,636,690,1078,1024,2.39e-19,97.1,54,54
"74648","Nsylvestris_NODE_26635_length_690_cov_7","Ntome_NODE_16217_length_1519_cov_285",98.182,55,1,0,1,55,286,340,2.39e-19,97.1,54,54
"74649","Nsylvestris_NODE_26636_length_690_cov_7","Ntome_NODE_27139_length_751_cov_14",100,28,0,0,628,655,420,393,5.25e-06,52.8,27,27
"74658","Nsylvestris_NODE_26639_length_690_cov_6","Ntome_NODE_5053_length_3066_cov_10",97.826,690,15,0,1,690,217,906,0,1192,689,689
"74665","Nsylvestris_NODE_26642_length_689_cov_230","Ntome_NODE_18416_length_1324_cov_138",91.411,489,31,6,1,481,769,1254,0,660,480,485
"74671","Nsylvestris_NODE_26645_length_689_cov_189","Ntome_NODE_2750_length_3789_cov_242",97.053,475,14,0,1,475,691,217,0,800,474,474
"74672","Nsylvestris_NODE_26646_length_689_cov_170","Ntome_NODE_17858_length_1370_cov_202",95.853,627,22,2,64,687,1080,455,0,1011,623,625
"74673","Nsylvestris_NODE_26647_length_689_cov_87","Ntome_NODE_7398_length_2585_cov_171",96.066,483,19,0,9,491,2474,1992,0,787,482,482
"74674","Nsylvestris_NODE_26648_length_689_cov_19","Ntome_NODE_6212_length_2808_cov_137",85.666,586,43,13,139,689,3,582,1.95e-164,579,550,579
"74685","Nsylvestris_NODE_26652_length_689_cov_14","Ntome_NODE_1112_length_4935_cov_285",98.182,55,1,0,635,689,1213,1267,2.39e-19,97.1,54,54
"74714","Nsylvestris_NODE_26668_length_688_cov_46","Ntome_NODE_30978_length_590_cov_10",94.147,598,18,7,81,671,1,588,0,894,590,587
"74715","Nsylvestris_NODE_26669_length_688_cov_32","Ntome_NODE_76_length_8880_cov_70",100,55,0,0,634,688,7324,7378,5.13e-21,102,54,54
"74720","Nsylvestris_NODE_26673_length_688_cov_19","Ntome_NODE_25465_length_835_cov_15",93.849,634,37,1,55,688,202,833,0,953,633,631
"74732","Nsylvestris_NODE_26678_length_688_cov_11","Ntome_NODE_38347_length_281_cov_6",92,200,4,2,204,397,1,194,1.33e-71,270,193,193
"74739","Nsylvestris_NODE_26682_length_688_cov_8","Ntome_NODE_2956_length_3716_cov_183",96.552,58,2,0,1,58,1216,1159,2.39e-19,97.1,57,57
"74756","Nsylvestris_NODE_26690_length_687_cov_217","Ntome_NODE_601_length_5770_cov_253",95.975,646,24,2,1,646,4985,5628,0,1048,645,643
"74757","Nsylvestris_NODE_26691_length_687_cov_201","Ntome_NODE_37233_length_305_cov_9",91.883,308,13,2,270,568,1,305,1.24e-116,420,298,304
"74771","Nsylvestris_NODE_26697_length_687_cov_106","Ntome_NODE_27318_length_742_cov_62",88.292,726,30,19,1,687,734,25,0,819,686,709
"74775","Nsylvestris_NODE_26701_length_687_cov_29","Ntome_NODE_4809_length_3131_cov_144",94.667,75,3,1,549,622,2358,2432,6.58e-25,115,73,74
"74776","Nsylvestris_NODE_26702_length_687_cov_27","Ntome_NODE_11791_length_1982_cov_66",92.453,689,45,7,1,687,1381,698,0,977,686,683
"74797","Nsylvestris_NODE_26714_length_686_cov_208","Ntome_NODE_14180_length_1717_cov_193",94.082,659,21,9,37,686,105,754,0,985,649,649
"74798","Nsylvestris_NODE_26715_length_686_cov_167","Ntome_NODE_36070_length_336_cov_10",91.74,339,22,3,244,581,334,1,1.57e-130,466,337,333
"74801","Nsylvestris_NODE_26718_length_686_cov_120","Ntome_NODE_22313_length_1027_cov_252",89.873,79,5,3,611,686,711,633,6.61e-20,99,75,78
"74804","Nsylvestris_NODE_26721_length_686_cov_57","Ntome_NODE_28201_length_701_cov_39",84,350,32,12,3,341,48,384,6.03e-85,315,338,336
"74805","Nsylvestris_NODE_26722_length_686_cov_53","Ntome_NODE_32087_length_543_cov_15",86.755,302,28,9,89,383,525,229,2.79e-88,326,294,296
"74815","Nsylvestris_NODE_26726_length_686_cov_18","Ntome_NODE_28004_length_710_cov_48",81.008,516,61,25,3,516,8,488,2.73e-103,375,513,480
"74819","Nsylvestris_NODE_26729_length_686_cov_14","Ntome_NODE_18022_length_1356_cov_40",93.878,245,14,1,1,244,354,598,4.57e-101,368,243,244
"74829","Nsylvestris_NODE_26735_length_686_cov_9","Ntome_NODE_3337_length_3572_cov_107",95.501,689,27,3,1,686,2107,2794,0,1098,685,687
"74833","Nsylvestris_NODE_26737_length_686_cov_9","Ntome_NODE_2129_length_4092_cov_208",98.182,55,1,0,1,55,2716,2770,2.38e-19,97.1,54,54
"74834","Nsylvestris_NODE_26738_length_686_cov_9","Ntome_NODE_13459_length_1790_cov_28",91.023,557,38,7,1,546,977,1532,0,741,545,555
"74835","Nsylvestris_NODE_26740_length_686_cov_7","Ntome_NODE_9540_length_2264_cov_188",91.172,691,37,9,1,686,995,1666,0,917,685,671
"74842","Nsylvestris_NODE_26745_length_685_cov_167","Ntome_NODE_27030_length_757_cov_16",87.018,570,49,15,133,685,1,562,1.14e-176,619,552,561
"74843","Nsylvestris_NODE_26747_length_685_cov_126","Ntome_NODE_22418_length_1021_cov_215",88.737,586,42,15,1,569,629,51,0,695,568,578
"74848","Nsylvestris_NODE_26750_length_685_cov_74","Ntome_NODE_22336_length_1026_cov_151",94.629,633,30,3,1,632,131,760,0,977,631,629
"74849","Nsylvestris_NODE_26751_length_686_cov_57","Ntome_NODE_6260_length_2796_cov_85",88.793,232,16,6,257,481,272,44,2.85e-73,276,224,228
"74869","Nsylvestris_NODE_26760_length_685_cov_17","Ntome_NODE_1435_length_4595_cov_225",87.047,193,22,3,220,411,3497,3307,6.28e-55,215,191,190
"74874","Nsylvestris_NODE_26763_length_685_cov_8","Ntome_NODE_13961_length_1741_cov_64",96.552,58,2,0,628,685,186,243,2.37e-19,97.1,57,57
"74875","Nsylvestris_NODE_26766_length_684_cov_236","Ntome_NODE_3017_length_3692_cov_162",96.897,580,15,2,53,631,3637,3060,0,968,578,577
"74876","Nsylvestris_NODE_26767_length_684_cov_215","Ntome_NODE_27260_length_745_cov_206",87.619,630,42,23,27,632,7,624,0,699,605,617
"74895","Nsylvestris_NODE_26776_length_684_cov_18","Ntome_NODE_2470_length_3921_cov_253",98.182,55,1,0,630,684,3571,3625,2.37e-19,97.1,54,54
"74910","Nsylvestris_NODE_26782_length_684_cov_10","Ntome_NODE_37260_length_305_cov_2",97.917,48,1,0,637,684,10,57,1.85e-15,84.2,47,47
"74911","Nsylvestris_NODE_26783_length_685_cov_9","Ntome_NODE_11266_length_2042_cov_188",93.149,686,33,5,1,685,1495,823,0,994,684,672
"74914","Nsylvestris_NODE_26785_length_684_cov_7","Ntome_NODE_3487_length_3522_cov_112",95.313,64,3,0,621,684,1117,1180,5.1e-21,102,63,63
"74944","Nsylvestris_NODE_26800_length_683_cov_18","Ntome_NODE_25530_length_831_cov_175",96.396,111,4,0,412,522,391,501,1.77e-45,183,110,110
"74961","Nsylvestris_NODE_26810_length_683_cov_6","Ntome_NODE_28066_length_707_cov_13",90.909,649,32,11,19,649,655,16,0,846,630,639
"74962","Nsylvestris_NODE_26811_length_683_cov_5","Ntome_NODE_19187_length_1260_cov_280",98.182,55,1,0,1,55,809,863,2.37e-19,97.1,54,54
"75000","Nsylvestris_NODE_26817_length_682_cov_46","Ntome_NODE_12753_length_1867_cov_155",92.076,631,50,0,52,682,1829,1199,0,889,630,630
"75001","Nsylvestris_NODE_26818_length_682_cov_42","Ntome_NODE_24540_length_889_cov_161",90.625,448,30,8,197,636,865,422,4.14e-166,584,439,443
"75002","Nsylvestris_NODE_26819_length_682_cov_13","Ntome_NODE_13364_length_1801_cov_20",91.038,703,21,9,1,682,1798,1117,0,911,681,681
"75003","Nsylvestris_NODE_26821_length_682_cov_10","Ntome_NODE_5392_length_2987_cov_250",100,55,0,0,628,682,912,966,5.08e-21,102,54,54
"75007","Nsylvestris_NODE_26823_length_682_cov_9","Ntome_NODE_7325_length_2600_cov_62",92.371,603,30,2,84,682,95,685,0,845,598,590
"75013","Nsylvestris_NODE_26830_length_682_cov_5","Ntome_NODE_42_length_10190_cov_24",77.742,620,102,28,9,619,1947,1355,5.91e-95,348,610,592
"75019","Nsylvestris_NODE_26835_length_681_cov_220","Ntome_NODE_22405_length_1022_cov_224",94.69,113,6,0,1,113,495,383,2.95e-43,176,112,112
"75027","Nsylvestris_NODE_26839_length_681_cov_173","Ntome_NODE_7025_length_2651_cov_137",91.045,536,28,10,160,681,81,610,0,706,521,529
"75036","Nsylvestris_NODE_26841_length_681_cov_32","Ntome_NODE_2957_length_3715_cov_296",90.909,517,47,0,1,517,1747,1231,0,695,516,516
"75037","Nsylvestris_NODE_26842_length_681_cov_22","Ntome_NODE_22053_length_1045_cov_32",96.364,55,2,0,1,55,485,431,1.1e-17,91.6,54,54
"75046","Nsylvestris_NODE_26848_length_681_cov_7","Ntome_NODE_1340_length_4691_cov_286",100,42,0,0,640,681,1000,959,8.55e-14,78.7,41,41
"75049","Nsylvestris_NODE_26850_length_680_cov_176","Ntome_NODE_27864_length_716_cov_133",92.757,497,28,6,165,656,50,543,0,712,491,493
"75056","Nsylvestris_NODE_26853_length_680_cov_119","Ntome_NODE_28479_length_689_cov_246",88.462,572,37,11,41,612,93,635,0,664,571,542
"75060","Nsylvestris_NODE_26856_length_680_cov_51","Ntome_NODE_1488_length_4542_cov_109",84.105,497,50,8,143,636,2960,2490,1.21e-126,453,493,470
"75061","Nsylvestris_NODE_26857_length_680_cov_40","Ntome_NODE_5765_length_2904_cov_277",90,50,4,1,632,680,1256,1207,2.39e-09,63.9,48,49
"75062","Nsylvestris_NODE_26858_length_680_cov_34","Ntome_NODE_8953_length_2345_cov_269",98.182,55,1,0,1,55,805,859,2.36e-19,97.1,54,54
"75069","Nsylvestris_NODE_26861_length_680_cov_10","Ntome_NODE_4484_length_3213_cov_295",82.609,276,44,3,1,274,1347,1620,1.03e-62,241,273,273
"75073","Nsylvestris_NODE_26863_length_680_cov_7","Ntome_NODE_951_length_5164_cov_69",91.068,515,31,12,178,679,2636,3148,0,682,501,512
"75076","Nsylvestris_NODE_26865_length_680_cov_4","Ntome_NODE_9050_length_2331_cov_25",96.324,680,25,0,1,680,1032,1711,0,1118,679,679
"75089","Nsylvestris_NODE_26871_length_679_cov_47","Ntome_NODE_30242_length_618_cov_219",88.376,628,25,21,22,611,1,618,0,712,589,617
"75096","Nsylvestris_NODE_26875_length_679_cov_27","Ntome_NODE_6884_length_2676_cov_277",96.364,55,2,0,1,55,2051,2105,1.09e-17,91.6,54,54
"75106","Nsylvestris_NODE_26880_length_679_cov_19","Ntome_NODE_8010_length_2489_cov_261",98.182,55,1,0,1,55,1279,1333,2.35e-19,97.1,54,54
"75113","Nsylvestris_NODE_26884_length_679_cov_7","Ntome_NODE_8076_length_2479_cov_35",91.57,688,44,7,1,679,1491,2173,0,937,678,682
"75114","Nsylvestris_NODE_26885_length_679_cov_6","Ntome_NODE_21482_length_1083_cov_40",90.826,654,43,6,20,656,1077,424,0,859,636,653
"75117","Nsylvestris_NODE_26887_length_678_cov_148","Ntome_NODE_25459_length_835_cov_84",90.653,567,33,15,72,632,786,234,0,736,560,552
"75118","Nsylvestris_NODE_26888_length_678_cov_144","Ntome_NODE_30992_length_589_cov_267",80.157,383,54,13,1,371,43,415,1.69e-70,267,370,372
"75147","Nsylvestris_NODE_26900_length_678_cov_12","Ntome_NODE_14543_length_1680_cov_272",93.269,104,7,0,197,300,588,691,1.37e-36,154,103,103
"75148","Nsylvestris_NODE_26901_length_678_cov_9","Ntome_NODE_11151_length_2055_cov_79",92.679,642,32,4,1,628,452,1092,0,911,627,640
"75152","Nsylvestris_NODE_26903_length_678_cov_7","Ntome_NODE_30412_length_612_cov_6",84.574,188,13,9,78,255,206,387,3.8e-42,172,177,181
"75153","Nsylvestris_NODE_26904_length_678_cov_6","Ntome_NODE_16173_length_1524_cov_219",82.524,309,26,10,387,678,1227,1524,2.2e-64,246,291,297
"75170","Nsylvestris_NODE_26912_length_677_cov_138","Ntome_NODE_5202_length_3030_cov_279",94.903,667,17,4,25,677,1,664,0,1027,652,663
"75173","Nsylvestris_NODE_26915_length_677_cov_72","Ntome_NODE_25604_length_827_cov_71",89.255,698,50,12,1,677,25,718,0,850,676,693
"75183","Nsylvestris_NODE_26922_length_677_cov_10","Ntome_NODE_23296_length_966_cov_6",91.266,687,27,8,20,677,966,284,0,905,657,682
"75184","Nsylvestris_NODE_26923_length_677_cov_10","Ntome_NODE_22743_length_995_cov_21",96.314,624,20,2,1,623,53,674,0,1022,622,621
"75187","Nsylvestris_NODE_26927_length_677_cov_3","Ntome_NODE_24290_length_907_cov_27",93.606,563,31,5,94,652,856,295,0,835,558,561
"75207","Nsylvestris_NODE_26934_length_676_cov_26","Ntome_NODE_17500_length_1403_cov_229",98,50,1,0,6,55,908,859,1.41e-16,87.9,49,49
"75216","Nsylvestris_NODE_26938_length_676_cov_16","Ntome_NODE_154_length_7806_cov_166",90.603,713,30,3,1,676,1747,1035,0,911,675,712
"75224","Nsylvestris_NODE_26943_length_676_cov_7","Ntome_NODE_5804_length_2893_cov_168",90.607,692,45,13,1,674,1527,838,0,900,673,689
"75225","Nsylvestris_NODE_26945_length_676_cov_6","Ntome_NODE_39479_length_258_cov_5",96.774,248,8,0,1,248,248,1,5.69e-115,414,247,247
"75226","Nsylvestris_NODE_26946_length_676_cov_5","Ntome_NODE_610_length_5748_cov_177",92.478,678,28,7,1,666,2229,2895,0,948,665,666
"75227","Nsylvestris_NODE_26947_length_676_cov_5","Ntome_NODE_5052_length_3066_cov_56",96.875,256,6,2,193,447,327,73,7.31e-119,427,254,254
"75240","Nsylvestris_NODE_26952_length_675_cov_92","Ntome_NODE_20124_length_1182_cov_254",86.196,326,39,2,327,646,393,68,5.85e-95,348,319,325
"75253","Nsylvestris_NODE_26960_length_675_cov_16","Ntome_NODE_4600_length_3182_cov_199",98.182,55,1,0,621,675,1241,1187,2.34e-19,97.1,54,54
"75254","Nsylvestris_NODE_26961_length_675_cov_15","Ntome_NODE_21685_length_1068_cov_255",100,55,0,0,621,675,318,372,5.03e-21,102,54,54
"75255","Nsylvestris_NODE_26966_length_675_cov_7","Ntome_NODE_1006_length_5083_cov_217",98.182,55,1,0,1,55,1882,1828,2.34e-19,97.1,54,54
"75256","Nsylvestris_NODE_26968_length_675_cov_3","Ntome_NODE_8221_length_2456_cov_138",96.364,55,2,0,1,55,943,889,1.09e-17,91.6,54,54
"75257","Nsylvestris_NODE_26969_length_674_cov_222","Ntome_NODE_18783_length_1293_cov_281",95.915,612,19,4,66,674,56,664,0,987,608,608
"75264","Nsylvestris_NODE_26974_length_674_cov_79","Ntome_NODE_25615_length_826_cov_131",89.267,587,36,12,28,614,74,633,0,710,586,559
"75288","Nsylvestris_NODE_26984_length_674_cov_8","Ntome_NODE_1664_length_4413_cov_245",96.364,55,2,0,1,55,1839,1893,1.09e-17,91.6,54,54
"75289","Nsylvestris_NODE_26985_length_674_cov_8","Ntome_NODE_16836_length_1462_cov_11",100,28,0,0,1,28,1341,1368,5.13e-06,52.8,27,27
"75293","Nsylvestris_NODE_26991_length_674_cov_3","Ntome_NODE_11558_length_2007_cov_245",86.901,313,41,0,1,313,1371,1683,4.51e-96,351,312,312
"75317","Nsylvestris_NODE_26999_length_673_cov_62","Ntome_NODE_5794_length_2896_cov_261",92.662,695,23,14,1,673,2866,2178,0,976,672,688
"75325","Nsylvestris_NODE_27003_length_673_cov_38","Ntome_NODE_7271_length_2610_cov_123",95.082,61,2,1,613,673,721,780,8.39e-19,95.3,60,59
"75332","Nsylvestris_NODE_27006_length_673_cov_28","Ntome_NODE_1372_length_4657_cov_119",91.026,78,6,1,589,665,1735,1812,1.39e-21,104,76,77
"75333","Nsylvestris_NODE_27008_length_673_cov_22","Ntome_NODE_22652_length_1007_cov_9",87.568,185,17,6,473,653,195,13,2.87e-53,209,180,182
"75339","Nsylvestris_NODE_27012_length_673_cov_8","Ntome_NODE_23333_length_964_cov_5",94.635,671,27,6,1,670,202,864,0,1031,669,662
"75340","Nsylvestris_NODE_27014_length_673_cov_7","Ntome_NODE_2055_length_4137_cov_157",93.22,59,3,1,615,673,1974,1917,5.05e-16,86.1,58,57
"75346","Nsylvestris_NODE_27016_length_673_cov_6","Ntome_NODE_19246_length_1256_cov_31",94.145,649,34,4,27,673,926,280,0,985,646,646
"75347","Nsylvestris_NODE_27020_length_673_cov_5","Ntome_NODE_1816_length_4296_cov_143",87.667,673,42,20,1,670,2898,2264,0,745,669,634
"75353","Nsylvestris_NODE_27024_length_672_cov_205","Ntome_NODE_27300_length_743_cov_215",88.967,426,27,7,71,476,687,262,2.52e-143,508,405,425
"75359","Nsylvestris_NODE_27026_length_672_cov_181","Ntome_NODE_32_length_10554_cov_279",96.233,584,15,3,1,577,7365,7948,0,950,576,583
"75360","Nsylvestris_NODE_27027_length_672_cov_171","Ntome_NODE_13914_length_1745_cov_85",91.358,567,30,7,112,668,578,21,0,758,556,557
"75363","Nsylvestris_NODE_27029_length_672_cov_147","Ntome_NODE_20624_length_1143_cov_194",97.619,672,14,2,1,672,391,1060,0,1151,671,669
"75381","Nsylvestris_NODE_27036_length_672_cov_28","Ntome_NODE_4783_length_3137_cov_255",100,37,0,0,1,37,2552,2588,5.08e-11,69.4,36,36
"75386","Nsylvestris_NODE_27041_length_672_cov_11","Ntome_NODE_18143_length_1347_cov_91",93.399,606,29,7,1,599,1,602,0,887,598,601
"75387","Nsylvestris_NODE_27042_length_672_cov_11","Ntome_NODE_20033_length_1189_cov_153",94.86,681,25,8,1,672,1,680,0,1055,671,679
"75388","Nsylvestris_NODE_27043_length_672_cov_9","Ntome_NODE_27595_length_728_cov_42",90.949,685,41,15,1,672,1,677,0,902,671,676
"75398","Nsylvestris_NODE_27048_length_671_cov_64","Ntome_NODE_649_length_5651_cov_29",96.274,671,25,0,1,671,3748,3078,0,1101,670,670
"75399","Nsylvestris_NODE_27049_length_671_cov_39","Ntome_NODE_649_length_5651_cov_29",94.784,671,35,0,1,671,3078,3748,0,1046,670,670
"75400","Nsylvestris_NODE_27050_length_671_cov_34","Ntome_NODE_3130_length_3646_cov_196",100,55,0,0,1,55,2721,2775,5e-21,102,54,54
"75412","Nsylvestris_NODE_27059_length_671_cov_5","Ntome_NODE_1359_length_4670_cov_73",75.887,141,27,5,519,652,2251,2391,6.56e-10,65.8,133,140
"75413","Nsylvestris_NODE_27060_length_671_cov_4","Ntome_NODE_9911_length_2211_cov_287",100,55,0,0,1,55,1989,1935,5e-21,102,54,54
"75414","Nsylvestris_NODE_27061_length_671_cov_4","Ntome_NODE_721_length_5523_cov_207",100,55,0,0,1,55,3265,3319,5e-21,102,54,54
"75422","Nsylvestris_NODE_27065_length_670_cov_173","Ntome_NODE_190_length_7486_cov_226",99.399,333,2,0,1,333,1864,2196,3.12e-172,604,332,332
"75432","Nsylvestris_NODE_27069_length_670_cov_168","Ntome_NODE_22598_length_1010_cov_98",92.476,412,23,5,35,445,14,418,1.46e-165,582,410,404
"75441","Nsylvestris_NODE_27072_length_670_cov_39","Ntome_NODE_9519_length_2267_cov_254",97.313,670,18,0,1,670,706,1375,0,1138,669,669
"75448","Nsylvestris_NODE_27077_length_670_cov_24","Ntome_NODE_3974_length_3363_cov_83",91.736,121,8,2,4,122,3183,3063,1.74e-40,167,118,120
"75455","Nsylvestris_NODE_27080_length_670_cov_19","Ntome_NODE_1764_length_4334_cov_296",100,55,0,0,1,55,515,569,4.99e-21,102,54,54
"75477","Nsylvestris_NODE_27089_length_669_cov_5","Ntome_NODE_19281_length_1253_cov_265",98.182,55,1,0,1,55,701,647,2.32e-19,97.1,54,54
"75503","Nsylvestris_NODE_27101_length_669_cov_16","Ntome_NODE_1214_length_4821_cov_120",96.364,55,2,0,1,55,1481,1535,1.08e-17,91.6,54,54
"75507","Nsylvestris_NODE_27103_length_669_cov_9","Ntome_NODE_11797_length_1981_cov_140",94.09,423,25,0,1,423,1513,1935,0,643,422,422
"75510","Nsylvestris_NODE_27107_length_669_cov_4","Ntome_NODE_5752_length_2906_cov_277",96.364,55,2,0,1,55,337,391,1.08e-17,91.6,54,54
"75511","Nsylvestris_NODE_27108_length_668_cov_214","Ntome_NODE_1811_length_4299_cov_283",92.128,343,20,3,1,338,3854,4194,7.07e-134,477,337,340
"75526","Nsylvestris_NODE_27116_length_668_cov_40","Ntome_NODE_10348_length_2152_cov_140",91.111,675,32,8,14,668,1491,825,0,889,654,666
"75529","Nsylvestris_NODE_27120_length_668_cov_14","Ntome_NODE_10292_length_2157_cov_227",93.731,670,31,5,1,668,571,1231,0,994,667,660
"75540","Nsylvestris_NODE_27125_length_668_cov_10","Ntome_NODE_332_length_6594_cov_283",98.182,55,1,0,614,668,4870,4924,2.31e-19,97.1,54,54
"75544","Nsylvestris_NODE_27127_length_668_cov_7","Ntome_NODE_1665_length_4413_cov_205",94.545,55,3,0,1,55,3847,3901,5.01e-16,86.1,54,54
"75548","Nsylvestris_NODE_27129_length_668_cov_7","Ntome_NODE_11705_length_1990_cov_273",92.676,669,48,1,1,668,551,1219,0,963,667,668
"75549","Nsylvestris_NODE_27131_length_668_cov_6","Ntome_NODE_9657_length_2245_cov_37",93.534,665,40,2,4,668,139,800,0,987,664,661
"75550","Nsylvestris_NODE_27132_length_667_cov_229","Ntome_NODE_14704_length_1665_cov_233",92.456,676,35,6,8,667,1642,967,0,952,659,675
"75553","Nsylvestris_NODE_27134_length_667_cov_201","Ntome_NODE_7093_length_2640_cov_154",94.887,665,18,5,1,664,1967,2616,0,1026,663,649
"75556","Nsylvestris_NODE_27136_length_667_cov_185","Ntome_NODE_3789_length_3423_cov_260",94.485,544,25,5,1,541,2381,2922,0,833,540,541
"75557","Nsylvestris_NODE_27137_length_667_cov_177","Ntome_NODE_32047_length_546_cov_38",91.731,520,36,3,125,644,546,34,0,715,519,512
"75560","Nsylvestris_NODE_27139_length_667_cov_171","Ntome_NODE_24702_length_880_cov_163",94.676,601,24,6,24,617,880,281,0,926,593,599
"75570","Nsylvestris_NODE_27144_length_667_cov_30","Ntome_NODE_25704_length_821_cov_7",81.081,185,22,9,37,213,186,7,4.9e-31,135,176,179
"75577","Nsylvestris_NODE_27149_length_667_cov_13","Ntome_NODE_9326_length_2292_cov_59",100,55,0,0,613,667,385,331,4.97e-21,102,54,54
"75578","Nsylvestris_NODE_27150_length_667_cov_12","Ntome_NODE_20870_length_1127_cov_6",93.382,680,30,6,1,667,33,710,0,992,666,677
"75594","Nsylvestris_NODE_27159_length_666_cov_239","Ntome_NODE_5583_length_2943_cov_226",95.645,574,21,4,41,613,2100,2670,0,918,572,570
"75595","Nsylvestris_NODE_27160_length_666_cov_228","Ntome_NODE_9634_length_2248_cov_248",97.748,666,15,0,1,666,619,1284,0,1147,665,665
"75616","Nsylvestris_NODE_27169_length_666_cov_39","Ntome_NODE_6661_length_2719_cov_85",93.553,667,42,1,1,666,1998,1332,0,992,665,666
"75621","Nsylvestris_NODE_27172_length_666_cov_14","Ntome_NODE_8840_length_2363_cov_38",98.148,54,1,0,2,55,790,737,8.3e-19,95.3,53,53
"75622","Nsylvestris_NODE_27173_length_666_cov_13","Ntome_NODE_10390_length_2146_cov_266",94.231,52,3,0,615,666,1198,1249,2.32e-14,80.5,51,51
"75623","Nsylvestris_NODE_27176_length_666_cov_11","Ntome_NODE_14657_length_1671_cov_233",93.431,137,8,1,259,395,160,295,4.75e-51,202,136,135
"75624","Nsylvestris_NODE_27177_length_666_cov_11","Ntome_NODE_15016_length_1633_cov_237",94.709,189,9,1,137,324,1582,1394,2.74e-78,292,187,188
"75625","Nsylvestris_NODE_27178_length_666_cov_7","Ntome_NODE_11305_length_2036_cov_228",98.182,55,1,0,1,55,882,828,2.31e-19,97.1,54,54
"75626","Nsylvestris_NODE_27180_length_666_cov_7","Ntome_NODE_2355_length_3983_cov_58",94.937,79,4,0,555,633,3184,3262,1.06e-27,124,78,78
"75632","Nsylvestris_NODE_27185_length_665_cov_217","Ntome_NODE_23060_length_979_cov_228",90.651,599,38,10,75,656,180,777,0,780,581,597
"75635","Nsylvestris_NODE_27187_length_665_cov_206","Ntome_NODE_14308_length_1704_cov_189",94.821,560,28,1,99,658,1087,1645,0,872,559,558
"75638","Nsylvestris_NODE_27189_length_665_cov_101","Ntome_NODE_19618_length_1224_cov_59",96.97,33,1,0,563,595,175,207,3.91e-07,56.5,32,32
"75639","Nsylvestris_NODE_27190_length_665_cov_91","Ntome_NODE_1691_length_4386_cov_27",82.256,665,116,2,2,665,3359,2696,8.73e-163,573,663,663
"75649","Nsylvestris_NODE_27197_length_665_cov_11","Ntome_NODE_6604_length_2729_cov_226",96.541,665,20,2,1,665,1814,1153,0,1098,664,661
"75652","Nsylvestris_NODE_27199_length_665_cov_6","Ntome_NODE_22996_length_984_cov_5",91.737,593,49,0,1,593,593,1,0,824,592,592
"75653","Nsylvestris_NODE_27202_length_664_cov_193","Ntome_NODE_13892_length_1747_cov_43",83.559,590,73,11,51,617,619,31,5.32e-150,531,566,588
"75660","Nsylvestris_NODE_27205_length_664_cov_39","Ntome_NODE_27202_length_748_cov_31",90.909,638,35,7,1,634,67,685,0,835,633,618
"75676","Nsylvestris_NODE_27213_length_664_cov_16","Ntome_NODE_3670_length_3461_cov_291",98.305,59,0,1,606,664,741,798,4.94e-21,102,58,57
"75691","Nsylvestris_NODE_27221_length_663_cov_180","Ntome_NODE_23855_length_933_cov_162",90.671,611,33,13,1,610,292,879,0,791,609,587
"75701","Nsylvestris_NODE_27225_length_663_cov_60","Ntome_NODE_18741_length_1297_cov_46",91.084,415,23,5,49,450,524,937,1.47e-155,549,401,413
"75713","Nsylvestris_NODE_27234_length_663_cov_10","Ntome_NODE_3080_length_3665_cov_263",89.205,667,23,15,32,663,32,684,0,787,631,652
"75718","Nsylvestris_NODE_27238_length_663_cov_5","Ntome_NODE_23442_length_958_cov_49",93.949,661,25,6,3,663,204,849,0,985,660,645
"75723","Nsylvestris_NODE_27241_length_662_cov_209","Ntome_NODE_24523_length_890_cov_273",96.344,547,17,1,2,548,293,836,0,896,546,543
"75733","Nsylvestris_NODE_27245_length_662_cov_158","Ntome_NODE_19498_length_1234_cov_165",90.484,641,24,9,1,628,599,1215,0,811,627,616
"75747","Nsylvestris_NODE_27251_length_662_cov_33","Ntome_NODE_10709_length_2106_cov_42",91.139,79,6,1,334,411,144,66,3.81e-22,106,77,78
"75753","Nsylvestris_NODE_27254_length_662_cov_21","Ntome_NODE_12769_length_1865_cov_234",92.359,301,12,5,103,395,368,665,4.31e-116,418,292,297
"75764","Nsylvestris_NODE_27263_length_662_cov_6","Ntome_NODE_11788_length_1982_cov_158",98.182,55,1,0,608,662,745,691,2.29e-19,97.1,54,54
"75765","Nsylvestris_NODE_27264_length_662_cov_5","Ntome_NODE_220_length_7282_cov_263",92.251,684,27,11,1,662,1785,1106,0,946,661,679
"75787","Nsylvestris_NODE_27271_length_661_cov_80","Ntome_NODE_30240_length_618_cov_253",88.36,189,22,0,262,450,438,250,7.78e-59,228,188,188
"75788","Nsylvestris_NODE_27272_length_661_cov_76","Ntome_NODE_12186_length_1935_cov_141",82.18,477,71,13,190,659,1005,1474,5.6e-110,398,469,469
"75789","Nsylvestris_NODE_27273_length_661_cov_69","Ntome_NODE_29299_length_656_cov_107",90.975,554,28,6,56,608,653,121,0,726,552,532
"75790","Nsylvestris_NODE_27274_length_661_cov_22","Ntome_NODE_9424_length_2277_cov_308",92.084,619,49,0,43,661,1601,983,0,872,618,618
"75793","Nsylvestris_NODE_27276_length_661_cov_20","Ntome_NODE_18351_length_1330_cov_8",93.192,426,28,1,188,613,1324,900,2.36e-178,625,425,424
"75810","Nsylvestris_NODE_27283_length_661_cov_8","Ntome_NODE_1358_length_4670_cov_231",94.545,55,3,0,607,661,3767,3713,4.95e-16,86.1,54,54
"75825","Nsylvestris_NODE_27292_length_660_cov_58","Ntome_NODE_607_length_5758_cov_201",96.552,58,2,0,603,660,2941,2998,2.28e-19,97.1,57,57
"75830","Nsylvestris_NODE_27294_length_658_cov_54","Ntome_NODE_33678_length_434_cov_228",87.784,352,34,5,113,457,350,1,1.2e-111,403,344,349
"75834","Nsylvestris_NODE_27296_length_660_cov_26","Ntome_NODE_46_length_9810_cov_171",75.292,684,132,25,1,657,4346,5019,2.72e-78,292,656,673
"75835","Nsylvestris_NODE_27297_length_660_cov_22","Ntome_NODE_22199_length_1034_cov_73",89.95,398,31,6,51,442,299,693,3.2e-142,505,391,394
"75836","Nsylvestris_NODE_27298_length_660_cov_19","Ntome_NODE_29474_length_649_cov_19",91.239,662,41,8,2,660,2,649,0,885,658,647
"75837","Nsylvestris_NODE_27301_length_660_cov_18","Ntome_NODE_22715_length_1003_cov_8",85.574,610,50,18,57,660,991,414,3.07e-172,604,603,577
"75838","Nsylvestris_NODE_27302_length_660_cov_16","Ntome_NODE_22384_length_1024_cov_17",94.418,627,28,2,34,660,290,909,0,957,626,619
"75839","Nsylvestris_NODE_27303_length_660_cov_15","Ntome_NODE_8016_length_2489_cov_95",90.937,662,41,9,1,660,1225,581,0,872,659,644
"75846","Nsylvestris_NODE_27306_length_660_cov_9","Ntome_NODE_19_length_11828_cov_48",81.846,661,116,3,1,660,4226,4883,1.13e-156,553,659,657
"75858","Nsylvestris_NODE_27312_length_660_cov_5","Ntome_NODE_22406_length_1022_cov_169",100,55,0,0,606,660,469,415,4.91e-21,102,54,54
"75859","Nsylvestris_NODE_27313_length_660_cov_4","Ntome_NODE_2156_length_4082_cov_127",93.353,662,28,10,1,660,793,146,0,965,659,647
"75862","Nsylvestris_NODE_27315_length_660_cov_3","Ntome_NODE_10367_length_2150_cov_52",91.331,323,25,1,57,379,2150,1831,3.3e-122,438,322,319
"75865","Nsylvestris_NODE_27317_length_659_cov_205","Ntome_NODE_12801_length_1862_cov_147",84.956,113,17,0,137,249,1796,1684,6.3e-25,115,112,112
"75866","Nsylvestris_NODE_27318_length_659_cov_197","Ntome_NODE_24008_length_924_cov_95",95.085,529,23,1,131,659,923,398,0,830,528,525
"75870","Nsylvestris_NODE_27320_length_660_cov_189","Ntome_NODE_24764_length_876_cov_222",94.921,630,18,3,1,619,849,223,0,974,618,626
"75873","Nsylvestris_NODE_27322_length_659_cov_163","Ntome_NODE_2239_length_4041_cov_152",94.992,659,33,0,1,659,1228,570,0,1035,658,658
"75874","Nsylvestris_NODE_27324_length_659_cov_28","Ntome_NODE_3879_length_3394_cov_32",89.531,277,10,3,365,623,3117,3392,1.6e-90,333,258,275
"75880","Nsylvestris_NODE_27326_length_659_cov_21","Ntome_NODE_11383_length_2027_cov_206",89.333,75,5,3,42,115,713,785,1.06e-17,91.6,73,72
"75883","Nsylvestris_NODE_27328_length_659_cov_19","Ntome_NODE_4179_length_3301_cov_244",98.182,55,1,0,1,55,888,942,2.28e-19,97.1,54,54
"75884","Nsylvestris_NODE_27329_length_659_cov_17","Ntome_NODE_12871_length_1854_cov_107",92.261,659,51,0,1,659,979,321,0,935,658,658
"75885","Nsylvestris_NODE_27331_length_659_cov_12","Ntome_NODE_6023_length_2843_cov_235",98.182,55,1,0,1,55,704,650,2.28e-19,97.1,54,54
"75888","Nsylvestris_NODE_27334_length_659_cov_7","Ntome_NODE_17513_length_1402_cov_23",91.831,661,50,3,1,659,827,169,0,918,658,658
"75889","Nsylvestris_NODE_27335_length_659_cov_7","Ntome_NODE_23744_length_941_cov_9",91.438,292,22,3,226,515,291,1,5.58e-110,398,289,290
"75890","Nsylvestris_NODE_27336_length_659_cov_6","Ntome_NODE_29787_length_637_cov_3",96.325,381,14,0,279,659,1,381,6.54e-179,627,380,380
"75895","Nsylvestris_NODE_27342_length_658_cov_119","Ntome_NODE_6901_length_2674_cov_237",94.234,659,24,3,1,657,1108,1754,0,994,656,646
"75896","Nsylvestris_NODE_27343_length_658_cov_114","Ntome_NODE_23224_length_970_cov_15",92.893,394,16,2,277,658,970,577,1.87e-159,562,381,393
"75923","Nsylvestris_NODE_27353_length_658_cov_15","Ntome_NODE_13705_length_1767_cov_183",83.784,74,12,0,99,172,263,190,1.38e-11,71.3,73,73
"75924","Nsylvestris_NODE_27354_length_658_cov_14","Ntome_NODE_2213_length_4054_cov_181",89.806,412,38,4,122,531,419,10,2.45e-148,525,409,409
"75925","Nsylvestris_NODE_27355_length_658_cov_10","Ntome_NODE_14427_length_1693_cov_35",95.413,109,5,0,362,470,478,370,1.02e-42,174,108,108
"75930","Nsylvestris_NODE_27360_length_658_cov_6","Ntome_NODE_18276_length_1335_cov_266",100,53,0,0,3,55,785,837,6.33e-20,99,52,52
"75931","Nsylvestris_NODE_27362_length_658_cov_4","Ntome_NODE_6403_length_2766_cov_187",100,35,0,0,1,35,1089,1123,6.42e-10,65.8,34,34
"75935","Nsylvestris_NODE_27364_length_657_cov_225","Ntome_NODE_9096_length_2324_cov_126",94.872,39,2,0,86,124,1951,1989,8.3e-09,62.1,38,38
"75936","Nsylvestris_NODE_27365_length_657_cov_181","Ntome_NODE_32076_length_544_cov_12",93.153,555,21,5,44,592,1,544,0,798,548,543
"75937","Nsylvestris_NODE_27366_length_657_cov_178","Ntome_NODE_20785_length_1132_cov_97",87.871,371,22,6,248,595,714,1084,5.53e-115,414,347,370
"75940","Nsylvestris_NODE_27369_length_657_cov_91","Ntome_NODE_6734_length_2706_cov_86",90.533,338,23,5,58,394,2,331,3.28e-122,438,336,329
"75941","Nsylvestris_NODE_27370_length_657_cov_65","Ntome_NODE_34092_length_415_cov_2",92.105,342,25,2,317,657,415,75,5.37e-135,481,340,340
"75945","Nsylvestris_NODE_27373_length_657_cov_23","Ntome_NODE_2126_length_4094_cov_213",80.303,198,26,8,471,657,1924,1729,1.34e-31,137,186,195
"75946","Nsylvestris_NODE_27374_length_657_cov_22","Ntome_NODE_3132_length_3646_cov_125",100,55,0,0,603,657,2497,2551,4.89e-21,102,54,54
"75951","Nsylvestris_NODE_27376_length_657_cov_17","Ntome_NODE_35858_length_343_cov_5",83.944,355,35,14,30,374,343,1,1.24e-86,320,344,342
"75958","Nsylvestris_NODE_27379_length_657_cov_10","Ntome_NODE_10147_length_2178_cov_232",89.259,661,51,6,1,657,1956,1312,0,809,656,644
"75991","Nsylvestris_NODE_27397_length_656_cov_11","Ntome_NODE_5941_length_2863_cov_100",97.453,589,14,1,51,639,2041,2628,0,1003,588,587
"75998","Nsylvestris_NODE_27403_length_656_cov_5","Ntome_NODE_3054_length_3677_cov_68",100,30,0,0,626,655,1070,1099,3.85e-07,56.5,29,29
"75999","Nsylvestris_NODE_27404_length_655_cov_216","Ntome_NODE_20861_length_1127_cov_179",93.627,659,36,3,1,655,3,659,0,979,654,656
"76006","Nsylvestris_NODE_27407_length_655_cov_102","Ntome_NODE_8053_length_2483_cov_96",93.095,391,27,0,265,655,2358,1968,8.59e-163,573,390,390
"76007","Nsylvestris_NODE_27408_length_655_cov_87","Ntome_NODE_724_length_5520_cov_200",89.189,74,3,2,253,321,3822,3749,1.36e-16,87.9,68,73
"76013","Nsylvestris_NODE_27412_length_655_cov_35","Ntome_NODE_10800_length_2095_cov_289",94.118,68,3,1,1,67,970,1037,4.87e-21,102,66,67
"76014","Nsylvestris_NODE_27414_length_655_cov_30","Ntome_NODE_12299_length_1922_cov_30",78.261,207,34,11,450,651,289,489,3.74e-27,122,201,200
"76023","Nsylvestris_NODE_27419_length_655_cov_12","Ntome_NODE_12483_length_1899_cov_184",94.038,369,12,7,82,448,1678,1318,4.03e-156,551,366,360
"76026","Nsylvestris_NODE_27421_length_655_cov_7","Ntome_NODE_4235_length_3281_cov_247",96.61,59,1,1,597,655,1520,1577,2.27e-19,97.1,58,57
"76027","Nsylvestris_NODE_27422_length_655_cov_6","Ntome_NODE_5710_length_2915_cov_112",98.182,55,1,0,1,55,1096,1042,2.27e-19,97.1,54,54
"76028","Nsylvestris_NODE_27423_length_655_cov_4","Ntome_NODE_28068_length_707_cov_11",87.915,422,26,12,242,653,524,118,8.96e-133,473,411,406
"76029","Nsylvestris_NODE_27424_length_655_cov_4","Ntome_NODE_18343_length_1330_cov_224",100,55,0,0,1,55,480,534,4.87e-21,102,54,54
"76033","Nsylvestris_NODE_27426_length_654_cov_201","Ntome_NODE_24216_length_911_cov_286",94.266,436,20,1,219,654,907,477,0,662,435,430
"76034","Nsylvestris_NODE_27427_length_654_cov_176","Ntome_NODE_28451_length_690_cov_194",89.109,505,25,16,52,547,533,50,3.93e-171,601,495,483
"76035","Nsylvestris_NODE_27428_length_654_cov_157","Ntome_NODE_23260_length_967_cov_178",93.874,555,26,4,104,654,967,417,0,830,550,550
"76040","Nsylvestris_NODE_27430_length_654_cov_98","Ntome_NODE_29701_length_640_cov_10",97.55,449,11,0,158,606,1,449,0,769,448,448
"76047","Nsylvestris_NODE_27433_length_654_cov_26","Ntome_NODE_15542_length_1580_cov_172",98.039,51,1,0,604,654,1346,1396,3.79e-17,89.8,50,50
"76048","Nsylvestris_NODE_27435_length_654_cov_18","Ntome_NODE_31713_length_563_cov_279",96.364,55,2,0,1,55,319,265,1.05e-17,91.6,54,54
"76049","Nsylvestris_NODE_27436_length_654_cov_11","Ntome_NODE_1300_length_4730_cov_140",98.182,55,1,0,600,654,332,278,2.26e-19,97.1,54,54
"76050","Nsylvestris_NODE_27440_length_654_cov_6","Ntome_NODE_23322_length_964_cov_28",94.545,55,3,0,600,654,563,509,4.9e-16,86.1,54,54
"76062","Nsylvestris_NODE_27445_length_653_cov_211","Ntome_NODE_25253_length_847_cov_235",90.206,582,25,16,51,601,216,796,0,730,550,580
"76083","Nsylvestris_NODE_27454_length_653_cov_10","Ntome_NODE_14135_length_1724_cov_8",90.841,666,48,7,1,653,669,4,0,880,652,665
"76090","Nsylvestris_NODE_27458_length_653_cov_6","Ntome_NODE_27386_length_739_cov_7",84.602,591,48,29,88,653,739,167,5.19e-155,547,565,572
"76093","Nsylvestris_NODE_27462_length_653_cov_5","Ntome_NODE_16135_length_1528_cov_30",95.645,643,12,3,11,653,193,819,0,1018,642,626
"76106","Nsylvestris_NODE_27468_length_652_cov_61","Ntome_NODE_20860_length_1127_cov_184",95.134,596,29,0,45,640,482,1077,0,941,595,595
"76110","Nsylvestris_NODE_27471_length_652_cov_42","Ntome_NODE_10229_length_2166_cov_64",98.182,55,1,0,1,55,655,709,2.26e-19,97.1,54,54
"76111","Nsylvestris_NODE_27472_length_652_cov_41","Ntome_NODE_24873_length_870_cov_269",96.364,55,2,0,598,652,128,182,1.05e-17,91.6,54,54
"76124","Nsylvestris_NODE_27477_length_652_cov_13","Ntome_NODE_1667_length_4410_cov_33",92.265,181,12,2,178,357,140,319,3.52e-67,255,179,179
"76125","Nsylvestris_NODE_27479_length_652_cov_10","Ntome_NODE_12668_length_1878_cov_265",92.537,67,5,0,3,69,1251,1185,2.26e-19,97.1,66,66
"76126","Nsylvestris_NODE_27480_length_652_cov_10","Ntome_NODE_34377_length_401_cov_7",94.4,125,7,0,515,639,398,274,2.8e-48,193,124,124
"76145","Nsylvestris_NODE_27489_length_652_cov_3","Ntome_NODE_68_length_9166_cov_102",93.506,77,4,1,71,147,6089,6164,2.24e-24,113,76,75
"76148","Nsylvestris_NODE_27491_length_651_cov_209","Ntome_NODE_20843_length_1128_cov_286",97.035,607,11,2,45,651,112,711,0,1014,606,599
"76149","Nsylvestris_NODE_27492_length_651_cov_199","Ntome_NODE_17160_length_1434_cov_137",94.937,553,25,1,50,602,602,53,0,863,552,549
"76152","Nsylvestris_NODE_27494_length_651_cov_167","Ntome_NODE_3208_length_3619_cov_251",91.653,611,37,8,50,651,3491,2886,0,833,601,605
"76155","Nsylvestris_NODE_27496_length_651_cov_47","Ntome_NODE_7539_length_2563_cov_253",80.981,673,82,26,1,646,2351,1698,2.46e-138,492,645,653
"76160","Nsylvestris_NODE_27499_length_651_cov_22","Ntome_NODE_3697_length_3452_cov_258",100,52,0,0,600,651,2617,2566,2.25e-19,97.1,51,51
"76171","Nsylvestris_NODE_27504_length_651_cov_11","Ntome_NODE_6880_length_2678_cov_216",96.364,55,2,0,597,651,629,575,1.05e-17,91.6,54,54
"76172","Nsylvestris_NODE_27505_length_651_cov_11","Ntome_NODE_6877_length_2679_cov_123",84.091,176,27,1,272,446,1494,1319,4.71e-41,169,174,175
"76179","Nsylvestris_NODE_27508_length_651_cov_9","Ntome_NODE_1341_length_4691_cov_248",98.182,55,1,0,597,651,3497,3551,2.25e-19,97.1,54,54
"76184","Nsylvestris_NODE_27510_length_651_cov_8","Ntome_NODE_12489_length_1898_cov_251",94.545,55,3,0,1,55,1172,1226,4.88e-16,86.1,54,54
"76192","Nsylvestris_NODE_27516_length_650_cov_163","Ntome_NODE_13683_length_1768_cov_139",94.198,655,18,4,1,644,657,12,0,981,643,645
"76201","Nsylvestris_NODE_27519_length_650_cov_35","Ntome_NODE_2823_length_3765_cov_67",93.519,324,17,3,328,650,1,321,1.91e-134,479,322,320
"76202","Nsylvestris_NODE_27520_length_650_cov_33","Ntome_NODE_3258_length_3603_cov_97",98.182,55,1,0,596,650,1305,1251,2.25e-19,97.1,54,54
"76203","Nsylvestris_NODE_27522_length_650_cov_22","Ntome_NODE_22850_length_993_cov_38",89.362,47,4,1,585,631,852,897,1.06e-07,58.4,46,45
"76223","Nsylvestris_NODE_27532_length_650_cov_5","Ntome_NODE_31201_length_582_cov_4",93.966,580,35,0,64,643,3,582,0,878,579,579
"76238","Nsylvestris_NODE_27540_length_649_cov_65","Ntome_NODE_2823_length_3765_cov_67",92.727,55,4,0,1,55,321,267,2.26e-14,80.5,54,54
"76241","Nsylvestris_NODE_27542_length_649_cov_32","Ntome_NODE_36329_length_329_cov_9",100,32,0,0,595,626,32,1,2.95e-08,60.2,31,31
"76242","Nsylvestris_NODE_27543_length_649_cov_23","Ntome_NODE_15952_length_1543_cov_30",77.953,127,26,2,278,403,1260,1135,8.13e-14,78.7,125,125
"76245","Nsylvestris_NODE_27545_length_649_cov_19","Ntome_NODE_28131_length_704_cov_103",92.936,637,45,0,1,637,673,37,0,928,636,636
"76246","Nsylvestris_NODE_27546_length_649_cov_19","Ntome_NODE_21063_length_1103_cov_17",85.08,563,44,11,87,649,628,106,3.1e-152,538,562,522
"76254","Nsylvestris_NODE_27550_length_649_cov_7","Ntome_NODE_8843_length_2362_cov_274",84.413,494,67,7,1,492,703,218,6.86e-134,477,491,485
"76257","Nsylvestris_NODE_27552_length_649_cov_5","Ntome_NODE_9351_length_2288_cov_263",95.556,45,2,0,605,649,951,907,3.78e-12,73.1,44,44
"76262","Nsylvestris_NODE_27556_length_648_cov_212","Ntome_NODE_24424_length_897_cov_197",86.677,623,43,19,27,647,869,285,0,654,620,584
"76267","Nsylvestris_NODE_27561_length_648_cov_80","Ntome_NODE_4669_length_3166_cov_115",95.833,72,2,1,577,648,201,131,6.19e-25,115,71,70
"76268","Nsylvestris_NODE_27562_length_648_cov_78","Ntome_NODE_23624_length_947_cov_134",92.727,55,4,0,594,648,335,281,2.26e-14,80.5,54,54
"76277","Nsylvestris_NODE_27568_length_648_cov_17","Ntome_NODE_1724_length_4360_cov_97",73.563,348,64,25,11,350,894,567,1.04e-22,108,339,327
"76286","Nsylvestris_NODE_27573_length_648_cov_7","Ntome_NODE_3385_length_3556_cov_15",90.698,645,58,2,4,648,2308,1666,0,857,644,642
"76306","Nsylvestris_NODE_27586_length_647_cov_32","Ntome_NODE_4730_length_3152_cov_249",82.803,628,54,26,33,647,2855,2269,1.88e-144,512,614,586
"76318","Nsylvestris_NODE_27592_length_647_cov_16","Ntome_NODE_14965_length_1639_cov_181",98.182,55,1,0,1,55,1381,1327,2.24e-19,97.1,54,54
"76319","Nsylvestris_NODE_27593_length_647_cov_15","Ntome_NODE_3348_length_3568_cov_295",100,55,0,0,1,55,1445,1499,4.81e-21,102,54,54
"76325","Nsylvestris_NODE_27597_length_647_cov_9","Ntome_NODE_3316_length_3579_cov_149",89.954,647,23,4,1,645,974,1580,0,797,644,606
"76326","Nsylvestris_NODE_27600_length_647_cov_8","Ntome_NODE_39_length_10305_cov_279",79.819,441,78,10,208,644,9243,9676,7.34e-84,311,436,433
"76327","Nsylvestris_NODE_27602_length_647_cov_5","Ntome_NODE_986_length_5110_cov_73",98.529,68,1,0,1,68,3553,3620,1.33e-26,121,67,67
"76328","Nsylvestris_NODE_27603_length_647_cov_5","Ntome_NODE_7531_length_2566_cov_80",93.934,544,28,5,109,647,167,710,0,817,538,543
"76339","Nsylvestris_NODE_27608_length_646_cov_180","Ntome_NODE_19239_length_1256_cov_246",94.772,593,24,2,1,592,728,142,0,917,591,586
"76350","Nsylvestris_NODE_27615_length_646_cov_22","Ntome_NODE_21294_length_1095_cov_59",94.31,580,23,3,27,596,1036,457,0,880,569,579
"76353","Nsylvestris_NODE_27617_length_646_cov_17","Ntome_NODE_26436_length_785_cov_185",96.604,589,20,0,3,591,60,648,0,977,588,588
"76356","Nsylvestris_NODE_27619_length_646_cov_13","Ntome_NODE_408_length_6289_cov_156",88.771,659,57,10,1,646,2442,1788,0,791,645,654
"76357","Nsylvestris_NODE_27620_length_646_cov_12","Ntome_NODE_15123_length_1621_cov_291",100,54,0,0,2,55,1070,1123,1.73e-20,100,53,53
"76366","Nsylvestris_NODE_27624_length_646_cov_5","Ntome_NODE_35693_length_348_cov_3",94.842,349,14,2,26,371,348,1,2.39e-153,542,345,347
"76367","Nsylvestris_NODE_27625_length_646_cov_4","Ntome_NODE_11923_length_1968_cov_39",95.969,645,26,0,2,646,261,905,0,1048,644,644
"76370","Nsylvestris_NODE_27627_length_645_cov_195","Ntome_NODE_12834_length_1858_cov_139",92.843,517,18,14,46,553,1260,1766,0,732,507,506
"76373","Nsylvestris_NODE_27631_length_645_cov_15","Ntome_NODE_25123_length_856_cov_75",98.182,55,1,0,591,645,484,430,2.23e-19,97.1,54,54
"76374","Nsylvestris_NODE_27632_length_645_cov_13","Ntome_NODE_22475_length_1018_cov_103",88.571,280,23,3,369,645,558,831,5.62e-90,331,276,273
"76378","Nsylvestris_NODE_27634_length_645_cov_10","Ntome_NODE_14426_length_1693_cov_49",94.098,610,19,9,3,597,969,362,0,911,594,607
"76379","Nsylvestris_NODE_27635_length_645_cov_10","Ntome_NODE_12418_length_1906_cov_246",98.182,55,1,0,1,55,1507,1453,2.23e-19,97.1,54,54
"76380","Nsylvestris_NODE_27636_length_645_cov_7","Ntome_NODE_2691_length_3818_cov_231",87.085,271,23,6,377,644,1505,1244,2.05e-79,296,267,261
"76381","Nsylvestris_NODE_27637_length_645_cov_5","Ntome_NODE_38011_length_288_cov_4",96.596,235,8,0,1,235,7,241,9.14e-108,390,234,234
"76387","Nsylvestris_NODE_27642_length_644_cov_73","Ntome_NODE_31428_length_572_cov_62",86.957,161,17,4,211,369,211,53,7.73e-44,178,158,158
"76394","Nsylvestris_NODE_27647_length_644_cov_14","Ntome_NODE_293_length_6755_cov_121",91.615,644,54,0,1,644,5429,6072,0,891,643,643
"76400","Nsylvestris_NODE_27649_length_644_cov_12","Ntome_NODE_436_length_6212_cov_90",90.752,638,28,11,3,610,2966,2330,0,822,607,636
"76401","Nsylvestris_NODE_27653_length_644_cov_7","Ntome_NODE_1469_length_4560_cov_253",98.182,55,1,0,1,55,2940,2886,2.23e-19,97.1,54,54
"76402","Nsylvestris_NODE_27654_length_644_cov_7","Ntome_NODE_11722_length_1989_cov_101",92.747,648,38,8,1,644,108,750,0,928,643,642
"76403","Nsylvestris_NODE_27655_length_644_cov_7","Ntome_NODE_39779_length_253_cov_2",100,55,0,0,1,55,156,102,4.79e-21,102,54,54
"76404","Nsylvestris_NODE_27657_length_644_cov_5","Ntome_NODE_8721_length_2382_cov_64",100,53,0,0,592,644,1425,1477,6.19e-20,99,52,52
"76413","Nsylvestris_NODE_27664_length_643_cov_81","Ntome_NODE_13681_length_1769_cov_169",88.408,647,70,5,1,643,746,101,0,774,642,645
"76423","Nsylvestris_NODE_27668_length_643_cov_38","Ntome_NODE_8534_length_2408_cov_47",96.429,56,0,2,1,55,276,222,1.03e-17,91.6,54,54
"76443","Nsylvestris_NODE_27675_length_643_cov_11","Ntome_NODE_30021_length_627_cov_8",91.978,536,42,1,2,536,42,577,0,750,534,535
"76447","Nsylvestris_NODE_27678_length_643_cov_8","Ntome_NODE_5641_length_2930_cov_18",97.969,640,11,2,1,638,2194,1555,0,1109,637,639
"76450","Nsylvestris_NODE_27684_length_643_cov_5","Ntome_NODE_433_length_6221_cov_85",88.75,640,41,15,6,641,3108,3720,0,754,635,612
"76451","Nsylvestris_NODE_27685_length_642_cov_244","Ntome_NODE_20678_length_1139_cov_346",99.533,642,3,0,1,642,230,871,0,1170,641,641
"76452","Nsylvestris_NODE_27686_length_642_cov_130","Ntome_NODE_5794_length_2896_cov_261",90.796,641,37,7,1,622,2178,2815,0,837,621,637
"76453","Nsylvestris_NODE_27687_length_642_cov_77","Ntome_NODE_27252_length_746_cov_9",98.182,55,1,0,1,55,487,541,2.22e-19,97.1,54,54
"76463","Nsylvestris_NODE_27690_length_642_cov_45","Ntome_NODE_37405_length_301_cov_11",81.707,82,11,3,470,550,295,217,6.26e-10,65.8,80,78
"76468","Nsylvestris_NODE_27693_length_642_cov_20","Ntome_NODE_17543_length_1398_cov_281",94.545,55,3,0,1,55,933,879,4.81e-16,86.1,54,54
"76469","Nsylvestris_NODE_27694_length_642_cov_14","Ntome_NODE_277_length_6918_cov_98",89.879,247,23,1,398,642,5303,5057,1.57e-85,316,244,246
"76477","Nsylvestris_NODE_27699_length_642_cov_5","Ntome_NODE_16097_length_1531_cov_265",92.835,656,29,6,1,642,765,114,0,935,641,651
"76490","Nsylvestris_NODE_27705_length_641_cov_131","Ntome_NODE_18649_length_1304_cov_241",97.674,43,1,0,1,43,1077,1035,1.04e-12,75,42,42
"76491","Nsylvestris_NODE_27706_length_641_cov_121","Ntome_NODE_18947_length_1281_cov_57",97.816,641,14,0,1,641,1205,565,0,1107,640,640
"76495","Nsylvestris_NODE_27708_length_641_cov_47","Ntome_NODE_1721_length_4366_cov_178",92.727,55,4,0,1,55,1722,1668,2.23e-14,80.5,54,54
"76496","Nsylvestris_NODE_27709_length_641_cov_33","Ntome_NODE_6625_length_2725_cov_56",87.037,54,7,0,106,159,2661,2714,8.09e-09,62.1,53,53
"76508","Nsylvestris_NODE_27718_length_641_cov_16","Ntome_NODE_28303_length_697_cov_264",96.875,64,1,1,579,641,161,224,3.68e-22,106,62,63
"76517","Nsylvestris_NODE_27722_length_641_cov_10","Ntome_NODE_25762_length_818_cov_10",90.465,430,35,5,6,431,30,457,1.82e-159,562,425,427
"76523","Nsylvestris_NODE_27725_length_641_cov_8","Ntome_NODE_1958_length_4205_cov_259",98.182,55,1,0,1,55,3130,3184,2.22e-19,97.1,54,54
"76526","Nsylvestris_NODE_27728_length_641_cov_6","Ntome_NODE_28034_length_709_cov_4",85.645,411,41,8,243,641,104,508,1.5e-115,416,398,404
"76538","Nsylvestris_NODE_27736_length_640_cov_198","Ntome_NODE_26212_length_796_cov_264",86.01,579,40,17,54,594,220,795,1.39e-165,582,540,575
"76542","Nsylvestris_NODE_27738_length_640_cov_154","Ntome_NODE_11712_length_1988_cov_83",97.318,261,7,0,1,261,1304,1564,6.86e-124,444,260,260
"76553","Nsylvestris_NODE_27743_length_640_cov_17","Ntome_NODE_24970_length_864_cov_40",82.212,208,35,2,301,507,512,306,7.68e-44,178,206,206
"76563","Nsylvestris_NODE_27750_length_640_cov_9","Ntome_NODE_3837_length_3408_cov_172",86.91,657,43,15,5,637,6,643,0,697,632,637
"76579","Nsylvestris_NODE_27759_length_639_cov_165","Ntome_NODE_17554_length_1397_cov_240",100,55,0,0,585,639,536,590,4.75e-21,102,54,54
"76583","Nsylvestris_NODE_27762_length_639_cov_52","Ntome_NODE_4756_length_3144_cov_294",96.875,32,1,0,1,32,1837,1806,1.35e-06,54.7,31,31
"76584","Nsylvestris_NODE_27764_length_639_cov_27","Ntome_NODE_1898_length_4236_cov_268",100,46,0,0,594,639,4236,4191,4.78e-16,86.1,45,45
"76589","Nsylvestris_NODE_27768_length_639_cov_15","Ntome_NODE_22850_length_993_cov_38",100,28,0,0,22,49,512,539,4.85e-06,52.8,27,27
"76590","Nsylvestris_NODE_27769_length_639_cov_15","Ntome_NODE_22085_length_1042_cov_176",84.127,252,37,2,263,514,452,204,9.65e-63,241,251,248
"76595","Nsylvestris_NODE_27773_length_639_cov_8","Ntome_NODE_5278_length_3012_cov_141",93.103,58,1,2,585,639,643,586,6.19e-15,82.4,54,57
"76596","Nsylvestris_NODE_27775_length_639_cov_6","Ntome_NODE_17795_length_1375_cov_99",100,55,0,0,585,639,513,567,4.75e-21,102,54,54
"76597","Nsylvestris_NODE_27777_length_639_cov_6","Ntome_NODE_4417_length_3234_cov_49",94.539,586,28,2,1,584,35,618,0,902,583,583
"76598","Nsylvestris_NODE_27778_length_639_cov_6","Ntome_NODE_5089_length_3056_cov_162",94.844,640,30,3,1,639,1099,1736,0,996,638,637
"76612","Nsylvestris_NODE_27786_length_638_cov_63","Ntome_NODE_12453_length_1903_cov_46",95.149,639,27,4,1,638,842,1477,0,1005,637,635
"76620","Nsylvestris_NODE_27793_length_638_cov_24","Ntome_NODE_1396_length_4636_cov_255",92.427,647,35,8,1,638,1418,2059,0,911,637,641
"76624","Nsylvestris_NODE_27796_length_638_cov_12","Ntome_NODE_34251_length_407_cov_15",95.652,46,2,0,10,55,336,291,1.03e-12,75,45,45
"76627","Nsylvestris_NODE_27798_length_638_cov_10","Ntome_NODE_18026_length_1355_cov_321",98.182,55,1,0,1,55,422,368,2.21e-19,97.1,54,54
"76628","Nsylvestris_NODE_27799_length_638_cov_9","Ntome_NODE_10709_length_2106_cov_42",95.768,638,26,1,2,638,1125,488,0,1027,636,637
"76629","Nsylvestris_NODE_27800_length_638_cov_8","Ntome_NODE_17364_length_1415_cov_221",87.956,274,31,2,298,570,1021,749,3.34e-87,322,272,272
"76635","Nsylvestris_NODE_27803_length_638_cov_5","Ntome_NODE_19395_length_1243_cov_12",94.83,619,29,2,1,616,541,1159,0,963,615,618
"76636","Nsylvestris_NODE_27804_length_638_cov_4","Ntome_NODE_5991_length_2849_cov_93",93.782,193,12,0,16,208,1362,1554,9.43e-78,291,192,192
"76643","Nsylvestris_NODE_27809_length_637_cov_203","Ntome_NODE_19445_length_1238_cov_270",91.446,643,41,10,1,637,597,1231,0,870,636,634
"76644","Nsylvestris_NODE_27810_length_637_cov_183","Ntome_NODE_30646_length_602_cov_33",81.557,244,40,4,54,293,533,291,2.11e-49,196,239,242
"76645","Nsylvestris_NODE_27811_length_637_cov_138","Ntome_NODE_34781_length_383_cov_8",93.6,375,23,1,249,623,374,1,2.34e-158,558,374,373
"76646","Nsylvestris_NODE_27814_length_637_cov_53","Ntome_NODE_36337_length_329_cov_3",96.241,133,5,0,55,187,197,329,4.5e-56,219,132,132
"76649","Nsylvestris_NODE_27817_length_637_cov_16","Ntome_NODE_1996_length_4175_cov_286",92.593,54,4,0,584,637,723,776,2.22e-14,80.5,53,53
"76660","Nsylvestris_NODE_27823_length_637_cov_8","Ntome_NODE_6740_length_2705_cov_155",98.182,55,1,0,583,637,515,569,2.2e-19,97.1,54,54
"76663","Nsylvestris_NODE_27825_length_637_cov_6","Ntome_NODE_18528_length_1314_cov_42",85.779,661,44,23,1,627,64,708,0,654,626,644
"76664","Nsylvestris_NODE_27828_length_637_cov_5","Ntome_NODE_22628_length_1008_cov_177",86.179,123,17,0,287,409,324,446,1.68e-30,134,122,122
"76680","Nsylvestris_NODE_27837_length_636_cov_16","Ntome_NODE_6038_length_2841_cov_95",100,55,0,0,582,636,604,658,4.73e-21,102,54,54
"76681","Nsylvestris_NODE_27838_length_636_cov_16","Ntome_NODE_20091_length_1185_cov_42",86.074,596,50,6,54,627,772,188,6.35e-174,610,573,584
"76693","Nsylvestris_NODE_27843_length_636_cov_12","Ntome_NODE_17398_length_1412_cov_63",86.19,420,45,8,24,437,68,480,2.45e-123,442,413,412
"76694","Nsylvestris_NODE_27844_length_636_cov_10","Ntome_NODE_2212_length_4053_cov_253",90.455,660,33,10,1,636,2401,1748,0,843,635,653
"76719","Nsylvestris_NODE_27856_length_635_cov_36","Ntome_NODE_3881_length_3396_cov_247",100,55,0,0,581,635,2614,2560,4.72e-21,102,54,54
"76722","Nsylvestris_NODE_27858_length_635_cov_19","Ntome_NODE_9095_length_2324_cov_188",98.182,55,1,0,581,635,967,913,2.2e-19,97.1,54,54
"76723","Nsylvestris_NODE_27859_length_635_cov_18","Ntome_NODE_33187_length_464_cov_7",88.352,352,38,1,47,395,408,57,1.15e-116,420,348,351
"76724","Nsylvestris_NODE_27860_length_635_cov_15","Ntome_NODE_4905_length_3110_cov_243",94.21,639,32,5,1,635,782,1419,0,970,634,637
"76734","Nsylvestris_NODE_27866_length_634_cov_230","Ntome_NODE_10678_length_2109_cov_250",97.634,634,15,0,1,634,522,1155,0,1088,633,633
"76735","Nsylvestris_NODE_27867_length_634_cov_203","Ntome_NODE_25195_length_851_cov_264",88.889,522,37,9,30,547,1,505,8.13e-178,623,517,504
"76739","Nsylvestris_NODE_27869_length_634_cov_66","Ntome_NODE_5787_length_2899_cov_71",94.811,636,31,2,1,634,2586,1951,0,990,633,635
"76742","Nsylvestris_NODE_27871_length_634_cov_40","Ntome_NODE_16687_length_1477_cov_170",94.322,634,33,3,3,633,741,108,0,968,630,633
"76750","Nsylvestris_NODE_27875_length_634_cov_17","Ntome_NODE_30039_length_626_cov_18",92.308,221,12,3,36,252,626,407,2.59e-83,309,216,219
"76751","Nsylvestris_NODE_27876_length_634_cov_13","Ntome_NODE_6288_length_2790_cov_101",80.337,534,48,24,5,488,4,530,4.24e-96,351,483,526
"76754","Nsylvestris_NODE_27878_length_634_cov_12","Ntome_NODE_19687_length_1219_cov_100",98.182,55,1,0,1,55,108,54,2.19e-19,97.1,54,54
"76757","Nsylvestris_NODE_27880_length_634_cov_7","Ntome_NODE_26749_length_770_cov_69",91.416,664,25,16,1,634,770,109,0,881,633,661
"76766","Nsylvestris_NODE_27884_length_633_cov_181","Ntome_NODE_29437_length_650_cov_247",77.344,256,46,10,1,251,146,394,9.97e-33,141,250,248
"76767","Nsylvestris_NODE_27885_length_633_cov_150","Ntome_NODE_13763_length_1761_cov_189",97.059,170,5,0,464,633,1181,1012,1.21e-76,287,169,169
"76770","Nsylvestris_NODE_27887_length_633_cov_59","Ntome_NODE_8252_length_2451_cov_18",96.051,633,25,0,1,633,584,1216,0,1031,632,632
"76785","Nsylvestris_NODE_27892_length_633_cov_21","Ntome_NODE_5568_length_2947_cov_71",92.986,499,21,11,1,491,493,1,0,715,490,492
"76800","Nsylvestris_NODE_27898_length_633_cov_9","Ntome_NODE_7670_length_2545_cov_213",93.448,641,29,10,1,633,968,1603,0,939,632,635
"76803","Nsylvestris_NODE_27900_length_633_cov_7","Ntome_NODE_38221_length_284_cov_4",91.544,272,20,1,1,272,1,269,3.25e-102,372,271,268
"76806","Nsylvestris_NODE_27906_length_633_cov_4","Ntome_NODE_3674_length_3460_cov_187",95.597,636,16,6,4,633,1677,1048,0,1009,629,629
"76807","Nsylvestris_NODE_27907_length_633_cov_3","Ntome_NODE_37096_length_309_cov_2",89.796,245,24,1,379,622,309,65,2e-84,313,243,244
"76810","Nsylvestris_NODE_27909_length_632_cov_224","Ntome_NODE_3392_length_3549_cov_303",98.05,564,11,0,69,632,67,630,0,981,563,563
"76813","Nsylvestris_NODE_27911_length_632_cov_141","Ntome_NODE_6044_length_2840_cov_208",95.679,162,7,0,416,577,102,263,7.32e-69,261,161,161
"76827","Nsylvestris_NODE_27916_length_632_cov_17","Ntome_NODE_7646_length_2548_cov_305",96.364,55,2,0,578,632,994,1048,1.02e-17,91.6,54,54
"76835","Nsylvestris_NODE_27921_length_632_cov_12","Ntome_NODE_11916_length_1968_cov_206",90.805,87,7,1,538,624,1966,1881,6.03e-25,115,86,85
"76838","Nsylvestris_NODE_27925_length_632_cov_6","Ntome_NODE_10628_length_2115_cov_103",81.859,667,79,21,1,632,1426,767,8.45e-148,523,631,659
"76842","Nsylvestris_NODE_27928_length_632_cov_5","Ntome_NODE_16628_length_1484_cov_69",91.304,92,8,0,541,632,1476,1385,2.79e-28,126,91,91
"76843","Nsylvestris_NODE_27929_length_632_cov_4","Ntome_NODE_14998_length_1636_cov_104",92.476,319,22,2,9,325,372,54,3.13e-127,455,316,318
"76844","Nsylvestris_NODE_27930_length_631_cov_199","Ntome_NODE_10459_length_2137_cov_253",91.932,471,21,2,1,471,1381,1834,0,643,470,453
"76850","Nsylvestris_NODE_27933_length_631_cov_160","Ntome_NODE_30659_length_593_cov_263",90.317,537,24,8,111,627,556,28,0,678,516,528
"76857","Nsylvestris_NODE_27936_length_631_cov_61","Ntome_NODE_10386_length_2147_cov_205",89.904,624,25,19,1,621,589,1,0,769,620,588
"76858","Nsylvestris_NODE_27937_length_631_cov_60","Ntome_NODE_4315_length_3256_cov_162",94.946,554,15,6,1,553,2712,3253,0,856,552,541
"76863","Nsylvestris_NODE_27942_length_631_cov_18","Ntome_NODE_16384_length_1506_cov_253",94.545,55,3,0,577,631,552,606,4.72e-16,86.1,54,54
"76873","Nsylvestris_NODE_27954_length_630_cov_230","Ntome_NODE_10797_length_2096_cov_111",97.881,236,5,0,395,630,962,727,2.46e-113,409,235,235
"76881","Nsylvestris_NODE_27957_length_630_cov_126","Ntome_NODE_26156_length_799_cov_126",93.299,388,23,3,33,418,1,387,1.07e-161,569,385,386
"76887","Nsylvestris_NODE_27960_length_630_cov_50","Ntome_NODE_5787_length_2899_cov_71",96.038,631,23,2,1,630,1572,943,0,1026,629,629
"76907","Nsylvestris_NODE_27970_length_630_cov_9","Ntome_NODE_6767_length_2700_cov_67",83.096,633,56,20,1,605,1,610,1.81e-149,529,604,609
"76910","Nsylvestris_NODE_27972_length_630_cov_8","Ntome_NODE_5912_length_2869_cov_140",98.182,55,1,0,576,630,1149,1203,2.18e-19,97.1,54,54
"76916","Nsylvestris_NODE_27975_length_630_cov_6","Ntome_NODE_6728_length_2707_cov_32",88.636,44,5,0,17,60,458,501,1.33e-06,54.7,43,43
"76922","Nsylvestris_NODE_27978_length_630_cov_4","Ntome_NODE_151_length_7840_cov_67",96.875,64,1,1,567,630,6288,6350,3.62e-22,106,63,62
"76925","Nsylvestris_NODE_27982_length_629_cov_164","Ntome_NODE_852_length_5292_cov_168",100,44,0,0,1,44,917,874,6.09e-15,82.4,43,43
"76942","Nsylvestris_NODE_27991_length_629_cov_40","Ntome_NODE_21371_length_1090_cov_199",91.424,653,29,15,1,629,168,817,0,870,628,649
"76949","Nsylvestris_NODE_27996_length_629_cov_19","Ntome_NODE_15125_length_1621_cov_265",98.333,60,1,0,570,629,1166,1107,3.61e-22,106,59,59
"76956","Nsylvestris_NODE_27999_length_629_cov_12","Ntome_NODE_303_length_6706_cov_254",84.615,78,8,4,286,362,5181,5255,1.02e-12,75,76,74
"76957","Nsylvestris_NODE_28000_length_629_cov_10","Ntome_NODE_24310_length_905_cov_30",89.418,567,31,7,90,629,821,257,0,688,539,564
"76961","Nsylvestris_NODE_28003_length_629_cov_7","Ntome_NODE_23499_length_955_cov_14",93.468,643,26,7,1,629,244,884,0,941,628,640
"76962","Nsylvestris_NODE_28004_length_629_cov_7","Ntome_NODE_11944_length_1965_cov_52",100,55,0,0,1,55,269,323,4.67e-21,102,54,54
"76963","Nsylvestris_NODE_28005_length_629_cov_7","Ntome_NODE_12619_length_1884_cov_273",100,55,0,0,1,55,815,761,4.67e-21,102,54,54
"76966","Nsylvestris_NODE_28008_length_629_cov_4","Ntome_NODE_3158_length_3634_cov_108",94.277,629,13,4,4,629,1362,754,0,941,625,608
"76967","Nsylvestris_NODE_28009_length_629_cov_3","Ntome_NODE_36614_length_321_cov_2",90.909,275,16,4,127,395,321,50,6.98e-99,361,268,271
"76968","Nsylvestris_NODE_28010_length_629_cov_3","Ntome_NODE_1936_length_4218_cov_84",93.77,626,37,2,6,629,2900,3525,0,939,623,625
"76978","Nsylvestris_NODE_28014_length_628_cov_143","Ntome_NODE_33367_length_453_cov_184",97.444,313,8,0,316,628,45,357,3.88e-151,534,312,312
"76983","Nsylvestris_NODE_28018_length_628_cov_31","Ntome_NODE_32777_length_493_cov_19",91.411,163,12,2,125,287,31,191,3.43e-57,222,162,160
"76987","Nsylvestris_NODE_28020_length_628_cov_20","Ntome_NODE_3878_length_3394_cov_102",89.789,617,41,13,19,617,2782,3394,0,771,598,612
"76988","Nsylvestris_NODE_28023_length_628_cov_14","Ntome_NODE_5487_length_2964_cov_305",94.545,55,3,0,574,628,1009,1063,4.7e-16,86.1,54,54
"76993","Nsylvestris_NODE_28025_length_628_cov_10","Ntome_NODE_5150_length_3044_cov_284",97.561,41,1,0,588,628,792,832,1.32e-11,71.3,40,40
"76994","Nsylvestris_NODE_28026_length_628_cov_10","Ntome_NODE_15783_length_1559_cov_268",100,55,0,0,1,55,725,671,4.66e-21,102,54,54
"77011","Nsylvestris_NODE_28033_length_627_cov_200","Ntome_NODE_6328_length_2781_cov_190",96.429,364,7,2,221,584,2734,2377,1.75e-169,595,363,357
"77033","Nsylvestris_NODE_28043_length_627_cov_4","Ntome_NODE_10588_length_2122_cov_37",90.388,645,38,12,1,627,1343,1981,0,826,626,638
"77034","Nsylvestris_NODE_28044_length_627_cov_3","Ntome_NODE_7026_length_2651_cov_114",92.635,611,19,9,1,611,1387,803,0,856,610,584
"77044","Nsylvestris_NODE_28048_length_626_cov_179","Ntome_NODE_288_length_6792_cov_130",88.125,640,39,17,1,626,719,103,0,726,625,616
"77047","Nsylvestris_NODE_28050_length_626_cov_35","Ntome_NODE_29218_length_659_cov_100",90.747,616,34,12,1,603,12,617,0,800,602,605
"77059","Nsylvestris_NODE_28055_length_626_cov_17","Ntome_NODE_9268_length_2300_cov_257",100,55,0,0,1,55,789,843,4.65e-21,102,54,54
"77064","Nsylvestris_NODE_28058_length_626_cov_11","Ntome_NODE_10973_length_2076_cov_187",98.182,55,1,0,1,55,1746,1692,2.16e-19,97.1,54,54
"77072","Nsylvestris_NODE_28066_length_625_cov_207","Ntome_NODE_4869_length_3119_cov_59",92.022,539,32,10,49,584,32,562,0,747,535,530
"77081","Nsylvestris_NODE_28071_length_625_cov_105","Ntome_NODE_2019_length_4159_cov_215",92.491,586,37,6,1,583,3383,3964,0,832,582,581
"77082","Nsylvestris_NODE_28072_length_625_cov_65","Ntome_NODE_27558_length_730_cov_9",87.636,275,13,5,345,604,462,730,1.53e-80,300,259,268
"77086","Nsylvestris_NODE_28075_length_625_cov_40","Ntome_NODE_4930_length_3103_cov_34",98.182,55,1,0,571,625,2034,2088,2.16e-19,97.1,54,54
"77103","Nsylvestris_NODE_28083_length_625_cov_9","Ntome_NODE_6512_length_2746_cov_158",98.246,57,1,0,1,57,2630,2574,1.67e-20,100,56,56
"77104","Nsylvestris_NODE_28084_length_625_cov_8","Ntome_NODE_5114_length_3051_cov_208",98.182,55,1,0,571,625,1565,1619,2.16e-19,97.1,54,54
"77105","Nsylvestris_NODE_28087_length_625_cov_7","Ntome_NODE_5437_length_2976_cov_201",95.215,627,21,6,1,625,2077,2696,0,983,624,619
"77111","Nsylvestris_NODE_28090_length_625_cov_3","Ntome_NODE_2830_length_3764_cov_193",96.338,628,19,3,1,625,779,153,0,1029,624,626
"77112","Nsylvestris_NODE_28091_length_625_cov_3","Ntome_NODE_33450_length_449_cov_6",81.637,452,42,15,2,426,1,438,1.17e-91,337,424,437
"77118","Nsylvestris_NODE_28094_length_624_cov_218","Ntome_NODE_15738_length_1564_cov_276",100,55,0,0,1,55,866,920,4.63e-21,102,54,54
"77124","Nsylvestris_NODE_28097_length_624_cov_153","Ntome_NODE_3_length_15105_cov_292",91.045,67,5,1,1,67,330,265,3.61e-17,89.8,66,65
"77140","Nsylvestris_NODE_28103_length_624_cov_76","Ntome_NODE_2407_length_3957_cov_96",95.338,622,20,3,1,622,824,212,0,979,621,612
"77144","Nsylvestris_NODE_28105_length_624_cov_61","Ntome_NODE_9987_length_2200_cov_280",100,55,0,0,1,55,895,949,4.63e-21,102,54,54
"77154","Nsylvestris_NODE_28110_length_624_cov_11","Ntome_NODE_11547_length_2009_cov_16",83.579,475,35,17,1,460,2009,1563,3.15e-112,405,459,446
"77155","Nsylvestris_NODE_28111_length_624_cov_11","Ntome_NODE_19807_length_1209_cov_168",83.877,583,45,20,4,573,1129,583,6.5e-144,510,569,546
"77156","Nsylvestris_NODE_28112_length_624_cov_10","Ntome_NODE_37041_length_310_cov_3",93.772,289,16,1,313,601,310,24,1.45e-120,433,288,286
"77157","Nsylvestris_NODE_28113_length_624_cov_9","Ntome_NODE_16169_length_1524_cov_289",82.642,530,86,6,44,570,1203,677,5.13e-130,464,526,526
"77161","Nsylvestris_NODE_28115_length_624_cov_8","Ntome_NODE_1405_length_4626_cov_102",90.256,626,40,13,1,624,1975,2581,0,798,623,606
"77164","Nsylvestris_NODE_28117_length_624_cov_6","Ntome_NODE_16404_length_1505_cov_10",96.491,627,19,1,1,624,454,1080,0,1033,623,626
"77168","Nsylvestris_NODE_28121_length_624_cov_4","Ntome_NODE_22362_length_1025_cov_82",82.212,208,26,8,155,358,86,286,4.5e-41,169,203,200
"77181","Nsylvestris_NODE_28127_length_623_cov_192","Ntome_NODE_222_length_7262_cov_259",90.411,584,15,6,49,623,4565,4014,0,730,574,551
"77196","Nsylvestris_NODE_28134_length_623_cov_45","Ntome_NODE_2437_length_3938_cov_292",100,55,0,0,569,623,2176,2122,4.63e-21,102,54,54
"77205","Nsylvestris_NODE_28138_length_623_cov_14","Ntome_NODE_37896_length_290_cov_201",96.364,55,2,0,1,55,162,108,1e-17,91.6,54,54
"77209","Nsylvestris_NODE_28140_length_623_cov_8","Ntome_NODE_33813_length_429_cov_3",93.316,374,25,0,249,622,1,374,1.06e-156,553,373,373
"77217","Nsylvestris_NODE_28147_length_622_cov_246","Ntome_NODE_2301_length_4006_cov_268",95.2,625,19,2,1,622,492,1108,0,977,621,616
"77218","Nsylvestris_NODE_28148_length_622_cov_223","Ntome_NODE_18496_length_1317_cov_220",95.091,550,27,0,73,622,46,595,0,867,549,549
"77227","Nsylvestris_NODE_28154_length_622_cov_97","Ntome_NODE_30178_length_621_cov_20",85.039,254,31,5,307,556,266,16,4.33e-66,252,249,250
"77235","Nsylvestris_NODE_28158_length_622_cov_44","Ntome_NODE_2840_length_3760_cov_238",98.182,55,1,0,568,622,1380,1434,2.15e-19,97.1,54,54
"77241","Nsylvestris_NODE_28161_length_622_cov_24","Ntome_NODE_2492_length_3913_cov_75",92.222,540,20,10,1,530,528,1,0,745,529,527
"77244","Nsylvestris_NODE_28163_length_622_cov_15","Ntome_NODE_202_length_7440_cov_62",85.996,507,61,6,1,505,5430,5928,3.84e-151,534,504,498
"77250","Nsylvestris_NODE_28166_length_622_cov_10","Ntome_NODE_11635_length_1998_cov_117",96.226,53,2,0,3,55,689,637,1.29e-16,87.9,52,52
"77251","Nsylvestris_NODE_28167_length_622_cov_10","Ntome_NODE_18476_length_1319_cov_7",90.317,599,30,13,47,622,1184,591,0,760,575,593
"77255","Nsylvestris_NODE_28169_length_622_cov_8","Ntome_NODE_4679_length_3163_cov_290",100,55,0,0,568,622,2387,2441,4.62e-21,102,54,54
"77259","Nsylvestris_NODE_28173_length_622_cov_5","Ntome_NODE_4636_length_3175_cov_161",93.461,627,32,3,1,622,1185,563,0,922,621,622
"77263","Nsylvestris_NODE_28176_length_621_cov_175","Ntome_NODE_19242_length_1256_cov_152",96.049,405,16,0,1,405,453,49,0,660,404,404
"77266","Nsylvestris_NODE_28178_length_621_cov_174","Ntome_NODE_3248_length_3606_cov_58",95.177,622,28,2,1,621,3515,2895,0,981,620,620
"77272","Nsylvestris_NODE_28182_length_621_cov_31","Ntome_NODE_14257_length_1709_cov_279",100,55,0,0,567,621,859,913,4.61e-21,102,54,54
"77284","Nsylvestris_NODE_28187_length_621_cov_13","Ntome_NODE_2249_length_4035_cov_251",89.482,637,36,10,1,621,2488,1867,0,776,620,621
"77290","Nsylvestris_NODE_28189_length_621_cov_8","Ntome_NODE_16281_length_1511_cov_47",78.384,458,80,17,177,621,683,232,1.98e-74,279,444,451
"77313","Nsylvestris_NODE_28199_length_621_cov_3","Ntome_NODE_107_length_8381_cov_103",78,350,63,13,181,522,5477,5134,9.5e-53,207,341,343
"77318","Nsylvestris_NODE_28203_length_620_cov_72","Ntome_NODE_354_length_6487_cov_214",86.42,486,41,11,92,562,6430,5955,2.32e-143,508,470,475
"77331","Nsylvestris_NODE_28209_length_620_cov_7","Ntome_NODE_5275_length_3013_cov_287",94.444,54,3,0,567,620,2706,2653,1.67e-15,84.2,53,53
"77332","Nsylvestris_NODE_28210_length_620_cov_6","Ntome_NODE_10257_length_2162_cov_11",93.301,627,14,8,1,620,1639,1034,0,900,619,605
"77333","Nsylvestris_NODE_28211_length_620_cov_3","Ntome_NODE_18849_length_1287_cov_175",95.238,63,3,0,1,63,599,661,1.66e-20,100,62,62
"77346","Nsylvestris_NODE_28216_length_619_cov_176","Ntome_NODE_28360_length_694_cov_220",90.774,607,48,7,1,602,50,653,0,804,601,603
"77350","Nsylvestris_NODE_28218_length_619_cov_46","Ntome_NODE_13616_length_1775_cov_143",98.182,55,1,0,1,55,1550,1496,2.14e-19,97.1,54,54
"77355","Nsylvestris_NODE_28220_length_619_cov_30","Ntome_NODE_33989_length_419_cov_192",98.182,55,1,0,1,55,165,111,2.14e-19,97.1,54,54
"77371","Nsylvestris_NODE_28229_length_618_cov_145","Ntome_NODE_32727_length_496_cov_131",95.172,290,12,2,47,336,117,404,8.5e-128,457,289,287
"77372","Nsylvestris_NODE_28230_length_618_cov_87","Ntome_NODE_32760_length_494_cov_17",95.918,147,6,0,292,438,310,456,3.35e-62,239,146,146
"77373","Nsylvestris_NODE_28231_length_618_cov_52","Ntome_NODE_11838_length_1976_cov_259",90.741,54,4,1,6,59,1629,1681,1.29e-11,71.3,53,52
"77374","Nsylvestris_NODE_28232_length_618_cov_44","Ntome_NODE_7468_length_2575_cov_139",92.869,617,37,1,1,617,867,258,0,889,616,609
"77375","Nsylvestris_NODE_28233_length_618_cov_33","Ntome_NODE_9560_length_2257_cov_132",89.952,209,20,1,197,405,1369,1576,4.27e-71,268,208,207
"77383","Nsylvestris_NODE_28241_length_618_cov_4","Ntome_NODE_19150_length_1263_cov_144",93.923,181,8,2,382,559,882,702,1.19e-71,270,177,180
"77384","Nsylvestris_NODE_28242_length_618_cov_4","Ntome_NODE_35629_length_350_cov_127",98.182,55,1,0,564,618,114,168,2.13e-19,97.1,54,54
"77407","Nsylvestris_NODE_28255_length_617_cov_7","Ntome_NODE_1709_length_4375_cov_228",100,33,0,0,585,617,2600,2568,7.77e-09,62.1,32,32
"77408","Nsylvestris_NODE_28259_length_617_cov_3","Ntome_NODE_31644_length_566_cov_11",93.82,534,30,3,84,617,5,535,0,800,533,530
"77415","Nsylvestris_NODE_28263_length_616_cov_14","Ntome_NODE_32909_length_484_cov_15",87.931,522,19,12,80,595,484,1,2.24e-163,575,515,483
"77416","Nsylvestris_NODE_28264_length_616_cov_10","Ntome_NODE_2332_length_3991_cov_277",96.364,55,2,0,562,616,2961,2907,9.89e-18,91.6,54,54
"77420","Nsylvestris_NODE_28266_length_616_cov_7","Ntome_NODE_11784_length_1983_cov_132",87.801,623,49,12,1,614,172,776,0,704,613,604
"77424","Nsylvestris_NODE_28270_length_616_cov_5","Ntome_NODE_30165_length_621_cov_241",98.182,55,1,0,562,616,407,461,2.13e-19,97.1,54,54
"77427","Nsylvestris_NODE_28272_length_616_cov_3","Ntome_NODE_28876_length_673_cov_10",93.41,607,28,5,22,616,1,607,0,889,594,606
"77434","Nsylvestris_NODE_28275_length_615_cov_130","Ntome_NODE_21132_length_1106_cov_252",91.011,89,8,0,158,246,710,798,1.26e-26,121,88,88
"77446","Nsylvestris_NODE_28280_length_615_cov_26","Ntome_NODE_17042_length_1444_cov_135",100,55,0,0,1,55,777,831,4.56e-21,102,54,54
"77454","Nsylvestris_NODE_28285_length_615_cov_6","Ntome_NODE_16799_length_1466_cov_41",100,54,0,0,561,614,838,785,1.64e-20,100,53,53
"77457","Nsylvestris_NODE_28289_length_615_cov_4","Ntome_NODE_4504_length_3208_cov_254",98.182,55,1,0,1,55,1590,1536,2.12e-19,97.1,54,54
"77458","Nsylvestris_NODE_28291_length_614_cov_241","Ntome_NODE_9010_length_2338_cov_62",93.994,616,30,7,2,614,34,645,0,926,612,611
"77459","Nsylvestris_NODE_28292_length_614_cov_240","Ntome_NODE_1939_length_4215_cov_268",97.068,614,12,1,1,614,2983,3590,0,1029,613,607
"77464","Nsylvestris_NODE_28295_length_614_cov_130","Ntome_NODE_7590_length_2556_cov_129",92.143,280,22,0,1,280,873,594,1.87e-109,396,279,279
"77473","Nsylvestris_NODE_28302_length_615_cov_15","Ntome_NODE_11769_length_1984_cov_11",82.941,170,26,3,205,373,482,315,1.61e-35,150,168,167
"77474","Nsylvestris_NODE_28303_length_614_cov_15","Ntome_NODE_2721_length_3805_cov_135",94.76,229,10,2,1,228,1092,1319,3.17e-97,355,227,227
"77482","Nsylvestris_NODE_28307_length_614_cov_9","Ntome_NODE_31858_length_558_cov_12",88.71,62,6,1,294,354,411,472,9.93e-13,75,60,61
"77486","Nsylvestris_NODE_28309_length_614_cov_8","Ntome_NODE_1184_length_4857_cov_129",93.443,61,4,0,554,614,699,639,9.86e-18,91.6,60,60
"77490","Nsylvestris_NODE_28311_length_614_cov_6","Ntome_NODE_25269_length_846_cov_312",97.5,40,1,0,1,40,465,504,4.62e-11,69.4,39,39
"77497","Nsylvestris_NODE_28315_length_613_cov_190","Ntome_NODE_29415_length_651_cov_191",87.776,589,29,20,9,564,3,581,0,649,555,578
"77498","Nsylvestris_NODE_28316_length_613_cov_110","Ntome_NODE_29194_length_660_cov_56",93.648,614,25,7,1,606,622,15,0,905,605,607
"77499","Nsylvestris_NODE_28317_length_613_cov_55","Ntome_NODE_12323_length_1918_cov_251",94.4,250,14,0,1,250,1627,1876,4.03e-106,385,249,249
"77504","Nsylvestris_NODE_28320_length_613_cov_26","Ntome_NODE_28231_length_699_cov_312",98.182,55,1,0,1,55,241,187,2.12e-19,97.1,54,54
"77518","Nsylvestris_NODE_28326_length_613_cov_10","Ntome_NODE_16170_length_1524_cov_283",98.182,55,1,0,559,613,579,633,2.12e-19,97.1,54,54
"77519","Nsylvestris_NODE_28327_length_613_cov_9","Ntome_NODE_4683_length_3163_cov_105",100,55,0,0,559,613,519,465,4.55e-21,102,54,54
"77523","Nsylvestris_NODE_28329_length_613_cov_7","Ntome_NODE_13901_length_1746_cov_88",84.38,621,75,8,7,613,265,877,7.96e-168,590,606,612
"77524","Nsylvestris_NODE_28330_length_613_cov_6","Ntome_NODE_3994_length_3353_cov_253",98.276,58,1,0,1,58,1150,1093,4.55e-21,102,57,57
"77525","Nsylvestris_NODE_28333_length_613_cov_4","Ntome_NODE_1289_length_4744_cov_81",88.63,343,24,9,1,340,4155,3825,1.11e-111,403,339,330
"77526","Nsylvestris_NODE_28334_length_613_cov_3","Ntome_NODE_5833_length_2888_cov_119",89.322,590,24,13,1,570,1960,1390,0,704,569,570
"77535","Nsylvestris_NODE_28339_length_612_cov_189","Ntome_NODE_6665_length_2718_cov_175",87.5,632,31,9,2,612,634,30,0,686,610,604
"77536","Nsylvestris_NODE_28340_length_612_cov_159","Ntome_NODE_3237_length_3608_cov_236",92.742,620,28,6,1,605,684,67,0,880,604,617
"77537","Nsylvestris_NODE_28341_length_612_cov_151","Ntome_NODE_4628_length_3177_cov_123",92.954,369,25,1,245,612,2734,3102,1.05e-151,536,367,368
"77538","Nsylvestris_NODE_28342_length_612_cov_96","Ntome_NODE_2779_length_3777_cov_207",98.182,55,1,0,1,55,656,602,2.11e-19,97.1,54,54
"77545","Nsylvestris_NODE_28345_length_612_cov_41","Ntome_NODE_421_length_6241_cov_267",98.182,55,1,0,1,55,1093,1147,2.11e-19,97.1,54,54
"77546","Nsylvestris_NODE_28346_length_612_cov_25","Ntome_NODE_23087_length_978_cov_32",96.283,269,10,0,245,513,68,336,2.36e-123,442,268,268
"77547","Nsylvestris_NODE_28347_length_612_cov_24","Ntome_NODE_19941_length_1197_cov_54",97.674,43,1,0,480,522,253,211,9.9e-13,75,42,42
"77548","Nsylvestris_NODE_28348_length_612_cov_13","Ntome_NODE_38304_length_282_cov_4",92.334,287,17,2,142,428,1,282,1.11e-111,403,286,281
"77557","Nsylvestris_NODE_28351_length_612_cov_8","Ntome_NODE_17813_length_1373_cov_130",98.182,55,1,0,558,612,369,315,2.11e-19,97.1,54,54
"77560","Nsylvestris_NODE_28353_length_612_cov_7","Ntome_NODE_10112_length_2184_cov_102",92.647,68,3,2,546,612,1380,1446,2.11e-19,97.1,66,66
"77561","Nsylvestris_NODE_28354_length_612_cov_7","Ntome_NODE_5691_length_2920_cov_278",100,55,0,0,1,55,2237,2291,4.54e-21,102,54,54
"77565","Nsylvestris_NODE_28357_length_612_cov_6","Ntome_NODE_2752_length_3789_cov_148",94.003,617,32,2,1,612,1129,513,0,929,611,616
"77570","Nsylvestris_NODE_28363_length_611_cov_223","Ntome_NODE_15522_length_1582_cov_160",92.842,461,28,2,2,460,507,50,0,664,458,457
"77573","Nsylvestris_NODE_28366_length_611_cov_179","Ntome_NODE_6642_length_2722_cov_36",79.189,370,51,12,182,551,613,270,1.54e-60,233,369,343
"77576","Nsylvestris_NODE_28368_length_611_cov_51","Ntome_NODE_29620_length_643_cov_104",91.829,514,25,5,1,511,102,601,0,701,510,499
"77591","Nsylvestris_NODE_28378_length_611_cov_7","Ntome_NODE_7133_length_2633_cov_195",100,33,0,0,579,611,1846,1814,7.69e-09,62.1,32,32
"77592","Nsylvestris_NODE_28379_length_611_cov_6","Ntome_NODE_21237_length_1099_cov_223",100,55,0,0,1,55,768,714,4.53e-21,102,54,54
"77601","Nsylvestris_NODE_28385_length_610_cov_236","Ntome_NODE_15952_length_1543_cov_30",91.442,631,33,3,1,610,173,803,0,846,609,630
"77608","Nsylvestris_NODE_28388_length_610_cov_150","Ntome_NODE_5486_length_2965_cov_79",95.169,414,20,0,151,564,688,275,0,654,413,413
"77611","Nsylvestris_NODE_28390_length_610_cov_45","Ntome_NODE_25161_length_854_cov_12",91.406,384,30,3,227,608,690,308,8.15e-148,523,381,382
"77614","Nsylvestris_NODE_28392_length_610_cov_34","Ntome_NODE_12125_length_1942_cov_183",89.085,568,30,11,43,610,1231,696,0,676,567,535
"77641","Nsylvestris_NODE_28407_length_610_cov_5","Ntome_NODE_19678_length_1220_cov_38",100,55,0,0,556,610,267,321,4.52e-21,102,54,54
"77648","Nsylvestris_NODE_28410_length_609_cov_186","Ntome_NODE_24701_length_880_cov_238",93.878,539,20,7,9,538,537,3,0,800,529,534
"77677","Nsylvestris_NODE_28426_length_609_cov_5","Ntome_NODE_31689_length_564_cov_158",78.882,161,18,11,218,363,94,253,7.56e-19,95.3,145,159
"77680","Nsylvestris_NODE_28429_length_609_cov_4","Ntome_NODE_13904_length_1745_cov_305",100,35,0,0,1,35,475,509,5.93e-10,65.8,34,34
"77681","Nsylvestris_NODE_28430_length_608_cov_219","Ntome_NODE_10881_length_2087_cov_165",98.113,53,1,0,3,55,1916,1864,2.71e-18,93.5,52,52
"77682","Nsylvestris_NODE_28432_length_608_cov_146","Ntome_NODE_13450_length_1791_cov_51",89.6,125,10,1,269,390,990,1114,3.41e-37,156,121,124
"77683","Nsylvestris_NODE_28433_length_608_cov_141","Ntome_NODE_4822_length_3128_cov_147",92.584,418,14,6,188,605,49,449,3.67e-166,584,417,400
"77688","Nsylvestris_NODE_28436_length_608_cov_79","Ntome_NODE_9709_length_2238_cov_43",83.826,575,89,3,1,572,681,1254,6.23e-154,544,571,573
"77700","Nsylvestris_NODE_28447_length_608_cov_8","Ntome_NODE_13055_length_1835_cov_274",96.364,55,2,0,554,608,1185,1239,9.76e-18,91.6,54,54
"77718","Nsylvestris_NODE_28454_length_608_cov_6","Ntome_NODE_35816_length_344_cov_7",95.361,194,8,1,74,266,1,194,8.9e-83,307,192,193
"77719","Nsylvestris_NODE_28456_length_604_cov_5","Ntome_NODE_32944_length_482_cov_4",91.473,258,19,3,191,446,482,226,4.03e-96,351,255,256
"77723","Nsylvestris_NODE_28458_length_608_cov_4","Ntome_NODE_2957_length_3715_cov_296",92.371,485,37,0,123,607,3236,2752,0,691,484,484
"77724","Nsylvestris_NODE_28459_length_607_cov_215","Ntome_NODE_16701_length_1476_cov_256",96.264,455,15,2,154,607,19,472,0,745,453,453
"77734","Nsylvestris_NODE_28463_length_607_cov_149","Ntome_NODE_5122_length_3050_cov_215",87.85,107,13,0,1,107,136,242,2.67e-28,126,106,106
"77735","Nsylvestris_NODE_28464_length_607_cov_139","Ntome_NODE_3047_length_3679_cov_106",83.673,98,16,0,333,430,690,593,2.71e-18,93.5,97,97
"77744","Nsylvestris_NODE_28468_length_607_cov_21","Ntome_NODE_8473_length_2416_cov_235",98.182,55,1,0,553,607,1360,1414,2.09e-19,97.1,54,54
"77749","Nsylvestris_NODE_28472_length_607_cov_9","Ntome_NODE_12950_length_1846_cov_203",76.541,584,117,20,1,574,962,1535,4.13e-81,302,573,573
"77750","Nsylvestris_NODE_28473_length_607_cov_8","Ntome_NODE_13257_length_1813_cov_133",98.182,55,1,0,1,55,851,905,2.09e-19,97.1,54,54
"77754","Nsylvestris_NODE_28475_length_607_cov_5","Ntome_NODE_1230_length_4798_cov_56",94.893,607,28,1,1,607,4051,3448,0,946,606,603
"77757","Nsylvestris_NODE_28478_length_607_cov_3","Ntome_NODE_8987_length_2340_cov_229",96.364,55,2,0,1,55,891,837,9.74e-18,91.6,54,54
"77764","Nsylvestris_NODE_28481_length_606_cov_190","Ntome_NODE_12342_length_1916_cov_159",91.228,513,19,9,1,513,1216,730,0,675,512,486
"77765","Nsylvestris_NODE_28482_length_606_cov_187","Ntome_NODE_5443_length_2974_cov_162",93.865,163,10,0,1,163,163,1,1.96e-64,246,162,162
"77766","Nsylvestris_NODE_28484_length_606_cov_157","Ntome_NODE_30768_length_597_cov_163",90.926,551,22,9,56,579,1,550,0,715,523,549
"77767","Nsylvestris_NODE_28486_length_606_cov_92","Ntome_NODE_33231_length_461_cov_88",91.589,214,14,3,1,210,209,422,2.48e-78,292,209,213
"77771","Nsylvestris_NODE_28488_length_606_cov_55","Ntome_NODE_12283_length_1923_cov_151",98.182,55,1,0,1,55,864,810,2.09e-19,97.1,54,54
"77778","Nsylvestris_NODE_28495_length_606_cov_19","Ntome_NODE_24891_length_870_cov_9",95.39,282,12,1,95,375,282,1,5.01e-125,448,280,281
"77783","Nsylvestris_NODE_28499_length_606_cov_14","Ntome_NODE_36319_length_330_cov_2",95.333,300,11,3,140,436,300,1,8.27e-133,473,296,299
"77796","Nsylvestris_NODE_28507_length_606_cov_6","Ntome_NODE_12433_length_1905_cov_34",83.184,446,60,7,1,445,292,723,6.62e-109,394,444,431
"77800","Nsylvestris_NODE_28511_length_606_cov_4","Ntome_NODE_39333_length_261_cov_4",87.879,264,19,7,268,521,1,261,5.34e-80,298,253,260
"77815","Nsylvestris_NODE_28521_length_605_cov_24","Ntome_NODE_11253_length_2043_cov_280",90.868,219,8,3,40,247,1967,1750,1.49e-75,283,207,217
"77821","Nsylvestris_NODE_28525_length_605_cov_14","Ntome_NODE_4436_length_3225_cov_209",95.247,526,24,1,1,525,1270,1795,0,832,524,525
"77824","Nsylvestris_NODE_28527_length_605_cov_9","Ntome_NODE_8504_length_2412_cov_92",93.99,599,36,0,7,605,1477,879,0,907,598,598
"77827","Nsylvestris_NODE_28529_length_605_cov_7","Ntome_NODE_3014_length_3694_cov_119",96.364,55,2,0,1,55,281,335,9.71e-18,91.6,54,54
"77831","Nsylvestris_NODE_28531_length_605_cov_6","Ntome_NODE_14161_length_1720_cov_272",96.364,55,2,0,551,605,1511,1565,9.71e-18,91.6,54,54
"77856","Nsylvestris_NODE_28541_length_604_cov_21","Ntome_NODE_8235_length_2453_cov_265",94.502,582,28,4,27,604,22,603,0,894,577,581
"77857","Nsylvestris_NODE_28542_length_604_cov_14","Ntome_NODE_18205_length_1342_cov_71",88.998,609,28,4,1,603,766,1341,0,717,602,575
"77874","Nsylvestris_NODE_28556_length_603_cov_26","Ntome_NODE_23337_length_963_cov_211",80.84,595,100,12,12,603,883,300,2.98e-127,455,591,583
"77883","Nsylvestris_NODE_28562_length_603_cov_13","Ntome_NODE_199_length_7445_cov_140",92.635,611,28,9,6,603,2152,1546,0,863,597,606
"77887","Nsylvestris_NODE_28567_length_603_cov_6","Ntome_NODE_37371_length_302_cov_5",97.701,261,6,0,343,603,302,42,1.39e-125,449,260,260
"77890","Nsylvestris_NODE_28569_length_603_cov_5","Ntome_NODE_89_length_8717_cov_109",85.849,106,15,0,484,589,7861,7756,2.07e-24,113,105,105
"77893","Nsylvestris_NODE_28571_length_603_cov_5","Ntome_NODE_23797_length_937_cov_8",93.432,609,27,6,3,602,790,186,0,891,599,604
"77897","Nsylvestris_NODE_28573_length_603_cov_5","Ntome_NODE_293_length_6755_cov_121",85.099,604,88,2,1,603,3102,3704,1.29e-175,616,602,602
"77901","Nsylvestris_NODE_28576_length_603_cov_4","Ntome_NODE_19235_length_1257_cov_12",94.813,482,19,2,3,481,726,1204,0,747,478,478
"77905","Nsylvestris_NODE_28579_length_602_cov_221","Ntome_NODE_22339_length_1026_cov_73",94.964,556,28,0,1,556,388,943,0,872,555,555
"77910","Nsylvestris_NODE_28581_length_602_cov_188","Ntome_NODE_21237_length_1099_cov_223",98.673,452,5,1,152,602,209,660,0,800,450,451
"77913","Nsylvestris_NODE_28585_length_602_cov_40","Ntome_NODE_29440_length_650_cov_68",82.093,497,57,14,50,529,563,82,1.83e-109,396,479,481
"77914","Nsylvestris_NODE_28587_length_602_cov_29","Ntome_NODE_9895_length_2213_cov_281",92.193,602,47,0,1,602,993,1594,0,852,601,601
"77922","Nsylvestris_NODE_28591_length_602_cov_12","Ntome_NODE_2666_length_3830_cov_76",83.054,596,48,23,41,602,1447,2023,2.27e-138,492,561,576
"77923","Nsylvestris_NODE_28592_length_602_cov_10","Ntome_NODE_17292_length_1421_cov_58",88.562,612,55,7,1,601,1376,769,0,728,600,607
"77932","Nsylvestris_NODE_28598_length_602_cov_9","Ntome_NODE_11638_length_1998_cov_16",94.5,600,28,3,1,599,261,856,0,920,598,595
"77936","Nsylvestris_NODE_28600_length_602_cov_8","Ntome_NODE_8496_length_2413_cov_117",81.169,154,20,8,1,151,891,744,5.73e-25,115,150,147
"77940","Nsylvestris_NODE_28602_length_602_cov_8","Ntome_NODE_221_length_7267_cov_247",98.182,55,1,0,548,602,5358,5304,2.08e-19,97.1,54,54
"77947","Nsylvestris_NODE_28604_length_602_cov_6","Ntome_NODE_5564_length_2947_cov_163",89.338,619,39,13,1,602,602,1210,0,752,601,608
"77952","Nsylvestris_NODE_28607_length_602_cov_3","Ntome_NODE_207_length_7386_cov_127",98.182,55,1,0,1,55,579,525,2.08e-19,97.1,54,54
"77956","Nsylvestris_NODE_28609_length_601_cov_200","Ntome_NODE_30251_length_618_cov_41",86.146,563,29,14,10,551,574,40,1.7e-159,562,541,534
"77957","Nsylvestris_NODE_28610_length_601_cov_191","Ntome_NODE_5452_length_2973_cov_153",92.816,348,20,4,257,601,1074,729,1.35e-140,499,344,345
"77962","Nsylvestris_NODE_28613_length_601_cov_120","Ntome_NODE_141_length_7936_cov_227",96.672,601,20,0,1,601,4768,4168,0,1000,600,600
"77963","Nsylvestris_NODE_28614_length_601_cov_78","Ntome_NODE_7260_length_2612_cov_11",83.103,290,43,5,1,286,2292,2579,2.5e-68,259,285,287
"77966","Nsylvestris_NODE_28618_length_601_cov_43","Ntome_NODE_8271_length_2446_cov_203",88.462,624,38,11,1,601,93,705,0,723,600,612
"77969","Nsylvestris_NODE_28621_length_601_cov_21","Ntome_NODE_6954_length_2663_cov_42",88.679,53,6,0,5,57,202,254,5.84e-10,65.8,52,52
"77970","Nsylvestris_NODE_28623_length_601_cov_11","Ntome_NODE_1428_length_4602_cov_80",83.139,599,97,4,2,598,3841,3245,6.16e-154,544,596,596
"77974","Nsylvestris_NODE_28626_length_601_cov_6","Ntome_NODE_799_length_5381_cov_116",90.966,476,37,5,1,471,3064,2590,0,636,470,474
"77984","Nsylvestris_NODE_28630_length_601_cov_3","Ntome_NODE_7205_length_2621_cov_184",98.182,55,1,0,547,601,1616,1670,2.07e-19,97.1,54,54
"77985","Nsylvestris_NODE_28633_length_600_cov_58","Ntome_NODE_17076_length_1441_cov_222",89.517,601,58,4,1,600,1,597,0,756,599,596
"77992","Nsylvestris_NODE_28636_length_600_cov_32","Ntome_NODE_15232_length_1611_cov_19",91.055,559,42,6,23,578,1591,1038,0,749,555,553
"77993","Nsylvestris_NODE_28637_length_600_cov_30","Ntome_NODE_3896_length_3389_cov_170",90.476,42,3,1,207,248,2437,2477,1.26e-06,54.7,41,40
"78002","Nsylvestris_NODE_28641_length_600_cov_9","Ntome_NODE_12269_length_1924_cov_316",98.182,55,1,0,1,55,114,60,2.07e-19,97.1,54,54
"78003","Nsylvestris_NODE_28644_length_600_cov_7","Ntome_NODE_10330_length_2154_cov_29",82.54,252,14,3,17,241,1985,1737,7.13e-49,195,224,248
"78007","Nsylvestris_NODE_28646_length_600_cov_4","Ntome_NODE_30845_length_594_cov_138",86.957,253,29,3,1,249,276,528,5.32e-75,281,248,252
"78015","Nsylvestris_NODE_28649_length_599_cov_157","Ntome_NODE_26495_length_782_cov_250",96.721,61,2,0,539,599,456,516,4.44e-21,102,60,60
"78021","Nsylvestris_NODE_28653_length_599_cov_32","Ntome_NODE_27587_length_728_cov_262",100,55,0,0,545,599,222,276,4.44e-21,102,54,54
"78022","Nsylvestris_NODE_28654_length_599_cov_25","Ntome_NODE_4631_length_3176_cov_204",98.182,55,1,0,545,599,308,254,2.07e-19,97.1,54,54
"78027","Nsylvestris_NODE_28657_length_599_cov_22","Ntome_NODE_4508_length_3207_cov_258",79.882,169,32,2,273,440,2071,2238,3.41e-27,122,167,167
"78030","Nsylvestris_NODE_28661_length_599_cov_10","Ntome_NODE_10484_length_2134_cov_35",88.851,583,28,18,41,599,704,135,0,682,558,569
"78035","Nsylvestris_NODE_28663_length_599_cov_8","Ntome_NODE_22015_length_1047_cov_15",96.491,57,2,0,181,237,632,688,7.43e-19,95.3,56,56
"78044","Nsylvestris_NODE_28668_length_599_cov_4","Ntome_NODE_12111_length_1943_cov_272",96.364,55,2,0,545,599,380,434,9.61e-18,91.6,54,54
"78045","Nsylvestris_NODE_28670_length_599_cov_4","Ntome_NODE_1921_length_4224_cov_179",94.491,599,33,0,1,599,3146,3744,0,924,598,598
"78048","Nsylvestris_NODE_28672_length_598_cov_229","Ntome_NODE_30091_length_623_cov_19",85,300,37,5,1,292,561,262,5.27e-80,298,291,299
"78053","Nsylvestris_NODE_28674_length_598_cov_223","Ntome_NODE_26919_length_762_cov_239",92.308,598,25,9,7,592,9,597,0,830,585,588
"78057","Nsylvestris_NODE_28676_length_598_cov_198","Ntome_NODE_15169_length_1616_cov_206",96.416,586,20,1,13,598,1,585,0,965,585,584
"78063","Nsylvestris_NODE_28680_length_598_cov_43","Ntome_NODE_31526_length_570_cov_45",92.171,281,22,0,171,451,148,428,5.05e-110,398,280,280
"78064","Nsylvestris_NODE_28681_length_598_cov_39","Ntome_NODE_2984_length_3705_cov_290",100,55,0,0,1,55,1687,1741,4.43e-21,102,54,54
"78071","Nsylvestris_NODE_28685_length_598_cov_29","Ntome_NODE_10488_length_2133_cov_219",96.591,176,6,0,1,176,581,756,2.45e-78,292,175,175
"78072","Nsylvestris_NODE_28687_length_598_cov_22","Ntome_NODE_28695_length_680_cov_247",95.265,528,22,2,73,598,635,109,0,833,525,526
"78083","Nsylvestris_NODE_28693_length_598_cov_11","Ntome_NODE_8138_length_2470_cov_23",94.444,54,2,1,6,59,1,53,5.77e-15,82.4,53,52
"78088","Nsylvestris_NODE_28697_length_598_cov_6","Ntome_NODE_21422_length_1087_cov_37",95.949,395,16,0,1,395,433,39,0,641,394,394
"78094","Nsylvestris_NODE_28701_length_598_cov_5","Ntome_NODE_15373_length_1596_cov_203",95.492,599,26,1,1,598,1220,622,0,955,597,598
"78100","Nsylvestris_NODE_28704_length_597_cov_30","Ntome_NODE_7880_length_2511_cov_82",79.022,634,65,36,1,597,676,1278,3.05e-102,372,596,602
"78101","Nsylvestris_NODE_28706_length_597_cov_19","Ntome_NODE_16767_length_1469_cov_109",94.07,489,29,0,56,544,560,1048,0,743,488,488
"78105","Nsylvestris_NODE_28708_length_597_cov_12","Ntome_NODE_8024_length_2487_cov_211",98.182,55,1,0,1,55,817,871,2.06e-19,97.1,54,54
"78111","Nsylvestris_NODE_28712_length_597_cov_8","Ntome_NODE_1988_length_4182_cov_198",86.386,617,35,15,4,597,1741,1151,1.64e-179,628,593,590
"78112","Nsylvestris_NODE_28713_length_596_cov_8","Ntome_NODE_5870_length_2879_cov_150",93.333,60,4,0,1,60,698,639,3.44e-17,89.8,59,59
"78121","Nsylvestris_NODE_28718_length_597_cov_4","Ntome_NODE_8056_length_2482_cov_253",100,55,0,0,1,55,491,545,4.42e-21,102,54,54
"78122","Nsylvestris_NODE_28719_length_597_cov_3","Ntome_NODE_5871_length_2879_cov_87",95.485,598,26,1,1,597,1564,2161,0,953,596,597
"78123","Nsylvestris_NODE_28720_length_596_cov_221","Ntome_NODE_26358_length_789_cov_60",86.149,592,27,16,50,596,203,784,2.78e-167,588,546,581
"78138","Nsylvestris_NODE_28725_length_596_cov_111","Ntome_NODE_17386_length_1413_cov_248",97.885,520,8,1,77,596,75,591,0,896,519,516
"78141","Nsylvestris_NODE_28727_length_596_cov_97","Ntome_NODE_12288_length_1923_cov_38",98.182,55,1,0,1,55,903,849,2.05e-19,97.1,54,54
"78146","Nsylvestris_NODE_28729_length_596_cov_85","Ntome_NODE_27544_length_730_cov_91",90.773,401,24,3,203,593,318,715,7.95e-148,523,390,397
"78156","Nsylvestris_NODE_28735_length_596_cov_17","Ntome_NODE_1055_length_5013_cov_20",96.453,592,21,0,1,592,1369,1960,0,977,591,591
"78161","Nsylvestris_NODE_28738_length_596_cov_16","Ntome_NODE_18223_length_1340_cov_275",100,55,0,0,1,55,728,782,4.42e-21,102,54,54
"78172","Nsylvestris_NODE_28747_length_595_cov_50","Ntome_NODE_1235_length_4794_cov_133",93.95,595,20,8,14,595,2447,3038,0,885,581,591
"78178","Nsylvestris_NODE_28749_length_595_cov_21","Ntome_NODE_5976_length_2853_cov_296",96.364,55,2,0,1,55,1207,1153,9.54e-18,91.6,54,54
"78181","Nsylvestris_NODE_28751_length_595_cov_15","Ntome_NODE_24643_length_883_cov_278",98.182,55,1,0,1,55,326,272,2.05e-19,97.1,54,54
"78187","Nsylvestris_NODE_28755_length_595_cov_7","Ntome_NODE_9098_length_2324_cov_82",98.113,53,1,0,1,53,173,225,2.65e-18,93.5,52,52
"78188","Nsylvestris_NODE_28756_length_595_cov_6","Ntome_NODE_11452_length_2019_cov_208",84.161,322,32,8,112,419,1935,1619,6.78e-79,294,307,316
"78198","Nsylvestris_NODE_28761_length_595_cov_3","Ntome_NODE_2181_length_4070_cov_163",83.172,309,52,0,285,593,1515,1823,1.47e-75,283,308,308
"78204","Nsylvestris_NODE_28763_length_594_cov_164","Ntome_NODE_10461_length_2137_cov_25",93.121,596,39,2,1,594,1237,642,0,872,593,595
"78205","Nsylvestris_NODE_28764_length_594_cov_163","Ntome_NODE_24193_length_913_cov_24",81.223,229,30,5,238,462,684,465,3.31e-42,172,224,219
"78217","Nsylvestris_NODE_28771_length_594_cov_9","Ntome_NODE_2768_length_3782_cov_204",91,100,9,0,1,100,872,773,4.34e-31,135,99,99
"78220","Nsylvestris_NODE_28773_length_594_cov_7","Ntome_NODE_9209_length_2308_cov_22",93.134,335,16,4,55,388,1875,2203,3.74e-136,484,333,328
"78226","Nsylvestris_NODE_28778_length_593_cov_205","Ntome_NODE_8005_length_2490_cov_219",91.971,137,10,1,458,593,1988,2124,9.11e-48,191,135,136
"78227","Nsylvestris_NODE_28779_length_593_cov_187","Ntome_NODE_2674_length_3825_cov_305",89.643,560,17,12,1,547,3270,3801,0,675,546,531
"78228","Nsylvestris_NODE_28780_length_593_cov_182","Ntome_NODE_1401_length_4633_cov_224",96.364,55,2,0,1,55,4534,4480,9.51e-18,91.6,54,54
"78244","Nsylvestris_NODE_28788_length_593_cov_13","Ntome_NODE_8489_length_2414_cov_159",95.447,593,23,2,1,593,732,1320,0,942,592,588
"78251","Nsylvestris_NODE_28793_length_593_cov_6","Ntome_NODE_6390_length_2769_cov_125",92.54,563,23,5,3,563,1207,1752,0,789,560,545
"78257","Nsylvestris_NODE_28797_length_593_cov_5","Ntome_NODE_9155_length_2317_cov_264",98.182,55,1,0,1,55,1613,1559,2.04e-19,97.1,54,54
"78258","Nsylvestris_NODE_28798_length_593_cov_5","Ntome_NODE_16804_length_1465_cov_247",100,55,0,0,1,55,873,927,4.39e-21,102,54,54
"78279","Nsylvestris_NODE_28808_length_592_cov_15","Ntome_NODE_11923_length_1968_cov_39",94.088,592,35,0,1,592,964,1555,0,900,591,591
"78280","Nsylvestris_NODE_28811_length_592_cov_10","Ntome_NODE_22222_length_1033_cov_44",96.172,418,16,0,172,589,589,1006,0,684,417,417
"78286","Nsylvestris_NODE_28814_length_592_cov_8","Ntome_NODE_39070_length_266_cov_3",98.12,266,5,0,134,399,266,1,4.86e-130,464,265,265
"78287","Nsylvestris_NODE_28815_length_592_cov_8","Ntome_NODE_21610_length_1074_cov_7",89.767,215,19,1,298,509,811,597,3.16e-72,272,211,214
"78288","Nsylvestris_NODE_28816_length_592_cov_8","Ntome_NODE_1171_length_4873_cov_148",79.897,388,64,9,3,389,2322,2696,3.16e-72,272,386,374
"78291","Nsylvestris_NODE_28818_length_592_cov_5","Ntome_NODE_6522_length_2745_cov_58",94.435,593,22,5,3,592,101,685,0,902,589,584
"78303","Nsylvestris_NODE_28824_length_591_cov_74","Ntome_NODE_873_length_5263_cov_279",80.812,542,102,2,1,541,1588,2128,8.23e-118,424,540,540
"78304","Nsylvestris_NODE_28826_length_591_cov_19","Ntome_NODE_523_length_5958_cov_300",100,55,0,0,537,591,2203,2149,4.38e-21,102,54,54
"78305","Nsylvestris_NODE_28827_length_591_cov_14","Ntome_NODE_2988_length_3704_cov_32",92.99,485,33,1,107,591,2935,3418,0,706,484,483
"78310","Nsylvestris_NODE_28830_length_591_cov_9","Ntome_NODE_31338_length_576_cov_48",95,60,3,0,22,81,153,94,7.33e-19,95.3,59,59
"78313","Nsylvestris_NODE_28832_length_591_cov_8","Ntome_NODE_17991_length_1358_cov_118",91.525,590,25,5,2,591,116,680,0,789,589,564
"78322","Nsylvestris_NODE_28839_length_590_cov_51","Ntome_NODE_5741_length_2908_cov_168",88.144,582,25,19,1,554,1,566,0,652,553,565
"78328","Nsylvestris_NODE_28844_length_590_cov_14","Ntome_NODE_13327_length_1805_cov_105",86.403,581,57,15,22,588,598,1170,1.26e-175,616,566,572
"78332","Nsylvestris_NODE_28846_length_590_cov_12","Ntome_NODE_3168_length_3631_cov_144",98.182,55,1,0,1,55,2932,2986,2.03e-19,97.1,54,54
"78342","Nsylvestris_NODE_28850_length_590_cov_9","Ntome_NODE_24279_length_907_cov_287",98.182,55,1,0,1,55,677,623,2.03e-19,97.1,54,54
"78343","Nsylvestris_NODE_28851_length_590_cov_9","Ntome_NODE_13705_length_1767_cov_183",93.729,590,33,2,1,587,370,958,0,881,586,588
"78347","Nsylvestris_NODE_28854_length_590_cov_7","Ntome_NODE_2223_length_4048_cov_116",94.237,590,34,0,1,590,2953,2364,0,902,589,589
"78348","Nsylvestris_NODE_28856_length_590_cov_6","Ntome_NODE_732_length_5498_cov_277",88.007,592,41,13,1,588,4888,4323,0,673,587,565
"78351","Nsylvestris_NODE_28860_length_589_cov_179","Ntome_NODE_24422_length_897_cov_218",92.115,520,27,3,70,589,853,348,0,721,519,505
"78360","Nsylvestris_NODE_28868_length_589_cov_22","Ntome_NODE_32077_length_544_cov_10",90.744,551,31,5,6,556,5,535,0,717,550,530
"78364","Nsylvestris_NODE_28870_length_589_cov_14","Ntome_NODE_22862_length_991_cov_125",93.596,203,13,0,1,203,255,457,1.11e-81,303,202,202
"78376","Nsylvestris_NODE_28878_length_589_cov_8","Ntome_NODE_16497_length_1496_cov_283",98.276,58,1,0,1,58,239,182,4.36e-21,102,57,57
"78380","Nsylvestris_NODE_28882_length_589_cov_7","Ntome_NODE_3592_length_3486_cov_156",88.018,217,21,4,377,589,1743,1958,4.09e-66,252,212,215
"78381","Nsylvestris_NODE_28883_length_589_cov_7","Ntome_NODE_11513_length_2013_cov_85",88.79,562,31,6,55,589,1348,792,0,660,534,556
"78387","Nsylvestris_NODE_28887_length_588_cov_87","Ntome_NODE_14979_length_1638_cov_150",100,55,0,0,534,588,1243,1297,4.35e-21,102,54,54
"78388","Nsylvestris_NODE_28888_length_588_cov_85","Ntome_NODE_29056_length_665_cov_238",89.842,571,29,13,10,559,13,575,0,706,549,562
"78395","Nsylvestris_NODE_28891_length_588_cov_51","Ntome_NODE_3472_length_3525_cov_107",91.434,537,31,5,2,534,3355,2830,0,723,532,525
"78404","Nsylvestris_NODE_28896_length_588_cov_18","Ntome_NODE_4126_length_3314_cov_301",98.182,55,1,0,534,588,1655,1601,2.03e-19,97.1,54,54
"78405","Nsylvestris_NODE_28898_length_588_cov_15","Ntome_NODE_36403_length_327_cov_6",98.148,54,1,0,2,55,266,319,7.29e-19,95.3,53,53
"78406","Nsylvestris_NODE_28899_length_588_cov_14","Ntome_NODE_7547_length_2563_cov_294",98.182,55,1,0,1,55,904,850,2.03e-19,97.1,54,54
"78422","Nsylvestris_NODE_28910_length_587_cov_191","Ntome_NODE_2148_length_4084_cov_120",95.943,419,14,1,172,587,768,1186,0,676,415,418
"78423","Nsylvestris_NODE_28911_length_587_cov_164","Ntome_NODE_31122_length_584_cov_252",91.317,357,31,0,4,360,574,218,2.86e-137,488,356,356
"78426","Nsylvestris_NODE_28915_length_587_cov_28","Ntome_NODE_13373_length_1800_cov_228",95.395,152,7,0,91,242,323,474,2.45e-63,243,151,151
"78437","Nsylvestris_NODE_28921_length_587_cov_8","Ntome_NODE_35908_length_342_cov_3",93.805,113,7,0,475,587,49,161,1.17e-41,171,112,112
"78438","Nsylvestris_NODE_28922_length_579_cov_7","Ntome_NODE_4482_length_3214_cov_212",88.073,109,12,1,469,577,1440,1547,7.07e-29,128,108,107
"78441","Nsylvestris_NODE_28924_length_587_cov_5","Ntome_NODE_23061_length_979_cov_123",96.721,549,18,0,2,550,731,183,0,915,548,548
"78444","Nsylvestris_NODE_28926_length_587_cov_5","Ntome_NODE_6960_length_2661_cov_279",91.241,137,8,2,4,140,1427,1295,1.51e-45,183,136,132
"78448","Nsylvestris_NODE_28928_length_587_cov_4","Ntome_NODE_24166_length_915_cov_6",92.523,107,8,0,481,587,1,107,1.18e-36,154,106,106
"78458","Nsylvestris_NODE_28933_length_586_cov_41","Ntome_NODE_11806_length_1980_cov_210",88.075,587,40,14,1,586,1038,481,0,669,585,557
"78463","Nsylvestris_NODE_28936_length_586_cov_18","Ntome_NODE_26355_length_789_cov_146",98.182,55,1,0,1,55,397,451,2.02e-19,97.1,54,54
"78467","Nsylvestris_NODE_28940_length_586_cov_14","Ntome_NODE_6441_length_2758_cov_251",92.63,597,32,5,1,586,1475,2070,0,848,585,595
"78470","Nsylvestris_NODE_28942_length_586_cov_10","Ntome_NODE_420_length_6242_cov_30",78.842,501,85,13,9,490,1582,1084,3.96e-86,318,481,498
"78474","Nsylvestris_NODE_28944_length_586_cov_9","Ntome_NODE_5696_length_2918_cov_241",90.769,455,28,2,133,586,697,256,1.63e-169,595,453,441
"78477","Nsylvestris_NODE_28948_length_586_cov_6","Ntome_NODE_2776_length_3778_cov_125",100,32,0,0,555,586,1331,1300,2.65e-08,60.2,31,31
"78495","Nsylvestris_NODE_28960_length_585_cov_50","Ntome_NODE_7287_length_2606_cov_182",95.06,587,27,2,1,585,1736,2322,0,922,584,586
"78512","Nsylvestris_NODE_28967_length_585_cov_21","Ntome_NODE_17346_length_1416_cov_288",100,55,0,0,531,585,638,584,4.33e-21,102,54,54
"78518","Nsylvestris_NODE_28971_length_585_cov_11","Ntome_NODE_5199_length_3031_cov_121",100,55,0,0,1,55,2335,2389,4.33e-21,102,54,54
"78519","Nsylvestris_NODE_28972_length_585_cov_11","Ntome_NODE_3592_length_3486_cov_156",85.185,378,38,10,217,585,220,588,2.99e-102,372,368,368
"78520","Nsylvestris_NODE_28973_length_585_cov_10","Ntome_NODE_12994_length_1843_cov_139",98.182,55,1,0,531,585,816,870,2.02e-19,97.1,54,54
"78532","Nsylvestris_NODE_28979_length_585_cov_6","Ntome_NODE_15289_length_1606_cov_25",80.101,397,40,21,1,378,48,424,2.43e-68,259,377,376
"78540","Nsylvestris_NODE_28984_length_585_cov_4","Ntome_NODE_26966_length_760_cov_186",93.443,61,1,1,1,58,354,294,1.21e-16,87.9,57,60
"78541","Nsylvestris_NODE_28986_length_585_cov_3","Ntome_NODE_8328_length_2438_cov_121",81.197,585,105,3,3,585,1404,823,1.33e-130,466,582,581
"78545","Nsylvestris_NODE_28988_length_584_cov_196","Ntome_NODE_24481_length_892_cov_247",95.548,584,26,0,1,584,179,762,0,935,583,583
"78550","Nsylvestris_NODE_28992_length_584_cov_69","Ntome_NODE_7915_length_2504_cov_138",83.037,507,70,10,1,501,1004,508,1.73e-124,446,500,496
"78611","Nsylvestris_NODE_28996_length_584_cov_26","Ntome_NODE_5382_length_2989_cov_117",92.479,585,26,3,1,584,2470,1903,0,821,583,567
"78614","Nsylvestris_NODE_28998_length_584_cov_11","Ntome_NODE_8159_length_2466_cov_278",92.398,171,12,1,193,362,2423,2253,2.44e-63,243,169,170
"78615","Nsylvestris_NODE_28999_length_584_cov_7","Ntome_NODE_1428_length_4602_cov_80",84.321,523,71,4,1,514,3176,2656,3.65e-141,501,513,520
"78616","Nsylvestris_NODE_29000_length_584_cov_7","Ntome_NODE_34809_length_382_cov_9",87.442,215,24,2,373,584,1,215,6.79e-64,244,211,214
"78617","Nsylvestris_NODE_29002_length_584_cov_4","Ntome_NODE_18622_length_1306_cov_203",100,54,0,0,1,54,277,224,1.55e-20,100,53,53
"78618","Nsylvestris_NODE_29003_length_584_cov_4","Ntome_NODE_1641_length_4426_cov_284",100,55,0,0,1,55,1523,1469,4.32e-21,102,54,54
"78619","Nsylvestris_NODE_29004_length_584_cov_4","Ntome_NODE_37098_length_309_cov_1",93.226,310,20,1,189,498,309,1,2.88e-127,455,309,308
"78623","Nsylvestris_NODE_29006_length_583_cov_204","Ntome_NODE_3665_length_3465_cov_261",100,36,0,0,542,577,3248,3283,1.57e-10,67.6,35,35
"78627","Nsylvestris_NODE_29008_length_583_cov_140","Ntome_NODE_4046_length_3335_cov_251",93.925,214,12,1,321,534,197,409,3.04e-87,322,213,212
"78638","Nsylvestris_NODE_29013_length_583_cov_36","Ntome_NODE_22850_length_993_cov_38",84.783,138,21,0,89,226,512,649,3.29e-32,139,137,137
"78648","Nsylvestris_NODE_29018_length_583_cov_11","Ntome_NODE_15945_length_1543_cov_134",96.491,57,2,0,1,57,834,778,7.22e-19,95.3,56,56
"78652","Nsylvestris_NODE_29020_length_583_cov_11","Ntome_NODE_29727_length_639_cov_15",96.822,535,17,0,1,535,535,1,0,894,534,534
"78653","Nsylvestris_NODE_29021_length_583_cov_11","Ntome_NODE_3774_length_3428_cov_109",94.545,55,3,0,529,583,724,670,4.35e-16,86.1,54,54
"78654","Nsylvestris_NODE_29023_length_583_cov_9","Ntome_NODE_1564_length_4486_cov_83",93.924,576,16,8,1,574,2874,2316,0,852,573,558
"78658","Nsylvestris_NODE_29026_length_583_cov_7","Ntome_NODE_520_length_5966_cov_133",95.833,48,2,0,511,558,5001,5048,7.27e-14,78.7,47,47
"78664","Nsylvestris_NODE_29031_length_583_cov_5","Ntome_NODE_20272_length_1171_cov_230",98.182,55,1,0,1,55,329,275,2.01e-19,97.1,54,54
"78665","Nsylvestris_NODE_29032_length_583_cov_4","Ntome_NODE_17367_length_1415_cov_139",93.504,585,33,3,1,583,96,677,0,865,582,581
"78677","Nsylvestris_NODE_29037_length_582_cov_13","Ntome_NODE_34502_length_395_cov_6",92.929,396,22,3,157,550,1,392,2.73e-162,571,393,391
"78681","Nsylvestris_NODE_29039_length_582_cov_9","Ntome_NODE_13497_length_1786_cov_232",94.545,55,3,0,1,55,1491,1545,4.34e-16,86.1,54,54
"78682","Nsylvestris_NODE_29040_length_582_cov_7","Ntome_NODE_15217_length_1612_cov_193",98.333,60,1,0,1,60,850,909,3.33e-22,106,59,59
"78683","Nsylvestris_NODE_29042_length_582_cov_6","Ntome_NODE_35089_length_371_cov_3",89.101,367,37,3,135,501,2,365,1.03e-126,453,366,363
"78684","Nsylvestris_NODE_29043_length_582_cov_6","Ntome_NODE_35396_length_358_cov_5",97.5,240,6,0,1,240,255,16,6.3e-114,411,239,239
"78696","Nsylvestris_NODE_29057_length_581_cov_8","Ntome_NODE_1192_length_4847_cov_232",100,55,0,0,1,55,1136,1082,4.3e-21,102,54,54
"78711","Nsylvestris_NODE_29066_length_581_cov_4","Ntome_NODE_9423_length_2275_cov_10",84.055,508,62,12,88,579,1769,2273,2.85e-132,472,491,504
"78715","Nsylvestris_NODE_29068_length_580_cov_226","Ntome_NODE_16804_length_1465_cov_247",95.438,548,20,3,36,580,1415,870,0,869,544,545
"78720","Nsylvestris_NODE_29070_length_580_cov_174","Ntome_NODE_10722_length_2105_cov_75",96.124,516,19,1,65,580,110,624,0,841,515,514
"78721","Nsylvestris_NODE_29071_length_581_cov_137","Ntome_NODE_10677_length_2109_cov_268",94.444,54,2,1,1,54,397,345,5.6e-15,82.4,53,52
"78724","Nsylvestris_NODE_29073_length_580_cov_42","Ntome_NODE_3945_length_3374_cov_299",96.558,581,17,3,1,580,997,1575,0,959,579,578
"78735","Nsylvestris_NODE_29080_length_580_cov_12","Ntome_NODE_55_length_9658_cov_63",98.182,55,1,0,1,55,642,588,2e-19,97.1,54,54
"78736","Nsylvestris_NODE_29082_length_580_cov_11","Ntome_NODE_9793_length_2226_cov_232",92.401,579,33,6,1,577,503,1072,0,815,576,569
"78746","Nsylvestris_NODE_29089_length_580_cov_3","Ntome_NODE_17481_length_1405_cov_110",94.369,586,27,3,1,580,289,874,0,894,579,585
"78749","Nsylvestris_NODE_29092_length_579_cov_174","Ntome_NODE_11823_length_1978_cov_238",92.802,514,30,4,1,511,510,1,0,737,510,509
"78750","Nsylvestris_NODE_29093_length_579_cov_132","Ntome_NODE_141_length_7936_cov_227",98.618,579,8,0,1,579,4743,5321,0,1026,578,578
"78754","Nsylvestris_NODE_29095_length_579_cov_102","Ntome_NODE_2421_length_3948_cov_156",96.667,60,1,1,1,60,614,672,5.54e-20,99,59,58
"78775","Nsylvestris_NODE_29105_length_579_cov_11","Ntome_NODE_10909_length_2083_cov_267",98.182,55,1,0,1,55,1595,1649,1.99e-19,97.1,54,54
"78776","Nsylvestris_NODE_29107_length_579_cov_9","Ntome_NODE_20304_length_1169_cov_18",90,40,4,0,190,229,1012,1051,4.38e-06,52.8,39,39
"78781","Nsylvestris_NODE_29110_length_579_cov_6","Ntome_NODE_1513_length_4526_cov_129",94.413,537,25,5,4,537,357,891,0,821,533,534
"78782","Nsylvestris_NODE_29111_length_579_cov_6","Ntome_NODE_17821_length_1373_cov_33",88.704,602,37,12,1,577,752,1347,0,706,576,595
"78789","Nsylvestris_NODE_29115_length_578_cov_161","Ntome_NODE_21180_length_1103_cov_303",96.963,428,13,0,1,428,471,44,0,719,427,427
"78790","Nsylvestris_NODE_29116_length_578_cov_148","Ntome_NODE_1449_length_4579_cov_260",94.245,556,22,5,3,557,993,1539,0,841,554,546
"78793","Nsylvestris_NODE_29118_length_578_cov_63","Ntome_NODE_28883_length_672_cov_184",87.838,444,30,13,143,574,160,591,1.3e-140,499,431,431
"78794","Nsylvestris_NODE_29120_length_578_cov_49","Ntome_NODE_29841_length_634_cov_18",93.514,555,28,5,1,554,629,82,0,819,553,547
"78795","Nsylvestris_NODE_29121_length_578_cov_36","Ntome_NODE_14664_length_1670_cov_210",92.893,591,28,6,1,578,1243,654,0,846,577,589
"78810","Nsylvestris_NODE_29126_length_578_cov_22","Ntome_NODE_22198_length_1034_cov_154",96.364,55,2,0,524,578,579,525,9.26e-18,91.6,54,54
"78821","Nsylvestris_NODE_29131_length_578_cov_8","Ntome_NODE_9846_length_2219_cov_240",100,55,0,0,1,55,458,512,4.28e-21,102,54,54
"78822","Nsylvestris_NODE_29132_length_578_cov_5","Ntome_NODE_321_length_6619_cov_201",100,55,0,0,524,578,4336,4390,4.28e-21,102,54,54
"78830","Nsylvestris_NODE_29136_length_577_cov_55","Ntome_NODE_69_length_9046_cov_201",94.944,178,9,0,335,512,8869,9046,1.84e-74,279,177,177
"78836","Nsylvestris_NODE_29140_length_577_cov_29","Ntome_NODE_20993_length_1117_cov_43",87.206,383,35,4,67,438,60,439,8.02e-118,424,371,379
"78844","Nsylvestris_NODE_29146_length_577_cov_11","Ntome_NODE_26578_length_778_cov_22",96.007,576,22,1,2,577,98,672,0,935,575,574
"78845","Nsylvestris_NODE_29147_length_577_cov_10","Ntome_NODE_10530_length_2127_cov_74",79.229,597,77,20,1,577,1276,1845,2.95e-102,372,576,569
"78850","Nsylvestris_NODE_29150_length_577_cov_9","Ntome_NODE_9182_length_2311_cov_249",100,55,0,0,1,55,868,922,4.27e-21,102,54,54
"78851","Nsylvestris_NODE_29151_length_577_cov_8","Ntome_NODE_184_length_7533_cov_278",100,55,0,0,1,55,1250,1304,4.27e-21,102,54,54
"78875","Nsylvestris_NODE_29166_length_576_cov_22","Ntome_NODE_3492_length_3519_cov_246",100,55,0,0,1,55,2870,2924,4.26e-21,102,54,54
"78878","Nsylvestris_NODE_29168_length_576_cov_19","Ntome_NODE_26017_length_805_cov_236",100,55,0,0,1,55,433,379,4.26e-21,102,54,54
"78891","Nsylvestris_NODE_29176_length_576_cov_8","Ntome_NODE_1387_length_4647_cov_59",90.085,585,37,11,2,576,3735,4308,0,739,574,573
"78892","Nsylvestris_NODE_29177_length_576_cov_6","Ntome_NODE_8602_length_2398_cov_279",98.148,54,1,0,522,575,1717,1770,7.13e-19,95.3,53,53
"78893","Nsylvestris_NODE_29179_length_576_cov_6","Ntome_NODE_39068_length_266_cov_3",86.94,268,22,4,263,525,1,260,3.05e-77,289,262,259
"78900","Nsylvestris_NODE_29182_length_576_cov_4","Ntome_NODE_3897_length_3389_cov_120",89.708,583,44,8,1,576,1790,2363,0,730,575,573
"78914","Nsylvestris_NODE_29191_length_575_cov_34","Ntome_NODE_6337_length_2777_cov_222",84.185,607,40,16,1,575,1922,2504,2.74e-152,538,574,582
"78917","Nsylvestris_NODE_29193_length_575_cov_26","Ntome_NODE_7358_length_2593_cov_127",93.87,261,15,1,160,419,2501,2241,2.25e-108,392,259,260
"78924","Nsylvestris_NODE_29198_length_575_cov_10","Ntome_NODE_18815_length_1290_cov_12",91.005,567,12,6,3,551,1141,596,0,728,548,545
"78931","Nsylvestris_NODE_29202_length_575_cov_6","Ntome_NODE_7087_length_2641_cov_194",95.238,63,2,1,513,575,1650,1711,5.5e-20,99,62,61
"78932","Nsylvestris_NODE_29203_length_575_cov_6","Ntome_NODE_10282_length_2158_cov_197",85.443,158,18,4,421,575,1999,1844,2.49e-38,159,154,155
"78933","Nsylvestris_NODE_29204_length_575_cov_5","Ntome_NODE_3592_length_3486_cov_156",86.426,582,63,13,2,575,1189,616,7.34e-178,623,573,573
"78937","Nsylvestris_NODE_29206_length_575_cov_4","Ntome_NODE_17593_length_1394_cov_53",94.231,52,2,1,1,51,1131,1080,7.17e-14,78.7,50,51
"78941","Nsylvestris_NODE_29208_length_574_cov_204","Ntome_NODE_21774_length_1063_cov_65",94.661,487,20,5,1,487,549,1029,0,750,486,480
"78950","Nsylvestris_NODE_29214_length_574_cov_38","Ntome_NODE_21564_length_1077_cov_24",86.207,145,19,1,185,329,185,328,3.21e-37,156,144,143
"78951","Nsylvestris_NODE_29215_length_574_cov_29","Ntome_NODE_20351_length_1165_cov_265",100,55,0,0,1,55,684,738,4.25e-21,102,54,54
"78969","Nsylvestris_NODE_29222_length_574_cov_10","Ntome_NODE_5497_length_2962_cov_132",100,33,0,0,542,574,1915,1883,7.21e-09,62.1,32,32
"78974","Nsylvestris_NODE_29226_length_574_cov_8","Ntome_NODE_15487_length_1585_cov_110",98.182,55,1,0,520,574,649,595,1.98e-19,97.1,54,54
"78977","Nsylvestris_NODE_29230_length_574_cov_6","Ntome_NODE_598_length_5777_cov_147",87.575,499,53,9,25,520,2894,3386,9.68e-162,569,495,492
"78978","Nsylvestris_NODE_29231_length_574_cov_5","Ntome_NODE_23880_length_932_cov_30",95.333,450,21,0,1,450,502,53,0,715,449,449
"78981","Nsylvestris_NODE_29235_length_573_cov_212","Ntome_NODE_13001_length_1842_cov_220",89.134,589,45,6,1,573,948,363,0,715,572,585
"79007","Nsylvestris_NODE_29247_length_573_cov_17","Ntome_NODE_13285_length_1810_cov_106",95.122,574,27,1,1,573,307,880,0,904,572,573
"79015","Nsylvestris_NODE_29255_length_573_cov_5","Ntome_NODE_15427_length_1591_cov_247",96.364,55,2,0,1,55,639,585,9.17e-18,91.6,54,54
"79022","Nsylvestris_NODE_29259_length_572_cov_211","Ntome_NODE_18633_length_1305_cov_252",94.027,519,12,3,73,572,17,535,0,769,499,518
"79038","Nsylvestris_NODE_29266_length_572_cov_28","Ntome_NODE_4751_length_3146_cov_281",98.182,55,1,0,1,55,734,788,1.97e-19,97.1,54,54
"79042","Nsylvestris_NODE_29271_length_572_cov_14","Ntome_NODE_17660_length_1387_cov_172",100,55,0,0,1,55,834,888,4.23e-21,102,54,54
"79046","Nsylvestris_NODE_29273_length_572_cov_13","Ntome_NODE_14468_length_1688_cov_285",100,55,0,0,518,572,485,539,4.23e-21,102,54,54
"79049","Nsylvestris_NODE_29279_length_572_cov_6","Ntome_NODE_6654_length_2720_cov_199",95.345,537,21,3,35,568,567,1102,0,850,533,535
"79050","Nsylvestris_NODE_29282_length_572_cov_5","Ntome_NODE_14977_length_1638_cov_252",94.545,55,3,0,518,572,836,782,4.26e-16,86.1,54,54
"79051","Nsylvestris_NODE_29283_length_572_cov_4","Ntome_NODE_37558_length_298_cov_4",89.723,253,10,3,316,558,52,298,2.32e-83,309,242,246
"79052","Nsylvestris_NODE_29284_length_572_cov_4","Ntome_NODE_3699_length_3452_cov_103",91.111,90,8,0,1,90,2670,2581,3.25e-27,122,89,89
"79055","Nsylvestris_NODE_29286_length_571_cov_254","Ntome_NODE_19349_length_1247_cov_245",93.849,569,31,1,3,571,705,141,0,854,568,564
"79065","Nsylvestris_NODE_29290_length_571_cov_142","Ntome_NODE_12353_length_1915_cov_186",87.703,553,25,14,1,516,1347,1893,2.64e-172,604,515,546
"79071","Nsylvestris_NODE_29293_length_571_cov_45","Ntome_NODE_5022_length_3073_cov_271",96.364,55,2,0,1,55,1310,1364,9.14e-18,91.6,54,54
"79072","Nsylvestris_NODE_29296_length_571_cov_28","Ntome_NODE_11487_length_2015_cov_293",100,55,0,0,1,55,1272,1218,4.22e-21,102,54,54
"79075","Nsylvestris_NODE_29298_length_571_cov_16","Ntome_NODE_10028_length_2196_cov_85",98.039,51,1,0,4,54,1619,1569,3.29e-17,89.8,50,50
"79079","Nsylvestris_NODE_29300_length_571_cov_11","Ntome_NODE_28576_length_685_cov_21",80.993,584,76,16,11,571,49,620,4.74e-120,431,560,571
"79082","Nsylvestris_NODE_29303_length_571_cov_8","Ntome_NODE_5857_length_2882_cov_92",91.228,171,10,4,1,166,1474,1644,6.68e-59,228,165,170
"79083","Nsylvestris_NODE_29304_length_571_cov_7","Ntome_NODE_1584_length_4466_cov_164",87.979,574,32,14,7,571,615,1160,0,643,564,545
"79084","Nsylvestris_NODE_29305_length_571_cov_7","Ntome_NODE_14063_length_1731_cov_271",98.182,55,1,0,517,571,642,696,1.96e-19,97.1,54,54
"79085","Nsylvestris_NODE_29307_length_571_cov_5","Ntome_NODE_2271_length_4020_cov_73",100,55,0,0,1,55,1691,1745,4.22e-21,102,54,54
"79086","Nsylvestris_NODE_29308_length_571_cov_4","Ntome_NODE_34645_length_389_cov_3",98.182,55,1,0,517,571,386,332,1.96e-19,97.1,54,54
"79089","Nsylvestris_NODE_29310_length_571_cov_4","Ntome_NODE_12521_length_1895_cov_232",96.364,55,2,0,1,55,940,994,9.14e-18,91.6,54,54
"79090","Nsylvestris_NODE_29312_length_570_cov_215","Ntome_NODE_15246_length_1610_cov_9",96.774,62,1,1,1,61,866,927,4.22e-21,102,60,61
"79117","Nsylvestris_NODE_29326_length_570_cov_8","Ntome_NODE_8584_length_2401_cov_35",95.246,568,24,1,1,568,682,1246,0,896,567,564
"79118","Nsylvestris_NODE_29327_length_570_cov_8","Ntome_NODE_22929_length_988_cov_8",90.435,575,42,5,1,570,988,422,0,745,569,566
"79121","Nsylvestris_NODE_29331_length_570_cov_4","Ntome_NODE_1718_length_4367_cov_193",92.845,573,35,2,1,567,4203,3631,0,826,566,572
"79124","Nsylvestris_NODE_29335_length_569_cov_221","Ntome_NODE_19176_length_1261_cov_268",97.211,502,14,0,1,502,909,408,0,850,501,501
"79130","Nsylvestris_NODE_29339_length_569_cov_135","Ntome_NODE_2526_length_3897_cov_128",96.277,564,12,5,7,569,3897,3342,0,917,562,555
"79133","Nsylvestris_NODE_29341_length_569_cov_37","Ntome_NODE_32280_length_530_cov_11",91.885,382,31,0,130,511,383,2,3.5e-151,534,381,381
"79134","Nsylvestris_NODE_29342_length_569_cov_24","Ntome_NODE_4594_length_3183_cov_113",100,55,0,0,1,55,2204,2258,4.21e-21,102,54,54
"79139","Nsylvestris_NODE_29345_length_569_cov_17","Ntome_NODE_10327_length_2154_cov_215",90.909,176,11,3,374,548,1185,1014,5.14e-60,231,174,171
"79142","Nsylvestris_NODE_29347_length_569_cov_15","Ntome_NODE_8202_length_2459_cov_273",96.429,56,2,0,512,567,592,647,2.53e-18,93.5,55,55
"79147","Nsylvestris_NODE_29350_length_569_cov_12","Ntome_NODE_3718_length_3445_cov_67",97.222,36,1,0,2,37,2394,2359,7.14e-09,62.1,35,35
"79150","Nsylvestris_NODE_29355_length_569_cov_9","Ntome_NODE_3173_length_3629_cov_278",94.828,58,3,0,1,58,2521,2464,9.11e-18,91.6,57,57
"79151","Nsylvestris_NODE_29356_length_569_cov_8","Ntome_NODE_1959_length_4204_cov_186",98.182,55,1,0,515,569,3710,3764,1.96e-19,97.1,54,54
"79152","Nsylvestris_NODE_29357_length_569_cov_8","Ntome_NODE_5154_length_3043_cov_139",95,200,7,3,2,199,2087,1889,6.42e-84,311,197,198
"79156","Nsylvestris_NODE_29361_length_569_cov_5","Ntome_NODE_3584_length_3489_cov_70",79.31,87,14,4,184,268,1954,1870,9.24e-08,58.4,84,84
"79159","Nsylvestris_NODE_29363_length_569_cov_2","Ntome_NODE_32950_length_481_cov_241",100,52,0,0,518,569,423,372,1.96e-19,97.1,51,51
"79165","Nsylvestris_NODE_29366_length_568_cov_207","Ntome_NODE_21658_length_1070_cov_244",95.407,479,21,1,41,518,186,664,0,761,477,478
"79171","Nsylvestris_NODE_29369_length_568_cov_34","Ntome_NODE_9082_length_2326_cov_257",100,55,0,0,514,568,868,922,4.2e-21,102,54,54
"79172","Nsylvestris_NODE_29370_length_568_cov_23","Ntome_NODE_28126_length_704_cov_218",91.453,117,7,2,1,117,621,508,8.84e-38,158,116,113
"79173","Nsylvestris_NODE_29371_length_568_cov_22","Ntome_NODE_13052_length_1836_cov_33",100,55,0,0,514,568,997,943,4.2e-21,102,54,54
"79178","Nsylvestris_NODE_29373_length_568_cov_21","Ntome_NODE_11476_length_2016_cov_258",96.364,55,2,0,1,55,976,922,9.09e-18,91.6,54,54
"79183","Nsylvestris_NODE_29375_length_568_cov_14","Ntome_NODE_7613_length_2552_cov_227",88.753,489,29,16,3,489,2518,2054,2.06e-163,575,486,464
"79190","Nsylvestris_NODE_29378_length_568_cov_11","Ntome_NODE_28014_length_710_cov_3",90.359,446,31,6,126,568,142,578,2.06e-163,575,442,436
"79191","Nsylvestris_NODE_29379_length_568_cov_9","Ntome_NODE_5993_length_2848_cov_298",96.364,55,2,0,1,55,899,845,9.09e-18,91.6,54,54
"79194","Nsylvestris_NODE_29383_length_568_cov_7","Ntome_NODE_3519_length_3509_cov_302",98.182,55,1,0,1,55,3147,3201,1.95e-19,97.1,54,54
"79198","Nsylvestris_NODE_29385_length_568_cov_6","Ntome_NODE_11769_length_1984_cov_11",76.789,517,98,14,4,504,1531,1021,1.09e-71,270,500,510
"79202","Nsylvestris_NODE_29387_length_568_cov_5","Ntome_NODE_335_length_6589_cov_84",82.329,249,31,11,161,404,5519,5279,1.12e-51,204,243,240
"79207","Nsylvestris_NODE_29390_length_567_cov_213","Ntome_NODE_6408_length_2765_cov_281",91.56,545,31,6,35,567,2646,2105,0,737,532,541
"79208","Nsylvestris_NODE_29391_length_567_cov_180","Ntome_NODE_28618_length_683_cov_55",90.353,539,37,9,8,543,131,657,0,693,535,526
"79216","Nsylvestris_NODE_29395_length_567_cov_58","Ntome_NODE_4322_length_3255_cov_244",91.334,577,29,9,1,565,1826,1259,0,769,564,567
"79229","Nsylvestris_NODE_29402_length_567_cov_14","Ntome_NODE_4353_length_3249_cov_141",88.961,462,39,10,29,481,194,652,5.75e-159,560,452,458
"79253","Nsylvestris_NODE_29414_length_566_cov_51","Ntome_NODE_6410_length_2765_cov_244",93.214,280,13,3,1,280,2071,1798,7.92e-113,407,279,273
"79277","Nsylvestris_NODE_29422_length_566_cov_8","Ntome_NODE_10440_length_2140_cov_222",100,55,0,0,1,55,1856,1910,4.18e-21,102,54,54
"79281","Nsylvestris_NODE_29424_length_566_cov_7","Ntome_NODE_501_length_6015_cov_213",98.182,55,1,0,512,566,5379,5325,1.95e-19,97.1,54,54
"79282","Nsylvestris_NODE_29426_length_566_cov_7","Ntome_NODE_6884_length_2676_cov_277",94.34,53,3,0,512,564,2185,2237,5.45e-15,82.4,52,52
"79288","Nsylvestris_NODE_29429_length_566_cov_6","Ntome_NODE_6850_length_2685_cov_76",96.071,509,19,1,58,566,981,474,0,828,508,507
"79289","Nsylvestris_NODE_29430_length_566_cov_6","Ntome_NODE_2604_length_3858_cov_141",92.094,468,22,6,4,460,2576,2113,0,645,456,463
"79290","Nsylvestris_NODE_29431_length_566_cov_6","Ntome_NODE_10875_length_2087_cov_289",100,55,0,0,512,566,1459,1405,4.18e-21,102,54,54
"79291","Nsylvestris_NODE_29432_length_566_cov_5","Ntome_NODE_13704_length_1767_cov_237",96.552,58,2,0,1,58,730,673,1.95e-19,97.1,57,57
"79308","Nsylvestris_NODE_29442_length_565_cov_55","Ntome_NODE_9832_length_2221_cov_252",100,55,0,0,1,55,948,1002,4.18e-21,102,54,54
"79312","Nsylvestris_NODE_29445_length_565_cov_25","Ntome_NODE_5329_length_3001_cov_51",96.364,55,2,0,511,565,2350,2404,9.04e-18,91.6,54,54
"79323","Nsylvestris_NODE_29451_length_565_cov_8","Ntome_NODE_23224_length_970_cov_15",96.364,55,2,0,1,55,511,565,9.04e-18,91.6,54,54
"79327","Nsylvestris_NODE_29453_length_565_cov_7","Ntome_NODE_27029_length_757_cov_16",87.776,589,43,12,2,564,663,78,0,662,562,585
"79328","Nsylvestris_NODE_29454_length_564_cov_5","Ntome_NODE_13083_length_1832_cov_46",80,125,15,9,1,121,670,552,1.51e-15,84.2,120,118
"79351","Nsylvestris_NODE_29464_length_564_cov_24","Ntome_NODE_649_length_5651_cov_29",85.515,573,53,15,1,564,1871,1320,2.64e-162,571,563,551
"79352","Nsylvestris_NODE_29466_length_564_cov_23","Ntome_NODE_429_length_6230_cov_171",100,50,0,0,1,50,859,810,2.51e-18,93.5,49,49
"79358","Nsylvestris_NODE_29469_length_564_cov_15","Ntome_NODE_2532_length_3892_cov_293",100,55,0,0,510,564,2827,2773,4.17e-21,102,54,54
"79372","Nsylvestris_NODE_29475_length_564_cov_11","Ntome_NODE_12426_length_1906_cov_30",79.095,464,59,17,95,546,1352,1789,3.86e-76,285,451,437
"79383","Nsylvestris_NODE_29479_length_564_cov_5","Ntome_NODE_12872_length_1854_cov_45",75.918,245,59,0,37,281,599,355,2.47e-28,126,244,244
"79387","Nsylvestris_NODE_29482_length_564_cov_4","Ntome_NODE_12348_length_1916_cov_18",93.717,573,14,8,1,564,1240,1799,0,839,563,559
"79388","Nsylvestris_NODE_29483_length_564_cov_3","Ntome_NODE_31757_length_562_cov_7",95.823,407,17,0,158,564,561,155,0,658,406,406
"79403","Nsylvestris_NODE_29493_length_563_cov_33","Ntome_NODE_2400_length_3959_cov_163",86.243,567,54,13,4,553,11,570,5.63e-169,593,549,559
"79406","Nsylvestris_NODE_29495_length_562_cov_28","Ntome_NODE_31358_length_576_cov_3",100,49,0,0,513,561,528,576,8.99e-18,91.6,48,48
"79407","Nsylvestris_NODE_29498_length_563_cov_23","Ntome_NODE_29157_length_662_cov_11",88.408,578,11,18,1,563,126,662,0,645,562,536
"79408","Nsylvestris_NODE_29499_length_563_cov_23","Ntome_NODE_12966_length_1845_cov_92",91.549,71,4,2,1,71,1105,1037,1.94e-19,97.1,70,68
"79409","Nsylvestris_NODE_29501_length_563_cov_13","Ntome_NODE_460_length_6130_cov_196",74.613,323,66,14,71,385,390,76,6.86e-29,128,314,314
"79410","Nsylvestris_NODE_29502_length_563_cov_12","Ntome_NODE_5700_length_2918_cov_74",91.822,538,28,8,33,563,1544,1016,0,736,530,528
"79416","Nsylvestris_NODE_29505_length_563_cov_9","Ntome_NODE_18141_length_1347_cov_154",92.562,484,22,7,81,560,1,474,0,682,479,473
"79417","Nsylvestris_NODE_29506_length_563_cov_9","Ntome_NODE_5243_length_3019_cov_74",91.434,572,35,7,1,560,602,1171,0,773,559,569
"79424","Nsylvestris_NODE_29510_length_563_cov_6","Ntome_NODE_20125_length_1182_cov_232",94.545,55,3,0,509,563,422,368,4.19e-16,86.1,54,54
"79425","Nsylvestris_NODE_29511_length_563_cov_5","Ntome_NODE_22463_length_1019_cov_32",97.053,509,15,0,55,563,976,468,0,857,508,508
"79426","Nsylvestris_NODE_29512_length_563_cov_5","Ntome_NODE_23847_length_934_cov_20",87.079,178,15,7,331,502,600,775,6.67e-49,195,171,175
"79454","Nsylvestris_NODE_29526_length_562_cov_24","Ntome_NODE_20693_length_1138_cov_282",87.903,124,12,3,1,121,155,278,2.45e-33,143,120,123
"79455","Nsylvestris_NODE_29527_length_562_cov_15","Ntome_NODE_19795_length_1210_cov_274",94.915,59,2,1,1,59,411,468,8.99e-18,91.6,58,57
"79461","Nsylvestris_NODE_29530_length_562_cov_9","Ntome_NODE_716_length_5532_cov_172",92.045,528,20,6,3,508,660,1187,0,723,505,527
"79466","Nsylvestris_NODE_29533_length_562_cov_9","Ntome_NODE_29237_length_659_cov_7",92.491,546,28,3,13,556,50,584,0,769,543,534
"79479","Nsylvestris_NODE_29539_length_562_cov_6","Ntome_NODE_4048_length_3335_cov_173",100,29,0,0,1,29,1296,1324,1.18e-06,54.7,28,28
"79488","Nsylvestris_NODE_29543_length_561_cov_191","Ntome_NODE_7733_length_2535_cov_135",96.564,291,10,0,271,561,2535,2245,1.27e-135,483,290,290
"79496","Nsylvestris_NODE_29547_length_561_cov_52","Ntome_NODE_37702_length_295_cov_3",91.892,296,15,6,83,370,1,295,2.82e-112,405,287,294
"79502","Nsylvestris_NODE_29553_length_561_cov_12","Ntome_NODE_17607_length_1393_cov_87",78.696,230,40,5,49,275,137,360,6.79e-34,145,226,223
"79503","Nsylvestris_NODE_29555_length_561_cov_11","Ntome_NODE_7110_length_2636_cov_206",98.182,55,1,0,1,55,1889,1943,1.93e-19,97.1,54,54
"79514","Nsylvestris_NODE_29561_length_561_cov_5","Ntome_NODE_23190_length_972_cov_167",94.939,573,16,5,2,561,660,88,0,885,559,572
"79515","Nsylvestris_NODE_29563_length_563_cov_4","Ntome_NODE_2483_length_3915_cov_295",100,50,0,0,509,558,3012,2963,2.5e-18,93.5,49,49
"79516","Nsylvestris_NODE_29565_length_560_cov_215","Ntome_NODE_22311_length_1027_cov_268",96.169,522,20,0,39,560,926,405,0,854,521,521
"79531","Nsylvestris_NODE_29573_length_560_cov_23","Ntome_NODE_6195_length_2812_cov_218",89.199,574,38,9,5,560,830,1397,0,695,555,567
"79532","Nsylvestris_NODE_29576_length_560_cov_21","Ntome_NODE_25897_length_810_cov_174",90.526,95,9,0,1,95,137,231,2.46e-28,126,94,94
"79533","Nsylvestris_NODE_29579_length_560_cov_17","Ntome_NODE_1061_length_5006_cov_185",100,55,0,0,506,560,2973,2919,4.14e-21,102,54,54
"79534","Nsylvestris_NODE_29580_length_560_cov_16","Ntome_NODE_1328_length_4700_cov_103",91.786,560,36,4,3,560,3699,4250,0,771,557,551
"79535","Nsylvestris_NODE_29581_length_560_cov_16","Ntome_NODE_657_length_5640_cov_123",77.936,281,52,8,38,312,621,345,1.45e-40,167,274,276
"79538","Nsylvestris_NODE_29583_length_560_cov_11","Ntome_NODE_39378_length_260_cov_5",90.361,83,6,2,39,119,260,178,8.89e-23,108,80,82
"79543","Nsylvestris_NODE_29587_length_560_cov_6","Ntome_NODE_27141_length_751_cov_13",78.661,239,42,7,1,235,515,748,1.46e-35,150,234,233
"79544","Nsylvestris_NODE_29588_length_560_cov_6","Ntome_NODE_25096_length_858_cov_10",87.975,316,29,7,247,560,1,309,4.78e-100,364,313,308
"79547","Nsylvestris_NODE_29590_length_560_cov_5","Ntome_NODE_19981_length_1193_cov_216",74.609,256,55,7,300,550,748,498,1.15e-21,104,250,250
"79550","Nsylvestris_NODE_29594_length_559_cov_202","Ntome_NODE_24117_length_917_cov_214",95.043,464,20,1,48,508,509,46,0,726,460,463
"79551","Nsylvestris_NODE_29595_length_559_cov_192","Ntome_NODE_9803_length_2224_cov_293",90.511,548,23,14,24,559,1,531,0,697,535,530
"79561","Nsylvestris_NODE_29599_length_559_cov_18","Ntome_NODE_18040_length_1354_cov_263",98.333,60,0,1,501,559,190,131,1.15e-21,104,58,59
"79566","Nsylvestris_NODE_29602_length_558_cov_16","Ntome_NODE_16970_length_1451_cov_188",91.892,74,6,0,1,74,1167,1240,1.15e-21,104,73,73
"79573","Nsylvestris_NODE_29607_length_559_cov_8","Ntome_NODE_16012_length_1538_cov_52",82.877,146,17,7,418,559,1090,1231,8.81e-28,124,141,141
"79580","Nsylvestris_NODE_29612_length_559_cov_3","Ntome_NODE_17357_length_1416_cov_25",93.173,498,33,1,62,558,889,1386,0,730,496,497
"79585","Nsylvestris_NODE_29614_length_558_cov_175","Ntome_NODE_10074_length_2190_cov_117",84.181,177,27,1,241,416,181,5,1.11e-41,171,175,176
"79605","Nsylvestris_NODE_29625_length_558_cov_8","Ntome_NODE_28119_length_705_cov_7",93.482,537,19,5,24,558,685,163,0,784,534,522
"79609","Nsylvestris_NODE_29628_length_558_cov_6","Ntome_NODE_28139_length_704_cov_21",91.971,548,29,4,1,548,169,701,0,754,547,532
"79610","Nsylvestris_NODE_29629_length_558_cov_6","Ntome_NODE_25189_length_852_cov_11",88.328,574,43,10,1,558,198,763,0,667,557,565
"79611","Nsylvestris_NODE_29631_length_557_cov_175","Ntome_NODE_5791_length_2897_cov_276",95.179,560,24,1,1,557,1175,616,0,881,556,559
"79617","Nsylvestris_NODE_29634_length_557_cov_68","Ntome_NODE_31857_length_558_cov_13",99.82,556,0,1,3,557,1,556,0,1020,554,555
"79618","Nsylvestris_NODE_29635_length_557_cov_38","Ntome_NODE_2919_length_3728_cov_211",83.838,594,38,19,3,557,839,265,1.6e-144,512,554,574
"79632","Nsylvestris_NODE_29643_length_557_cov_7","Ntome_NODE_35_length_10358_cov_88",95.884,413,12,2,147,557,3207,2798,0,664,410,409
"79633","Nsylvestris_NODE_29644_length_557_cov_6","Ntome_NODE_29111_length_664_cov_5",93.814,388,20,2,1,385,387,1,4.34e-165,580,384,386
"79634","Nsylvestris_NODE_29645_length_557_cov_6","Ntome_NODE_3377_length_3558_cov_122",87.013,154,15,5,2,152,2345,2496,4e-41,169,150,151
"79635","Nsylvestris_NODE_29646_length_557_cov_5","Ntome_NODE_19064_length_1270_cov_219",98.305,59,1,0,499,557,653,595,1.14e-21,104,58,58
"79654","Nsylvestris_NODE_29656_length_556_cov_16","Ntome_NODE_6530_length_2743_cov_103",98.182,55,1,0,502,556,1829,1775,1.91e-19,97.1,54,54
"79663","Nsylvestris_NODE_29664_length_556_cov_6","Ntome_NODE_2140_length_4087_cov_104",93.14,379,16,4,187,556,1645,1268,4.39e-155,547,369,377
"79664","Nsylvestris_NODE_29666_length_556_cov_6","Ntome_NODE_13192_length_1820_cov_287",100,33,0,0,1,33,625,593,6.97e-09,62.1,32,32
"79665","Nsylvestris_NODE_29667_length_556_cov_6","Ntome_NODE_6730_length_2707_cov_23",89.946,557,47,6,1,551,1,554,0,710,550,553
"79676","Nsylvestris_NODE_29673_length_555_cov_194","Ntome_NODE_12621_length_1884_cov_190",90.274,401,30,6,3,400,1443,1837,1.24e-145,516,397,394
"79695","Nsylvestris_NODE_29681_length_555_cov_18","Ntome_NODE_33057_length_473_cov_19",87.719,171,20,1,233,403,172,3,5.08e-50,198,170,169
"79707","Nsylvestris_NODE_29688_length_554_cov_238","Ntome_NODE_1396_length_4636_cov_255",96.57,554,19,0,1,554,2601,3154,0,918,553,553
"79708","Nsylvestris_NODE_29689_length_554_cov_167","Ntome_NODE_6309_length_2786_cov_238",84.672,274,27,10,88,355,74,338,2.29e-68,259,267,264
"79715","Nsylvestris_NODE_29695_length_554_cov_17","Ntome_NODE_6867_length_2682_cov_37",85.965,114,13,3,22,133,190,302,4.06e-26,119,111,112
"79716","Nsylvestris_NODE_29699_length_554_cov_7","Ntome_NODE_451_length_6157_cov_184",89.068,558,57,2,1,554,2367,2924,0,689,553,557
"79717","Nsylvestris_NODE_29700_length_554_cov_6","Ntome_NODE_335_length_6589_cov_84",74.135,549,94,32,19,554,3234,2721,1.42e-45,183,535,513
"79720","Nsylvestris_NODE_29702_length_554_cov_5","Ntome_NODE_21422_length_1087_cov_37",95.281,551,26,0,4,554,982,432,0,874,550,550
"79721","Nsylvestris_NODE_29704_length_554_cov_4","Ntome_NODE_1315_length_4714_cov_107",88.889,63,7,0,250,312,1627,1565,6.89e-14,78.7,62,62
"79722","Nsylvestris_NODE_29706_length_554_cov_3","Ntome_NODE_31702_length_564_cov_8",83.455,550,44,15,33,551,564,31,3.5e-131,468,518,533
"79730","Nsylvestris_NODE_29709_length_553_cov_178","Ntome_NODE_2041_length_4147_cov_275",96.193,394,13,1,115,506,778,385,0,643,391,393
"79731","Nsylvestris_NODE_29710_length_553_cov_166","Ntome_NODE_3850_length_3404_cov_213",93.402,485,16,7,82,553,2434,2915,0,704,471,481
"79738","Nsylvestris_NODE_29716_length_553_cov_9","Ntome_NODE_7123_length_2635_cov_89",91.297,563,37,9,1,552,256,817,0,758,551,561
"79739","Nsylvestris_NODE_29717_length_553_cov_9","Ntome_NODE_27858_length_716_cov_265",100,39,0,0,1,39,393,355,3.2e-12,73.1,38,38
"79740","Nsylvestris_NODE_29718_length_553_cov_5","Ntome_NODE_21846_length_1058_cov_15",93.282,521,28,6,37,553,584,67,0,761,516,517
"79751","Nsylvestris_NODE_29727_length_552_cov_9","Ntome_NODE_15988_length_1540_cov_13",86.344,227,30,1,31,256,831,605,1.78e-64,246,225,226
"79752","Nsylvestris_NODE_29729_length_552_cov_6","Ntome_NODE_5476_length_2968_cov_176",89.474,76,8,0,77,152,1741,1666,1.9e-19,97.1,75,75
"79753","Nsylvestris_NODE_29731_length_552_cov_5","Ntome_NODE_261_length_7011_cov_115",94.928,552,25,2,1,552,731,1279,0,861,551,548
"79756","Nsylvestris_NODE_29733_length_552_cov_4","Ntome_NODE_17378_length_1414_cov_105",90.244,574,31,13,1,552,883,313,0,726,551,570
"79757","Nsylvestris_NODE_29734_length_552_cov_3","Ntome_NODE_16191_length_1522_cov_12",99.076,541,5,0,1,541,982,1522,0,972,540,540
"79758","Nsylvestris_NODE_29735_length_551_cov_158","Ntome_NODE_22041_length_1045_cov_236",87.574,338,20,5,1,316,463,800,2.81e-102,372,315,337
"79759","Nsylvestris_NODE_29736_length_551_cov_60","Ntome_NODE_28913_length_671_cov_121",87.679,560,31,16,1,551,607,77,3.27e-176,617,550,530
"79760","Nsylvestris_NODE_29737_length_551_cov_55","Ntome_NODE_31985_length_551_cov_30",90.647,556,40,9,2,550,1,551,0,728,548,550
"79767","Nsylvestris_NODE_29741_length_551_cov_7","Ntome_NODE_23643_length_944_cov_5",93.26,549,35,2,3,551,110,656,0,808,548,546
"79776","Nsylvestris_NODE_29747_length_550_cov_5","Ntome_NODE_22321_length_1027_cov_36",90.877,570,30,6,1,550,264,831,0,745,549,567
"79777","Nsylvestris_NODE_29748_length_550_cov_5","Ntome_NODE_395_length_6322_cov_124",77.37,327,67,5,225,549,5760,5439,1.09e-46,187,324,321
"79780","Nsylvestris_NODE_29752_length_549_cov_44","Ntome_NODE_25499_length_833_cov_64",89.091,330,28,3,193,522,326,5,9.92e-112,403,329,321
"79781","Nsylvestris_NODE_29755_length_549_cov_5","Ntome_NODE_799_length_5381_cov_116",92.407,540,31,9,1,538,4305,3774,0,761,537,531
"79782","Nsylvestris_NODE_29756_length_549_cov_5","Ntome_NODE_12992_length_1843_cov_175",92.982,285,17,3,90,372,768,485,1.65e-114,412,282,283
"79783","Nsylvestris_NODE_29758_length_548_cov_218","Ntome_NODE_6012_length_2845_cov_131",95.803,548,20,1,1,548,2812,2268,0,881,547,544
"79786","Nsylvestris_NODE_29760_length_548_cov_181","Ntome_NODE_1001_length_5089_cov_187",94.505,91,5,0,455,545,2054,1964,8.57e-33,141,90,90
"79790","Nsylvestris_NODE_29762_length_548_cov_146","Ntome_NODE_19116_length_1266_cov_213",95.775,497,18,1,1,497,887,394,0,798,496,493
"79791","Nsylvestris_NODE_29763_length_548_cov_84","Ntome_NODE_36425_length_326_cov_167",93.548,217,14,0,1,217,267,51,7.93e-88,324,216,216
"79792","Nsylvestris_NODE_29765_length_548_cov_11","Ntome_NODE_32409_length_520_cov_25",91.154,520,28,10,22,528,515,1,0,689,506,514
"79798","Nsylvestris_NODE_29770_length_548_cov_3","Ntome_NODE_4218_length_3288_cov_45",95.709,536,15,4,1,528,1179,644,0,856,527,535
"79801","Nsylvestris_NODE_29772_length_547_cov_229","Ntome_NODE_7231_length_2617_cov_251",94.908,491,25,0,1,491,629,139,0,769,490,490
"79807","Nsylvestris_NODE_29775_length_547_cov_37","Ntome_NODE_1547_length_4486_cov_109",87.108,574,44,13,4,547,3773,4346,6.97e-178,623,543,573
"79811","Nsylvestris_NODE_29780_length_546_cov_242","Ntome_NODE_5929_length_2866_cov_161",98.901,546,6,0,1,546,1248,1793,0,976,545,545
"79812","Nsylvestris_NODE_29781_length_546_cov_217","Ntome_NODE_4339_length_3252_cov_179",96.371,496,18,0,1,496,2757,3252,0,817,495,495
"79816","Nsylvestris_NODE_29783_length_546_cov_24","Ntome_NODE_2988_length_3704_cov_32",92.88,309,22,0,238,546,2547,2855,1.25e-125,449,308,308
"79829","Nsylvestris_NODE_29794_length_545_cov_13","Ntome_NODE_27219_length_747_cov_55",93.535,495,29,1,8,499,555,61,0,734,491,494
"79833","Nsylvestris_NODE_29797_length_545_cov_6","Ntome_NODE_32961_length_481_cov_4",88.337,463,26,14,93,544,28,473,4.33e-150,531,451,445
"79839","Nsylvestris_NODE_29800_length_544_cov_190","Ntome_NODE_27712_length_723_cov_202",90.101,495,20,19,69,544,671,187,1.16e-175,616,475,484
"79846","Nsylvestris_NODE_29804_length_544_cov_20","Ntome_NODE_27469_length_734_cov_38",91.583,499,31,7,1,488,174,672,0,678,487,498
"79847","Nsylvestris_NODE_29805_length_544_cov_9","Ntome_NODE_15389_length_1595_cov_81",92.094,468,33,2,77,541,922,1388,0,656,464,466
"79848","Nsylvestris_NODE_29809_length_544_cov_4","Ntome_NODE_4801_length_3133_cov_78",81.801,533,55,25,1,516,2189,2696,2.11e-113,409,515,507
"79856","Nsylvestris_NODE_29814_length_543_cov_165","Ntome_NODE_33000_length_477_cov_291",86.038,265,28,5,176,437,310,52,2.23e-73,276,261,258
"79861","Nsylvestris_NODE_29818_length_543_cov_9","Ntome_NODE_10461_length_2137_cov_25",100,36,0,0,508,543,1107,1072,1.46e-10,67.6,35,35
"79862","Nsylvestris_NODE_29819_length_543_cov_7","Ntome_NODE_28600_length_684_cov_67",95.316,427,17,2,120,543,54,480,0,675,423,426
"79865","Nsylvestris_NODE_29822_length_543_cov_6","Ntome_NODE_25593_length_828_cov_15",93.04,273,19,0,271,543,264,536,1.27e-110,399,272,272
"79871","Nsylvestris_NODE_29825_length_543_cov_5","Ntome_NODE_3238_length_3608_cov_91",88.077,260,31,0,2,261,2147,2406,2.2e-83,309,259,259
"79883","Nsylvestris_NODE_29830_length_542_cov_153","Ntome_NODE_1068_length_5000_cov_132",94.28,507,15,8,27,519,4459,4965,0,763,492,506
"79884","Nsylvestris_NODE_29836_length_542_cov_7","Ntome_NODE_23455_length_957_cov_236",91.618,513,37,3,36,542,637,125,0,704,506,512
"79891","Nsylvestris_NODE_29840_length_542_cov_4","Ntome_NODE_36379_length_328_cov_3",95,180,8,1,1,179,180,1,4.79e-75,281,178,179
"79897","Nsylvestris_NODE_29845_length_541_cov_9","Ntome_NODE_23343_length_963_cov_61",94.956,456,19,2,56,510,109,561,0,712,454,452
"79902","Nsylvestris_NODE_29849_length_541_cov_2","Ntome_NODE_17584_length_1395_cov_8",93.714,525,33,0,17,541,41,565,0,787,524,524
"79906","Nsylvestris_NODE_29851_length_540_cov_219","Ntome_NODE_21502_length_1081_cov_174",95.185,540,18,7,1,538,1018,485,0,846,537,533
"79918","Nsylvestris_NODE_29856_length_540_cov_16","Ntome_NODE_15787_length_1559_cov_220",94.667,75,4,0,230,304,295,369,1.42e-25,117,74,74
"79919","Nsylvestris_NODE_29857_length_540_cov_9","Ntome_NODE_24968_length_865_cov_60",95.926,540,22,0,1,540,134,673,0,876,539,539
"79920","Nsylvestris_NODE_29858_length_540_cov_6","Ntome_NODE_907_length_5215_cov_113",85.978,542,74,2,1,540,1120,1661,1.51e-164,579,539,541
"79921","Nsylvestris_NODE_29859_length_540_cov_5","Ntome_NODE_5958_length_2859_cov_134",88.083,579,29,8,1,540,1309,732,0,651,539,577
"79927","Nsylvestris_NODE_29864_length_539_cov_24","Ntome_NODE_32994_length_478_cov_6",77.46,315,51,16,141,451,100,398,1.07e-41,171,310,298
"79931","Nsylvestris_NODE_29868_length_539_cov_6","Ntome_NODE_23407_length_960_cov_18",94.991,539,27,0,1,539,324,862,0,846,538,538
"79936","Nsylvestris_NODE_29874_length_538_cov_202","Ntome_NODE_19783_length_1211_cov_240",93.224,487,17,4,52,538,58,528,0,702,486,470
"79944","Nsylvestris_NODE_29880_length_538_cov_7","Ntome_NODE_38969_length_268_cov_4",98.039,204,4,0,335,538,268,65,2.76e-97,355,203,203
"79945","Nsylvestris_NODE_29881_length_538_cov_6","Ntome_NODE_699_length_5560_cov_20",97.368,38,0,1,353,390,1927,1963,1.87e-09,63.9,37,36
"79959","Nsylvestris_NODE_29889_length_537_cov_11","Ntome_NODE_29119_length_663_cov_237",88.841,466,36,9,69,530,508,55,1.95e-158,558,461,453
"79960","Nsylvestris_NODE_29890_length_537_cov_5","Ntome_NODE_22600_length_1010_cov_41",94.403,536,26,2,1,536,467,998,0,821,535,531
"79961","Nsylvestris_NODE_29894_length_537_cov_4","Ntome_NODE_27511_length_732_cov_3",96.063,127,4,1,1,127,623,498,2.93e-52,206,126,125
"79964","Nsylvestris_NODE_29896_length_536_cov_158","Ntome_NODE_10639_length_2114_cov_94",93.947,413,19,3,124,536,2070,1664,8.82e-177,619,412,406
"79965","Nsylvestris_NODE_29899_length_536_cov_7","Ntome_NODE_13719_length_1766_cov_7",89.362,376,25,7,174,536,1764,1391,2.04e-128,459,362,373
"79966","Nsylvestris_NODE_29900_length_536_cov_6","Ntome_NODE_7828_length_2519_cov_103",97.938,194,4,0,343,536,450,257,9.95e-92,337,193,193
"79973","Nsylvestris_NODE_29904_length_535_cov_219","Ntome_NODE_6971_length_2660_cov_117",92.621,393,27,2,2,392,2191,2583,4.19e-160,564,390,392
"79977","Nsylvestris_NODE_29906_length_535_cov_163","Ntome_NODE_32728_length_496_cov_62",91.515,495,29,12,25,511,491,2,0,669,486,489
"79981","Nsylvestris_NODE_29909_length_535_cov_9","Ntome_NODE_28841_length_674_cov_75",84.254,362,46,8,78,439,466,116,2.13e-93,342,361,350
"79986","Nsylvestris_NODE_29916_length_534_cov_212","Ntome_NODE_20005_length_1191_cov_280",90.26,462,24,12,24,485,14,454,3.21e-166,584,461,440
"79990","Nsylvestris_NODE_29920_length_534_cov_16","Ntome_NODE_30884_length_593_cov_8",85.266,319,31,6,1,317,77,381,4.64e-85,315,316,304
"79991","Nsylvestris_NODE_29922_length_534_cov_13","Ntome_NODE_26500_length_782_cov_73",86.945,383,29,6,92,456,2,381,5.76e-114,411,364,379
"79992","Nsylvestris_NODE_29923_length_534_cov_9","Ntome_NODE_210_length_7381_cov_111",89.964,548,36,12,1,534,3442,2900,0,689,533,542
"79995","Nsylvestris_NODE_29926_length_534_cov_4","Ntome_NODE_773_length_5429_cov_147",89.234,548,26,11,1,534,5083,4555,0,654,533,528
"79996","Nsylvestris_NODE_29927_length_534_cov_4","Ntome_NODE_20185_length_1178_cov_41",91.963,535,36,5,2,534,840,311,0,743,532,529
"79999","Nsylvestris_NODE_29930_length_533_cov_219","Ntome_NODE_29244_length_658_cov_248",95.297,489,21,2,46,533,171,658,0,774,487,487
"80003","Nsylvestris_NODE_29933_length_533_cov_153","Ntome_NODE_11012_length_2071_cov_196",89.121,478,38,10,68,533,166,641,1.15e-165,582,465,475
"80004","Nsylvestris_NODE_29934_length_533_cov_33","Ntome_NODE_20427_length_1159_cov_174",96.552,87,3,0,338,424,489,575,6.44e-34,145,86,86
"80005","Nsylvestris_NODE_29935_length_532_cov_26","Ntome_NODE_12496_length_1897_cov_212",87.251,251,24,2,120,369,1622,1379,1.69e-74,279,249,243
"80011","Nsylvestris_NODE_29940_length_533_cov_7","Ntome_NODE_36293_length_330_cov_25",85.816,141,13,5,41,176,192,330,2.31e-33,143,135,138
"80014","Nsylvestris_NODE_29943_length_533_cov_5","Ntome_NODE_13767_length_1761_cov_40",92.279,531,39,1,1,531,529,1,0,752,530,528
"80015","Nsylvestris_NODE_29944_length_533_cov_4","Ntome_NODE_2671_length_3827_cov_152",87.589,419,32,12,14,415,186,601,3.36e-131,468,401,415
"80030","Nsylvestris_NODE_29950_length_532_cov_67","Ntome_NODE_6750_length_2704_cov_54",85.235,447,28,8,47,467,487,53,2.05e-118,425,420,434
"80033","Nsylvestris_NODE_29953_length_532_cov_7","Ntome_NODE_23478_length_956_cov_53",93.421,532,31,3,4,532,105,635,0,785,528,530
"80034","Nsylvestris_NODE_29954_length_532_cov_6","Ntome_NODE_32732_length_496_cov_9",90.549,455,32,7,1,452,447,1,1.91e-168,592,451,446
"80035","Nsylvestris_NODE_29956_length_532_cov_3","Ntome_NODE_1850_length_4271_cov_153",94.184,533,27,4,1,532,1265,736,0,809,531,529
"80036","Nsylvestris_NODE_29957_length_532_cov_2","Ntome_NODE_37945_length_289_cov_9",91.63,227,13,3,310,532,289,65,2.15e-83,309,222,224
"80041","Nsylvestris_NODE_29960_length_531_cov_173","Ntome_NODE_24525_length_890_cov_261",89.597,471,16,5,1,440,469,1,3.21e-161,568,439,468
"80042","Nsylvestris_NODE_29961_length_531_cov_146","Ntome_NODE_28936_length_670_cov_129",93.827,486,21,4,54,531,183,667,0,723,477,484
"80043","Nsylvestris_NODE_29962_length_531_cov_15","Ntome_NODE_1134_length_4913_cov_144",96.774,248,7,1,272,518,1201,954,1.59e-114,412,246,247
"80046","Nsylvestris_NODE_29964_length_531_cov_4","Ntome_NODE_6674_length_2717_cov_27",96.987,531,14,1,1,531,718,1246,0,891,530,528
"80057","Nsylvestris_NODE_29968_length_530_cov_195","Ntome_NODE_161_length_7710_cov_57",87.728,383,42,3,67,448,268,646,2.03e-123,442,381,378
"80066","Nsylvestris_NODE_29972_length_530_cov_71","Ntome_NODE_587_length_5799_cov_120",93.893,524,18,7,7,530,2619,2110,0,778,523,509
"80069","Nsylvestris_NODE_29974_length_530_cov_8","Ntome_NODE_16733_length_1473_cov_28",91.758,546,18,5,1,529,868,333,0,734,528,535
"80070","Nsylvestris_NODE_29975_length_530_cov_7","Ntome_NODE_30962_length_590_cov_60",92.203,513,34,2,1,513,590,84,0,721,512,506
"80074","Nsylvestris_NODE_29978_length_530_cov_7","Ntome_NODE_12143_length_1941_cov_72",96.565,524,16,2,8,530,714,192,0,867,522,522
"80075","Nsylvestris_NODE_29979_length_530_cov_5","Ntome_NODE_1936_length_4218_cov_84",95.957,371,15,0,160,530,4218,3848,8.78e-172,603,370,370
"80082","Nsylvestris_NODE_29982_length_529_cov_108","Ntome_NODE_30057_length_625_cov_101",87.711,415,34,7,131,529,521,108,3.34e-131,468,398,413
"80092","Nsylvestris_NODE_29992_length_528_cov_90","Ntome_NODE_5808_length_2892_cov_208",97.753,356,7,1,173,528,2709,2355,1.45e-174,612,355,354
"80093","Nsylvestris_NODE_29998_length_528_cov_5","Ntome_NODE_26699_length_773_cov_27",94.151,530,22,5,1,528,614,92,0,798,527,522
"80094","Nsylvestris_NODE_29999_length_528_cov_5","Ntome_NODE_9946_length_2206_cov_266",89.781,137,11,3,146,280,1349,1214,2.92e-42,172,134,135
"80095","Nsylvestris_NODE_30000_length_528_cov_4","Ntome_NODE_1225_length_4807_cov_19",92.803,528,38,0,1,528,3879,3352,0,765,527,527
"80112","Nsylvestris_NODE_30012_length_527_cov_9","Ntome_NODE_7845_length_2517_cov_151",96.952,525,16,0,3,527,2265,1741,0,881,524,524
"80113","Nsylvestris_NODE_30013_length_526_cov_193","Ntome_NODE_31597_length_567_cov_215",94.297,526,26,3,1,525,45,567,0,802,524,522
"80114","Nsylvestris_NODE_30014_length_526_cov_75","Ntome_NODE_33529_length_444_cov_11",94.432,449,20,2,26,474,1,444,0,686,448,443
"80115","Nsylvestris_NODE_30015_length_526_cov_19","Ntome_NODE_27000_length_758_cov_182",86.111,540,35,14,1,524,655,140,1.49e-154,545,523,515
"80120","Nsylvestris_NODE_30018_length_526_cov_5","Ntome_NODE_18683_length_1302_cov_43",94.828,58,2,1,469,526,4,60,3.02e-17,89.8,57,56
"80123","Nsylvestris_NODE_30020_length_526_cov_4","Ntome_NODE_12470_length_1901_cov_33",94.026,385,17,3,1,385,107,485,1.47e-164,579,384,378
"80126","Nsylvestris_NODE_30022_length_525_cov_247","Ntome_NODE_25731_length_819_cov_247",89.668,542,30,9,2,525,815,282,0,667,523,533
"80130","Nsylvestris_NODE_30024_length_525_cov_206","Ntome_NODE_12775_length_1865_cov_166",93.882,425,24,2,53,475,1238,1662,0,640,422,424
"80131","Nsylvestris_NODE_30025_length_525_cov_200","Ntome_NODE_10000_length_2199_cov_161",89.165,443,33,10,86,525,2148,1718,2.49e-152,538,439,430
"80135","Nsylvestris_NODE_30027_length_525_cov_82","Ntome_NODE_38339_length_281_cov_16",94.224,277,16,0,186,462,1,277,7.27e-118,424,276,276
"80139","Nsylvestris_NODE_30030_length_525_cov_26","Ntome_NODE_37508_length_299_cov_4",93.617,282,6,1,93,374,28,297,5.66e-114,411,281,269
"80140","Nsylvestris_NODE_30031_length_525_cov_20","Ntome_NODE_34338_length_403_cov_6",92.92,339,24,0,41,379,23,361,5.46e-139,494,338,338
"80145","Nsylvestris_NODE_30036_length_525_cov_4","Ntome_NODE_4660_length_3168_cov_51",97.04,473,13,1,1,473,1064,1535,0,795,472,471
"80151","Nsylvestris_NODE_30045_length_524_cov_5","Ntome_NODE_27070_length_755_cov_20",89.641,473,32,13,1,460,504,36,8.74e-167,586,459,468
"80152","Nsylvestris_NODE_30055_length_523_cov_8","Ntome_NODE_33074_length_472_cov_9",92.632,95,7,0,276,370,89,183,1.06e-31,137,94,94
"80156","Nsylvestris_NODE_30059_length_523_cov_4","Ntome_NODE_34402_length_400_cov_5",96.988,166,5,0,1,166,166,1,1.66e-74,279,165,165
"80159","Nsylvestris_NODE_30061_length_522_cov_194","Ntome_NODE_20706_length_1137_cov_281",97.587,373,9,0,1,373,715,1087,0,640,372,372
"80162","Nsylvestris_NODE_30063_length_522_cov_2","Ntome_NODE_64_length_9315_cov_92",88.314,522,61,0,1,522,4847,5368,5.13e-179,627,521,521
"80166","Nsylvestris_NODE_30065_length_521_cov_10","Ntome_NODE_34528_length_394_cov_6",98.473,393,5,1,36,428,1,392,0,691,392,391
"80169","Nsylvestris_NODE_30072_length_521_cov_7","Ntome_NODE_3291_length_3591_cov_44",90.23,522,25,5,1,521,2054,2550,0,658,520,496
"80178","Nsylvestris_NODE_30078_length_520_cov_10","Ntome_NODE_18097_length_1350_cov_47",94.828,522,20,4,3,520,732,214,0,808,517,518
"80186","Nsylvestris_NODE_30087_length_519_cov_196","Ntome_NODE_23400_length_960_cov_223",96.416,279,9,1,1,279,433,156,1.97e-128,459,278,277
"80189","Nsylvestris_NODE_30093_length_519_cov_6","Ntome_NODE_14726_length_1662_cov_292",100,29,0,0,489,517,1,29,1.09e-06,54.7,28,28
"80190","Nsylvestris_NODE_30094_length_519_cov_5","Ntome_NODE_7194_length_2623_cov_17",94.027,519,31,0,1,519,99,617,0,787,518,518
"80191","Nsylvestris_NODE_30095_length_519_cov_5","Ntome_NODE_27209_length_748_cov_6",88.182,550,27,11,1,515,647,101,2.37e-177,621,514,546
"80201","Nsylvestris_NODE_30101_length_518_cov_10","Ntome_NODE_29007_length_668_cov_8",91.441,222,17,2,3,222,375,596,9.74e-82,303,219,221
"80202","Nsylvestris_NODE_30103_length_518_cov_7","Ntome_NODE_29440_length_650_cov_68",79.456,331,62,5,152,476,414,84,1.68e-59,230,324,330
"80205","Nsylvestris_NODE_30105_length_518_cov_4","Ntome_NODE_29937_length_630_cov_154",95.858,169,7,0,1,169,71,239,7.64e-73,274,168,168
"80208","Nsylvestris_NODE_30112_length_517_cov_3","Ntome_NODE_2447_length_3932_cov_152",92.871,505,26,7,4,505,2142,2639,0,725,501,497
"80211","Nsylvestris_NODE_30114_length_516_cov_221","Ntome_NODE_5364_length_2995_cov_264",93.636,440,20,4,1,440,2516,2947,0,651,439,431
"80212","Nsylvestris_NODE_30115_length_516_cov_11","Ntome_NODE_36165_length_334_cov_4",84.923,325,44,3,161,484,321,1,7.44e-88,324,323,320
"80213","Nsylvestris_NODE_30116_length_516_cov_9","Ntome_NODE_36006_length_338_cov_7",86.174,311,14,10,2,312,52,333,2.08e-83,309,310,281
"80214","Nsylvestris_NODE_30118_length_516_cov_6","Ntome_NODE_13080_length_1833_cov_173",89.346,535,31,11,1,515,1259,731,0,649,514,528
"80215","Nsylvestris_NODE_30120_length_516_cov_5","Ntome_NODE_23265_length_967_cov_21",93.8,500,26,2,22,516,922,423,0,747,494,499
"80226","Nsylvestris_NODE_30130_length_515_cov_5","Ntome_NODE_4610_length_3181_cov_92",93.617,517,29,3,1,515,1250,1764,0,769,514,514
"80230","Nsylvestris_NODE_30136_length_514_cov_40","Ntome_NODE_268_length_6971_cov_167",86.102,295,21,10,69,346,6679,6970,1.25e-80,300,277,291
"80231","Nsylvestris_NODE_30137_length_514_cov_26","Ntome_NODE_33875_length_425_cov_23",89.441,322,27,4,40,354,73,394,1.2e-110,399,314,321
"80232","Nsylvestris_NODE_30138_length_514_cov_24","Ntome_NODE_32536_length_510_cov_13",89.61,385,18,9,20,386,118,498,9e-132,470,366,380
"80233","Nsylvestris_NODE_30140_length_514_cov_8","Ntome_NODE_34680_length_387_cov_7",94.1,339,20,0,176,514,387,49,1.14e-145,516,338,338
"80237","Nsylvestris_NODE_30146_length_514_cov_4","Ntome_NODE_245_length_7124_cov_110",76.482,506,85,19,2,501,3033,3510,5.94e-64,244,499,477
"80238","Nsylvestris_NODE_30147_length_514_cov_4","Ntome_NODE_2949_length_3720_cov_44",92.248,516,37,3,1,514,3027,2513,0,728,513,514
"80245","Nsylvestris_NODE_30150_length_513_cov_31","Ntome_NODE_30940_length_590_cov_12",94.444,72,4,0,181,252,340,269,6.27e-24,111,71,71
"80246","Nsylvestris_NODE_30152_length_513_cov_5","Ntome_NODE_34881_length_379_cov_4",98.551,345,5,0,1,345,345,1,5.07e-174,610,344,344
"80247","Nsylvestris_NODE_30153_length_513_cov_3","Ntome_NODE_23704_length_943_cov_10",94.304,158,8,1,357,513,787,630,7.67e-63,241,156,157
"80248","Nsylvestris_NODE_30155_length_512_cov_448","Ntome_NODE_28742_length_678_cov_304",87.153,288,15,4,7,273,461,175,7.44e-83,307,266,286
"80249","Nsylvestris_NODE_30156_length_512_cov_165","Ntome_NODE_763_length_5444_cov_89",91.417,501,20,8,23,512,78,566,0,665,489,488
"80252","Nsylvestris_NODE_30158_length_512_cov_138","Ntome_NODE_10455_length_2138_cov_194",90.429,303,21,2,218,512,44,346,2e-108,392,294,302
"80260","Nsylvestris_NODE_30168_length_512_cov_4","Ntome_NODE_4014_length_3346_cov_165",88.362,232,27,0,276,507,2466,2697,1.62e-74,279,231,231
"80261","Nsylvestris_NODE_30170_length_512_cov_3","Ntome_NODE_3617_length_3480_cov_147",100,28,0,0,11,38,2268,2241,3.85e-06,52.8,27,27
"80265","Nsylvestris_NODE_30173_length_511_cov_205","Ntome_NODE_7878_length_2511_cov_272",95.392,434,19,1,79,511,2447,2014,0,689,432,433
"80266","Nsylvestris_NODE_30174_length_511_cov_29","Ntome_NODE_28126_length_704_cov_218",92.754,69,3,2,170,237,176,243,4.86e-20,99,67,67
"80269","Nsylvestris_NODE_30176_length_511_cov_18","Ntome_NODE_15356_length_1598_cov_101",93.197,147,10,0,284,430,1162,1016,1.29e-55,217,146,146
"80270","Nsylvestris_NODE_30183_length_511_cov_7","Ntome_NODE_6037_length_2841_cov_105",86.927,436,48,7,16,444,2244,2677,4.13e-135,481,428,433
"80273","Nsylvestris_NODE_30185_length_511_cov_5","Ntome_NODE_11493_length_2015_cov_14",92.78,277,19,1,236,511,1417,1141,1.19e-110,399,275,276
"80274","Nsylvestris_NODE_30187_length_511_cov_1","Ntome_NODE_12792_length_1864_cov_20",87.324,71,8,1,217,286,14,84,1.76e-14,80.5,69,70
"80275","Nsylvestris_NODE_30188_length_510_cov_196","Ntome_NODE_228_length_7228_cov_122",85.535,477,21,19,49,492,550,89,2.5e-127,455,443,461
"80276","Nsylvestris_NODE_30189_length_510_cov_188","Ntome_NODE_11009_length_2072_cov_23",90.618,469,34,4,49,510,8,473,3.9e-175,614,461,465
"80282","Nsylvestris_NODE_30196_length_510_cov_7","Ntome_NODE_6759_length_2702_cov_61",95.285,509,24,0,1,509,1027,1535,0,808,508,508
"80283","Nsylvestris_NODE_30197_length_510_cov_6","Ntome_NODE_29949_length_630_cov_6",89.231,195,16,5,205,396,62,254,2.74e-62,239,191,192
"80284","Nsylvestris_NODE_30198_length_510_cov_6","Ntome_NODE_32038_length_547_cov_12",88,425,25,16,2,419,424,19,1.48e-134,479,417,405
"80285","Nsylvestris_NODE_30199_length_510_cov_5","Ntome_NODE_8306_length_2441_cov_71",90.359,529,28,9,1,510,1900,2424,0,673,509,524
"80286","Nsylvestris_NODE_30200_length_510_cov_3","Ntome_NODE_22679_length_1005_cov_9",88.866,485,32,3,48,510,305,789,5.11e-164,577,462,484
"80297","Nsylvestris_NODE_30206_length_509_cov_3","Ntome_NODE_23641_length_947_cov_10",96.471,510,15,3,1,509,197,704,0,839,508,507
"80298","Nsylvestris_NODE_30207_length_509_cov_3","Ntome_NODE_467_length_6110_cov_143",87.739,522,49,7,1,509,3335,2816,1.41e-169,595,508,519
"80301","Nsylvestris_NODE_30215_length_508_cov_15","Ntome_NODE_9162_length_2316_cov_37",92.105,228,18,0,26,253,73,300,2.63e-87,322,227,227
"80304","Nsylvestris_NODE_30218_length_508_cov_6","Ntome_NODE_16929_length_1454_cov_69",94.892,509,20,2,6,508,815,1323,0,791,502,508
"80305","Nsylvestris_NODE_30222_length_508_cov_5","Ntome_NODE_25397_length_839_cov_5",93.306,493,20,3,5,491,354,839,0,715,486,485
"80308","Nsylvestris_NODE_30227_length_508_cov_2","Ntome_NODE_14821_length_1654_cov_20",98.425,508,8,0,1,508,27,534,0,894,507,507
"80315","Nsylvestris_NODE_30230_length_507_cov_195","Ntome_NODE_8840_length_2363_cov_38",98.148,54,1,0,453,506,1653,1600,6.24e-19,95.3,53,53
"80322","Nsylvestris_NODE_30233_length_507_cov_13","Ntome_NODE_30791_length_596_cov_39",94.433,485,16,8,28,507,533,55,0,736,479,478
"80332","Nsylvestris_NODE_30242_length_506_cov_236","Ntome_NODE_1859_length_4265_cov_307",97.826,506,11,0,1,506,2075,1570,0,874,505,505
"80339","Nsylvestris_NODE_30248_length_506_cov_12","Ntome_NODE_30031_length_626_cov_131",95.069,507,16,4,3,506,106,606,0,789,503,500
"80363","Nsylvestris_NODE_30261_length_505_cov_11","Ntome_NODE_24805_length_874_cov_68",90.303,165,16,0,341,505,332,168,1.27e-55,217,164,164
"80364","Nsylvestris_NODE_30263_length_505_cov_8","Ntome_NODE_1817_length_4296_cov_61",89.286,336,33,3,172,505,1775,1441,3.25e-116,418,333,334
"80365","Nsylvestris_NODE_30268_length_505_cov_4","Ntome_NODE_23708_length_943_cov_8",91.821,379,28,3,65,443,25,400,1.86e-148,525,378,375
"80374","Nsylvestris_NODE_30274_length_504_cov_50","Ntome_NODE_24837_length_872_cov_305",93.861,505,30,1,1,504,92,596,0,760,503,504
"80375","Nsylvestris_NODE_30275_length_504_cov_13","Ntome_NODE_10000_length_2199_cov_161",91.169,419,29,6,1,413,788,372,1.41e-159,562,412,416
"80376","Nsylvestris_NODE_30276_length_505_cov_8","Ntome_NODE_36351_length_328_cov_77",91.473,129,5,4,334,461,328,205,2.79e-42,172,127,123
"80380","Nsylvestris_NODE_30278_length_504_cov_7","Ntome_NODE_1756_length_4337_cov_201",93.542,480,26,4,1,478,2304,1828,0,710,477,476
"80384","Nsylvestris_NODE_30282_length_504_cov_6","Ntome_NODE_23265_length_967_cov_21",92.615,325,10,4,7,329,350,38,2.47e-127,455,322,312
"80385","Nsylvestris_NODE_30285_length_504_cov_4","Ntome_NODE_15481_length_1585_cov_291",97.959,49,0,1,457,504,1452,1500,1.34e-15,84.2,47,48
"80386","Nsylvestris_NODE_30286_length_503_cov_214","Ntome_NODE_7893_length_2509_cov_184",94.433,503,28,0,1,503,895,393,0,774,502,502
"80387","Nsylvestris_NODE_30287_length_503_cov_168","Ntome_NODE_6389_length_2769_cov_127",98.182,55,1,0,449,503,1662,1716,1.72e-19,97.1,54,54
"80390","Nsylvestris_NODE_30289_length_503_cov_142","Ntome_NODE_23436_length_958_cov_190",94.545,55,3,0,449,503,478,424,3.72e-16,86.1,54,54
"80391","Nsylvestris_NODE_30290_length_503_cov_70","Ntome_NODE_6209_length_2809_cov_118",94.862,506,23,2,1,503,1097,1602,0,787,502,505
"80392","Nsylvestris_NODE_30291_length_503_cov_32","Ntome_NODE_16814_length_1464_cov_201",93.241,503,28,1,1,503,378,874,0,736,502,496
"80393","Nsylvestris_NODE_30294_length_503_cov_5","Ntome_NODE_13105_length_1831_cov_43",81.122,392,74,0,112,503,1621,1230,4.36e-85,315,391,391
"80394","Nsylvestris_NODE_30296_length_503_cov_5","Ntome_NODE_38385_length_280_cov_7",86.466,133,16,2,1,132,180,49,6.06e-34,145,131,131
"80410","Nsylvestris_NODE_30303_length_502_cov_11","Ntome_NODE_3150_length_3637_cov_38",91.975,162,11,1,1,160,33,194,2.1e-58,226,159,161
"80416","Nsylvestris_NODE_30307_length_502_cov_7","Ntome_NODE_7246_length_2615_cov_164",92.998,457,32,0,1,457,2245,1789,0,667,456,456
"80417","Nsylvestris_NODE_30308_length_502_cov_6","Ntome_NODE_10531_length_2128_cov_71",92.427,515,25,7,1,502,1354,841,0,723,501,513
"80420","Nsylvestris_NODE_30311_length_502_cov_2","Ntome_NODE_28368_length_694_cov_34",83.206,131,7,2,253,368,562,692,2.85e-22,106,115,130
"80424","Nsylvestris_NODE_30313_length_501_cov_155","Ntome_NODE_18942_length_1281_cov_135",90.634,331,11,11,54,378,959,1275,2.49e-117,422,324,316
"80427","Nsylvestris_NODE_30316_length_501_cov_6","Ntome_NODE_38448_length_279_cov_4",91.86,86,6,1,93,177,108,23,3.66e-26,119,84,85
"80428","Nsylvestris_NODE_30317_length_501_cov_5","Ntome_NODE_3141_length_3642_cov_105",90.04,502,20,11,1,489,878,1362,6.35e-178,623,488,484
"80438","Nsylvestris_NODE_30333_length_499_cov_21","Ntome_NODE_1377_length_4653_cov_237",95,40,1,1,460,499,4515,4553,6.22e-09,62.1,39,38
"80439","Nsylvestris_NODE_30334_length_499_cov_6","Ntome_NODE_21559_length_1077_cov_85",94.934,454,15,2,4,454,782,334,0,704,450,448
"80442","Nsylvestris_NODE_30336_length_499_cov_6","Ntome_NODE_18775_length_1294_cov_65",91.617,501,17,5,1,499,190,667,0,669,498,477
"80443","Nsylvestris_NODE_30337_length_499_cov_5","Ntome_NODE_4047_length_3335_cov_190",95.4,500,17,5,2,499,563,68,0,791,497,495
"80444","Nsylvestris_NODE_30343_length_498_cov_199","Ntome_NODE_23660_length_945_cov_261",88.969,417,26,16,1,409,358,762,3.99e-140,497,408,404
"80452","Nsylvestris_NODE_30348_length_498_cov_10","Ntome_NODE_33273_length_459_cov_5",95.842,457,18,1,10,465,3,459,0,737,455,456
"80453","Nsylvestris_NODE_30349_length_497_cov_9","Ntome_NODE_29598_length_642_cov_42",91.228,57,5,0,441,497,154,98,6.15e-14,78.7,56,56
"80459","Nsylvestris_NODE_30354_length_498_cov_3","Ntome_NODE_24567_length_888_cov_17",92.481,399,29,1,101,498,839,441,8.34e-162,569,397,398
"80466","Nsylvestris_NODE_30358_length_497_cov_202","Ntome_NODE_9156_length_2317_cov_246",97.664,428,10,0,70,497,1116,689,0,736,427,427
"80467","Nsylvestris_NODE_30359_length_497_cov_166","Ntome_NODE_20923_length_1121_cov_216",95.692,325,14,0,173,497,823,499,6.57e-148,523,324,324
"80470","Nsylvestris_NODE_30362_length_497_cov_11","Ntome_NODE_26261_length_794_cov_13",85.327,443,33,16,2,427,778,351,1.47e-119,429,425,427
"80473","Nsylvestris_NODE_30365_length_497_cov_3","Ntome_NODE_8527_length_2408_cov_285",97.222,36,1,0,462,497,1056,1091,6.2e-09,62.1,35,35
"80484","Nsylvestris_NODE_30375_length_496_cov_7","Ntome_NODE_319_length_6631_cov_16",86.759,506,37,12,12,496,5013,4517,8.43e-152,536,484,496
"80485","Nsylvestris_NODE_30377_length_496_cov_6","Ntome_NODE_277_length_6918_cov_98",90.769,520,17,10,1,495,3856,3343,0,665,494,513
"80489","Nsylvestris_NODE_30379_length_496_cov_4","Ntome_NODE_17969_length_1361_cov_13",98.387,496,8,0,1,496,560,1055,0,872,495,495
"80492","Nsylvestris_NODE_30381_length_496_cov_3","Ntome_NODE_1123_length_4927_cov_98",96.774,496,16,0,1,496,2058,2553,0,828,495,495
"80502","Nsylvestris_NODE_30386_length_495_cov_12","Ntome_NODE_9040_length_2331_cov_202",88.889,117,7,4,75,185,1228,1344,2.77e-32,139,110,116
"80508","Nsylvestris_NODE_30389_length_495_cov_8","Ntome_NODE_13380_length_1800_cov_8",95.152,495,24,0,1,495,1584,1090,0,782,494,494
"80509","Nsylvestris_NODE_30390_length_495_cov_7","Ntome_NODE_16013_length_1538_cov_31",91.667,120,10,0,270,389,10,129,1.27e-40,167,119,119
"80510","Nsylvestris_NODE_30391_length_495_cov_5","Ntome_NODE_4326_length_3254_cov_224",93.584,452,19,4,40,491,3000,2559,0,665,451,441
"80511","Nsylvestris_NODE_30392_length_495_cov_5","Ntome_NODE_13893_length_1747_cov_14",92.944,496,32,3,1,495,753,1246,0,719,494,493
"80530","Nsylvestris_NODE_30403_length_494_cov_7","Ntome_NODE_18009_length_1356_cov_44",88.776,392,25,9,1,374,958,568,1.44e-129,462,373,390
"80533","Nsylvestris_NODE_30407_length_494_cov_5","Ntome_NODE_36313_length_330_cov_4",89.407,236,24,1,259,493,1,236,1.55e-79,296,234,235
"80534","Nsylvestris_NODE_30409_length_493_cov_204","Ntome_NODE_5923_length_2867_cov_165",92.698,493,36,0,1,493,107,599,0,712,492,492
"80539","Nsylvestris_NODE_30413_length_493_cov_12","Ntome_NODE_14113_length_1725_cov_239",92.4,250,14,5,111,359,304,59,3.26e-96,351,248,245
"80550","Nsylvestris_NODE_30422_length_492_cov_155","Ntome_NODE_1513_length_4526_cov_129",94.715,492,23,1,1,492,3974,4462,0,761,491,488
"80551","Nsylvestris_NODE_30423_length_492_cov_143","Ntome_NODE_36119_length_335_cov_7",97.059,34,1,0,431,464,272,305,7.93e-08,58.4,33,33
"80552","Nsylvestris_NODE_30424_length_492_cov_66","Ntome_NODE_30353_length_614_cov_177",93.636,440,21,3,2,436,558,121,0,651,434,437
"80563","Nsylvestris_NODE_30430_length_492_cov_4","Ntome_NODE_3341_length_3571_cov_199",95.696,395,15,2,98,492,2965,2573,0,634,394,392
"80578","Nsylvestris_NODE_30438_length_491_cov_150","Ntome_NODE_3443_length_3532_cov_72",94.79,499,15,3,2,491,3532,3036,0,767,489,496
"80581","Nsylvestris_NODE_30444_length_491_cov_9","Ntome_NODE_36634_length_320_cov_4",90.78,282,19,3,175,451,41,320,8.95e-102,370,276,279
"80584","Nsylvestris_NODE_30450_length_490_cov_10","Ntome_NODE_16738_length_1472_cov_137",96.735,490,16,0,1,490,404,893,0,817,489,489
"80587","Nsylvestris_NODE_30453_length_490_cov_6","Ntome_NODE_5031_length_3069_cov_287",100,35,0,0,1,35,656,690,4.72e-10,65.8,34,34
"80588","Nsylvestris_NODE_30456_length_490_cov_5","Ntome_NODE_8145_length_2468_cov_287",91.358,486,33,4,1,486,581,1057,0,656,485,476
"80593","Nsylvestris_NODE_30459_length_489_cov_159","Ntome_NODE_28865_length_673_cov_92",94.211,190,8,3,109,297,570,383,9.23e-77,287,188,187
"80597","Nsylvestris_NODE_30465_length_489_cov_7","Ntome_NODE_26186_length_798_cov_17",92.285,337,24,2,1,337,52,386,5.1e-134,477,336,334
"80598","Nsylvestris_NODE_30467_length_489_cov_5","Ntome_NODE_26124_length_801_cov_12",92.574,404,24,4,87,489,746,348,1.76e-163,575,402,398
"80601","Nsylvestris_NODE_30469_length_488_cov_205","Ntome_NODE_5197_length_3031_cov_276",97.354,378,9,1,1,378,560,184,0,641,377,376
"80605","Nsylvestris_NODE_30471_length_488_cov_23","Ntome_NODE_16200_length_1521_cov_125",95.833,72,3,0,311,382,891,962,1.28e-25,117,71,71
"80606","Nsylvestris_NODE_30473_length_488_cov_8","Ntome_NODE_39494_length_258_cov_3",94.8,250,13,0,228,477,3,252,6.82e-108,390,249,249
"80607","Nsylvestris_NODE_30475_length_488_cov_4","Ntome_NODE_4983_length_3087_cov_133",98,50,1,0,439,488,1749,1700,1e-16,87.9,49,49
"80608","Nsylvestris_NODE_30476_length_488_cov_4","Ntome_NODE_6026_length_2843_cov_61",85.674,356,47,1,74,429,1249,898,2.47e-102,372,355,351
"80609","Nsylvestris_NODE_30478_length_487_cov_233","Ntome_NODE_9263_length_2301_cov_79",95.688,487,17,2,1,487,1624,2106,0,780,486,482
"80614","Nsylvestris_NODE_30480_length_487_cov_198","Ntome_NODE_16317_length_1511_cov_146",92.784,388,14,5,1,383,1066,1444,1.06e-155,549,382,378
"80615","Nsylvestris_NODE_30481_length_487_cov_193","Ntome_NODE_15161_length_1617_cov_112",90.069,433,23,9,21,433,40,472,4.94e-154,544,412,432
"80616","Nsylvestris_NODE_30483_length_487_cov_22","Ntome_NODE_16424_length_1503_cov_55",87.739,261,32,0,79,339,730,470,2.54e-82,305,260,260
"80624","Nsylvestris_NODE_30491_length_487_cov_5","Ntome_NODE_34261_length_407_cov_3",97.472,356,6,1,1,353,52,407,2.23e-172,604,352,355
"80643","Nsylvestris_NODE_30501_length_486_cov_17","Ntome_NODE_850_length_5298_cov_266",78.058,515,59,32,1,484,5283,4792,1.99e-73,276,483,491
"80646","Nsylvestris_NODE_30508_length_485_cov_78","Ntome_NODE_24628_length_884_cov_136",91.753,485,23,4,1,485,878,411,0,658,484,467
"80647","Nsylvestris_NODE_30509_length_485_cov_18","Ntome_NODE_36086_length_336_cov_4",86.726,339,40,4,7,344,2,336,2.46e-102,372,337,334
"80648","Nsylvestris_NODE_30510_length_485_cov_12","Ntome_NODE_36790_length_316_cov_4",82.734,139,23,1,348,485,51,189,2.73e-27,122,137,138
"80649","Nsylvestris_NODE_30511_length_485_cov_11","Ntome_NODE_20065_length_1187_cov_24",87.162,148,15,3,63,207,82,228,4.47e-40,165,144,146
"80650","Nsylvestris_NODE_30512_length_485_cov_10","Ntome_NODE_1219_length_4812_cov_121",96.217,423,16,0,1,423,3835,4257,0,693,422,422
"80658","Nsylvestris_NODE_30518_length_484_cov_80","Ntome_NODE_5787_length_2899_cov_71",96.311,488,14,2,1,484,1518,2005,0,798,483,487
"80659","Nsylvestris_NODE_30520_length_484_cov_10","Ntome_NODE_33064_length_473_cov_4",95.181,83,4,0,1,83,362,280,4.53e-30,132,82,82
"80660","Nsylvestris_NODE_30521_length_484_cov_8","Ntome_NODE_9035_length_2333_cov_34",80.233,344,27,20,23,356,2101,1789,9.39e-57,220,333,312
"80661","Nsylvestris_NODE_30522_length_484_cov_7","Ntome_NODE_2666_length_3830_cov_76",84.413,494,44,15,2,484,3036,2565,2.37e-127,455,482,471
"80671","Nsylvestris_NODE_30530_length_483_cov_174","Ntome_NODE_6108_length_2829_cov_206",98.344,483,8,0,1,483,394,876,0,848,482,482
"80672","Nsylvestris_NODE_30531_length_483_cov_166","Ntome_NODE_7029_length_2650_cov_222",91.518,448,21,10,48,483,547,105,2.86e-171,601,435,442
"80673","Nsylvestris_NODE_30532_length_483_cov_18","Ntome_NODE_7394_length_2586_cov_63",88.212,509,24,24,6,483,1305,1808,1.74e-163,575,477,503
"80674","Nsylvestris_NODE_30533_length_483_cov_11","Ntome_NODE_21956_length_1052_cov_35",91.242,491,23,12,1,483,394,872,0,651,482,478
"80675","Nsylvestris_NODE_30534_length_483_cov_9","Ntome_NODE_12913_length_1851_cov_23",93.402,485,15,3,1,483,1092,1561,0,702,482,469
"80676","Nsylvestris_NODE_30535_length_483_cov_8","Ntome_NODE_13183_length_1821_cov_220",97.872,47,1,0,1,47,1531,1577,4.61e-15,82.4,46,46
"80677","Nsylvestris_NODE_30537_length_483_cov_7","Ntome_NODE_21649_length_1071_cov_22",83.748,523,36,12,1,483,1036,523,1.1e-125,449,482,513
"80693","Nsylvestris_NODE_30552_length_483_cov_8","Ntome_NODE_4125_length_3315_cov_100",87.5,168,12,5,229,388,438,604,3.42e-46,185,159,166
"80696","Nsylvestris_NODE_30556_length_482_cov_6","Ntome_NODE_6422_length_2763_cov_80",87.896,347,42,0,1,347,395,49,1.86e-113,409,346,346
"80700","Nsylvestris_NODE_30560_length_482_cov_4","Ntome_NODE_15056_length_1630_cov_10",91.613,465,15,2,2,442,1152,688,2.19e-177,621,440,464
"80706","Nsylvestris_NODE_30563_length_481_cov_189","Ntome_NODE_14211_length_1714_cov_186",88.952,353,21,6,3,355,1107,1441,8.57e-117,420,352,334
"80712","Nsylvestris_NODE_30566_length_481_cov_8","Ntome_NODE_32028_length_528_cov_10",85.171,263,37,2,219,480,50,311,3.29e-71,268,261,261
"80713","Nsylvestris_NODE_30567_length_481_cov_7","Ntome_NODE_3578_length_3492_cov_45",89.516,124,13,0,357,480,357,234,7.42e-38,158,123,123
"80714","Nsylvestris_NODE_30570_length_481_cov_5","Ntome_NODE_10539_length_2126_cov_135",90.021,481,28,12,12,481,775,1246,2.21e-172,604,469,471
"80720","Nsylvestris_NODE_30573_length_481_cov_3","Ntome_NODE_1312_length_4715_cov_189",86.154,130,15,3,34,162,3326,3453,9.67e-32,137,128,127
"80725","Nsylvestris_NODE_30575_length_480_cov_210","Ntome_NODE_3882_length_3393_cov_152",93.007,286,14,3,138,417,1,286,1.43e-114,412,279,285
"80733","Nsylvestris_NODE_30586_length_480_cov_3","Ntome_NODE_34962_length_376_cov_3",93.238,281,11,4,1,273,281,1,6.66e-113,407,272,280
"80746","Nsylvestris_NODE_30590_length_479_cov_68","Ntome_NODE_14661_length_1671_cov_47",92.248,387,30,0,1,387,338,724,1.04e-155,549,386,386
"80750","Nsylvestris_NODE_30592_length_479_cov_10","Ntome_NODE_1745_length_4349_cov_94",96.436,477,14,1,3,479,2760,2287,0,784,476,473
"80751","Nsylvestris_NODE_30593_length_478_cov_9","Ntome_NODE_1314_length_4714_cov_163",91.284,436,18,4,61,478,4664,4231,4.78e-164,577,417,433
"80752","Nsylvestris_NODE_30595_length_479_cov_8","Ntome_NODE_37864_length_291_cov_8",93.559,295,14,4,186,479,1,291,3.05e-121,435,293,290
"80753","Nsylvestris_NODE_30598_length_479_cov_5","Ntome_NODE_33944_length_422_cov_4",95.469,309,14,0,1,309,114,422,4.96e-139,494,308,308
"80762","Nsylvestris_NODE_30603_length_478_cov_12","Ntome_NODE_12267_length_1925_cov_29",98.276,174,3,0,1,174,650,823,2.49e-82,305,173,173
"80771","Nsylvestris_NODE_30611_length_478_cov_5","Ntome_NODE_42_length_10190_cov_24",75.301,332,78,3,11,340,4090,4419,2.65e-37,156,329,329
"80785","Nsylvestris_NODE_30620_length_477_cov_10","Ntome_NODE_32797_length_492_cov_12",93.96,447,22,4,33,477,484,41,0,671,444,443
"80791","Nsylvestris_NODE_30628_length_476_cov_171","Ntome_NODE_11027_length_2069_cov_225",97.059,476,14,0,1,476,144,619,0,802,475,475
"80792","Nsylvestris_NODE_30631_length_476_cov_29","Ntome_NODE_19736_length_1216_cov_46",87.374,198,12,2,175,360,311,115,4.29e-55,215,185,196
"80793","Nsylvestris_NODE_30632_length_476_cov_19","Ntome_NODE_26571_length_778_cov_257",89.955,448,38,6,32,476,596,153,2.21e-162,571,444,443
"80796","Nsylvestris_NODE_30636_length_476_cov_7","Ntome_NODE_3621_length_3479_cov_102",92.693,479,32,2,1,476,1755,1277,0,688,475,478
"80797","Nsylvestris_NODE_30637_length_476_cov_7","Ntome_NODE_6038_length_2841_cov_95",95.178,477,14,3,1,476,2342,1874,0,745,475,468
"80798","Nsylvestris_NODE_30638_length_476_cov_6","Ntome_NODE_18097_length_1350_cov_47",92.857,476,24,7,1,474,747,1214,0,682,473,467
"80801","Nsylvestris_NODE_30641_length_475_cov_201","Ntome_NODE_19896_length_1201_cov_263",97.665,257,4,2,1,256,310,55,6.49e-123,440,255,255
"80811","Nsylvestris_NODE_30645_length_475_cov_14","Ntome_NODE_22083_length_1042_cov_204",100,33,0,0,1,33,530,562,5.91e-09,62.1,32,32
"80815","Nsylvestris_NODE_30649_length_475_cov_6","Ntome_NODE_3389_length_3551_cov_139",93.933,478,18,5,1,475,317,786,0,712,474,469
"80816","Nsylvestris_NODE_30650_length_475_cov_4","Ntome_NODE_4640_length_3174_cov_86",91.411,489,28,3,1,475,1357,869,0,658,474,488
"80819","Nsylvestris_NODE_30652_length_474_cov_200","Ntome_NODE_20877_length_1125_cov_277",83.445,447,17,16,1,406,649,1079,1.44e-99,363,405,430
"80820","Nsylvestris_NODE_30653_length_474_cov_193","Ntome_NODE_26944_length_762_cov_5",90.909,55,5,0,237,291,708,762,7.57e-13,75,54,54
"80821","Nsylvestris_NODE_30654_length_474_cov_93","Ntome_NODE_37663_length_296_cov_3",92.829,251,13,3,31,276,251,1,1.87e-98,359,245,250
"80822","Nsylvestris_NODE_30655_length_474_cov_13","Ntome_NODE_13830_length_1755_cov_8",82.927,328,37,10,40,366,764,1073,5.38e-74,278,326,309
"80826","Nsylvestris_NODE_30657_length_474_cov_10","Ntome_NODE_4400_length_3238_cov_199",92.675,314,9,10,152,460,3189,2885,6.48e-123,440,308,304
"80827","Nsylvestris_NODE_30661_length_474_cov_4","Ntome_NODE_1050_length_5020_cov_242",88.174,482,47,9,1,474,4472,4951,1.02e-160,566,473,479
"80828","Nsylvestris_NODE_30662_length_474_cov_3","Ntome_NODE_16308_length_1512_cov_17",81.288,497,52,9,1,474,380,858,4.01e-100,364,473,478
"80841","Nsylvestris_NODE_30670_length_473_cov_7","Ntome_NODE_5460_length_2972_cov_87",80.255,157,27,3,69,223,2688,2534,4.45e-25,115,154,154
"80842","Nsylvestris_NODE_30672_length_473_cov_5","Ntome_NODE_15247_length_1610_cov_8",91.429,490,11,8,1,469,1108,1587,0,643,468,479
"80845","Nsylvestris_NODE_30674_length_473_cov_4","Ntome_NODE_35190_length_366_cov_15",91.765,170,11,2,147,316,366,200,1.18e-60,233,169,166
"80849","Nsylvestris_NODE_30678_length_472_cov_12","Ntome_NODE_19592_length_1226_cov_229",98.246,57,1,0,416,472,673,729,1.24e-20,100,56,56
"80850","Nsylvestris_NODE_30679_length_472_cov_12","Ntome_NODE_19085_length_1268_cov_213",92.698,315,20,3,160,472,806,493,2.98e-126,451,312,313
"80851","Nsylvestris_NODE_30680_length_472_cov_6","Ntome_NODE_27694_length_724_cov_19",95.339,472,16,4,3,472,510,43,0,745,469,467
"80864","Nsylvestris_NODE_30693_length_472_cov_3","Ntome_NODE_10452_length_2139_cov_12",94.344,442,23,2,32,472,1242,802,0,676,440,440
"80865","Nsylvestris_NODE_30694_length_472_cov_2","Ntome_NODE_14418_length_1694_cov_45",96.414,474,13,3,1,472,1100,1571,0,778,471,471
"80866","Nsylvestris_NODE_30695_length_471_cov_230","Ntome_NODE_6502_length_2747_cov_291",96.391,471,17,0,1,471,2393,1923,0,776,470,470
"80874","Nsylvestris_NODE_30699_length_471_cov_178","Ntome_NODE_29570_length_645_cov_218",93.651,315,20,0,50,364,362,48,2.28e-132,472,314,314
"80875","Nsylvestris_NODE_30700_length_471_cov_7","Ntome_NODE_11058_length_2066_cov_95",94.904,471,23,1,1,470,138,608,0,736,469,470
"80876","Nsylvestris_NODE_30701_length_471_cov_7","Ntome_NODE_38555_length_277_cov_2",98.917,277,3,0,22,298,277,1,1.35e-139,496,276,276
"80877","Nsylvestris_NODE_30704_length_471_cov_5","Ntome_NODE_39251_length_263_cov_3",93.633,267,11,4,153,417,263,1,5.08e-109,394,264,262
"80885","Nsylvestris_NODE_30710_length_471_cov_2","Ntome_NODE_16742_length_1472_cov_20",90.726,496,16,9,1,471,860,1350,0,634,470,490
"80894","Nsylvestris_NODE_30714_length_467_cov_152","Ntome_NODE_1736_length_4357_cov_200",86.354,469,45,10,3,463,2769,2312,4.83e-139,494,460,457
"80895","Nsylvestris_NODE_30717_length_470_cov_7","Ntome_NODE_16172_length_1524_cov_238",95,40,2,0,426,465,1288,1327,1.62e-09,63.9,39,39
"80896","Nsylvestris_NODE_30718_length_470_cov_6","Ntome_NODE_1710_length_4374_cov_103",91.954,435,24,5,1,432,1406,980,1e-170,599,431,426
"80897","Nsylvestris_NODE_30721_length_470_cov_4","Ntome_NODE_12280_length_1924_cov_18",96.324,272,10,0,199,470,1890,1619,3.84e-125,448,271,271
"80898","Nsylvestris_NODE_30725_length_470_cov_4","Ntome_NODE_4660_length_3168_cov_51",93.432,472,27,4,1,470,1952,2421,0,697,469,469
"80902","Nsylvestris_NODE_30729_length_470_cov_3","Ntome_NODE_3588_length_3487_cov_247",88.177,203,12,6,1,194,524,723,4.21e-60,231,193,199
"80903","Nsylvestris_NODE_30731_length_469_cov_219","Ntome_NODE_5364_length_2995_cov_264",93.737,463,29,0,7,469,1254,1716,0,695,462,462
"80909","Nsylvestris_NODE_30738_length_469_cov_11","Ntome_NODE_32074_length_544_cov_72",93.103,406,18,1,64,469,544,149,7.78e-167,586,405,395
"80910","Nsylvestris_NODE_30739_length_469_cov_8","Ntome_NODE_2630_length_3846_cov_313",94.798,173,8,1,102,274,1566,1737,3.2e-71,268,172,171
"80911","Nsylvestris_NODE_30741_length_469_cov_5","Ntome_NODE_19079_length_1269_cov_12",95.99,399,16,0,1,399,555,953,0,649,398,398
"80917","Nsylvestris_NODE_30747_length_468_cov_169","Ntome_NODE_12957_length_1845_cov_276",92.944,411,16,1,1,398,1417,1827,7.76e-167,586,397,410
"80918","Nsylvestris_NODE_30748_length_468_cov_24","Ntome_NODE_3445_length_3531_cov_298",100,40,0,0,3,42,2229,2268,7.47e-13,75,39,39
"80924","Nsylvestris_NODE_30752_length_468_cov_9","Ntome_NODE_22687_length_1004_cov_90",88.918,388,37,3,57,441,527,143,6.3e-133,473,384,384
"80925","Nsylvestris_NODE_30753_length_468_cov_9","Ntome_NODE_7184_length_2625_cov_14",97.009,468,14,0,1,468,570,103,0,787,467,467
"80928","Nsylvestris_NODE_30755_length_468_cov_8","Ntome_NODE_900_length_5225_cov_120",93.766,401,22,2,3,402,1655,2053,9.97e-171,599,399,398
"80934","Nsylvestris_NODE_30760_length_468_cov_4","Ntome_NODE_349_length_6512_cov_123",94.13,460,24,2,10,468,1691,1234,0,697,458,457
"80937","Nsylvestris_NODE_30765_length_467_cov_12","Ntome_NODE_9818_length_2222_cov_277",93.069,101,7,0,100,200,779,879,4.33e-35,148,100,100
"80938","Nsylvestris_NODE_30767_length_467_cov_10","Ntome_NODE_39883_length_251_cov_3",95.652,161,7,0,307,467,1,161,1.92e-68,259,160,160
"80948","Nsylvestris_NODE_30776_length_466_cov_14","Ntome_NODE_33267_length_459_cov_11",93.705,413,22,3,1,413,410,2,9.85e-176,616,412,408
"80949","Nsylvestris_NODE_30779_length_466_cov_8","Ntome_NODE_23465_length_957_cov_25",92.797,472,26,6,1,466,202,671,0,676,465,469
"80950","Nsylvestris_NODE_30784_length_465_cov_192","Ntome_NODE_13116_length_1829_cov_252",93.089,463,26,3,1,463,1277,1733,0,673,462,456
"80953","Nsylvestris_NODE_30790_length_465_cov_16","Ntome_NODE_523_length_5958_cov_300",96.078,51,1,1,1,51,2054,2005,4.43e-15,82.4,50,49
"80957","Nsylvestris_NODE_30794_length_465_cov_4","Ntome_NODE_20711_length_1137_cov_85",83.754,357,54,4,5,359,480,834,3.08e-91,335,354,354
"80958","Nsylvestris_NODE_30795_length_465_cov_4","Ntome_NODE_1599_length_4454_cov_84",94.612,464,22,3,3,465,1119,658,0,715,462,461
"80964","Nsylvestris_NODE_30803_length_464_cov_7","Ntome_NODE_34233_length_408_cov_7",96.078,51,2,0,89,139,180,230,1.23e-15,84.2,50,50
"80965","Nsylvestris_NODE_30805_length_464_cov_5","Ntome_NODE_6271_length_2793_cov_138",88.938,452,38,8,9,454,2279,2724,3.63e-155,547,445,445
"80966","Nsylvestris_NODE_30806_length_464_cov_5","Ntome_NODE_4301_length_3261_cov_37",96.398,472,8,3,1,464,1255,785,0,769,463,470
"80967","Nsylvestris_NODE_30807_length_464_cov_4","Ntome_NODE_12187_length_1935_cov_119",89.352,432,29,7,29,452,1059,1481,4.73e-149,527,423,422
"80968","Nsylvestris_NODE_30808_length_464_cov_4","Ntome_NODE_9050_length_2331_cov_25",95.905,464,19,0,1,464,135,598,0,752,463,463
"80976","Nsylvestris_NODE_30812_length_463_cov_10","Ntome_NODE_23816_length_936_cov_29",95.817,263,10,1,201,463,419,680,6.37e-118,424,262,261
"80977","Nsylvestris_NODE_30813_length_463_cov_8","Ntome_NODE_29334_length_655_cov_14",93.737,463,13,9,1,463,547,101,0,680,462,446
"80978","Nsylvestris_NODE_30815_length_463_cov_6","Ntome_NODE_35822_length_344_cov_5",96.552,319,11,0,9,327,319,1,1.31e-149,529,318,318
"80981","Nsylvestris_NODE_30817_length_463_cov_4","Ntome_NODE_33089_length_471_cov_4",95.749,447,11,2,5,451,33,471,0,713,446,438
"80982","Nsylvestris_NODE_30818_length_461_cov_4","Ntome_NODE_38839_length_270_cov_10",97.619,84,2,0,32,115,1,84,5.52e-34,145,83,83
"80983","Nsylvestris_NODE_30819_length_463_cov_3","Ntome_NODE_13685_length_1769_cov_96",94.828,464,21,3,1,463,623,162,0,721,462,461
"80991","Nsylvestris_NODE_30824_length_462_cov_156","Ntome_NODE_7935_length_2500_cov_128",90.531,433,7,6,55,462,2071,2494,1.68e-153,542,407,423
"80999","Nsylvestris_NODE_30832_length_462_cov_8","Ntome_NODE_5228_length_3023_cov_113",93.067,476,19,5,1,462,1237,1712,0,684,461,475
"81000","Nsylvestris_NODE_30833_length_462_cov_5","Ntome_NODE_6455_length_2757_cov_20",88.397,474,39,8,2,462,2238,1768,6e-158,556,460,470
"81001","Nsylvestris_NODE_30834_length_462_cov_5","Ntome_NODE_27250_length_746_cov_13",82.292,192,21,5,195,374,713,523,9.2e-37,154,179,190
"81002","Nsylvestris_NODE_30836_length_462_cov_5","Ntome_NODE_7934_length_2500_cov_144",87.257,463,52,5,1,462,1145,1601,2.19e-147,521,461,456
"81008","Nsylvestris_NODE_30842_length_461_cov_4","Ntome_NODE_752_length_5453_cov_230",90.889,461,33,9,1,456,2653,3109,4.53e-174,610,455,456
"81009","Nsylvestris_NODE_30844_length_461_cov_3","Ntome_NODE_29251_length_658_cov_39",95.708,466,14,4,1,461,183,647,0,745,460,464
"81010","Nsylvestris_NODE_30845_length_461_cov_1","Ntome_NODE_29971_length_629_cov_11",97.5,40,1,0,1,40,86,125,3.42e-11,69.4,39,39
"81013","Nsylvestris_NODE_30847_length_460_cov_220","Ntome_NODE_24440_length_896_cov_263",87.5,440,21,9,1,410,484,49,4.78e-134,477,409,435
"81017","Nsylvestris_NODE_30849_length_460_cov_11","Ntome_NODE_31159_length_583_cov_40",95.207,459,15,3,1,455,550,95,0,719,454,455
"81018","Nsylvestris_NODE_30853_length_460_cov_8","Ntome_NODE_31958_length_553_cov_7",89.979,479,21,9,1,454,10,486,4.55e-169,593,453,476
"81019","Nsylvestris_NODE_30855_length_460_cov_7","Ntome_NODE_4803_length_3132_cov_213",96,50,2,0,411,460,1029,1078,4.38e-15,82.4,49,49
"81025","Nsylvestris_NODE_30861_length_460_cov_5","Ntome_NODE_6978_length_2659_cov_12",79.444,180,27,9,6,180,2097,1923,3.34e-26,119,174,174
"81026","Nsylvestris_NODE_30862_length_461_cov_4","Ntome_NODE_2035_length_4150_cov_197",88.732,142,15,1,148,288,4013,3872,2.53e-42,172,140,141
"81033","Nsylvestris_NODE_30866_length_459_cov_187","Ntome_NODE_8964_length_2343_cov_276",97.436,78,2,0,46,123,2312,2235,1.19e-30,134,77,77
"81037","Nsylvestris_NODE_30868_length_459_cov_172","Ntome_NODE_5971_length_2855_cov_26",92.697,178,10,1,1,178,2403,2577,8.76e-67,254,177,174
"81048","Nsylvestris_NODE_30874_length_459_cov_7","Ntome_NODE_31652_length_566_cov_6",92.795,458,26,3,1,457,51,502,0,656,456,451
"81049","Nsylvestris_NODE_30882_length_458_cov_169","Ntome_NODE_4235_length_3281_cov_247",95.652,276,8,1,183,458,1303,1574,6.25e-123,440,275,271
"81055","Nsylvestris_NODE_30890_length_458_cov_7","Ntome_NODE_17498_length_1404_cov_6",96.507,458,16,0,1,458,951,494,0,758,457,457
"81056","Nsylvestris_NODE_30891_length_458_cov_7","Ntome_NODE_36544_length_323_cov_5",90.476,273,22,1,190,458,311,39,6.47e-98,357,268,272
"81057","Nsylvestris_NODE_30893_length_458_cov_6","Ntome_NODE_22926_length_988_cov_15",95.538,381,16,1,1,381,336,715,1.62e-173,608,380,379
"81058","Nsylvestris_NODE_30894_length_458_cov_5","Ntome_NODE_30104_length_624_cov_5",96.061,457,18,0,1,457,581,125,0,745,456,456
"81059","Nsylvestris_NODE_30895_length_458_cov_5","Ntome_NODE_19234_length_1257_cov_23",93.446,473,13,6,1,458,607,138,0,686,457,469
"81060","Nsylvestris_NODE_30896_length_458_cov_5","Ntome_NODE_15577_length_1578_cov_29",78.363,342,68,6,75,412,75,414,1.15e-55,217,337,339
"81061","Nsylvestris_NODE_30898_length_458_cov_4","Ntome_NODE_8979_length_2342_cov_37",93.028,459,31,1,1,458,2030,1572,0,669,457,458
"81062","Nsylvestris_NODE_30899_length_458_cov_3","Ntome_NODE_10994_length_2074_cov_23",95.161,248,5,4,217,458,2020,1774,2.97e-106,385,241,246
"81074","Nsylvestris_NODE_30908_length_457_cov_14","Ntome_NODE_34573_length_392_cov_7",96.507,229,8,0,162,390,326,98,1.38e-104,379,228,228
"81075","Nsylvestris_NODE_30909_length_457_cov_13","Ntome_NODE_6293_length_2788_cov_129",95.879,461,12,3,1,457,1631,1174,0,739,456,457
"81076","Nsylvestris_NODE_30911_length_457_cov_7","Ntome_NODE_5936_length_2865_cov_57",92.217,424,27,5,39,457,2865,2443,1.26e-169,595,418,422
"81077","Nsylvestris_NODE_30914_length_457_cov_6","Ntome_NODE_451_length_6157_cov_184",91.209,364,32,0,1,364,3518,3155,1.31e-139,496,363,363
"81078","Nsylvestris_NODE_30915_length_457_cov_6","Ntome_NODE_15261_length_1609_cov_8",94.348,460,23,1,1,457,50,509,0,702,456,459
"81082","Nsylvestris_NODE_30921_length_457_cov_3","Ntome_NODE_10452_length_2139_cov_12",95.385,455,21,0,2,456,1847,1393,0,725,454,454
"81083","Nsylvestris_NODE_30922_length_457_cov_2","Ntome_NODE_3176_length_3629_cov_87",91.721,459,20,8,2,457,2918,3361,2.07e-177,621,455,443
"81092","Nsylvestris_NODE_30928_length_456_cov_4","Ntome_NODE_31945_length_554_cov_10",94.737,228,5,2,1,228,221,1,3.88e-95,348,227,220
"81095","Nsylvestris_NODE_30930_length_456_cov_3","Ntome_NODE_32184_length_537_cov_10",90,400,21,9,1,381,401,2,1.01e-140,499,380,399
"81111","Nsylvestris_NODE_30936_length_447_cov_145","Ntome_NODE_3132_length_3646_cov_125",94.828,348,7,1,1,337,397,50,9.77e-151,532,336,347
"81112","Nsylvestris_NODE_30937_length_455_cov_28","Ntome_NODE_23719_length_942_cov_66",77.22,259,38,6,194,451,557,795,4.24e-30,132,257,238
"81116","Nsylvestris_NODE_30941_length_455_cov_5","Ntome_NODE_20516_length_1153_cov_9",94.802,404,19,2,5,408,402,1,1.23e-179,628,403,401
"81117","Nsylvestris_NODE_30942_length_455_cov_5","Ntome_NODE_7475_length_2574_cov_145",91.939,459,33,2,1,455,1310,852,0,640,454,458
"81120","Nsylvestris_NODE_30945_length_455_cov_4","Ntome_NODE_25650_length_824_cov_262",82.974,464,53,17,1,455,714,268,1.36e-109,396,454,446
"81127","Nsylvestris_NODE_30949_length_454_cov_142","Ntome_NODE_714_length_5535_cov_177",89.89,455,17,10,1,454,1878,1452,1.64e-158,558,453,426
"81131","Nsylvestris_NODE_30956_length_454_cov_4","Ntome_NODE_19129_length_1265_cov_89",92.035,113,8,1,336,448,589,700,6.98e-38,158,112,111
"81132","Nsylvestris_NODE_30957_length_454_cov_4","Ntome_NODE_31303_length_578_cov_10",86.75,400,30,9,66,452,436,47,6.23e-118,424,386,389
"81133","Nsylvestris_NODE_30958_length_454_cov_4","Ntome_NODE_21012_length_1115_cov_49",93.833,227,11,3,9,234,495,271,2.32e-92,339,225,224
"81134","Nsylvestris_NODE_30960_length_454_cov_4","Ntome_NODE_925_length_5198_cov_131",83.871,465,49,18,1,454,2677,3126,8.06e-117,420,453,449
"81135","Nsylvestris_NODE_30961_length_454_cov_3","Ntome_NODE_28741_length_679_cov_3",83.929,224,16,9,2,205,456,679,1.48e-49,196,203,223
"81136","Nsylvestris_NODE_30962_length_453_cov_3","Ntome_NODE_30056_length_625_cov_141",96.429,56,2,0,211,266,596,541,1.99e-18,93.5,55,55
"81137","Nsylvestris_NODE_30963_length_453_cov_238","Ntome_NODE_4406_length_3236_cov_263",97.143,455,11,1,1,453,1094,640,0,767,452,454
"81146","Nsylvestris_NODE_30968_length_453_cov_57","Ntome_NODE_30643_length_602_cov_46",95.043,464,12,5,1,453,130,593,0,719,452,463
"81147","Nsylvestris_NODE_30969_length_453_cov_14","Ntome_NODE_16552_length_1491_cov_224",89.083,458,42,5,1,453,812,358,1.26e-159,562,452,454
"81148","Nsylvestris_NODE_30971_length_453_cov_9","Ntome_NODE_2625_length_3849_cov_260",94.855,447,21,1,1,447,1607,2051,0,697,446,444
"81149","Nsylvestris_NODE_30972_length_453_cov_7","Ntome_NODE_16670_length_1479_cov_139",96.231,451,17,0,1,451,787,1237,0,739,450,450
"81153","Nsylvestris_NODE_30975_length_453_cov_5","Ntome_NODE_8769_length_2375_cov_21",94.013,451,16,4,4,453,1349,909,0,673,449,440
"81154","Nsylvestris_NODE_30977_length_453_cov_5","Ntome_NODE_23543_length_952_cov_27",88.11,328,24,7,105,431,560,873,1.77e-103,375,326,313
"81155","Nsylvestris_NODE_30978_length_453_cov_5","Ntome_NODE_20391_length_1162_cov_38",98.455,453,5,1,1,453,592,142,0,797,452,450
"81156","Nsylvestris_NODE_30979_length_453_cov_4","Ntome_NODE_2576_length_3869_cov_238",84.956,113,11,4,345,453,730,620,1.98e-23,110,108,110
"81159","Nsylvestris_NODE_30981_length_453_cov_2","Ntome_NODE_1364_length_4663_cov_85",81.148,122,23,0,111,232,1333,1212,4.28e-20,99,121,121
"81164","Nsylvestris_NODE_30984_length_452_cov_184","Ntome_NODE_24879_length_870_cov_208",92.641,462,20,6,1,449,186,646,0,652,448,460
"81165","Nsylvestris_NODE_30985_length_452_cov_180","Ntome_NODE_7487_length_2573_cov_122",93.22,59,3,1,395,452,1434,1492,3.33e-16,86.1,57,58
"81166","Nsylvestris_NODE_30989_length_452_cov_20","Ntome_NODE_25108_length_857_cov_23",87.871,404,35,11,2,403,523,132,1.32e-129,462,401,391
"81169","Nsylvestris_NODE_30991_length_452_cov_9","Ntome_NODE_38033_length_288_cov_2",87.762,286,35,0,8,293,1,286,2.99e-91,335,285,285
"81172","Nsylvestris_NODE_30994_length_452_cov_5","Ntome_NODE_28409_length_692_cov_29",88.788,330,37,0,1,330,296,625,2.25e-112,405,329,329
"81178","Nsylvestris_NODE_30999_length_451_cov_182","Ntome_NODE_6126_length_2826_cov_256",96.552,58,2,0,394,451,321,378,1.53e-19,97.1,57,57
"81183","Nsylvestris_NODE_31002_length_451_cov_33","Ntome_NODE_32102_length_542_cov_168",97.229,397,10,1,52,447,65,461,0,671,395,396
"81184","Nsylvestris_NODE_31005_length_451_cov_4","Ntome_NODE_16425_length_1503_cov_54",95.814,430,15,2,25,451,920,1349,0,691,426,429
"81185","Nsylvestris_NODE_31006_length_451_cov_3","Ntome_NODE_19844_length_1206_cov_11",96.889,450,14,0,1,450,978,529,0,754,449,449
"81192","Nsylvestris_NODE_31012_length_450_cov_5","Ntome_NODE_15097_length_1624_cov_74",79.938,324,56,5,127,445,504,185,1.45e-59,230,318,319
"81193","Nsylvestris_NODE_31013_length_450_cov_5","Ntome_NODE_28865_length_673_cov_92",96.364,55,2,0,48,102,338,392,7.12e-18,91.6,54,54
"81203","Nsylvestris_NODE_31021_length_449_cov_207","Ntome_NODE_21638_length_1072_cov_40",89.762,420,20,9,1,399,570,153,9.88e-146,516,398,417
"81206","Nsylvestris_NODE_31023_length_449_cov_18","Ntome_NODE_31723_length_563_cov_15",91.006,467,22,6,1,449,556,92,1.23e-174,612,448,464
"81207","Nsylvestris_NODE_31024_length_449_cov_11","Ntome_NODE_28797_length_676_cov_37",88.862,413,38,6,27,433,60,470,2.77e-141,501,406,410
"81208","Nsylvestris_NODE_31026_length_449_cov_9","Ntome_NODE_11190_length_2050_cov_255",97.727,44,1,0,405,448,1947,1990,1.99e-13,76.8,43,43
"81209","Nsylvestris_NODE_31027_length_449_cov_8","Ntome_NODE_27992_length_710_cov_287",100,32,0,0,418,449,593,562,2e-08,60.2,31,31
"81221","Nsylvestris_NODE_31037_length_448_cov_190","Ntome_NODE_3632_length_3475_cov_194",96.798,406,12,1,1,405,3225,2820,0,676,404,405
"81226","Nsylvestris_NODE_31040_length_448_cov_31","Ntome_NODE_27513_length_731_cov_221",89.017,346,32,5,1,343,633,291,6.15e-118,424,342,342
"81227","Nsylvestris_NODE_31042_length_448_cov_11","Ntome_NODE_36797_length_316_cov_4",82.166,314,50,5,87,397,6,316,3.94e-70,265,310,310
"81231","Nsylvestris_NODE_31046_length_448_cov_7","Ntome_NODE_4826_length_3127_cov_190",87.872,470,23,10,1,448,1181,1638,2.12e-147,521,447,457
"81232","Nsylvestris_NODE_31047_length_448_cov_7","Ntome_NODE_36567_length_322_cov_5",95.062,324,13,3,3,325,1,322,5.93e-143,507,322,321
"81235","Nsylvestris_NODE_31050_length_448_cov_5","Ntome_NODE_12708_length_1872_cov_126",86.653,472,27,10,1,446,71,532,5.98e-138,490,445,461
"81236","Nsylvestris_NODE_31051_length_448_cov_5","Ntome_NODE_29862_length_633_cov_39",92.308,221,16,1,227,447,209,428,1.39e-84,313,220,219
"81237","Nsylvestris_NODE_31052_length_448_cov_5","Ntome_NODE_24619_length_885_cov_8",92.692,260,16,3,37,295,573,830,2.26e-102,372,258,257
"81241","Nsylvestris_NODE_31054_length_448_cov_5","Ntome_NODE_18561_length_1311_cov_44",87.742,465,30,11,1,448,808,1262,2.74e-146,518,447,454
"81245","Nsylvestris_NODE_31058_length_448_cov_4","Ntome_NODE_2140_length_4087_cov_104",88.636,44,5,0,405,448,3097,3140,9.29e-07,54.7,43,43
"81258","Nsylvestris_NODE_31067_length_447_cov_8","Ntome_NODE_7656_length_2547_cov_93",94.42,448,24,1,1,447,1292,1739,0,688,446,447
"81259","Nsylvestris_NODE_31070_length_447_cov_4","Ntome_NODE_7828_length_2519_cov_103",93.889,360,20,2,1,359,1429,1787,1.62e-153,542,358,358
"81271","Nsylvestris_NODE_31078_length_446_cov_158","Ntome_NODE_702_length_5556_cov_237",93.886,229,14,0,218,446,5504,5276,1.36e-94,346,228,228
"81274","Nsylvestris_NODE_31080_length_446_cov_7","Ntome_NODE_24564_length_888_cov_28",86.667,165,16,2,283,441,409,245,5.26e-44,178,158,164
"81275","Nsylvestris_NODE_31081_length_446_cov_7","Ntome_NODE_19385_length_1244_cov_10",87.778,450,24,13,1,446,487,909,3.55e-140,497,445,422
"81279","Nsylvestris_NODE_31087_length_446_cov_5","Ntome_NODE_4790_length_3136_cov_162",93.512,447,26,3,1,446,2437,2881,0,662,445,444
"81280","Nsylvestris_NODE_31088_length_446_cov_4","Ntome_NODE_15798_length_1558_cov_226",87.359,443,56,0,4,446,724,282,1.64e-143,508,442,442
"81287","Nsylvestris_NODE_31097_length_445_cov_7","Ntome_NODE_11453_length_2019_cov_141",93.468,444,25,3,2,443,589,1030,0,656,441,441
"81293","Nsylvestris_NODE_31103_length_445_cov_4","Ntome_NODE_14135_length_1724_cov_8",96.629,445,15,0,1,445,1109,665,0,739,444,444
"81310","Nsylvestris_NODE_31111_length_444_cov_80","Ntome_NODE_27983_length_711_cov_39",91.241,411,15,7,2,412,257,646,5.8e-153,540,410,389
"81313","Nsylvestris_NODE_31114_length_444_cov_10","Ntome_NODE_28096_length_706_cov_16",88.02,409,29,3,1,390,75,482,9.98e-131,466,389,407
"81316","Nsylvestris_NODE_31117_length_444_cov_6","Ntome_NODE_12741_length_1868_cov_244",100,28,0,0,417,444,1579,1552,3.31e-06,52.8,27,27
"81329","Nsylvestris_NODE_31122_length_443_cov_177","Ntome_NODE_2309_length_4001_cov_148",90.674,386,8,3,54,439,382,25,2.12e-137,488,385,357
"81330","Nsylvestris_NODE_31123_length_443_cov_175","Ntome_NODE_5000_length_3081_cov_280",93.665,442,18,6,3,443,72,504,0,652,440,432
"81339","Nsylvestris_NODE_31132_length_443_cov_4","Ntome_NODE_24591_length_887_cov_5",95.937,443,18,0,1,443,539,97,0,719,442,442
"81340","Nsylvestris_NODE_31133_length_443_cov_4","Ntome_NODE_8672_length_2389_cov_159",93.023,215,12,2,223,437,620,409,4.93e-84,311,214,211
"81343","Nsylvestris_NODE_31137_length_443_cov_3","Ntome_NODE_28385_length_694_cov_3",89.316,234,21,3,19,251,231,1,6.43e-78,291,232,230
"81356","Nsylvestris_NODE_31151_length_442_cov_3","Ntome_NODE_16277_length_1514_cov_191",83.099,71,5,6,361,428,425,359,7.08e-08,58.4,67,66
"81357","Nsylvestris_NODE_31152_length_442_cov_3","Ntome_NODE_36966_length_311_cov_7",86.765,68,9,0,374,441,8,75,1.95e-13,76.8,67,67
"81358","Nsylvestris_NODE_31154_length_441_cov_150","Ntome_NODE_27769_length_721_cov_111",94.248,226,13,0,1,226,281,56,1.35e-94,346,225,225
"81359","Nsylvestris_NODE_31155_length_441_cov_9","Ntome_NODE_26587_length_778_cov_9",84.235,425,37,19,21,428,660,249,7.93e-107,387,407,411
"81360","Nsylvestris_NODE_31157_length_441_cov_5","Ntome_NODE_38942_length_268_cov_8",96.988,166,5,0,276,441,1,166,1.38e-74,279,165,165
"81361","Nsylvestris_NODE_31159_length_441_cov_4","Ntome_NODE_33811_length_429_cov_4",96.382,387,14,0,55,441,1,387,0,638,386,386
"81362","Nsylvestris_NODE_31162_length_441_cov_4","Ntome_NODE_29479_length_649_cov_11",91.499,447,26,8,1,441,172,612,2.01e-172,604,440,440
"81366","Nsylvestris_NODE_31167_length_440_cov_164","Ntome_NODE_7824_length_2520_cov_189",95.408,392,18,0,49,440,2160,1769,1.54e-178,625,391,391
"81367","Nsylvestris_NODE_31168_length_440_cov_156","Ntome_NODE_13884_length_1747_cov_284",100,55,0,0,1,55,687,741,3.21e-21,102,54,54
"81368","Nsylvestris_NODE_31169_length_440_cov_102","Ntome_NODE_5509_length_2960_cov_186",88.491,391,23,13,53,440,420,49,7.69e-127,453,387,371
"81369","Nsylvestris_NODE_31170_length_440_cov_37","Ntome_NODE_38015_length_288_cov_4",95.918,196,5,2,245,440,283,91,3.79e-85,315,195,192
"81370","Nsylvestris_NODE_31174_length_440_cov_7","Ntome_NODE_459_length_6134_cov_53",95.455,440,19,1,1,440,1109,1547,0,701,439,438
"81371","Nsylvestris_NODE_31176_length_440_cov_6","Ntome_NODE_9717_length_2238_cov_170",100,32,0,0,4,35,1388,1419,1.96e-08,60.2,31,31
"81372","Nsylvestris_NODE_31177_length_440_cov_6","Ntome_NODE_9274_length_2300_cov_30",91.566,415,35,0,1,415,813,1227,5.66e-163,573,414,414
"81378","Nsylvestris_NODE_31182_length_439_cov_10","Ntome_NODE_26502_length_782_cov_39",88.889,468,18,8,4,439,167,632,1.23e-154,545,435,465
"81390","Nsylvestris_NODE_31196_length_438_cov_19","Ntome_NODE_14691_length_1667_cov_67",87.118,458,38,11,2,438,1657,1200,9.69e-141,499,436,457
"81391","Nsylvestris_NODE_31199_length_438_cov_12","Ntome_NODE_26150_length_800_cov_7",95.402,435,20,0,4,438,678,244,0,693,434,434
"81392","Nsylvestris_NODE_31200_length_438_cov_12","Ntome_NODE_35538_length_353_cov_4",94.571,350,16,1,69,415,1,350,2.05e-152,538,346,349
"81395","Nsylvestris_NODE_31202_length_438_cov_8","Ntome_NODE_33628_length_438_cov_6",79.602,201,14,3,235,435,226,399,3.17e-26,119,200,173
"81396","Nsylvestris_NODE_31203_length_438_cov_7","Ntome_NODE_22437_length_1020_cov_111",86.486,259,34,1,166,423,2,260,1.06e-75,283,257,258
"81397","Nsylvestris_NODE_31205_length_438_cov_6","Ntome_NODE_31567_length_569_cov_3",93.5,400,24,2,41,438,569,170,4.32e-169,593,397,399
"81403","Nsylvestris_NODE_31213_length_438_cov_4","Ntome_NODE_4357_length_3248_cov_167",97.531,324,8,0,1,324,2230,1907,2.04e-157,555,323,323
"81404","Nsylvestris_NODE_31214_length_438_cov_2","Ntome_NODE_23540_length_952_cov_59",97.059,68,2,0,3,70,122,55,4.1e-25,115,67,67
"81407","Nsylvestris_NODE_31216_length_437_cov_156","Ntome_NODE_32722_length_496_cov_303",92.34,235,16,1,1,233,222,456,1.04e-90,333,232,234
"81412","Nsylvestris_NODE_31222_length_437_cov_9","Ntome_NODE_35201_length_366_cov_5",97.701,261,6,0,1,261,261,1,9.88e-126,449,260,260
"81413","Nsylvestris_NODE_31226_length_437_cov_5","Ntome_NODE_19472_length_1236_cov_277",91.228,57,5,0,44,100,964,908,5.37e-14,78.7,56,56
"81414","Nsylvestris_NODE_31227_length_437_cov_5","Ntome_NODE_39649_length_255_cov_4",90.09,111,10,1,1,110,111,1,1.88e-33,143,109,110
"81415","Nsylvestris_NODE_31228_length_437_cov_5","Ntome_NODE_27651_length_726_cov_16",81.579,76,14,0,325,400,339,264,1.5e-09,63.9,75,75
"81416","Nsylvestris_NODE_31230_length_437_cov_3","Ntome_NODE_21692_length_1068_cov_98",91.391,151,7,2,218,362,1,151,3.05e-51,202,144,150
"81417","Nsylvestris_NODE_31231_length_437_cov_3","Ntome_NODE_6522_length_2745_cov_58",97.254,437,12,0,1,437,1618,2054,0,741,436,436
"81420","Nsylvestris_NODE_31234_length_436_cov_168","Ntome_NODE_16100_length_1531_cov_141",91.928,446,26,6,1,436,532,87,9.18e-176,616,435,445
"81423","Nsylvestris_NODE_31236_length_436_cov_131","Ntome_NODE_8538_length_2407_cov_270",88.218,348,22,9,57,391,168,509,3.62e-110,398,334,341
"81432","Nsylvestris_NODE_31247_length_436_cov_2","Ntome_NODE_27126_length_752_cov_11",93.111,450,15,10,2,436,190,638,0,645,434,448
"81439","Nsylvestris_NODE_31250_length_435_cov_155","Ntome_NODE_19337_length_1248_cov_226",86.882,465,15,22,13,435,38,498,1.25e-134,479,422,460
"81440","Nsylvestris_NODE_31251_length_435_cov_23","Ntome_NODE_28282_length_698_cov_23",90.492,305,27,2,132,435,306,3,2.79e-111,401,303,303
"81441","Nsylvestris_NODE_31253_length_435_cov_10","Ntome_NODE_3024_length_3690_cov_16",95.238,399,17,2,4,401,399,2,3.27e-180,630,397,397
"81455","Nsylvestris_NODE_31259_length_434_cov_7","Ntome_NODE_30837_length_595_cov_6",83.938,193,9,12,4,196,171,1,3.98e-40,165,192,170
"81458","Nsylvestris_NODE_31263_length_434_cov_4","Ntome_NODE_20975_length_1118_cov_22",92.14,458,12,1,1,434,441,898,1.52e-178,625,433,457
"81459","Nsylvestris_NODE_31265_length_434_cov_3","Ntome_NODE_22912_length_989_cov_11",90.112,445,30,7,1,434,300,741,9.33e-161,566,433,441
"81469","Nsylvestris_NODE_31271_length_433_cov_201","Ntome_NODE_32406_length_520_cov_244",95.843,433,14,2,2,433,73,502,0,697,431,429
"81470","Nsylvestris_NODE_31272_length_433_cov_165","Ntome_NODE_18361_length_1329_cov_112",100,35,0,0,387,421,680,714,4.14e-10,65.8,34,34
"81473","Nsylvestris_NODE_31275_length_433_cov_9","Ntome_NODE_10705_length_2106_cov_137",95.862,145,6,0,289,433,190,46,2.98e-61,235,144,144
"81474","Nsylvestris_NODE_31278_length_433_cov_6","Ntome_NODE_1745_length_4349_cov_94",96.536,433,15,0,1,433,1870,2302,0,717,432,432
"81480","Nsylvestris_NODE_31281_length_433_cov_6","Ntome_NODE_32441_length_518_cov_8",87.066,317,22,10,74,386,1,302,6.14e-93,340,312,301
"81481","Nsylvestris_NODE_31282_length_433_cov_6","Ntome_NODE_19734_length_1216_cov_49",89.485,447,30,11,1,433,315,758,9.38e-156,549,432,443
"81482","Nsylvestris_NODE_31285_length_433_cov_5","Ntome_NODE_9480_length_2272_cov_33",97.43,428,11,0,4,431,1236,809,0,730,427,427
"81483","Nsylvestris_NODE_31286_length_433_cov_5","Ntome_NODE_29486_length_649_cov_5",87.727,440,33,6,1,433,649,224,4.46e-139,494,432,425
"81484","Nsylvestris_NODE_31289_length_433_cov_4","Ntome_NODE_24497_length_893_cov_8",84.365,307,37,7,134,431,579,883,6.27e-78,291,297,304
"81485","Nsylvestris_NODE_31290_length_432_cov_209","Ntome_NODE_3595_length_3485_cov_38",90.566,106,9,1,218,322,3348,3243,2.4e-32,139,104,105
"81486","Nsylvestris_NODE_31291_length_432_cov_193","Ntome_NODE_12308_length_1921_cov_95",96.296,54,2,0,1,54,1164,1217,2.45e-17,89.8,53,53
"81490","Nsylvestris_NODE_31294_length_432_cov_9","Ntome_NODE_510_length_5989_cov_124",94.907,432,22,0,1,432,818,387,0,676,431,431
"81491","Nsylvestris_NODE_31296_length_432_cov_7","Ntome_NODE_15936_length_1544_cov_30",91.071,112,9,1,3,113,282,171,1.11e-35,150,110,111
"81492","Nsylvestris_NODE_31299_length_432_cov_5","Ntome_NODE_4509_length_3207_cov_179",97.115,312,9,0,121,432,1472,1161,4.38e-149,527,311,311
"81493","Nsylvestris_NODE_31303_length_432_cov_4","Ntome_NODE_18793_length_1292_cov_90",98.039,51,1,0,382,432,152,102,2.45e-17,89.8,50,50
"81494","Nsylvestris_NODE_31305_length_431_cov_237","Ntome_NODE_3872_length_3396_cov_292",98.128,374,7,0,1,374,529,156,0,652,373,373
"81495","Nsylvestris_NODE_31306_length_431_cov_24","Ntome_NODE_21010_length_1115_cov_209",92.453,212,15,1,11,221,904,1115,2.88e-81,302,210,211
"81496","Nsylvestris_NODE_31310_length_431_cov_7","Ntome_NODE_38678_length_274_cov_3",87.826,115,14,0,249,363,5,119,3.1e-31,135,114,114
"81497","Nsylvestris_NODE_31312_length_431_cov_6","Ntome_NODE_30361_length_614_cov_7",88.94,217,14,4,191,398,289,504,1.76e-68,259,207,215
"81498","Nsylvestris_NODE_31313_length_431_cov_6","Ntome_NODE_11184_length_2051_cov_105",97.436,39,1,0,294,332,1548,1586,1.15e-10,67.6,38,38
"81506","Nsylvestris_NODE_31327_length_430_cov_44","Ntome_NODE_14253_length_1710_cov_16",85.887,248,22,4,48,293,2,238,2.94e-66,252,245,236
"81507","Nsylvestris_NODE_31330_length_430_cov_10","Ntome_NODE_1793_length_4317_cov_274",96.591,88,3,0,2,89,1400,1487,1.43e-34,147,87,87
"81510","Nsylvestris_NODE_31333_length_430_cov_6","Ntome_NODE_2453_length_3931_cov_134",94.836,426,22,0,1,426,2902,3327,0,665,425,425
"81517","Nsylvestris_NODE_31339_length_430_cov_4","Ntome_NODE_32188_length_537_cov_5",97.297,37,1,0,1,37,37,1,1.48e-09,63.9,36,36
"81518","Nsylvestris_NODE_31343_length_429_cov_221","Ntome_NODE_23278_length_966_cov_144",97.436,429,11,0,1,429,430,858,0,732,428,428
"81519","Nsylvestris_NODE_31344_length_429_cov_184","Ntome_NODE_12089_length_1946_cov_247",93.151,438,11,4,4,429,1945,1515,1.5e-178,625,425,430
"81523","Nsylvestris_NODE_31348_length_429_cov_8","Ntome_NODE_36719_length_318_cov_6",97.59,83,1,1,348,429,1,83,6.62e-33,141,81,82
"81524","Nsylvestris_NODE_31350_length_429_cov_5","Ntome_NODE_240_length_7144_cov_194",93.75,432,24,1,1,429,2195,1764,0,645,428,431
"81525","Nsylvestris_NODE_31352_length_429_cov_5","Ntome_NODE_15626_length_1574_cov_7",94.118,204,9,2,228,429,1268,1066,6.17e-83,307,201,202
"81526","Nsylvestris_NODE_31354_length_429_cov_4","Ntome_NODE_5956_length_2859_cov_287",94.444,126,6,1,304,429,2839,2715,1.8e-48,193,125,124
"81530","Nsylvestris_NODE_31357_length_429_cov_2","Ntome_NODE_3143_length_3642_cov_94",93.822,437,17,6,1,429,3620,3186,0,649,428,434
"81531","Nsylvestris_NODE_31358_length_428_cov_198","Ntome_NODE_4214_length_3289_cov_86",97.203,429,11,1,1,428,23,451,0,725,427,428
"81535","Nsylvestris_NODE_31365_length_428_cov_4","Ntome_NODE_10724_length_2105_cov_50",95.455,440,7,2,1,428,1397,959,0,689,427,438
"81536","Nsylvestris_NODE_31366_length_428_cov_4","Ntome_NODE_39727_length_254_cov_2",90.65,246,17,4,186,428,1,243,2.2e-87,322,242,242
"81537","Nsylvestris_NODE_31367_length_428_cov_4","Ntome_NODE_3442_length_3532_cov_170",97.4,423,11,0,1,423,2200,2622,0,721,422,422
"81544","Nsylvestris_NODE_31371_length_427_cov_7","Ntome_NODE_10573_length_2123_cov_237",92.982,114,7,1,280,393,523,635,3.91e-40,165,113,112
"81545","Nsylvestris_NODE_31373_length_427_cov_6","Ntome_NODE_7871_length_2513_cov_18",85.507,414,34,13,17,424,32,425,1.64e-113,409,407,393
"81548","Nsylvestris_NODE_31377_length_427_cov_3","Ntome_NODE_24827_length_873_cov_19",85.6,250,21,8,166,414,484,719,3.77e-65,248,248,235
"81549","Nsylvestris_NODE_31378_length_427_cov_3","Ntome_NODE_36826_length_315_cov_5",86.869,99,12,1,316,414,65,162,1.86e-23,110,98,97
"81550","Nsylvestris_NODE_31379_length_427_cov_3","Ntome_NODE_31414_length_574_cov_8",95.082,427,17,1,1,427,48,470,0,669,426,422
"81551","Nsylvestris_NODE_31382_length_426_cov_185","Ntome_NODE_8886_length_2357_cov_138",90.645,310,23,2,45,351,1715,1409,5.87e-113,407,306,306
"81566","Nsylvestris_NODE_31394_length_426_cov_3","Ntome_NODE_52_length_9736_cov_185",86.813,364,45,3,62,424,7002,6641,7.59e-112,403,362,361
"81567","Nsylvestris_NODE_31395_length_426_cov_2","Ntome_NODE_24949_length_866_cov_81",92,350,15,5,1,341,400,55,1.23e-134,479,340,345
"81573","Nsylvestris_NODE_31398_length_425_cov_16","Ntome_NODE_39336_length_260_cov_4",95.094,265,6,4,10,274,3,260,4.53e-114,411,264,257
"81574","Nsylvestris_NODE_31401_length_425_cov_7","Ntome_NODE_2034_length_4150_cov_214",78.995,438,61,17,1,411,1847,2280,8.01e-72,270,410,433
"81577","Nsylvestris_NODE_31406_length_425_cov_5","Ntome_NODE_24161_length_915_cov_22",93.882,425,26,0,1,425,363,787,0,641,424,424
"81578","Nsylvestris_NODE_31407_length_425_cov_5","Ntome_NODE_24207_length_912_cov_29",94.34,424,23,1,2,425,555,133,0,649,423,422
"81584","Nsylvestris_NODE_31414_length_425_cov_3","Ntome_NODE_6356_length_2777_cov_19",96.682,422,14,0,1,422,752,1173,0,702,421,421
"81590","Nsylvestris_NODE_31417_length_424_cov_183","Ntome_NODE_14434_length_1691_cov_145",94.595,185,10,0,43,227,880,696,7.94e-77,287,184,184
"81591","Nsylvestris_NODE_31418_length_424_cov_119","Ntome_NODE_13220_length_1817_cov_188",87.269,432,25,11,1,424,744,335,9.5e-131,466,423,409
"81592","Nsylvestris_NODE_31419_length_424_cov_9","Ntome_NODE_32361_length_524_cov_4",89.681,407,38,3,19,424,4,407,9.3e-146,516,405,403
"81593","Nsylvestris_NODE_31422_length_424_cov_6","Ntome_NODE_13215_length_1818_cov_29",89.655,58,6,0,53,110,455,512,6.73e-13,75,57,57
"81599","Nsylvestris_NODE_31427_length_424_cov_4","Ntome_NODE_21893_length_1055_cov_218",90.393,229,18,3,197,424,626,851,3.67e-80,298,227,225
"81600","Nsylvestris_NODE_31428_length_424_cov_4","Ntome_NODE_28006_length_710_cov_28",92.235,425,32,1,1,424,556,132,2.5e-171,601,423,424
"81603","Nsylvestris_NODE_31432_length_423_cov_223","Ntome_NODE_6421_length_2763_cov_99",97.09,378,11,0,1,378,491,114,0,638,377,377
"81604","Nsylvestris_NODE_31433_length_423_cov_181","Ntome_NODE_5270_length_3014_cov_199",97.361,379,9,1,45,423,2695,2318,0,643,378,377
"81605","Nsylvestris_NODE_31434_length_423_cov_163","Ntome_NODE_568_length_5832_cov_68",91.409,291,10,1,1,291,4080,4355,2.73e-106,385,290,275
"81612","Nsylvestris_NODE_31441_length_423_cov_5","Ntome_NODE_254_length_7054_cov_52",77.305,423,89,6,6,423,4792,4372,1.74e-63,243,417,420
"81613","Nsylvestris_NODE_31446_length_422_cov_174","Ntome_NODE_24167_length_914_cov_269",96.912,421,9,4,2,420,3,421,0,702,418,418
"81618","Nsylvestris_NODE_31452_length_422_cov_7","Ntome_NODE_30801_length_596_cov_11",93.03,330,11,5,98,422,1,323,2.03e-132,472,324,322
"81627","Nsylvestris_NODE_31459_length_422_cov_3","Ntome_NODE_25972_length_807_cov_54",86.247,429,39,7,1,422,207,622,3.42e-125,448,421,415
"81628","Nsylvestris_NODE_31461_length_422_cov_2","Ntome_NODE_17837_length_1372_cov_68",89.268,410,29,9,1,407,184,581,9.32e-141,499,406,397
"81632","Nsylvestris_NODE_31463_length_421_cov_188","Ntome_NODE_30992_length_589_cov_267",84.815,270,30,7,13,277,152,415,4.77e-69,261,264,263
"81633","Nsylvestris_NODE_31464_length_421_cov_179","Ntome_NODE_2587_length_3863_cov_243",100,55,0,0,367,421,3253,3307,3.06e-21,102,54,54
"81634","Nsylvestris_NODE_31465_length_421_cov_163","Ntome_NODE_20805_length_1131_cov_168",98.333,120,2,0,302,421,26,145,4.88e-54,211,119,119
"81635","Nsylvestris_NODE_31469_length_421_cov_6","Ntome_NODE_11237_length_2045_cov_189",87.973,291,26,5,1,285,1229,1516,2.77e-91,335,284,287
"81636","Nsylvestris_NODE_31470_length_421_cov_6","Ntome_NODE_10536_length_2127_cov_266",100,30,0,0,392,421,69,98,2.42e-07,56.5,29,29
"81640","Nsylvestris_NODE_31473_length_421_cov_6","Ntome_NODE_4272_length_3269_cov_77",94.55,422,20,2,1,421,476,895,0,649,420,419
"81646","Nsylvestris_NODE_31482_length_421_cov_2","Ntome_NODE_209_length_7382_cov_58",89.074,421,42,4,1,421,6081,6497,7.14e-147,520,420,416
"81649","Nsylvestris_NODE_31485_length_418_cov_13","Ntome_NODE_25774_length_817_cov_60",83.453,139,16,4,282,418,190,57,2.33e-27,122,136,133
"81653","Nsylvestris_NODE_31491_length_420_cov_4","Ntome_NODE_382_length_6389_cov_119",83.565,359,53,6,1,354,4546,4189,3.58e-90,331,353,357
"81654","Nsylvestris_NODE_31492_length_420_cov_4","Ntome_NODE_8267_length_2447_cov_28",97.143,420,12,0,1,420,1729,2148,0,710,419,419
"81657","Nsylvestris_NODE_31494_length_420_cov_4","Ntome_NODE_31813_length_560_cov_4",92.695,397,29,0,1,397,397,1,5.39e-163,573,396,396
"81658","Nsylvestris_NODE_31495_length_420_cov_4","Ntome_NODE_34376_length_401_cov_9",90.598,234,13,4,13,238,233,1,2.81e-81,302,225,232
"81659","Nsylvestris_NODE_31497_length_420_cov_3","Ntome_NODE_7605_length_2553_cov_152",92.619,420,25,2,1,420,1681,1268,8.89e-171,599,419,413
"81660","Nsylvestris_NODE_31500_length_420_cov_3","Ntome_NODE_13477_length_1789_cov_24",95.192,416,20,0,3,418,1485,1070,0,658,415,415
"81669","Nsylvestris_NODE_31511_length_419_cov_6","Ntome_NODE_27461_length_735_cov_5",96.217,423,10,2,1,417,665,243,0,688,416,422
"81670","Nsylvestris_NODE_31512_length_419_cov_5","Ntome_NODE_5707_length_2916_cov_34",92.366,262,20,0,158,419,2522,2261,5.85e-103,374,261,261
"81671","Nsylvestris_NODE_31514_length_419_cov_4","Ntome_NODE_1341_length_4691_cov_248",100,32,0,0,1,32,2764,2733,1.86e-08,60.2,31,31
"81674","Nsylvestris_NODE_31518_length_418_cov_176","Ntome_NODE_10689_length_2108_cov_99",95.327,321,13,2,52,371,447,128,1.53e-143,508,319,319
"81678","Nsylvestris_NODE_31520_length_418_cov_60","Ntome_NODE_15792_length_1559_cov_25",95.69,116,5,0,303,418,1355,1240,8.16e-47,187,115,115
"81679","Nsylvestris_NODE_31522_length_418_cov_11","Ntome_NODE_10089_length_2188_cov_45",91.979,187,15,0,167,353,416,230,1.32e-69,263,186,186
"81683","Nsylvestris_NODE_31528_length_418_cov_4","Ntome_NODE_10265_length_2161_cov_23",91.686,421,26,3,1,418,1341,927,1.49e-163,575,417,414
"81687","Nsylvestris_NODE_31531_length_418_cov_3","Ntome_NODE_7483_length_2573_cov_246",96.552,116,4,0,250,365,2129,2244,1.75e-48,193,115,115
"81697","Nsylvestris_NODE_31536_length_417_cov_9","Ntome_NODE_16897_length_1457_cov_18",90.934,364,25,4,55,417,390,746,9.27e-136,483,362,356
"81698","Nsylvestris_NODE_31538_length_417_cov_6","Ntome_NODE_27393_length_738_cov_55",97.222,36,0,1,383,417,228,263,1.85e-08,60.2,34,35
"81699","Nsylvestris_NODE_31541_length_417_cov_5","Ntome_NODE_7733_length_2535_cov_135",96.25,240,9,0,178,417,1644,1405,4.47e-109,394,239,239
"81700","Nsylvestris_NODE_31546_length_417_cov_3","Ntome_NODE_36541_length_323_cov_5",97.426,272,7,0,145,416,322,51,3.36e-130,464,271,271
"81701","Nsylvestris_NODE_31547_length_417_cov_2","Ntome_NODE_22685_length_1004_cov_223",100,41,0,0,1,41,581,541,1.84e-13,76.8,40,40
"81702","Nsylvestris_NODE_31548_length_417_cov_2","Ntome_NODE_34930_length_377_cov_9",90.852,317,27,2,1,315,317,1,5.7e-118,424,314,316
"81703","Nsylvestris_NODE_31549_length_417_cov_2","Ntome_NODE_34042_length_418_cov_3",91.971,137,7,2,1,133,282,418,2.26e-47,189,132,136
"81704","Nsylvestris_NODE_31550_length_417_cov_2","Ntome_NODE_8175_length_2464_cov_26",89.209,417,39,5,1,417,1381,1791,9.14e-146,516,416,410
"81712","Nsylvestris_NODE_31554_length_416_cov_183","Ntome_NODE_8299_length_2441_cov_252",96.296,324,12,0,1,324,370,47,9.05e-151,532,323,323
"81721","Nsylvestris_NODE_31568_length_416_cov_3","Ntome_NODE_16166_length_1525_cov_9",97.113,381,11,0,36,416,155,535,0,643,380,380
"81724","Nsylvestris_NODE_31572_length_415_cov_175","Ntome_NODE_23396_length_960_cov_259",88.941,425,9,9,2,415,902,505,5.51e-138,490,413,397
"81725","Nsylvestris_NODE_31573_length_415_cov_161","Ntome_NODE_31899_length_556_cov_272",90.278,72,6,1,1,72,52,122,1.82e-18,93.5,71,70
"81726","Nsylvestris_NODE_31574_length_415_cov_30","Ntome_NODE_17980_length_1360_cov_29",87.879,396,21,11,1,382,1352,970,5.63e-123,440,381,382
"81730","Nsylvestris_NODE_31577_length_415_cov_7","Ntome_NODE_4880_length_3115_cov_200",84.524,168,19,6,1,165,1093,930,1.76e-38,159,164,163
"81731","Nsylvestris_NODE_31581_length_415_cov_6","Ntome_NODE_35720_length_347_cov_4",96.83,347,11,0,50,396,1,347,3.18e-165,580,346,346
"81732","Nsylvestris_NODE_31582_length_415_cov_5","Ntome_NODE_1227_length_4802_cov_140",97.115,416,11,1,1,415,1445,1860,0,701,414,415
"81733","Nsylvestris_NODE_31583_length_415_cov_5","Ntome_NODE_6080_length_2834_cov_105",99.036,415,4,0,1,415,1683,2097,0,745,414,414
"81734","Nsylvestris_NODE_31586_length_415_cov_4","Ntome_NODE_8483_length_2415_cov_26",96.275,349,10,3,49,394,1607,1259,6.88e-162,569,345,348
"81738","Nsylvestris_NODE_31589_length_415_cov_3","Ntome_NODE_20448_length_1158_cov_23",89.211,380,24,6,2,377,813,447,1.55e-128,459,375,366
"81747","Nsylvestris_NODE_31595_length_414_cov_130","Ntome_NODE_19048_length_1272_cov_116",91.608,429,21,1,1,414,516,88,1.14e-164,579,413,428
"81750","Nsylvestris_NODE_31602_length_414_cov_5","Ntome_NODE_10504_length_2132_cov_31",81.677,322,49,7,87,405,276,590,1.69e-68,259,318,314
"81751","Nsylvestris_NODE_31603_length_401_cov_5","Ntome_NODE_26305_length_792_cov_63",87.336,229,21,5,102,322,265,37,2.11e-67,255,220,228
"81752","Nsylvestris_NODE_31605_length_414_cov_4","Ntome_NODE_1921_length_4224_cov_179",96.535,404,14,0,11,414,1995,1592,0,669,403,403
"81753","Nsylvestris_NODE_31607_length_414_cov_4","Ntome_NODE_4402_length_3238_cov_53",98.068,414,8,0,1,414,1063,1476,0,721,413,413
"81756","Nsylvestris_NODE_31609_length_414_cov_3","Ntome_NODE_18745_length_1296_cov_139",85.39,397,49,7,1,390,781,387,7.36e-112,403,389,394
"81757","Nsylvestris_NODE_31614_length_413_cov_12","Ntome_NODE_12050_length_1952_cov_14",90.974,421,28,5,1,412,1114,695,1.48e-158,558,411,419
"81761","Nsylvestris_NODE_31617_length_413_cov_7","Ntome_NODE_10745_length_2102_cov_83",89.474,418,30,9,1,413,1189,1597,9.04e-146,516,412,408
"81764","Nsylvestris_NODE_31622_length_413_cov_4","Ntome_NODE_21016_length_1115_cov_8",86.275,357,35,3,1,356,589,932,1.6e-103,375,355,343
"81765","Nsylvestris_NODE_31623_length_413_cov_4","Ntome_NODE_8443_length_2421_cov_274",100,44,0,0,370,413,1509,1552,3.91e-15,82.4,43,43
"81766","Nsylvestris_NODE_31627_length_412_cov_249","Ntome_NODE_16100_length_1531_cov_141",97.33,412,11,0,1,412,889,478,0,701,411,411
"81776","Nsylvestris_NODE_31635_length_412_cov_11","Ntome_NODE_18945_length_1281_cov_80",88.235,68,7,1,297,363,605,538,1.4e-14,80.5,66,67
"81788","Nsylvestris_NODE_31647_length_411_cov_169","Ntome_NODE_149_length_7848_cov_117",88.649,185,18,3,227,411,4759,4940,2.2e-57,222,184,181
"81794","Nsylvestris_NODE_31656_length_411_cov_3","Ntome_NODE_1970_length_4195_cov_115",95.62,411,17,1,2,411,2233,2643,0,658,409,410
"81795","Nsylvestris_NODE_31657_length_411_cov_3","Ntome_NODE_16782_length_1468_cov_32",95.62,411,18,0,1,411,490,80,0,660,410,410
"81796","Nsylvestris_NODE_31659_length_411_cov_2","Ntome_NODE_4486_length_3213_cov_161",92.978,413,25,3,2,411,1090,1501,8.68e-171,599,409,411
"81797","Nsylvestris_NODE_31660_length_410_cov_138","Ntome_NODE_28596_length_684_cov_117",100,96,0,0,315,410,402,497,4.81e-44,178,95,95
"81813","Nsylvestris_NODE_31667_length_410_cov_6","Ntome_NODE_30400_length_612_cov_15",90.217,92,9,0,18,109,32,123,8.22e-27,121,91,91
"81814","Nsylvestris_NODE_31672_length_410_cov_3","Ntome_NODE_33676_length_436_cov_2",94.468,235,13,0,1,235,235,1,1.24e-99,363,234,234
"81815","Nsylvestris_NODE_31674_length_409_cov_31","Ntome_NODE_5024_length_3073_cov_177",92.537,402,16,8,2,391,2674,3073,3.15e-160,564,389,399
"81816","Nsylvestris_NODE_31682_length_409_cov_4","Ntome_NODE_24894_length_870_cov_4",92.905,296,21,0,2,297,44,339,3.33e-120,431,295,295
"81820","Nsylvestris_NODE_31685_length_409_cov_3","Ntome_NODE_25_length_11054_cov_122",79.087,416,65,11,14,407,2460,2875,9.95e-71,267,393,415
"81830","Nsylvestris_NODE_31695_length_408_cov_5","Ntome_NODE_33577_length_441_cov_17",87.468,391,26,12,1,374,385,1,1.2e-119,429,373,384
"81836","Nsylvestris_NODE_31703_length_408_cov_3","Ntome_NODE_13716_length_1766_cov_98",97.727,44,1,0,192,235,506,549,1.8e-13,76.8,43,43
"81842","Nsylvestris_NODE_31707_length_407_cov_9","Ntome_NODE_25972_length_807_cov_54",87.778,180,21,1,1,180,716,538,1.69e-53,209,179,178
"81843","Nsylvestris_NODE_31710_length_407_cov_7","Ntome_NODE_577_length_5817_cov_148",89.074,421,28,12,1,407,3137,3553,5.36e-143,507,406,416
"81844","Nsylvestris_NODE_31711_length_407_cov_6","Ntome_NODE_5334_length_3000_cov_52",85.852,311,31,6,66,370,1433,1130,2.69e-86,318,304,303
"81845","Nsylvestris_NODE_31714_length_407_cov_5","Ntome_NODE_15390_length_1595_cov_73",93.96,149,8,1,7,154,197,49,6.04e-58,224,147,148
"81846","Nsylvestris_NODE_31717_length_407_cov_5","Ntome_NODE_1225_length_4807_cov_19",92.629,407,30,0,1,407,2873,2467,6.69e-167,586,406,406
"81847","Nsylvestris_NODE_31718_length_407_cov_5","Ntome_NODE_26634_length_776_cov_25",91.912,408,15,6,1,407,747,357,1.89e-157,555,406,390
"81850","Nsylvestris_NODE_31723_length_407_cov_4","Ntome_NODE_37346_length_303_cov_2",95.05,303,15,0,9,311,1,303,4.2e-134,477,302,302
"81853","Nsylvestris_NODE_31730_length_406_cov_176","Ntome_NODE_857_length_5286_cov_201",100,56,0,0,351,406,2309,2254,8.19e-22,104,55,55
"81854","Nsylvestris_NODE_31731_length_406_cov_17","Ntome_NODE_31766_length_561_cov_148",87.037,216,22,5,30,243,7,218,2.15e-62,239,213,211
"81862","Nsylvestris_NODE_31739_length_406_cov_7","Ntome_NODE_9560_length_2257_cov_132",82.353,204,29,7,98,300,2126,1929,7.96e-42,171,202,197
"81865","Nsylvestris_NODE_31742_length_406_cov_5","Ntome_NODE_5096_length_3055_cov_50",98.03,406,8,0,1,406,774,1179,0,706,405,405
"81872","Nsylvestris_NODE_31746_length_406_cov_4","Ntome_NODE_8403_length_2427_cov_19",94.62,316,17,0,91,406,305,620,5.38e-138,490,315,315
"81882","Nsylvestris_NODE_31756_length_405_cov_9","Ntome_NODE_19081_length_1268_cov_257",92.804,403,11,9,1,385,1174,772,2.41e-161,568,384,402
"81883","Nsylvestris_NODE_31760_length_405_cov_7","Ntome_NODE_18444_length_1322_cov_9",95.918,392,16,0,1,392,855,1246,0,636,391,391
"81884","Nsylvestris_NODE_31763_length_405_cov_5","Ntome_NODE_11502_length_2014_cov_98",89.086,394,22,3,1,373,368,761,6.99e-132,470,372,393
"81885","Nsylvestris_NODE_31766_length_405_cov_3","Ntome_NODE_9617_length_2251_cov_43",93.333,150,9,1,256,405,1155,1007,7.78e-57,220,149,148
"81888","Nsylvestris_NODE_31768_length_405_cov_3","Ntome_NODE_36094_length_336_cov_3",95.431,197,6,2,209,405,336,143,4.49e-84,311,196,193
"81889","Nsylvestris_NODE_31769_length_405_cov_3","Ntome_NODE_885_length_5244_cov_42",95.309,405,17,2,1,405,3566,3164,0,641,404,402
"81897","Nsylvestris_NODE_31775_length_404_cov_188","Ntome_NODE_2900_length_3734_cov_147",92.754,69,3,2,169,236,332,265,3.79e-20,99,67,67
"81898","Nsylvestris_NODE_31776_length_404_cov_172","Ntome_NODE_12270_length_1924_cov_270",85.533,394,21,14,23,404,1722,1353,1.21e-104,379,381,369
"81902","Nsylvestris_NODE_31778_length_404_cov_116","Ntome_NODE_649_length_5651_cov_29",94.307,404,23,0,1,404,3132,2729,6.55e-177,619,403,403
"81903","Nsylvestris_NODE_31779_length_404_cov_21","Ntome_NODE_35099_length_370_cov_11",90.741,270,24,1,15,284,18,286,1.58e-98,359,269,268
"81906","Nsylvestris_NODE_31784_length_404_cov_7","Ntome_NODE_34495_length_395_cov_9",96.571,175,4,1,232,404,1,175,2.1e-77,289,172,174
"81907","Nsylvestris_NODE_31785_length_404_cov_6","Ntome_NODE_11801_length_1981_cov_14",85.856,403,52,3,4,404,1095,1494,5.51e-118,424,400,399
"81908","Nsylvestris_NODE_31786_length_404_cov_6","Ntome_NODE_29759_length_638_cov_11",94.03,402,8,2,1,392,100,495,1.1e-169,595,391,395
"81909","Nsylvestris_NODE_31791_length_404_cov_4","Ntome_NODE_30601_length_604_cov_7",90.476,378,33,3,24,401,95,469,1.15e-139,496,377,374
"81910","Nsylvestris_NODE_31792_length_404_cov_4","Ntome_NODE_30885_length_593_cov_8",93.151,219,11,3,1,215,219,1,2.67e-86,318,214,218
"81911","Nsylvestris_NODE_31793_length_404_cov_3","Ntome_NODE_8246_length_2452_cov_110",86.849,403,28,4,13,404,1513,1125,4.26e-119,427,391,388
"81912","Nsylvestris_NODE_31794_length_404_cov_2","Ntome_NODE_123_length_8118_cov_100",85.309,388,57,0,6,393,6300,6687,2.58e-111,401,387,387
"81921","Nsylvestris_NODE_31803_length_403_cov_8","Ntome_NODE_26_length_10987_cov_140",92.228,193,14,1,196,388,1071,880,2.11e-72,272,192,191
"81922","Nsylvestris_NODE_31805_length_403_cov_6","Ntome_NODE_22687_length_1004_cov_90",76.768,396,86,6,1,393,678,286,1e-55,217,392,392
"81923","Nsylvestris_NODE_31806_length_403_cov_5","Ntome_NODE_30017_length_627_cov_12",96.114,386,15,0,1,386,141,526,3.02e-180,630,385,385
"81929","Nsylvestris_NODE_31815_length_403_cov_3","Ntome_NODE_1117_length_4930_cov_102",91.687,409,28,5,1,403,2153,2561,1.12e-159,562,402,408
"81930","Nsylvestris_NODE_31818_length_403_cov_2","Ntome_NODE_7185_length_2625_cov_12",84.08,402,46,9,5,403,345,731,2.02e-102,372,398,386
"81936","Nsylvestris_NODE_31822_length_402_cov_8","Ntome_NODE_34656_length_388_cov_13",91.239,331,28,1,72,402,349,20,9.04e-126,449,330,329
"81937","Nsylvestris_NODE_31825_length_402_cov_7","Ntome_NODE_5478_length_2968_cov_131",88.517,209,22,2,196,402,1941,1733,2.74e-66,252,206,208
"81938","Nsylvestris_NODE_31829_length_402_cov_5","Ntome_NODE_1117_length_4930_cov_102",88.083,386,46,0,5,390,1290,905,1.5e-128,459,385,385
"81939","Nsylvestris_NODE_31831_length_402_cov_5","Ntome_NODE_5952_length_2861_cov_26",90.842,404,30,6,1,401,1361,962,2.43e-151,534,400,399
"81940","Nsylvestris_NODE_31839_length_401_cov_242","Ntome_NODE_560_length_5870_cov_259",98.504,401,6,0,1,401,1723,1323,0,708,400,400
"81945","Nsylvestris_NODE_31845_length_401_cov_15","Ntome_NODE_25185_length_852_cov_193",91.206,398,22,4,11,401,608,217,1.13e-149,529,390,391
"81946","Nsylvestris_NODE_31846_length_401_cov_9","Ntome_NODE_7194_length_2623_cov_17",95.262,401,19,0,1,401,598,998,0,636,400,400
"81947","Nsylvestris_NODE_31848_length_401_cov_8","Ntome_NODE_7194_length_2623_cov_17",95.778,379,14,2,1,378,2139,2516,3.91e-174,610,377,377
"81948","Nsylvestris_NODE_31850_length_401_cov_6","Ntome_NODE_26426_length_786_cov_8",93.611,360,18,3,1,358,233,589,8.7e-151,532,357,356
"81949","Nsylvestris_NODE_31851_length_401_cov_5","Ntome_NODE_4358_length_3248_cov_161",88.608,79,8,1,212,290,3130,3053,4.87e-19,95.3,78,77
"81950","Nsylvestris_NODE_31858_length_400_cov_196","Ntome_NODE_11172_length_2052_cov_269",95.99,399,16,0,2,400,555,157,0,649,398,398
"81956","Nsylvestris_NODE_31863_length_400_cov_8","Ntome_NODE_32824_length_490_cov_7",77.714,350,50,12,45,375,410,70,2.16e-47,189,330,340
"81957","Nsylvestris_NODE_31865_length_400_cov_6","Ntome_NODE_1161_length_4886_cov_55",97.859,327,7,0,73,399,3773,4099,8.56e-161,566,326,326
"81960","Nsylvestris_NODE_31867_length_400_cov_5","Ntome_NODE_37653_length_296_cov_4",89.562,297,14,2,88,368,1,296,4.33e-99,361,280,295
"81961","Nsylvestris_NODE_31873_length_400_cov_3","Ntome_NODE_33962_length_421_cov_4",90.254,236,20,3,1,234,184,418,2.06e-82,305,233,234
"81965","Nsylvestris_NODE_31881_length_399_cov_6","Ntome_NODE_28164_length_703_cov_13",93.415,410,12,4,1,395,59,468,3.91e-169,593,394,409
"81969","Nsylvestris_NODE_31884_length_399_cov_4","Ntome_NODE_18535_length_1313_cov_15",93.132,364,17,3,1,356,1283,920,4.03e-149,527,355,363
"81970","Nsylvestris_NODE_31887_length_399_cov_3","Ntome_NODE_7519_length_2567_cov_290",97.917,48,1,0,1,48,1636,1683,1.05e-15,84.2,47,47
"81971","Nsylvestris_NODE_31888_length_399_cov_3","Ntome_NODE_14646_length_1673_cov_22",83.871,403,33,10,2,399,282,657,2.01e-97,355,397,375
"81972","Nsylvestris_NODE_31889_length_399_cov_3","Ntome_NODE_39949_length_250_cov_3",92.035,113,6,1,3,115,110,1,2.19e-37,156,112,109
"81980","Nsylvestris_NODE_31894_length_398_cov_166","Ntome_NODE_23768_length_938_cov_255",88.52,331,9,12,71,398,889,585,5.54e-103,374,327,304
"81986","Nsylvestris_NODE_31897_length_398_cov_11","Ntome_NODE_15040_length_1631_cov_85",90.489,368,27,3,32,398,952,592,1.14e-134,479,366,360
"81994","Nsylvestris_NODE_31900_length_398_cov_8","Ntome_NODE_10425_length_2143_cov_11",92.203,295,21,2,105,398,1929,1636,9.07e-116,416,293,293
"81995","Nsylvestris_NODE_31905_length_398_cov_6","Ntome_NODE_21217_length_1101_cov_10",100,30,0,0,366,395,771,800,2.28e-07,56.5,29,29
"81996","Nsylvestris_NODE_31911_length_398_cov_4","Ntome_NODE_22285_length_1029_cov_32",80.478,251,49,0,148,398,677,427,1.66e-48,193,250,250
"81997","Nsylvestris_NODE_31913_length_398_cov_3","Ntome_NODE_7313_length_2602_cov_96",93.171,205,8,3,16,220,1765,1963,1.23e-79,296,204,198
"82001","Nsylvestris_NODE_31918_length_398_cov_2","Ntome_NODE_28705_length_680_cov_19",94.37,373,21,0,1,373,273,645,5.09e-163,573,372,372
"82002","Nsylvestris_NODE_31920_length_398_cov_2","Ntome_NODE_34559_length_393_cov_4",95.965,347,8,2,56,398,1,345,1.42e-158,558,342,344
"82008","Nsylvestris_NODE_31924_length_397_cov_32","Ntome_NODE_20483_length_1155_cov_11",86.601,306,34,6,84,386,841,540,3.37e-90,331,302,301
"82009","Nsylvestris_NODE_31925_length_397_cov_16","Ntome_NODE_28135_length_704_cov_46",85.606,132,15,4,3,131,572,702,2.84e-31,135,128,130
"82010","Nsylvestris_NODE_31926_length_397_cov_16","Ntome_NODE_23976_length_926_cov_277",100,34,0,0,1,34,348,381,1.36e-09,63.9,33,33
"82014","Nsylvestris_NODE_31935_length_397_cov_5","Ntome_NODE_14344_length_1701_cov_28",92.714,398,21,4,1,397,696,1086,2.36e-161,568,396,390
"82015","Nsylvestris_NODE_31936_length_397_cov_4","Ntome_NODE_26236_length_795_cov_99",92.768,401,20,3,1,392,722,322,1.82e-162,571,391,400
"82016","Nsylvestris_NODE_31941_length_396_cov_200","Ntome_NODE_21740_length_1065_cov_261",97.443,352,9,0,1,352,451,100,2.32e-171,601,351,351
"82017","Nsylvestris_NODE_31942_length_396_cov_199","Ntome_NODE_8370_length_2431_cov_281",97.436,39,1,0,1,39,1660,1622,1.05e-10,67.6,38,38
"82023","Nsylvestris_NODE_31945_length_396_cov_14","Ntome_NODE_34393_length_400_cov_41",94.474,380,20,1,17,396,400,22,2.34e-166,584,379,378
"82030","Nsylvestris_NODE_31952_length_396_cov_5","Ntome_NODE_22961_length_986_cov_6",90.5,200,8,6,1,194,247,441,7.49e-67,254,193,194
"82034","Nsylvestris_NODE_31956_length_395_cov_247","Ntome_NODE_8369_length_2431_cov_284",95.19,395,19,0,1,395,1694,2088,1.37e-178,625,394,394
"82035","Nsylvestris_NODE_31957_length_395_cov_11","Ntome_NODE_32731_length_496_cov_10",97.368,114,3,0,134,247,496,383,4.59e-49,195,113,113
"82036","Nsylvestris_NODE_31958_length_395_cov_10","Ntome_NODE_3812_length_3416_cov_131",87.006,177,19,2,123,296,1195,1020,1.28e-49,196,173,175
"82040","Nsylvestris_NODE_31962_length_395_cov_7","Ntome_NODE_26869_length_765_cov_12",90.594,202,11,6,1,198,238,435,4.46e-69,261,197,197
"82041","Nsylvestris_NODE_31963_length_395_cov_6","Ntome_NODE_3646_length_3472_cov_38",92.487,386,28,1,1,385,3095,2710,2.36e-156,551,384,385
"82042","Nsylvestris_NODE_31967_length_394_cov_5","Ntome_NODE_4603_length_3182_cov_51",81.746,378,41,13,11,366,2111,1740,5.67e-78,291,355,371
"82045","Nsylvestris_NODE_31970_length_395_cov_4","Ntome_NODE_3259_length_3603_cov_63",82.175,331,55,4,1,330,2297,1970,3.42e-75,281,329,327
"82046","Nsylvestris_NODE_31971_length_395_cov_4","Ntome_NODE_9091_length_2325_cov_13",91.624,394,31,2,2,394,1693,1301,3.96e-154,544,392,392
"82050","Nsylvestris_NODE_31975_length_395_cov_3","Ntome_NODE_4496_length_3210_cov_220",100,52,0,0,344,395,1889,1838,1.33e-19,97.1,51,51
"82055","Nsylvestris_NODE_31983_length_395_cov_2","Ntome_NODE_32596_length_506_cov_18",85.175,371,28,12,1,369,33,378,1.99e-97,355,368,345
"82061","Nsylvestris_NODE_31986_length_394_cov_20","Ntome_NODE_27362_length_740_cov_16",95.431,394,18,0,1,394,202,595,1.06e-179,628,393,393
"82064","Nsylvestris_NODE_31991_length_394_cov_7","Ntome_NODE_679_length_5601_cov_90",96.347,219,8,0,170,388,2937,2719,4.26e-99,361,218,218
"82065","Nsylvestris_NODE_31993_length_394_cov_6","Ntome_NODE_11348_length_2031_cov_243",90.566,53,3,1,343,393,1547,1495,2.89e-11,69.4,50,52
"82066","Nsylvestris_NODE_31997_length_394_cov_5","Ntome_NODE_38265_length_283_cov_3",93.902,246,14,1,21,265,246,1,7.09e-102,370,244,245
"82072","Nsylvestris_NODE_32002_length_394_cov_4","Ntome_NODE_35323_length_361_cov_4",97.541,122,3,0,3,124,122,1,1.63e-53,209,121,121
"82073","Nsylvestris_NODE_32003_length_394_cov_3","Ntome_NODE_13440_length_1792_cov_35",89.691,388,31,7,13,394,271,655,6.74e-137,486,381,384
"82074","Nsylvestris_NODE_32004_length_394_cov_3","Ntome_NODE_1423_length_4607_cov_132",90.404,396,31,4,1,394,1747,2137,3.09e-145,514,393,390
"82075","Nsylvestris_NODE_32005_length_394_cov_2","Ntome_NODE_33896_length_424_cov_43",87.831,378,35,10,6,382,57,424,8.91e-121,433,376,367
"82076","Nsylvestris_NODE_32006_length_392_cov_190","Ntome_NODE_12125_length_1942_cov_183",97.297,370,8,1,23,392,1939,1572,3.79e-179,627,369,367
"82077","Nsylvestris_NODE_32007_length_393_cov_127","Ntome_NODE_3298_length_3587_cov_283",89.518,353,24,10,1,344,3098,3446,2.47e-121,435,343,348
"82085","Nsylvestris_NODE_32016_length_393_cov_5","Ntome_NODE_1809_length_4300_cov_203",92.965,398,22,3,1,393,2681,3077,1.4e-163,575,392,396
"82086","Nsylvestris_NODE_32017_length_393_cov_4","Ntome_NODE_9090_length_2325_cov_17",83.946,299,21,8,59,351,1960,2237,4.44e-69,261,292,277
"82087","Nsylvestris_NODE_32021_length_393_cov_4","Ntome_NODE_1516_length_4524_cov_238",96.954,394,11,1,1,393,2987,3380,0,660,392,393
"82088","Nsylvestris_NODE_32022_length_393_cov_4","Ntome_NODE_1227_length_4802_cov_140",94.177,395,16,5,1,393,2327,1938,1.07e-169,595,392,389
"82089","Nsylvestris_NODE_32024_length_393_cov_4","Ntome_NODE_10491_length_2133_cov_175",89.031,392,40,1,2,390,791,1182,8.7e-136,483,388,391
"82092","Nsylvestris_NODE_32026_length_393_cov_2","Ntome_NODE_7607_length_2553_cov_104",96.183,393,15,0,1,393,1669,1277,0,643,392,392
"82098","Nsylvestris_NODE_32030_length_392_cov_189","Ntome_NODE_12124_length_1942_cov_187",85.882,425,25,9,1,391,594,171,6.9e-117,420,390,423
"82099","Nsylvestris_NODE_32031_length_392_cov_174","Ntome_NODE_27316_length_742_cov_239",90.71,366,8,6,1,342,405,42,3.14e-130,464,341,363
"82100","Nsylvestris_NODE_32032_length_392_cov_20","Ntome_NODE_34572_length_392_cov_8",90.181,387,32,4,4,386,389,5,8.61e-141,499,382,384
"82101","Nsylvestris_NODE_32033_length_392_cov_9","Ntome_NODE_14900_length_1644_cov_222",87.936,373,25,13,27,392,1191,1550,1.92e-117,422,365,359
"82102","Nsylvestris_NODE_32036_length_392_cov_6","Ntome_NODE_34164_length_411_cov_4",90.411,365,23,5,31,392,1,356,6.75e-132,470,361,355
"82107","Nsylvestris_NODE_32045_length_392_cov_4","Ntome_NODE_24778_length_876_cov_7",95.397,239,8,2,51,287,637,874,4.21e-104,377,236,237
"82108","Nsylvestris_NODE_32046_length_392_cov_4","Ntome_NODE_2324_length_3995_cov_244",96.382,304,8,2,2,303,2642,2944,3.1e-140,497,301,302
"82109","Nsylvestris_NODE_32049_length_392_cov_3","Ntome_NODE_9849_length_2219_cov_11",92.203,295,23,0,1,295,321,615,2.48e-116,418,294,294
"82112","Nsylvestris_NODE_32051_length_392_cov_3","Ntome_NODE_38237_length_284_cov_3",87.814,279,11,11,32,293,12,284,2.02e-82,305,261,272
"82113","Nsylvestris_NODE_32053_length_392_cov_2","Ntome_NODE_689_length_5578_cov_127",93.017,401,14,6,4,392,3124,2726,5e-163,573,388,398
"82114","Nsylvestris_NODE_32055_length_392_cov_2","Ntome_NODE_3286_length_3592_cov_55",87.143,70,7,2,100,168,2364,2296,4.78e-14,78.7,68,68
"82118","Nsylvestris_NODE_32058_length_391_cov_150","Ntome_NODE_1130_length_4919_cov_168",88.073,327,11,14,53,351,327,1,1.18e-99,363,298,326
"82119","Nsylvestris_NODE_32059_length_391_cov_13","Ntome_NODE_28202_length_701_cov_35",86.649,382,38,9,1,372,492,114,4.14e-114,411,371,378
"82122","Nsylvestris_NODE_32062_length_391_cov_7","Ntome_NODE_319_length_6631_cov_16",85.279,197,16,6,2,195,6498,6312,5.87e-48,191,193,186
"82123","Nsylvestris_NODE_32064_length_391_cov_7","Ntome_NODE_33198_length_463_cov_25",74.104,251,52,7,28,276,103,342,6.13e-18,91.6,248,239
"82129","Nsylvestris_NODE_32075_length_391_cov_3","Ntome_NODE_12384_length_1911_cov_28",91.87,369,22,6,27,391,657,1021,1.43e-143,508,364,364
"82130","Nsylvestris_NODE_32077_length_390_cov_259","Ntome_NODE_21301_length_1094_cov_316",99.231,390,3,0,1,390,612,223,0,704,389,389
"82137","Nsylvestris_NODE_32080_length_390_cov_165","Ntome_NODE_37917_length_290_cov_4",96.587,293,7,2,70,362,1,290,8.63e-136,483,292,289
"82138","Nsylvestris_NODE_32081_length_390_cov_152","Ntome_NODE_6263_length_2794_cov_241",90.043,231,20,2,4,233,1440,1668,1.21e-79,296,229,228
"82139","Nsylvestris_NODE_32082_length_390_cov_53","Ntome_NODE_25404_length_838_cov_220",84.881,377,22,14,1,377,428,769,3.28e-95,348,376,341
"82140","Nsylvestris_NODE_32084_length_390_cov_12","Ntome_NODE_21413_length_1087_cov_289",94.408,304,17,0,87,390,428,731,2.42e-131,468,303,303
"82144","Nsylvestris_NODE_32092_length_390_cov_5","Ntome_NODE_12823_length_1859_cov_180",93.557,388,25,0,1,388,390,777,1.07e-164,579,387,387
"82145","Nsylvestris_NODE_32093_length_390_cov_4","Ntome_NODE_18930_length_1282_cov_8",94.195,379,20,1,1,379,906,1282,3.85e-164,577,378,376
"82146","Nsylvestris_NODE_32094_length_390_cov_4","Ntome_NODE_16556_length_1491_cov_22",92.821,390,28,0,1,390,1035,1424,8.33e-161,566,389,389
"82147","Nsylvestris_NODE_32095_length_390_cov_4","Ntome_NODE_13284_length_1810_cov_134",88.652,282,22,6,3,276,393,114,2.56e-91,335,273,279
"82148","Nsylvestris_NODE_32098_length_390_cov_3","Ntome_NODE_3087_length_3663_cov_100",91.304,115,9,1,65,179,2743,2630,2.14e-37,156,114,113
"82160","Nsylvestris_NODE_32104_length_389_cov_14","Ntome_NODE_3606_length_3483_cov_163",81.102,127,16,6,188,307,1462,1587,4.71e-19,95.3,119,125
"82161","Nsylvestris_NODE_32105_length_389_cov_12","Ntome_NODE_13210_length_1818_cov_176",86.471,170,19,1,107,272,432,263,9.77e-46,183,165,169
"82162","Nsylvestris_NODE_32109_length_389_cov_7","Ntome_NODE_4423_length_3230_cov_209",91.878,394,23,3,1,386,2002,2394,1.4e-153,542,385,392
"82163","Nsylvestris_NODE_32111_length_389_cov_6","Ntome_NODE_10835_length_2092_cov_30",88.85,287,16,7,1,272,1993,1708,1.97e-92,339,271,285
"82164","Nsylvestris_NODE_32113_length_389_cov_5","Ntome_NODE_36388_length_328_cov_1",92.284,324,24,1,34,356,324,1,1.45e-128,459,322,323
"82165","Nsylvestris_NODE_32114_length_389_cov_5","Ntome_NODE_10662_length_2108_cov_151",87.032,347,29,6,9,341,407,63,4.18e-104,377,332,344
"82170","Nsylvestris_NODE_32125_length_388_cov_195","Ntome_NODE_6363_length_2775_cov_39",93.651,315,19,1,53,367,386,73,6.68e-132,470,314,313
"82174","Nsylvestris_NODE_32139_length_388_cov_4","Ntome_NODE_36442_length_326_cov_4",88.889,189,20,1,1,188,134,322,3.43e-60,231,187,188
"82175","Nsylvestris_NODE_32145_length_388_cov_3","Ntome_NODE_11398_length_2025_cov_284",98.113,53,1,0,336,388,1058,1006,1.69e-18,93.5,52,52
"82179","Nsylvestris_NODE_32151_length_387_cov_132","Ntome_NODE_20040_length_1188_cov_283",94.798,346,8,2,1,336,391,46,3.01e-150,531,335,345
"82180","Nsylvestris_NODE_32154_length_387_cov_8","Ntome_NODE_2185_length_4068_cov_89",93.662,142,7,1,248,387,3101,2960,4.46e-54,211,139,141
"82183","Nsylvestris_NODE_32162_length_387_cov_4","Ntome_NODE_24971_length_865_cov_40",96.134,388,13,2,1,387,262,648,0,632,386,386
"82195","Nsylvestris_NODE_32168_length_387_cov_3","Ntome_NODE_20745_length_1135_cov_74",94.845,388,19,1,1,387,629,242,1.75e-172,604,386,387
"82198","Nsylvestris_NODE_32171_length_386_cov_178","Ntome_NODE_19174_length_1261_cov_283",90.741,54,4,1,281,334,100,48,7.87e-12,71.3,53,52
"82207","Nsylvestris_NODE_32174_length_386_cov_11","Ntome_NODE_20703_length_1138_cov_22",84.551,356,24,11,4,345,339,1,5.47e-88,324,341,338
"82210","Nsylvestris_NODE_32177_length_386_cov_8","Ntome_NODE_4831_length_3120_cov_110",94.366,71,3,1,237,306,2147,2077,6e-23,108,69,70
"82211","Nsylvestris_NODE_32179_length_386_cov_6","Ntome_NODE_1541_length_4502_cov_287",97.872,47,1,0,1,47,652,606,3.64e-15,82.4,46,46
"82212","Nsylvestris_NODE_32180_length_386_cov_6","Ntome_NODE_35956_length_340_cov_4",93.004,243,17,0,1,243,98,340,1.94e-97,355,242,242
"82213","Nsylvestris_NODE_32182_length_386_cov_6","Ntome_NODE_28780_length_677_cov_19",85.823,395,17,14,1,386,512,148,8.9e-106,383,385,364
"82216","Nsylvestris_NODE_32184_length_386_cov_4","Ntome_NODE_33360_length_454_cov_4",95.439,285,13,0,1,285,166,450,1.86e-127,455,284,284
"82219","Nsylvestris_NODE_32190_length_386_cov_3","Ntome_NODE_12635_length_1883_cov_37",92.876,379,26,1,8,386,1287,910,8.3e-156,549,378,377
"82232","Nsylvestris_NODE_32199_length_385_cov_8","Ntome_NODE_28089_length_706_cov_53",95.584,385,17,0,1,385,467,83,2.24e-176,617,384,384
"82233","Nsylvestris_NODE_32202_length_385_cov_5","Ntome_NODE_26345_length_790_cov_11",88.974,390,24,10,1,384,402,26,3.08e-130,464,383,376
"82234","Nsylvestris_NODE_32203_length_385_cov_5","Ntome_NODE_10858_length_2089_cov_295",95.238,42,1,1,1,41,1103,1062,3.65e-10,65.8,40,41
"82235","Nsylvestris_NODE_32205_length_385_cov_5","Ntome_NODE_22792_length_997_cov_16",86.567,335,26,8,1,333,975,658,2.5e-96,351,332,317
"82239","Nsylvestris_NODE_32209_length_385_cov_4","Ntome_NODE_521_length_5963_cov_48",94.315,387,10,7,1,377,1723,1339,8.16e-166,582,376,384
"82242","Nsylvestris_NODE_32216_length_385_cov_2","Ntome_NODE_35461_length_356_cov_3",96.901,355,11,0,27,381,2,356,1.05e-169,595,354,354
"82243","Nsylvestris_NODE_32217_length_385_cov_2","Ntome_NODE_29209_length_660_cov_7",92.683,369,16,7,24,382,1,368,1.8e-147,521,358,367
"82244","Nsylvestris_NODE_32218_length_385_cov_2","Ntome_NODE_15713_length_1568_cov_13",97.035,371,11,0,15,385,687,1057,1.34e-178,625,370,370
"82245","Nsylvestris_NODE_32219_length_384_cov_234","Ntome_NODE_10461_length_2137_cov_25",93.523,386,23,1,1,384,852,1237,4.9e-163,573,383,385
"82248","Nsylvestris_NODE_32227_length_384_cov_6","Ntome_NODE_28734_length_679_cov_8",94.69,226,3,2,4,229,584,368,1.5e-93,342,225,216
"82249","Nsylvestris_NODE_32229_length_384_cov_6","Ntome_NODE_39543_length_257_cov_4",92.692,260,16,1,111,370,257,1,1.92e-102,372,259,256
"82253","Nsylvestris_NODE_32231_length_384_cov_6","Ntome_NODE_4251_length_3277_cov_30",80.155,388,69,6,1,381,2584,2970,9.24e-76,283,380,386
"82254","Nsylvestris_NODE_32233_length_384_cov_5","Ntome_NODE_15177_length_1616_cov_21",93.103,377,26,0,8,384,190,566,6.38e-157,553,376,376
"82255","Nsylvestris_NODE_32235_length_384_cov_5","Ntome_NODE_6143_length_2824_cov_21",91.667,384,32,0,1,384,1051,1434,8.31e-151,532,383,383
"82261","Nsylvestris_NODE_32241_length_384_cov_4","Ntome_NODE_1729_length_4359_cov_112",87.192,406,27,11,1,384,1867,1465,1.86e-122,438,383,402
"82262","Nsylvestris_NODE_32243_length_384_cov_4","Ntome_NODE_24778_length_876_cov_7",94.048,336,13,3,49,384,635,307,6.51e-142,503,335,328
"82263","Nsylvestris_NODE_32244_length_384_cov_3","Ntome_NODE_9541_length_2264_cov_16",93.639,393,16,3,1,384,1148,756,1.05e-164,579,383,392
"82264","Nsylvestris_NODE_32245_length_384_cov_2","Ntome_NODE_2339_length_3988_cov_307",97.872,47,1,0,1,47,2213,2259,3.62e-15,82.4,46,46
"82272","Nsylvestris_NODE_32250_length_383_cov_161","Ntome_NODE_17823_length_1373_cov_20",88.489,139,14,2,10,147,969,1106,9.68e-41,167,137,137
"82273","Nsylvestris_NODE_32255_length_383_cov_6","Ntome_NODE_38298_length_282_cov_5",93.19,279,16,2,87,362,1,279,5.24e-113,407,275,278
"82274","Nsylvestris_NODE_32256_length_383_cov_6","Ntome_NODE_8012_length_2489_cov_243",80.863,371,48,11,26,383,1634,1994,7.17e-72,270,357,360
"82278","Nsylvestris_NODE_32260_length_383_cov_4","Ntome_NODE_3161_length_3634_cov_20",93.211,383,23,2,1,380,785,1167,3.8e-159,560,379,382
"82279","Nsylvestris_NODE_32262_length_383_cov_3","Ntome_NODE_13679_length_1769_cov_219",89.441,161,15,2,207,365,490,650,2.65e-51,202,158,160
"82280","Nsylvestris_NODE_32263_length_383_cov_3","Ntome_NODE_15953_length_1543_cov_10",92.012,338,17,6,56,383,865,1202,8.52e-131,466,327,337
"82281","Nsylvestris_NODE_32264_length_383_cov_3","Ntome_NODE_35573_length_352_cov_5",95.846,337,12,2,1,335,337,1,3.83e-154,544,334,336
"82282","Nsylvestris_NODE_32267_length_382_cov_345","Ntome_NODE_975_length_5123_cov_110",98.168,382,7,0,1,382,2786,2405,0,667,381,381
"82283","Nsylvestris_NODE_32268_length_382_cov_169","Ntome_NODE_9358_length_2288_cov_149",95.812,382,14,2,1,382,2260,1881,7.98e-176,616,381,379
"82284","Nsylvestris_NODE_32270_length_382_cov_13","Ntome_NODE_172_length_7617_cov_161",86.885,122,12,2,9,126,4930,4809,9.79e-31,134,117,121
"82294","Nsylvestris_NODE_32280_length_382_cov_5","Ntome_NODE_17821_length_1373_cov_33",93.017,358,22,3,20,377,713,359,6.43e-147,520,357,354
"82295","Nsylvestris_NODE_32282_length_382_cov_4","Ntome_NODE_36953_length_312_cov_2",84.656,189,13,4,156,344,309,137,5.77e-43,174,188,172
"82299","Nsylvestris_NODE_32287_length_382_cov_3","Ntome_NODE_3382_length_3557_cov_57",93.351,376,23,2,7,382,1755,1382,1.76e-157,555,375,373
"82300","Nsylvestris_NODE_32290_length_382_cov_2","Ntome_NODE_451_length_6157_cov_184",92.147,382,30,0,1,382,4595,4214,4.94e-153,540,381,381
"82301","Nsylvestris_NODE_32291_length_382_cov_2","Ntome_NODE_11107_length_2059_cov_274",83.871,372,43,3,4,375,639,285,1.93e-92,339,371,354
"82302","Nsylvestris_NODE_32292_length_382_cov_2","Ntome_NODE_2428_length_3942_cov_186",89.378,386,30,5,1,379,1354,1735,1.41e-133,475,378,381
"82306","Nsylvestris_NODE_32294_length_382_cov_1","Ntome_NODE_25592_length_828_cov_18",83.577,274,38,4,103,370,522,794,9.32e-66,250,267,272
"82314","Nsylvestris_NODE_32298_length_381_cov_49","Ntome_NODE_28483_length_689_cov_137",89.958,239,12,5,142,370,324,88,3.27e-80,298,228,236
"82315","Nsylvestris_NODE_32299_length_381_cov_11","Ntome_NODE_30649_length_602_cov_16",83.408,223,15,11,3,225,209,9,7.39e-47,187,222,200
"82316","Nsylvestris_NODE_32300_length_381_cov_10","Ntome_NODE_40_length_10198_cov_97",94.751,381,20,0,1,381,7357,7737,3.73e-169,593,380,380
"82319","Nsylvestris_NODE_32305_length_381_cov_6","Ntome_NODE_18231_length_1340_cov_66",93.956,364,21,1,1,364,220,582,8.18e-156,549,363,362
"82320","Nsylvestris_NODE_32306_length_381_cov_5","Ntome_NODE_2355_length_3983_cov_58",93.112,392,16,2,1,381,398,789,2.92e-160,564,380,391
"82321","Nsylvestris_NODE_32307_length_381_cov_5","Ntome_NODE_33377_length_453_cov_3",86.207,290,29,5,1,279,345,56,7.03e-82,303,278,289
"82322","Nsylvestris_NODE_32311_length_381_cov_3","Ntome_NODE_13154_length_1825_cov_15",91.503,306,22,4,54,358,664,966,2.41e-116,418,304,302
"82326","Nsylvestris_NODE_32317_length_381_cov_2","Ntome_NODE_8483_length_2415_cov_26",95.288,382,17,1,1,381,846,465,1.72e-172,604,380,381
"82330","Nsylvestris_NODE_32319_length_380_cov_206","Ntome_NODE_11487_length_2015_cov_293",95.195,333,12,2,51,380,175,506,4.94e-148,523,329,331
"82334","Nsylvestris_NODE_32325_length_380_cov_5","Ntome_NODE_1169_length_4876_cov_127",96.817,377,11,1,4,380,3900,3525,1.02e-179,628,376,375
"82335","Nsylvestris_NODE_32328_length_380_cov_4","Ntome_NODE_15326_length_1602_cov_30",86.351,359,28,14,1,338,454,96,1.9e-102,372,337,358
"82336","Nsylvestris_NODE_32329_length_380_cov_4","Ntome_NODE_13215_length_1818_cov_29",81.186,388,49,15,14,380,1302,918,5.46e-78,291,366,384
"82337","Nsylvestris_NODE_32331_length_380_cov_3","Ntome_NODE_768_length_5437_cov_290",91.803,61,5,0,65,125,4124,4184,2.77e-16,86.1,60,60
"82338","Nsylvestris_NODE_32334_length_380_cov_2","Ntome_NODE_11740_length_1988_cov_11",87.468,391,35,6,1,378,826,437,1.84e-122,438,377,389
"82339","Nsylvestris_NODE_32335_length_380_cov_2","Ntome_NODE_8267_length_2447_cov_28",97.632,380,9,0,1,380,1673,1294,0,652,379,379
"82345","Nsylvestris_NODE_32341_length_379_cov_12","Ntome_NODE_34980_length_375_cov_8",90.377,239,17,3,144,379,1,236,1.5e-83,309,235,235
"82346","Nsylvestris_NODE_32346_length_379_cov_6","Ntome_NODE_13972_length_1740_cov_222",84.031,382,52,4,2,378,216,593,1.47e-98,359,376,377
"82347","Nsylvestris_NODE_32347_length_379_cov_6","Ntome_NODE_11127_length_2057_cov_12",97.361,379,10,0,1,379,1495,1873,0,645,378,378
"82348","Nsylvestris_NODE_32348_length_379_cov_4","Ntome_NODE_10533_length_2128_cov_23",86.834,319,42,0,2,320,1087,1405,5.29e-98,357,318,318
"82349","Nsylvestris_NODE_32349_length_379_cov_3","Ntome_NODE_38002_length_288_cov_5",97.569,288,7,0,76,363,288,1,3.87e-139,494,287,287
"82350","Nsylvestris_NODE_32351_length_379_cov_2","Ntome_NODE_24309_length_905_cov_38",92.248,129,9,1,3,130,710,838,3.42e-45,182,127,128
"82351","Nsylvestris_NODE_32352_length_379_cov_2","Ntome_NODE_26727_length_772_cov_5",93.298,373,19,1,5,377,560,194,1.05e-154,545,372,366
"82355","Nsylvestris_NODE_32355_length_378_cov_12","Ntome_NODE_35338_length_360_cov_16",83.473,357,25,13,9,357,25,355,2.51e-81,302,348,330
"82359","Nsylvestris_NODE_32359_length_378_cov_7","Ntome_NODE_794_length_5393_cov_87",85.675,363,52,0,10,372,2110,2472,8.71e-106,383,362,362
"82370","Nsylvestris_NODE_32369_length_378_cov_3","Ntome_NODE_38494_length_278_cov_4",82.969,229,38,1,151,378,276,48,2.02e-52,206,227,228
"82371","Nsylvestris_NODE_32372_length_378_cov_1","Ntome_NODE_27955_length_713_cov_5",96,50,2,0,110,159,664,713,3.56e-15,82.4,49,49
"82374","Nsylvestris_NODE_32375_length_377_cov_124","Ntome_NODE_8369_length_2431_cov_284",91.316,380,26,4,3,377,2411,2034,1.06e-144,512,374,377
"82380","Nsylvestris_NODE_32381_length_377_cov_6","Ntome_NODE_11367_length_2029_cov_124",86.331,278,19,10,2,274,1962,1699,2.52e-76,285,272,263
"82381","Nsylvestris_NODE_32382_length_377_cov_6","Ntome_NODE_12055_length_1951_cov_12",88.889,144,15,1,222,365,1042,1184,1.58e-43,176,143,142
"82382","Nsylvestris_NODE_32384_length_377_cov_5","Ntome_NODE_14646_length_1673_cov_22",87.966,349,30,7,1,341,1092,748,2.4e-111,401,340,344
"82383","Nsylvestris_NODE_32389_length_377_cov_4","Ntome_NODE_1341_length_4691_cov_248",77.089,371,67,11,1,365,3334,3692,3.38e-50,198,364,358
"82386","Nsylvestris_NODE_32391_length_377_cov_3","Ntome_NODE_2605_length_3857_cov_87",93.005,386,18,3,1,377,3056,3441,1.74e-157,555,376,385
"82392","Nsylvestris_NODE_32398_length_376_cov_148","Ntome_NODE_20034_length_1189_cov_142",93.14,379,12,6,1,365,600,222,3.75e-154,544,364,378
"82399","Nsylvestris_NODE_32405_length_376_cov_7","Ntome_NODE_25110_length_857_cov_15",90.283,247,16,4,126,368,220,462,8.91e-86,316,242,242
"82400","Nsylvestris_NODE_32407_length_376_cov_6","Ntome_NODE_621_length_5720_cov_100",82.178,101,17,1,35,135,2817,2718,2.73e-16,86.1,100,99
"82401","Nsylvestris_NODE_32410_length_376_cov_4","Ntome_NODE_2482_length_3916_cov_62",94.03,268,11,4,112,376,3557,3292,2.39e-111,401,264,265
"82402","Nsylvestris_NODE_32412_length_376_cov_4","Ntome_NODE_4417_length_3234_cov_49",90.323,279,23,4,97,375,2187,2461,1.13e-99,363,278,274
"82403","Nsylvestris_NODE_32413_length_376_cov_4","Ntome_NODE_10711_length_2106_cov_17",90.133,375,30,5,4,376,1137,768,2.98e-135,481,372,369
"82404","Nsylvestris_NODE_32418_length_376_cov_3","Ntome_NODE_18978_length_1278_cov_143",90.16,376,37,0,1,376,812,437,4.96e-138,490,375,375
"82405","Nsylvestris_NODE_32421_length_376_cov_2","Ntome_NODE_22735_length_1003_cov_232",98.077,52,1,0,11,62,542,593,5.88e-18,91.6,51,51
"82406","Nsylvestris_NODE_32425_length_375_cov_30","Ntome_NODE_13510_length_1785_cov_77",94.152,342,7,6,3,340,1411,1743,1.37e-143,508,337,332
"82407","Nsylvestris_NODE_32428_length_375_cov_10","Ntome_NODE_17954_length_1362_cov_145",100,75,0,0,45,119,773,699,2.06e-32,139,74,74
"82412","Nsylvestris_NODE_32435_length_375_cov_6","Ntome_NODE_33891_length_425_cov_4",87.719,399,21,18,1,375,3,397,5.05e-123,440,374,394
"82416","Nsylvestris_NODE_32437_length_375_cov_5","Ntome_NODE_10350_length_2152_cov_102",82.507,343,34,13,31,370,385,66,4.19e-74,278,339,319
"82422","Nsylvestris_NODE_32447_length_374_cov_8","Ntome_NODE_26920_length_762_cov_214",91.63,227,14,3,87,311,121,344,1.49e-83,309,224,223
"82423","Nsylvestris_NODE_32450_length_374_cov_7","Ntome_NODE_10265_length_2161_cov_23",97.043,372,11,0,1,372,537,908,3.61e-179,627,371,371
"82424","Nsylvestris_NODE_32455_length_374_cov_6","Ntome_NODE_25673_length_823_cov_22",92.533,375,25,3,1,374,200,572,2.25e-151,534,373,372
"82425","Nsylvestris_NODE_32458_length_374_cov_3","Ntome_NODE_10037_length_2195_cov_116",93.85,374,23,0,1,374,1234,861,2.87e-160,564,373,373
"82426","Nsylvestris_NODE_32461_length_374_cov_2","Ntome_NODE_13861_length_1750_cov_25",89.937,318,26,5,58,374,840,1152,1.84e-112,405,316,312
"82427","Nsylvestris_NODE_32462_length_374_cov_2","Ntome_NODE_3367_length_3562_cov_187",87.594,266,31,2,93,357,1431,1695,5.35e-83,307,264,264
"82428","Nsylvestris_NODE_32463_length_373_cov_242","Ntome_NODE_9895_length_2213_cov_281",99.196,373,3,0,1,373,1365,993,0,673,372,372
"82429","Nsylvestris_NODE_32464_length_373_cov_169","Ntome_NODE_1146_length_4902_cov_288",89.003,391,20,7,1,373,4902,4517,1.08e-129,462,372,385
"82438","Nsylvestris_NODE_32472_length_373_cov_5","Ntome_NODE_382_length_6389_cov_119",83.03,330,55,1,44,373,4188,4516,3.21e-80,298,329,328
"82439","Nsylvestris_NODE_32482_length_373_cov_2","Ntome_NODE_21469_length_1084_cov_21",89.56,364,34,4,2,364,558,918,1.39e-128,459,362,360
"82440","Nsylvestris_NODE_32484_length_373_cov_2","Ntome_NODE_20614_length_1144_cov_28",95.714,350,10,3,1,348,108,454,1.33e-158,558,347,346
"82444","Nsylvestris_NODE_32488_length_372_cov_16","Ntome_NODE_32023_length_548_cov_68",89.109,101,11,0,272,372,176,76,1.6e-28,126,100,100
"82447","Nsylvestris_NODE_32493_length_371_cov_8","Ntome_NODE_10941_length_2080_cov_281",86.957,253,32,1,86,337,1744,1492,8.94e-76,283,251,252
"82448","Nsylvestris_NODE_32494_length_372_cov_6","Ntome_NODE_15311_length_1604_cov_12",93.923,362,13,2,20,372,882,1243,1.73e-152,538,352,361
"82449","Nsylvestris_NODE_32495_length_372_cov_6","Ntome_NODE_5321_length_3003_cov_49",99.462,372,2,0,1,372,2104,2475,0,676,371,371
"82450","Nsylvestris_NODE_32497_length_372_cov_5","Ntome_NODE_2075_length_4123_cov_201",94.444,360,9,6,12,371,2015,2363,3.72e-154,544,359,348
"82451","Nsylvestris_NODE_32498_length_372_cov_5","Ntome_NODE_24847_length_872_cov_13",90.515,369,11,5,4,372,699,355,8.29e-131,466,368,344
"82452","Nsylvestris_NODE_32499_length_372_cov_5","Ntome_NODE_15623_length_1574_cov_39",84.173,278,34,7,1,271,499,773,4.2e-69,261,270,274
"82453","Nsylvestris_NODE_32502_length_372_cov_5","Ntome_NODE_15281_length_1607_cov_14",89.521,334,18,5,1,333,1408,1091,5.1e-113,407,332,317
"82459","Nsylvestris_NODE_32508_length_372_cov_3","Ntome_NODE_35777_length_346_cov_2",95.376,346,16,0,12,357,346,1,2.22e-156,551,345,345
"82460","Nsylvestris_NODE_32510_length_371_cov_3","Ntome_NODE_31031_length_588_cov_8",95.614,342,9,4,30,370,162,498,3.71e-154,544,340,336
"82461","Nsylvestris_NODE_32511_length_372_cov_3","Ntome_NODE_28260_length_699_cov_5",86.552,290,33,6,4,290,318,32,3.18e-85,315,286,286
"82462","Nsylvestris_NODE_32513_length_372_cov_3","Ntome_NODE_1123_length_4927_cov_98",95.968,372,15,0,1,372,1464,1835,1.68e-172,604,371,371
"82463","Nsylvestris_NODE_32514_length_372_cov_2","Ntome_NODE_2141_length_4087_cov_75",94.355,372,21,0,1,372,874,1245,1.71e-162,571,371,371
"82464","Nsylvestris_NODE_32515_length_371_cov_227","Ntome_NODE_17662_length_1387_cov_135",98.113,371,7,0,1,371,532,162,0,647,370,370
"82478","Nsylvestris_NODE_32528_length_371_cov_5","Ntome_NODE_31393_length_575_cov_4",98.844,346,4,0,4,349,346,1,2.16e-176,617,345,345
"82482","Nsylvestris_NODE_32531_length_371_cov_4","Ntome_NODE_28586_length_685_cov_8",90.576,382,23,8,1,371,39,418,3.79e-139,494,370,379
"82483","Nsylvestris_NODE_32536_length_371_cov_4","Ntome_NODE_32050_length_546_cov_7",87.356,87,11,0,99,185,460,546,9.66e-21,100,86,86
"82486","Nsylvestris_NODE_32540_length_371_cov_2","Ntome_NODE_36453_length_326_cov_1",95.392,217,6,3,1,214,216,1,1.45e-93,342,213,215
"82487","Nsylvestris_NODE_32541_length_371_cov_2","Ntome_NODE_18816_length_1290_cov_8",94.737,228,11,1,144,371,418,192,6.71e-97,353,227,226
"82502","Nsylvestris_NODE_32553_length_370_cov_3","Ntome_NODE_23752_length_940_cov_32",90.786,369,34,0,1,369,799,431,3.78e-139,494,368,368
"82503","Nsylvestris_NODE_32554_length_370_cov_3","Ntome_NODE_36977_length_311_cov_5",92.373,236,8,6,140,365,51,286,4.06e-89,327,225,235
"82504","Nsylvestris_NODE_32559_length_369_cov_245","Ntome_NODE_19509_length_1233_cov_131",98.916,369,4,0,1,369,143,511,0,660,368,368
"82505","Nsylvestris_NODE_32560_length_369_cov_219","Ntome_NODE_5228_length_3023_cov_113",97.29,369,10,0,1,369,587,219,3.56e-179,627,368,368
"82506","Nsylvestris_NODE_32561_length_369_cov_210","Ntome_NODE_20084_length_1185_cov_262",88.424,311,36,0,1,311,572,262,1.42e-103,375,310,310
"82509","Nsylvestris_NODE_32565_length_369_cov_8","Ntome_NODE_31657_length_566_cov_3",98.182,55,1,0,315,369,1,55,1.24e-19,97.1,54,54
"82513","Nsylvestris_NODE_32571_length_369_cov_4","Ntome_NODE_343_length_6555_cov_139",100,44,0,0,326,369,6310,6353,3.48e-15,82.4,43,43
"82514","Nsylvestris_NODE_32572_length_369_cov_3","Ntome_NODE_14906_length_1644_cov_54",92.412,369,28,0,1,369,952,1320,3.72e-149,527,368,368
"82515","Nsylvestris_NODE_32574_length_369_cov_3","Ntome_NODE_12694_length_1874_cov_75",93.471,291,13,1,79,369,72,356,3.88e-119,427,290,284
"82516","Nsylvestris_NODE_32575_length_369_cov_3","Ntome_NODE_27930_length_714_cov_6",95.664,369,16,0,1,369,105,473,3.61e-169,593,368,368
"82525","Nsylvestris_NODE_32581_length_368_cov_19","Ntome_NODE_7044_length_2648_cov_23",97.5,40,1,0,3,42,1079,1040,2.7e-11,69.4,39,39
"82526","Nsylvestris_NODE_32582_length_368_cov_15","Ntome_NODE_12702_length_1873_cov_76",87.356,87,5,2,126,212,1495,1415,4.45e-19,95.3,86,80
"82527","Nsylvestris_NODE_32585_length_368_cov_6","Ntome_NODE_17167_length_1434_cov_16",89.378,386,21,9,1,368,520,137,2.28e-131,468,367,383
"82528","Nsylvestris_NODE_32586_length_368_cov_5","Ntome_NODE_31868_length_558_cov_4",95.556,360,12,4,12,368,56,414,4.69e-163,573,356,358
"82529","Nsylvestris_NODE_32587_length_368_cov_5","Ntome_NODE_31266_length_579_cov_10",96.875,32,1,0,83,114,250,281,7.56e-07,54.7,31,31
"82530","Nsylvestris_NODE_32588_length_368_cov_5","Ntome_NODE_8386_length_2429_cov_174",90.217,368,25,2,3,360,1034,1400,6.34e-132,470,357,366
"82531","Nsylvestris_NODE_32590_length_368_cov_4","Ntome_NODE_6170_length_2818_cov_24",85.92,348,34,8,1,334,282,628,5.15e-98,357,333,346
"82536","Nsylvestris_NODE_32597_length_368_cov_2","Ntome_NODE_14724_length_1663_cov_43",91.351,370,30,2,1,368,1151,782,1.74e-142,505,367,369
"82537","Nsylvestris_NODE_32598_length_368_cov_2","Ntome_NODE_4602_length_3182_cov_108",92.308,377,16,3,1,364,2260,1884,4.79e-148,523,363,376
"82548","Nsylvestris_NODE_32608_length_367_cov_7","Ntome_NODE_5762_length_2901_cov_96",76.824,233,52,2,134,366,623,393,1.22e-29,130,232,230
"82549","Nsylvestris_NODE_32612_length_367_cov_6","Ntome_NODE_14728_length_1662_cov_203",95.135,370,15,1,1,367,996,1365,2.8e-165,580,366,369
"82550","Nsylvestris_NODE_32614_length_367_cov_5","Ntome_NODE_29051_length_666_cov_7",95.095,367,15,1,1,367,618,255,1.3e-163,575,366,363
"82551","Nsylvestris_NODE_32616_length_367_cov_4","Ntome_NODE_2342_length_3988_cov_137",91.573,178,14,1,1,178,2609,2433,4.17e-64,244,177,176
"82552","Nsylvestris_NODE_32618_length_367_cov_4","Ntome_NODE_4860_length_3120_cov_178",95.913,367,13,1,1,367,1033,1397,3.59e-169,593,366,364
"82556","Nsylvestris_NODE_32622_length_367_cov_3","Ntome_NODE_7508_length_2570_cov_125",92.453,53,3,1,1,53,1772,1721,5.79e-13,75,52,51
"82557","Nsylvestris_NODE_32623_length_367_cov_2","Ntome_NODE_19646_length_1222_cov_96",82,250,43,2,4,252,924,1172,4.23e-54,211,248,248
"82558","Nsylvestris_NODE_32625_length_367_cov_2","Ntome_NODE_13064_length_1835_cov_53",84.348,345,54,0,3,347,1083,1427,1.86e-92,339,344,344
"82561","Nsylvestris_NODE_32628_length_367_cov_2","Ntome_NODE_1158_length_4886_cov_229",79.592,147,22,7,7,148,398,541,3.43e-20,99,141,143
"82572","Nsylvestris_NODE_32635_length_362_cov_13","Ntome_NODE_14757_length_1660_cov_31",91.64,311,25,1,16,326,338,647,1.06e-119,429,310,309
"82573","Nsylvestris_NODE_32637_length_366_cov_7","Ntome_NODE_6740_length_2705_cov_155",94.278,367,14,4,1,366,1429,1789,1.69e-157,555,365,360
"82574","Nsylvestris_NODE_32638_length_366_cov_6","Ntome_NODE_9078_length_2327_cov_49",95.652,368,11,3,4,366,1321,1688,5.99e-167,586,362,367
"82575","Nsylvestris_NODE_32639_length_366_cov_6","Ntome_NODE_17788_length_1376_cov_13",95.082,366,18,0,1,366,700,1065,3.61e-164,577,365,365
"82586","Nsylvestris_NODE_32656_length_365_cov_9","Ntome_NODE_1338_length_4692_cov_218",91.892,37,3,0,89,125,2680,2644,2.7e-06,52.8,36,36
"82593","Nsylvestris_NODE_32663_length_365_cov_5","Ntome_NODE_22193_length_1035_cov_8",89.894,376,19,9,1,363,582,951,8.12e-131,466,362,369
"82597","Nsylvestris_NODE_32668_length_365_cov_4","Ntome_NODE_40_length_10198_cov_97",89.034,383,21,5,3,365,8066,8447,1.76e-127,455,362,381
"82598","Nsylvestris_NODE_32669_length_365_cov_3","Ntome_NODE_25555_length_830_cov_52",85.323,402,22,9,1,365,175,576,3.03e-105,381,364,401
"82599","Nsylvestris_NODE_32672_length_365_cov_3","Ntome_NODE_16455_length_1501_cov_19",96.97,363,10,1,3,364,1128,766,1.28e-173,608,361,362
"82600","Nsylvestris_NODE_32674_length_365_cov_2","Ntome_NODE_2406_length_3956_cov_205",90.476,315,24,2,51,365,121,429,3.86e-114,411,314,308
"82601","Nsylvestris_NODE_32675_length_365_cov_1","Ntome_NODE_18195_length_1343_cov_26",90.489,368,32,3,1,365,270,637,8.07e-136,483,364,367
"82604","Nsylvestris_NODE_32677_length_364_cov_156","Ntome_NODE_10350_length_2152_cov_102",82.796,279,21,14,1,269,1636,1375,5.38e-58,224,268,261
"82605","Nsylvestris_NODE_32678_length_364_cov_17","Ntome_NODE_20373_length_1163_cov_188",93.274,223,11,2,141,360,557,778,1.43e-88,326,219,221
"82606","Nsylvestris_NODE_32680_length_364_cov_13","Ntome_NODE_34753_length_384_cov_23",92,350,21,6,19,364,11,357,2.24e-136,484,345,346
"82607","Nsylvestris_NODE_32681_length_364_cov_10","Ntome_NODE_5923_length_2867_cov_165",87.925,265,30,2,101,364,742,479,4.02e-84,311,263,263
"82610","Nsylvestris_NODE_32687_length_364_cov_4","Ntome_NODE_12939_length_1848_cov_44",96.429,364,13,0,1,364,1522,1159,2.13e-171,601,363,363
"82611","Nsylvestris_NODE_32688_length_364_cov_4","Ntome_NODE_24130_length_917_cov_11",94.231,364,20,1,1,364,66,428,1.68e-157,555,363,362
"82612","Nsylvestris_NODE_32690_length_364_cov_4","Ntome_NODE_24525_length_890_cov_261",87.5,216,24,3,2,214,491,276,1.15e-64,246,212,215
"82616","Nsylvestris_NODE_32698_length_364_cov_3","Ntome_NODE_20769_length_1133_cov_39",88.657,335,36,2,32,364,740,406,4.98e-113,407,332,334
"82620","Nsylvestris_NODE_32702_length_364_cov_2","Ntome_NODE_20222_length_1176_cov_5",98.082,365,6,1,1,364,443,807,0,634,363,364
"82624","Nsylvestris_NODE_32707_length_363_cov_201","Ntome_NODE_26855_length_765_cov_212",82.196,337,39,11,36,363,762,438,6.8e-72,270,327,324
"82625","Nsylvestris_NODE_32708_length_363_cov_51","Ntome_NODE_39858_length_251_cov_9",91.02,245,22,0,16,260,251,7,3.07e-90,331,244,244
"82626","Nsylvestris_NODE_32712_length_363_cov_10","Ntome_NODE_13893_length_1747_cov_14",92.285,337,26,0,26,362,413,749,1.04e-134,479,336,336
"82630","Nsylvestris_NODE_32715_length_363_cov_6","Ntome_NODE_19574_length_1228_cov_18",85.106,376,21,11,1,363,780,1133,2.36e-96,351,362,353
"82631","Nsylvestris_NODE_32716_length_363_cov_6","Ntome_NODE_23025_length_982_cov_13",81.818,110,17,3,139,247,215,322,2.04e-17,89.8,108,107
"82632","Nsylvestris_NODE_32717_length_363_cov_6","Ntome_NODE_16556_length_1491_cov_22",88.189,381,27,8,1,363,422,42,1.76e-122,438,362,380
"82633","Nsylvestris_NODE_32718_length_363_cov_6","Ntome_NODE_20596_length_1146_cov_13",92.857,364,24,2,1,363,509,147,3.65e-149,527,362,362
"82634","Nsylvestris_NODE_32719_length_363_cov_5","Ntome_NODE_35511_length_354_cov_3",92.683,41,2,1,143,183,141,180,5.76e-08,58.4,40,39
"82635","Nsylvestris_NODE_32720_length_363_cov_5","Ntome_NODE_23552_length_951_cov_55",92.837,363,20,4,1,363,445,89,1.7e-147,521,362,356
"82636","Nsylvestris_NODE_32722_length_363_cov_4","Ntome_NODE_23008_length_983_cov_27",95.556,360,16,0,4,363,778,419,3.58e-164,577,359,359
"82637","Nsylvestris_NODE_32727_length_363_cov_4","Ntome_NODE_88_length_8730_cov_181",94.231,52,3,0,1,52,5854,5905,1.23e-14,80.5,51,51
"82642","Nsylvestris_NODE_32733_length_363_cov_3","Ntome_NODE_19443_length_1239_cov_12",90.04,251,10,3,33,268,26,276,4e-84,311,235,250
"82648","Nsylvestris_NODE_32745_length_362_cov_4","Ntome_NODE_14887_length_1645_cov_205",100,39,0,0,324,362,688,650,2.05e-12,73.1,38,38
"82649","Nsylvestris_NODE_32747_length_362_cov_3","Ntome_NODE_22364_length_1025_cov_56",88.828,367,27,6,1,362,599,956,1.76e-122,438,361,357
"82650","Nsylvestris_NODE_32749_length_362_cov_3","Ntome_NODE_6232_length_2802_cov_183",87.059,85,8,3,189,271,657,740,1.57e-18,93.5,82,83
"82651","Nsylvestris_NODE_32750_length_362_cov_2","Ntome_NODE_24638_length_885_cov_11",92.077,366,24,4,1,362,139,503,3.67e-144,510,361,364
"82652","Nsylvestris_NODE_32751_length_362_cov_2","Ntome_NODE_21465_length_1084_cov_47",92.391,368,18,5,1,362,364,727,7.88e-146,516,361,363
"82658","Nsylvestris_NODE_32757_length_361_cov_29","Ntome_NODE_32102_length_542_cov_168",95.33,364,13,2,1,361,440,78,1.28e-163,575,360,362
"82661","Nsylvestris_NODE_32762_length_361_cov_9","Ntome_NODE_31924_length_555_cov_178",83.862,378,32,12,1,354,31,403,8.5e-91,333,353,372
"82662","Nsylvestris_NODE_32763_length_361_cov_8","Ntome_NODE_19364_length_1246_cov_17",95,180,9,0,1,180,1221,1042,8.68e-76,283,179,179
"82663","Nsylvestris_NODE_32767_length_361_cov_7","Ntome_NODE_33235_length_461_cov_7",96.243,346,10,1,4,346,454,109,2.77e-160,564,342,345
"82667","Nsylvestris_NODE_32772_length_361_cov_5","Ntome_NODE_19856_length_1205_cov_9",91.008,367,26,3,1,361,1123,758,1.71e-137,488,360,365
"82668","Nsylvestris_NODE_32773_length_361_cov_5","Ntome_NODE_5137_length_3047_cov_88",97.784,361,8,0,1,361,1870,1510,4.5e-178,623,360,360
"82671","Nsylvestris_NODE_32779_length_361_cov_3","Ntome_NODE_1830_length_4287_cov_95",93.37,362,20,4,1,360,1818,2177,7.8e-151,532,359,359
"82672","Nsylvestris_NODE_32783_length_361_cov_2","Ntome_NODE_863_length_5280_cov_173",95.798,357,13,2,1,357,1513,1159,1.28e-163,575,356,354
"82673","Nsylvestris_NODE_32786_length_360_cov_197","Ntome_NODE_35017_length_374_cov_3",83.721,172,15,11,139,306,36,198,9.16e-36,150,167,162
"82678","Nsylvestris_NODE_32789_length_360_cov_38","Ntome_NODE_15388_length_1595_cov_86",97.77,269,6,0,1,269,1327,1595,2.88e-130,464,268,268
"82682","Nsylvestris_NODE_32792_length_360_cov_11","Ntome_NODE_8445_length_2421_cov_142",85.676,377,25,3,1,360,785,421,6.46e-102,370,359,364
"82685","Nsylvestris_NODE_32796_length_360_cov_8","Ntome_NODE_7009_length_2653_cov_134",89.474,361,36,2,1,359,1124,1484,1.73e-127,455,358,360
"82689","Nsylvestris_NODE_32801_length_360_cov_6","Ntome_NODE_28725_length_679_cov_43",95.291,361,14,3,1,360,128,486,5.93e-162,569,359,358
"82690","Nsylvestris_NODE_32802_length_360_cov_6","Ntome_NODE_33894_length_425_cov_3",92.973,185,12,1,78,261,199,15,2.42e-71,268,183,184
"82693","Nsylvestris_NODE_32804_length_360_cov_6","Ntome_NODE_10122_length_2183_cov_14",96.438,365,8,2,1,360,1024,660,2.72e-170,597,359,364
"82697","Nsylvestris_NODE_32806_length_360_cov_5","Ntome_NODE_4208_length_3291_cov_61",96.944,360,11,0,1,360,1487,1846,1.63e-172,604,359,359
"82698","Nsylvestris_NODE_32808_length_360_cov_5","Ntome_NODE_5936_length_2865_cov_57",86.508,252,11,10,130,360,9,258,1.89e-67,255,230,249
"82699","Nsylvestris_NODE_32811_length_360_cov_4","Ntome_NODE_8403_length_2427_cov_19",93.889,360,22,0,1,360,702,1061,3.59e-154,544,359,359
"82702","Nsylvestris_NODE_32817_length_360_cov_3","Ntome_NODE_12131_length_1942_cov_109",90.426,376,16,5,1,360,1858,1487,3.7e-134,477,359,371
"82712","Nsylvestris_NODE_32825_length_359_cov_7","Ntome_NODE_39296_length_262_cov_4",94.737,38,2,0,320,357,217,254,1.58e-08,60.2,37,37
"82713","Nsylvestris_NODE_32826_length_359_cov_6","Ntome_NODE_28864_length_673_cov_191",87.94,199,14,5,156,353,297,486,1.47e-58,226,197,189
"82714","Nsylvestris_NODE_32827_length_359_cov_6","Ntome_NODE_21192_length_1103_cov_10",94.444,36,2,0,322,357,229,194,2.05e-07,56.5,35,35
"82715","Nsylvestris_NODE_32831_length_359_cov_5","Ntome_NODE_10101_length_2186_cov_159",91.071,336,27,3,25,359,432,99,2.23e-126,451,334,333
"82716","Nsylvestris_NODE_32832_length_359_cov_5","Ntome_NODE_5244_length_3019_cov_22",87.853,354,42,1,7,359,1420,1067,2.93e-115,414,352,353
"82717","Nsylvestris_NODE_32833_length_359_cov_4","Ntome_NODE_21782_length_1063_cov_8",89.444,360,13,2,1,359,728,1063,2.91e-120,431,358,335
"82718","Nsylvestris_NODE_32834_length_359_cov_4","Ntome_NODE_157_length_7738_cov_110",96.667,360,11,1,1,359,1537,1896,2.71e-170,597,358,359
"82725","Nsylvestris_NODE_32838_length_359_cov_3","Ntome_NODE_32883_length_486_cov_17",87.732,269,33,0,84,352,470,202,3.06e-85,315,268,268
"82731","Nsylvestris_NODE_32844_length_358_cov_76","Ntome_NODE_8456_length_2419_cov_301",100,46,0,0,1,46,1166,1211,2.6e-16,86.1,45,45
"82732","Nsylvestris_NODE_32846_length_358_cov_12","Ntome_NODE_4075_length_3327_cov_258",93.023,129,9,0,1,129,695,567,1.93e-47,189,128,128
"82733","Nsylvestris_NODE_32847_length_358_cov_10","Ntome_NODE_18747_length_1296_cov_40",91.808,354,14,11,20,358,415,62,1.02e-134,479,338,353
"82734","Nsylvestris_NODE_32849_length_358_cov_8","Ntome_NODE_22218_length_1033_cov_55",93.333,360,21,2,1,357,483,842,1e-149,529,356,359
"82737","Nsylvestris_NODE_32855_length_358_cov_4","Ntome_NODE_35083_length_371_cov_4",92.5,360,21,6,3,358,1,358,3.62e-144,510,355,357
"82738","Nsylvestris_NODE_32858_length_358_cov_4","Ntome_NODE_25471_length_835_cov_7",94.137,307,15,3,55,358,835,529,2.86e-130,464,303,306
"82744","Nsylvestris_NODE_32867_length_357_cov_219","Ntome_NODE_21542_length_1078_cov_238",94.215,242,10,1,116,357,162,399,8.28e-101,366,241,237
"82750","Nsylvestris_NODE_32870_length_357_cov_22","Ntome_NODE_11405_length_2025_cov_147",85.632,174,6,5,1,155,610,783,3.24e-40,165,154,173
"82768","Nsylvestris_NODE_32878_length_357_cov_4","Ntome_NODE_2574_length_3872_cov_13",94.101,356,21,0,2,357,551,196,1.28e-153,542,355,355
"82769","Nsylvestris_NODE_32880_length_357_cov_4","Ntome_NODE_20253_length_1173_cov_275",100,33,0,0,1,33,955,987,4.37e-09,62.1,32,32
"82770","Nsylvestris_NODE_32881_length_357_cov_4","Ntome_NODE_10613_length_2118_cov_86",96.111,360,11,1,1,357,1168,1527,2.1e-166,584,356,359
"82771","Nsylvestris_NODE_32882_length_357_cov_4","Ntome_NODE_15129_length_1621_cov_52",88.439,173,13,2,191,357,803,974,2.47e-51,202,166,171
"82772","Nsylvestris_NODE_32885_length_357_cov_3","Ntome_NODE_24695_length_881_cov_9",95.868,363,8,4,1,356,494,856,2.72e-165,580,355,362
"82773","Nsylvestris_NODE_32889_length_357_cov_2","Ntome_NODE_15106_length_1623_cov_149",89.888,356,34,2,2,357,989,1342,4.77e-128,457,355,353
"82784","Nsylvestris_NODE_32893_length_356_cov_172","Ntome_NODE_32578_length_507_cov_218",94.366,142,5,3,42,180,118,259,3.16e-55,215,138,141
"82788","Nsylvestris_NODE_32895_length_356_cov_51","Ntome_NODE_37941_length_289_cov_43",92.347,196,13,2,25,219,36,230,3.98e-74,278,194,194
"82793","Nsylvestris_NODE_32897_length_356_cov_23","Ntome_NODE_7065_length_2644_cov_147",91.481,270,17,4,85,351,2580,2314,8.25e-101,366,266,266
"82797","Nsylvestris_NODE_32899_length_356_cov_14","Ntome_NODE_1562_length_4486_cov_201",100,30,0,0,327,356,3220,3191,2.03e-07,56.5,29,29
"82798","Nsylvestris_NODE_32901_length_356_cov_11","Ntome_NODE_22598_length_1010_cov_98",91.746,315,18,7,21,333,702,1010,2.89e-120,431,312,308
"82799","Nsylvestris_NODE_32904_length_356_cov_7","Ntome_NODE_7550_length_2563_cov_125",92.416,356,18,5,1,356,1056,1402,7.8e-141,499,355,346
"82803","Nsylvestris_NODE_32909_length_356_cov_5","Ntome_NODE_19655_length_1225_cov_13",79.605,152,26,5,207,354,432,582,7.14e-22,104,147,150
"82804","Nsylvestris_NODE_32912_length_356_cov_4","Ntome_NODE_37841_length_292_cov_4",92.466,292,15,1,18,302,1,292,3.76e-114,411,284,291
"82805","Nsylvestris_NODE_32914_length_356_cov_4","Ntome_NODE_4868_length_3119_cov_119",88.92,361,30,6,2,353,674,1033,6.2e-122,436,351,359
"82808","Nsylvestris_NODE_32917_length_356_cov_3","Ntome_NODE_27804_length_720_cov_7",95.706,326,12,2,1,324,9,334,4.63e-148,523,323,325
"82811","Nsylvestris_NODE_32925_length_356_cov_2","Ntome_NODE_26220_length_796_cov_23",93.258,356,19,3,2,356,570,219,5.99e-147,520,354,351
"82812","Nsylvestris_NODE_32926_length_356_cov_2","Ntome_NODE_441_length_6188_cov_61",88.219,365,30,4,4,356,5058,4695,4.83e-118,424,352,363
"82813","Nsylvestris_NODE_32928_length_356_cov_2","Ntome_NODE_26906_length_763_cov_136",91.854,356,29,0,1,356,728,373,2.8e-140,497,355,355
"82826","Nsylvestris_NODE_32940_length_355_cov_6","Ntome_NODE_25178_length_853_cov_10",90.423,355,22,5,1,354,160,503,4.75e-128,457,353,343
"82827","Nsylvestris_NODE_32943_length_355_cov_5","Ntome_NODE_10979_length_2076_cov_52",91.193,352,29,2,5,355,1152,802,3.64e-134,477,350,350
"82828","Nsylvestris_NODE_32945_length_355_cov_5","Ntome_NODE_14727_length_1662_cov_261",97.826,46,1,0,1,46,1330,1375,1.2e-14,80.5,45,45
"82832","Nsylvestris_NODE_32953_length_355_cov_3","Ntome_NODE_22873_length_992_cov_13",96.689,302,10,0,1,302,691,992,6.01e-142,503,301,301
"82843","Nsylvestris_NODE_32961_length_354_cov_217","Ntome_NODE_5180_length_3035_cov_281",90.654,321,22,3,1,319,2343,2029,6.21e-117,420,318,314
"82844","Nsylvestris_NODE_32964_length_354_cov_8","Ntome_NODE_40_length_10198_cov_97",92.053,302,23,1,54,354,5728,6029,4.8e-118,424,300,301
"82845","Nsylvestris_NODE_32968_length_354_cov_5","Ntome_NODE_7489_length_2573_cov_86",93.785,354,21,1,1,354,681,329,2.75e-150,531,353,352
"82846","Nsylvestris_NODE_32973_length_354_cov_4","Ntome_NODE_31535_length_570_cov_8",88.601,193,22,0,1,193,134,326,2.41e-61,235,192,192
"82849","Nsylvestris_NODE_32975_length_354_cov_3","Ntome_NODE_12258_length_1926_cov_102",79.008,262,42,10,91,348,471,723,8.93e-41,167,257,252
"82852","Nsylvestris_NODE_32980_length_354_cov_3","Ntome_NODE_18529_length_1314_cov_32",95.48,354,13,2,1,354,387,737,9.75e-160,562,353,350
"82853","Nsylvestris_NODE_32981_length_354_cov_2","Ntome_NODE_7771_length_2529_cov_101",96.034,353,13,1,1,353,1295,944,4.5e-163,573,352,351
"82854","Nsylvestris_NODE_32983_length_354_cov_2","Ntome_NODE_3656_length_3468_cov_47",83.427,356,53,6,1,351,1683,2037,1.39e-88,326,350,354
"82860","Nsylvestris_NODE_32986_length_353_cov_11","Ntome_NODE_30373_length_613_cov_153",92.878,337,19,2,1,335,256,589,2.16e-136,484,334,333
"82861","Nsylvestris_NODE_32992_length_353_cov_6","Ntome_NODE_26504_length_782_cov_36",92.898,352,15,3,2,353,526,185,5.97e-142,503,351,341
"82862","Nsylvestris_NODE_32994_length_353_cov_6","Ntome_NODE_30025_length_627_cov_5",97.444,313,6,1,1,313,317,627,7.62e-151,532,312,310
"82863","Nsylvestris_NODE_32995_length_353_cov_6","Ntome_NODE_21285_length_1096_cov_5",90.462,325,13,10,22,346,55,361,1.04e-114,412,324,306
"82864","Nsylvestris_NODE_32997_length_353_cov_5","Ntome_NODE_1629_length_4435_cov_123",91.071,56,4,1,4,59,1835,1781,5.55e-13,75,55,54
"82867","Nsylvestris_NODE_32999_length_353_cov_5","Ntome_NODE_7009_length_2653_cov_134",87.64,356,38,6,1,353,2351,1999,1.34e-113,409,352,352
"82868","Nsylvestris_NODE_33001_length_353_cov_5","Ntome_NODE_35483_length_355_cov_4",90.441,272,25,1,32,303,6,276,4.92e-98,357,271,270
"82869","Nsylvestris_NODE_33002_length_353_cov_5","Ntome_NODE_16367_length_1508_cov_10",87.16,257,17,7,108,353,1194,943,3.94e-74,278,245,251
"82870","Nsylvestris_NODE_33008_length_353_cov_4","Ntome_NODE_26546_length_780_cov_12",90.11,91,9,0,2,92,522,612,2.53e-26,119,90,90
"82876","Nsylvestris_NODE_33018_length_352_cov_134","Ntome_NODE_5802_length_2894_cov_85",99.281,139,1,0,214,352,378,516,2.38e-66,252,138,138
"82882","Nsylvestris_NODE_33021_length_352_cov_9","Ntome_NODE_7350_length_2595_cov_16",90.055,181,13,5,1,179,579,756,1.12e-59,230,178,177
"82885","Nsylvestris_NODE_33024_length_352_cov_7","Ntome_NODE_9422_length_2278_cov_23",95.513,312,9,5,1,309,2195,1886,3.58e-139,494,308,309
"82886","Nsylvestris_NODE_33025_length_352_cov_7","Ntome_NODE_36198_length_333_cov_4",96.988,332,10,0,20,351,332,1,1.25e-158,558,331,331
"82887","Nsylvestris_NODE_33034_length_352_cov_3","Ntome_NODE_17262_length_1424_cov_19",90.12,334,23,5,27,352,254,585,1.33e-118,425,325,331
"82888","Nsylvestris_NODE_33035_length_352_cov_3","Ntome_NODE_19960_length_1195_cov_119",94.362,337,16,2,4,340,451,118,2.75e-145,514,336,333
"82893","Nsylvestris_NODE_33042_length_351_cov_191","Ntome_NODE_12226_length_1929_cov_297",91.667,60,4,1,1,60,159,101,3.3e-15,82.4,59,58
"82897","Nsylvestris_NODE_33046_length_351_cov_157","Ntome_NODE_22020_length_1047_cov_253",95.322,342,12,3,10,351,933,596,4.53e-153,540,341,337
"82898","Nsylvestris_NODE_33051_length_351_cov_5","Ntome_NODE_13171_length_1823_cov_50",96.011,351,14,0,1,351,614,264,1.6e-162,571,350,350
"82902","Nsylvestris_NODE_33058_length_351_cov_4","Ntome_NODE_36551_length_323_cov_3",81.928,249,26,10,1,246,281,49,1.46e-48,193,245,232
"82914","Nsylvestris_NODE_33070_length_350_cov_6","Ntome_NODE_34572_length_392_cov_8",79.609,358,59,9,4,350,4,358,3.96e-64,244,346,354
"82915","Nsylvestris_NODE_33073_length_350_cov_5","Ntome_NODE_14858_length_1648_cov_140",90.062,161,14,2,140,299,457,298,5.2e-53,207,159,159
"82916","Nsylvestris_NODE_33076_length_350_cov_4","Ntome_NODE_342_length_6555_cov_174",83.333,102,12,5,184,283,6533,6435,1.96e-17,89.8,99,98
"82917","Nsylvestris_NODE_33082_length_350_cov_3","Ntome_NODE_12422_length_1906_cov_102",95.726,351,13,2,1,350,601,950,2.68e-160,564,349,349
"82931","Nsylvestris_NODE_33089_length_349_cov_111","Ntome_NODE_1858_length_4265_cov_32",84.821,224,33,1,89,311,350,573,5.14e-58,224,222,223
"82932","Nsylvestris_NODE_33098_length_349_cov_5","Ntome_NODE_19636_length_1223_cov_22",92.593,270,15,4,4,270,898,631,8.02e-106,383,266,267
"82933","Nsylvestris_NODE_33102_length_349_cov_4","Ntome_NODE_13902_length_1746_cov_80",92.373,354,8,11,1,349,1345,1684,5.94e-137,486,348,339
"82936","Nsylvestris_NODE_33105_length_349_cov_4","Ntome_NODE_6422_length_2763_cov_80",91.691,349,29,0,1,349,403,751,2.14e-136,484,348,348
"82937","Nsylvestris_NODE_33107_length_349_cov_3","Ntome_NODE_9050_length_2331_cov_25",94.944,356,11,1,1,349,942,587,2.08e-156,551,348,355
"82938","Nsylvestris_NODE_33109_length_349_cov_3","Ntome_NODE_16114_length_1530_cov_13",86.957,299,33,5,24,321,383,676,2.95e-90,331,297,293
"82939","Nsylvestris_NODE_33115_length_349_cov_2","Ntome_NODE_24067_length_921_cov_8",96.011,351,12,1,1,349,458,808,5.74e-162,569,348,350
"82948","Nsylvestris_NODE_33122_length_348_cov_22","Ntome_NODE_38491_length_278_cov_4",95.683,278,12,0,13,290,1,278,2.8e-125,448,277,277
"82949","Nsylvestris_NODE_33123_length_348_cov_12","Ntome_NODE_7657_length_2547_cov_50",93.678,348,21,1,1,347,2188,2535,5.84e-147,520,346,347
"82950","Nsylvestris_NODE_33125_length_348_cov_9","Ntome_NODE_31255_length_579_cov_49",90.608,362,15,5,1,345,140,499,9.98e-130,462,344,359
"82953","Nsylvestris_NODE_33127_length_348_cov_6","Ntome_NODE_140_length_7962_cov_220",87.931,348,42,0,1,348,7157,7504,3.67e-114,411,347,347
"82954","Nsylvestris_NODE_33130_length_348_cov_5","Ntome_NODE_9127_length_2320_cov_163",83.75,320,25,7,32,348,40,335,3.88e-74,278,316,295
"82955","Nsylvestris_NODE_33131_length_348_cov_4","Ntome_NODE_34442_length_398_cov_4",96.491,228,8,0,1,228,171,398,3.72e-104,377,227,227
"82959","Nsylvestris_NODE_33139_length_348_cov_3","Ntome_NODE_13259_length_1813_cov_71",92.329,365,10,9,1,348,399,762,5.88e-142,503,347,363
"82968","Nsylvestris_NODE_33152_length_347_cov_11","Ntome_NODE_9980_length_2202_cov_17",95.96,297,11,1,51,347,1992,1697,2.75e-135,481,296,295
"82969","Nsylvestris_NODE_33153_length_347_cov_11","Ntome_NODE_2022_length_4159_cov_159",85.507,138,16,4,178,312,3256,3120,5.3e-33,141,134,136
"82970","Nsylvestris_NODE_33156_length_347_cov_6","Ntome_NODE_33889_length_425_cov_4",85.801,331,17,12,23,341,425,113,4.9e-88,324,318,312
"82971","Nsylvestris_NODE_33157_length_347_cov_6","Ntome_NODE_27109_length_753_cov_4",91.404,349,22,5,6,346,126,474,1.65e-132,472,340,348
"82972","Nsylvestris_NODE_33158_length_347_cov_6","Ntome_NODE_26632_length_776_cov_30",92.708,288,19,1,1,286,36,323,2.83e-115,414,285,287
"82973","Nsylvestris_NODE_33159_length_347_cov_5","Ntome_NODE_756_length_5450_cov_288",100,48,0,0,1,48,4552,4505,1.95e-17,89.8,47,47
"82979","Nsylvestris_NODE_33163_length_347_cov_4","Ntome_NODE_36267_length_331_cov_5",86.25,80,5,1,268,341,331,252,3.26e-15,82.4,73,79
"82983","Nsylvestris_NODE_33173_length_347_cov_3","Ntome_NODE_25267_length_847_cov_6",82.787,244,38,3,106,347,847,606,3.08e-55,215,241,241
"82984","Nsylvestris_NODE_33174_length_347_cov_3","Ntome_NODE_30132_length_623_cov_7",97.126,348,9,1,1,347,160,507,5.66e-167,586,346,347
"82985","Nsylvestris_NODE_33176_length_347_cov_2","Ntome_NODE_24859_length_871_cov_46",95.115,348,15,2,1,347,828,482,2.67e-155,547,346,346
"83001","Nsylvestris_NODE_33187_length_346_cov_8","Ntome_NODE_36162_length_334_cov_4",95.753,259,7,2,89,346,1,256,2.82e-115,414,257,255
"83002","Nsylvestris_NODE_33188_length_346_cov_7","Ntome_NODE_2576_length_3869_cov_238",93.651,315,14,6,33,346,351,42,7.67e-131,466,313,309
"83009","Nsylvestris_NODE_33200_length_346_cov_4","Ntome_NODE_277_length_6918_cov_98",94.872,351,13,3,1,346,4397,4047,3.44e-154,544,345,350
"83010","Nsylvestris_NODE_33201_length_346_cov_4","Ntome_NODE_3639_length_3473_cov_102",93.064,346,11,2,1,346,1767,2099,3.52e-139,494,345,332
"83011","Nsylvestris_NODE_33203_length_346_cov_3","Ntome_NODE_26639_length_776_cov_11",93.642,346,18,3,1,343,476,132,2.7e-145,514,342,344
"83012","Nsylvestris_NODE_33204_length_346_cov_3","Ntome_NODE_14660_length_1671_cov_158",95.101,347,13,3,1,346,1398,1055,3.44e-154,544,345,343
"83013","Nsylvestris_NODE_33205_length_346_cov_3","Ntome_NODE_34306_length_405_cov_4",95.238,189,8,1,1,188,217,405,2.96e-80,298,187,188
"83014","Nsylvestris_NODE_33207_length_346_cov_2","Ntome_NODE_29634_length_643_cov_9",93.009,329,21,2,1,327,554,226,9.85e-135,479,326,328
"83015","Nsylvestris_NODE_33208_length_346_cov_2","Ntome_NODE_16008_length_1538_cov_125",100,36,0,0,1,36,635,670,9.09e-11,67.6,35,35
"83020","Nsylvestris_NODE_33211_length_345_cov_111","Ntome_NODE_9709_length_2238_cov_43",88.439,346,38,2,1,345,391,735,7.81e-116,416,344,344
"83021","Nsylvestris_NODE_33212_length_345_cov_39","Ntome_NODE_10755_length_2100_cov_147",89.381,339,23,4,7,343,2100,1773,2.81e-115,414,336,327
"83022","Nsylvestris_NODE_33219_length_345_cov_5","Ntome_NODE_8268_length_2447_cov_25",89.106,358,25,7,1,345,1622,1266,7.76e-121,433,344,356
"83029","Nsylvestris_NODE_33232_length_345_cov_4","Ntome_NODE_34561_length_393_cov_3",97.273,110,3,0,54,163,284,393,6.67e-47,187,109,109
"83030","Nsylvestris_NODE_33233_length_345_cov_4","Ntome_NODE_1388_length_4646_cov_52",96.784,342,11,0,1,342,3396,3737,1.58e-162,571,341,341
"83031","Nsylvestris_NODE_33241_length_345_cov_2","Ntome_NODE_15745_length_1564_cov_17",93.372,347,21,1,1,345,1177,1523,9.68e-145,512,344,346
"83032","Nsylvestris_NODE_33242_length_344_cov_233","Ntome_NODE_4789_length_3136_cov_217",96.21,343,13,0,2,344,445,103,9.45e-160,562,342,342
"83038","Nsylvestris_NODE_33245_length_344_cov_130","Ntome_NODE_27936_length_713_cov_182",94.161,274,6,5,74,344,46,312,1.3e-113,409,270,266
"83039","Nsylvestris_NODE_33246_length_344_cov_10","Ntome_NODE_2204_length_4059_cov_79",86.782,348,31,6,2,334,1657,2004,4.75e-103,374,332,347
"83045","Nsylvestris_NODE_33255_length_344_cov_5","Ntome_NODE_27738_length_723_cov_6",89.296,355,23,8,1,344,683,333,2.78e-120,431,343,350
"83049","Nsylvestris_NODE_33259_length_344_cov_4","Ntome_NODE_26621_length_777_cov_5",94.783,345,17,1,1,344,614,270,5.73e-152,536,343,344
"83050","Nsylvestris_NODE_33262_length_344_cov_3","Ntome_NODE_10847_length_2091_cov_104",89.565,345,31,3,2,344,477,136,7.73e-121,433,342,341
"83051","Nsylvestris_NODE_33263_length_344_cov_3","Ntome_NODE_12578_length_1890_cov_33",79.47,151,25,5,1,147,1506,1358,2.48e-21,102,146,148
"83052","Nsylvestris_NODE_33267_length_343_cov_240","Ntome_NODE_17051_length_1443_cov_282",97.541,122,3,0,222,343,255,376,1.41e-53,209,121,121
"83059","Nsylvestris_NODE_33270_length_343_cov_61","Ntome_NODE_31633_length_566_cov_38",92.44,291,9,9,26,312,525,244,6.04e-112,403,286,281
"83066","Nsylvestris_NODE_33274_length_343_cov_7","Ntome_NODE_4106_length_3319_cov_183",85.768,267,38,0,76,342,732,466,8.21e-76,283,266,266
"83067","Nsylvestris_NODE_33276_length_343_cov_7","Ntome_NODE_5271_length_3014_cov_123",100,29,0,0,89,117,1998,2026,7.01e-07,54.7,28,28
"83078","Nsylvestris_NODE_33285_length_343_cov_4","Ntome_NODE_2255_length_4031_cov_121",80.769,130,15,8,52,173,1030,1157,1.49e-18,93.5,121,127
"83079","Nsylvestris_NODE_33291_length_343_cov_3","Ntome_NODE_18910_length_1283_cov_14",95.627,343,13,1,1,343,222,562,7.34e-156,549,342,340
"83082","Nsylvestris_NODE_33294_length_343_cov_3","Ntome_NODE_3544_length_3503_cov_96",85.795,352,26,13,1,343,1995,2331,2.22e-96,351,342,336
"83083","Nsylvestris_NODE_33296_length_343_cov_3","Ntome_NODE_7607_length_2553_cov_104",96.512,344,11,1,1,343,1281,938,2.03e-161,568,342,343
"83084","Nsylvestris_NODE_33297_length_343_cov_3","Ntome_NODE_39058_length_266_cov_4",93.962,265,15,1,61,324,1,265,7.82e-111,399,263,264
"83085","Nsylvestris_NODE_33298_length_343_cov_3","Ntome_NODE_28382_length_694_cov_7",96.591,264,9,0,80,343,388,125,1.66e-122,438,263,263
"83086","Nsylvestris_NODE_33299_length_343_cov_3","Ntome_NODE_3161_length_3634_cov_20",84.507,355,36,12,1,340,1203,1553,8.04e-91,333,339,350
"83087","Nsylvestris_NODE_33300_length_343_cov_3","Ntome_NODE_6039_length_2841_cov_71",88.421,190,18,3,61,247,2569,2757,1.4e-58,226,186,188
"83091","Nsylvestris_NODE_33302_length_343_cov_2","Ntome_NODE_9325_length_2292_cov_134",96.795,312,10,0,1,312,1688,1999,1.6e-147,521,311,311
"83100","Nsylvestris_NODE_33307_length_342_cov_12","Ntome_NODE_9737_length_2235_cov_75",86.872,358,13,12,1,331,2210,1860,6.11e-102,370,330,350
"83104","Nsylvestris_NODE_33311_length_342_cov_8","Ntome_NODE_17401_length_1412_cov_24",92,325,21,2,19,342,1191,871,2.12e-126,451,323,320
"83105","Nsylvestris_NODE_33312_length_342_cov_5","Ntome_NODE_1672_length_4396_cov_59",93.713,334,21,0,8,341,2123,1790,2.08e-141,501,333,333
"83106","Nsylvestris_NODE_33313_length_342_cov_5","Ntome_NODE_24567_length_888_cov_17",91.176,340,26,3,7,342,25,364,1.27e-128,459,335,339
"83107","Nsylvestris_NODE_33318_length_342_cov_3","Ntome_NODE_15775_length_1560_cov_300",92.69,342,25,0,1,342,1093,1434,3.48e-139,494,341,341
"83108","Nsylvestris_NODE_33319_length_342_cov_3","Ntome_NODE_17547_length_1398_cov_186",90.184,163,16,0,23,185,674,836,1.09e-54,213,162,162
"83121","Nsylvestris_NODE_33328_length_341_cov_10","Ntome_NODE_3047_length_3679_cov_106",89.691,194,19,1,148,341,2167,1975,1.07e-64,246,193,192
"83122","Nsylvestris_NODE_33333_length_341_cov_5","Ntome_NODE_38925_length_269_cov_3",96.911,259,7,1,40,297,268,10,7.66e-121,433,257,258
"83123","Nsylvestris_NODE_33335_length_341_cov_5","Ntome_NODE_10530_length_2127_cov_74",88.034,117,13,1,1,116,1102,986,6.73e-32,137,115,116
"83130","Nsylvestris_NODE_33338_length_341_cov_4","Ntome_NODE_5384_length_2988_cov_79",83.092,207,29,5,67,270,1627,1830,8.52e-46,183,203,203
"83131","Nsylvestris_NODE_33347_length_341_cov_3","Ntome_NODE_38623_length_275_cov_3",91.866,209,7,3,143,341,1,209,8.16e-76,283,198,208
"83132","Nsylvestris_NODE_33351_length_341_cov_3","Ntome_NODE_20945_length_1120_cov_41",97.087,309,8,1,33,341,665,358,5.72e-147,520,308,307
"83133","Nsylvestris_NODE_33352_length_341_cov_2","Ntome_NODE_15464_length_1587_cov_102",91.04,346,16,6,1,341,512,177,5.88e-127,453,340,335
"83134","Nsylvestris_NODE_33354_length_341_cov_2","Ntome_NODE_29084_length_665_cov_4",90.058,342,33,1,1,341,266,607,1.27e-123,442,340,341
"83152","Nsylvestris_NODE_33364_length_340_cov_8","Ntome_NODE_1225_length_4807_cov_19",96.842,95,3,0,1,95,3858,3952,1.43e-38,159,94,94
"83153","Nsylvestris_NODE_33365_length_340_cov_7","Ntome_NODE_29626_length_643_cov_27",87.081,209,18,9,8,212,553,350,3.87e-59,228,204,203
"83154","Nsylvestris_NODE_33367_length_340_cov_6","Ntome_NODE_10183_length_2173_cov_130",87.96,299,36,0,3,301,941,1239,6.11e-97,353,298,298
"83155","Nsylvestris_NODE_33373_length_340_cov_4","Ntome_NODE_34306_length_405_cov_4",93.617,188,10,1,151,338,8,193,1.05e-74,279,187,185
"83159","Nsylvestris_NODE_33376_length_340_cov_4","Ntome_NODE_8413_length_2425_cov_59",94.985,339,17,0,1,339,1198,860,7.32e-151,532,338,338
"83162","Nsylvestris_NODE_33385_length_340_cov_3","Ntome_NODE_5170_length_3039_cov_55",95.985,274,9,2,68,340,1208,936,3.53e-124,444,272,272
"83163","Nsylvestris_NODE_33391_length_339_cov_241","Ntome_NODE_20332_length_1166_cov_310",99.115,339,3,0,1,339,623,961,3.28e-174,610,338,338
"83164","Nsylvestris_NODE_33392_length_339_cov_215","Ntome_NODE_4406_length_3236_cov_263",98.82,339,4,0,1,339,1209,1547,1.52e-172,604,338,338
"83184","Nsylvestris_NODE_33410_length_339_cov_4","Ntome_NODE_851_length_5297_cov_281",87.302,189,15,3,13,192,2846,3034,5.02e-53,207,179,188
"83185","Nsylvestris_NODE_33412_length_339_cov_4","Ntome_NODE_1238_length_4793_cov_49",90.805,87,4,3,37,121,358,442,1.13e-24,113,84,84
"83186","Nsylvestris_NODE_33413_length_339_cov_4","Ntome_NODE_21380_length_1090_cov_15",100,34,0,0,42,75,808,775,1.15e-09,63.9,33,33
"83189","Nsylvestris_NODE_33421_length_339_cov_2","Ntome_NODE_8162_length_2466_cov_79",88.166,338,25,3,3,339,94,417,1.67e-107,388,336,323
"83196","Nsylvestris_NODE_33426_length_338_cov_11","Ntome_NODE_18606_length_1308_cov_33",81.25,176,25,5,3,176,259,428,2.4e-31,135,173,169
"83197","Nsylvestris_NODE_33428_length_338_cov_10","Ntome_NODE_37834_length_292_cov_4",93.893,262,9,1,3,257,28,289,1.67e-107,388,254,261
"83201","Nsylvestris_NODE_33437_length_338_cov_5","Ntome_NODE_31750_length_562_cov_13",94.118,306,18,0,33,338,506,201,7.48e-131,466,305,305
"83204","Nsylvestris_NODE_33442_length_338_cov_4","Ntome_NODE_32121_length_541_cov_6",93.671,316,17,2,26,338,540,225,5.78e-132,470,312,315
"83205","Nsylvestris_NODE_33447_length_338_cov_3","Ntome_NODE_9977_length_2202_cov_103",92.355,327,22,3,1,327,515,838,9.68e-130,462,326,323
"83206","Nsylvestris_NODE_33453_length_338_cov_2","Ntome_NODE_25703_length_821_cov_8",89.489,333,17,10,5,333,606,288,1.65e-112,405,328,318
"83207","Nsylvestris_NODE_33454_length_338_cov_2","Ntome_NODE_1988_length_4182_cov_198",94.461,343,14,5,1,338,1840,2182,4.38e-148,523,337,342
"83211","Nsylvestris_NODE_33456_length_337_cov_226","Ntome_NODE_28742_length_678_cov_304",85.764,288,19,11,7,273,461,175,2.24e-76,285,266,286
"83212","Nsylvestris_NODE_33457_length_337_cov_223","Ntome_NODE_33908_length_423_cov_308",96.142,337,13,0,1,337,1,337,2e-156,551,336,336
"83213","Nsylvestris_NODE_33459_length_337_cov_208","Ntome_NODE_9201_length_2308_cov_202",92.692,260,5,4,86,337,1429,1176,1.01e-99,363,251,253
"83219","Nsylvestris_NODE_33462_length_337_cov_189","Ntome_NODE_16457_length_1500_cov_274",92.177,294,20,1,47,337,1445,1152,9.85e-115,412,290,293
"83223","Nsylvestris_NODE_33465_length_337_cov_89","Ntome_NODE_309_length_6664_cov_209",85.163,337,23,11,1,337,1935,1626,6.14e-87,320,336,309
"83226","Nsylvestris_NODE_33469_length_337_cov_7","Ntome_NODE_19076_length_1269_cov_23",95.821,335,14,0,1,335,431,765,1.2e-153,542,334,334
"83227","Nsylvestris_NODE_33473_length_337_cov_6","Ntome_NODE_21955_length_1052_cov_46",91.045,335,13,3,4,337,934,616,5.85e-122,436,333,318
"83228","Nsylvestris_NODE_33474_length_337_cov_6","Ntome_NODE_4617_length_3180_cov_160",95,320,13,1,1,320,100,416,7.35e-141,499,319,316
"83229","Nsylvestris_NODE_33475_length_337_cov_6","Ntome_NODE_3871_length_3397_cov_190",92.33,339,16,3,1,337,681,1011,4.46e-133,473,336,330
"83230","Nsylvestris_NODE_33476_length_337_cov_6","Ntome_NODE_21637_length_1072_cov_66",88.202,178,7,5,97,260,432,609,8.35e-51,200,163,177
"83231","Nsylvestris_NODE_33477_length_337_cov_6","Ntome_NODE_5811_length_2892_cov_20",93.443,305,17,3,33,337,1238,937,7.51e-126,449,304,301
"83232","Nsylvestris_NODE_33478_length_337_cov_6","Ntome_NODE_691_length_5576_cov_215",83.133,83,10,3,10,88,3559,3641,1.9e-12,73.1,78,82
"83233","Nsylvestris_NODE_33482_length_337_cov_4","Ntome_NODE_20688_length_1137_cov_19",92.537,335,23,1,5,337,613,279,9.58e-135,479,332,334
"83234","Nsylvestris_NODE_33483_length_337_cov_4","Ntome_NODE_27780_length_721_cov_12",91.746,315,9,6,38,337,1,313,1.64e-117,422,299,312
"83235","Nsylvestris_NODE_33484_length_337_cov_4","Ntome_NODE_27785_length_721_cov_7",90.728,302,20,5,38,337,712,417,9.92e-110,396,299,295
"83236","Nsylvestris_NODE_33485_length_337_cov_4","Ntome_NODE_5201_length_3031_cov_37",95.255,274,13,0,3,276,271,544,2.1e-121,435,273,273
"83237","Nsylvestris_NODE_33487_length_337_cov_4","Ntome_NODE_979_length_5119_cov_156",94.925,335,17,0,3,337,1841,2175,1.21e-148,525,334,334
"83241","Nsylvestris_NODE_33489_length_337_cov_3","Ntome_NODE_20364_length_1164_cov_83",84.158,101,11,5,83,181,209,112,1.46e-18,93.5,98,97
"83242","Nsylvestris_NODE_33491_length_337_cov_3","Ntome_NODE_272_length_6943_cov_198",88.618,123,14,0,1,123,4175,4297,8.53e-36,150,122,122
"83258","Nsylvestris_NODE_33504_length_336_cov_10","Ntome_NODE_1045_length_5024_cov_209",89.583,48,4,1,160,206,4105,4058,1.47e-08,60.2,46,47
"83259","Nsylvestris_NODE_33505_length_336_cov_8","Ntome_NODE_822_length_5351_cov_294",86.022,186,19,6,155,336,4801,4619,1.39e-48,193,181,182
"83260","Nsylvestris_NODE_33508_length_336_cov_6","Ntome_NODE_37647_length_296_cov_5",94.366,213,12,0,34,246,296,84,3.66e-89,327,212,212
"83261","Nsylvestris_NODE_33509_length_336_cov_6","Ntome_NODE_12021_length_1955_cov_72",93.452,336,20,2,1,336,1493,1160,2.64e-140,497,335,333
"83267","Nsylvestris_NODE_33516_length_336_cov_4","Ntome_NODE_32666_length_501_cov_4",90.355,197,18,1,1,196,203,7,4.87e-68,257,195,196
"83271","Nsylvestris_NODE_33519_length_336_cov_4","Ntome_NODE_25620_length_826_cov_27",97.321,336,8,1,1,336,144,478,5.51e-162,569,335,334
"83272","Nsylvestris_NODE_33522_length_336_cov_3","Ntome_NODE_8571_length_2402_cov_63",95.821,335,12,2,1,334,404,71,4.32e-153,540,333,333
"83273","Nsylvestris_NODE_33524_length_336_cov_3","Ntome_NODE_25648_length_825_cov_5",91.875,320,24,2,19,336,504,823,9.68e-125,446,317,319
"83274","Nsylvestris_NODE_33525_length_336_cov_3","Ntome_NODE_35248_length_364_cov_4",83.792,327,39,11,15,336,361,44,2.87e-80,298,321,317
"83275","Nsylvestris_NODE_33528_length_336_cov_3","Ntome_NODE_2516_length_3902_cov_145",85.07,355,30,11,2,336,1387,1036,4.7e-93,340,334,351
"83293","Nsylvestris_NODE_33544_length_335_cov_12","Ntome_NODE_5825_length_2890_cov_23",83.673,343,48,3,1,335,1648,1990,7.9e-86,316,334,342
"83294","Nsylvestris_NODE_33545_length_335_cov_10","Ntome_NODE_3515_length_3511_cov_71",82.353,238,34,8,100,335,1775,1544,8.3e-51,200,235,231
"83295","Nsylvestris_NODE_33547_length_335_cov_8","Ntome_NODE_15141_length_1619_cov_249",97.059,34,0,1,303,335,400,433,1.9e-07,56.5,32,33
"83299","Nsylvestris_NODE_33549_length_335_cov_7","Ntome_NODE_4845_length_3124_cov_51",85.115,262,32,7,76,333,686,944,3.75e-69,261,257,258
"83300","Nsylvestris_NODE_33551_length_335_cov_6","Ntome_NODE_3047_length_3679_cov_106",92.174,345,14,5,1,335,1751,1410,1.23e-133,475,334,341
"83301","Nsylvestris_NODE_33554_length_335_cov_5","Ntome_NODE_21594_length_1075_cov_30",91.884,345,15,7,1,334,66,408,5.73e-132,470,333,342
"83302","Nsylvestris_NODE_33556_length_335_cov_5","Ntome_NODE_35836_length_344_cov_2",93.119,218,10,3,1,218,121,333,2.84e-85,315,217,212
"83303","Nsylvestris_NODE_33559_length_335_cov_5","Ntome_NODE_11093_length_2062_cov_10",94.328,335,19,0,1,335,643,309,2.61e-145,514,334,334
"83304","Nsylvestris_NODE_33560_length_335_cov_5","Ntome_NODE_25832_length_814_cov_12",89.671,213,17,3,124,332,256,467,8.07e-71,267,208,211
"83305","Nsylvestris_NODE_33564_length_335_cov_4","Ntome_NODE_31393_length_575_cov_4",96.04,101,4,0,235,335,532,432,3.03e-40,165,100,100
"83306","Nsylvestris_NODE_33565_length_335_cov_4","Ntome_NODE_4568_length_3192_cov_103",90.909,330,22,2,13,335,1893,1565,5.81e-122,436,322,328
"83307","Nsylvestris_NODE_33572_length_335_cov_3","Ntome_NODE_16738_length_1472_cov_137",96.716,335,11,0,1,335,1268,934,1.19e-158,558,334,334
"83308","Nsylvestris_NODE_33575_length_334_cov_191","Ntome_NODE_15047_length_1630_cov_235",98.182,55,1,0,280,334,824,770,1.12e-19,97.1,54,54
"83309","Nsylvestris_NODE_33576_length_334_cov_28","Ntome_NODE_38898_length_269_cov_78",93.939,231,11,1,100,330,2,229,1e-94,346,230,227
"83310","Nsylvestris_NODE_33578_length_334_cov_9","Ntome_NODE_13798_length_1758_cov_11",95.082,61,3,0,236,296,1582,1642,1.12e-19,97.1,60,60
"83314","Nsylvestris_NODE_33585_length_334_cov_5","Ntome_NODE_32710_length_497_cov_241",87.943,282,17,8,1,266,217,497,7.87e-86,316,265,280
"83318","Nsylvestris_NODE_33596_length_334_cov_4","Ntome_NODE_18052_length_1354_cov_19",92.72,261,19,0,1,261,310,50,3.56e-104,377,260,260
"83322","Nsylvestris_NODE_33605_length_334_cov_2","Ntome_NODE_13215_length_1818_cov_29",86.025,322,24,8,4,323,157,459,1.31e-88,326,319,302
"83323","Nsylvestris_NODE_33606_length_334_cov_2","Ntome_NODE_18339_length_1331_cov_13",88.791,339,17,6,1,334,975,1297,9.83e-110,396,333,322
"83334","Nsylvestris_NODE_33613_length_333_cov_8","Ntome_NODE_1180_length_4860_cov_111",95.441,329,11,1,5,333,3779,4103,1.55e-147,521,328,324
"83340","Nsylvestris_NODE_33616_length_333_cov_7","Ntome_NODE_2449_length_3933_cov_86",94.91,334,16,1,1,333,2602,2935,1.55e-147,521,332,333
"83341","Nsylvestris_NODE_33617_length_333_cov_6","Ntome_NODE_8181_length_2463_cov_131",94.118,340,11,1,1,331,706,1045,1.21e-143,508,330,339
"83342","Nsylvestris_NODE_33618_length_333_cov_6","Ntome_NODE_24507_length_892_cov_36",96.687,332,11,0,1,332,99,430,5.49e-157,553,331,331
"83343","Nsylvestris_NODE_33619_length_333_cov_6","Ntome_NODE_3726_length_3443_cov_169",100,28,0,0,1,28,2187,2214,2.44e-06,52.8,27,27
"83344","Nsylvestris_NODE_33621_length_333_cov_5","Ntome_NODE_32191_length_537_cov_4",86.545,275,32,5,63,333,409,136,2.84e-80,298,270,273
"83345","Nsylvestris_NODE_33623_length_333_cov_5","Ntome_NODE_24827_length_873_cov_19",87.582,153,17,2,42,194,276,426,1.39e-43,176,152,150
"83346","Nsylvestris_NODE_33625_length_333_cov_5","Ntome_NODE_15952_length_1543_cov_30",80,160,28,3,160,317,1106,1263,3.07e-25,115,157,157
"83351","Nsylvestris_NODE_33632_length_333_cov_3","Ntome_NODE_3174_length_3629_cov_221",82.517,143,11,5,72,200,2298,2156,1.1e-24,113,128,142
"83352","Nsylvestris_NODE_33633_length_333_cov_3","Ntome_NODE_42_length_10190_cov_24",80.519,308,23,13,33,333,9333,9056,2.29e-51,202,300,277
"83371","Nsylvestris_NODE_33651_length_332_cov_6","Ntome_NODE_22671_length_1005_cov_57",94.595,333,17,1,1,332,775,443,2.58e-145,514,331,332
"83372","Nsylvestris_NODE_33652_length_332_cov_5","Ntome_NODE_1399_length_4629_cov_226",94.529,329,17,1,1,329,3322,3649,4.32e-143,507,328,327
"83377","Nsylvestris_NODE_33656_length_332_cov_4","Ntome_NODE_5096_length_3055_cov_50",98.193,332,6,0,1,332,1647,1978,2.51e-165,580,331,331
"83380","Nsylvestris_NODE_33658_length_332_cov_4","Ntome_NODE_29456_length_650_cov_6",88.52,331,38,0,2,332,291,621,2.1e-111,401,330,330
"83381","Nsylvestris_NODE_33661_length_332_cov_3","Ntome_NODE_15289_length_1606_cov_25",84.384,365,24,15,1,332,1012,1376,3.61e-89,327,331,364
"83388","Nsylvestris_NODE_33667_length_332_cov_3","Ntome_NODE_22894_length_990_cov_191",94.277,332,19,0,1,332,328,659,1.2e-143,508,331,331
"83389","Nsylvestris_NODE_33668_length_332_cov_3","Ntome_NODE_4100_length_3321_cov_170",93.827,162,10,0,160,321,3268,3107,3.74e-64,244,161,161
"83390","Nsylvestris_NODE_33669_length_332_cov_3","Ntome_NODE_9845_length_2219_cov_241",91.575,273,21,2,6,277,1891,1620,1.27e-103,375,271,271
"83391","Nsylvestris_NODE_33670_length_332_cov_2","Ntome_NODE_7273_length_2610_cov_104",92.169,332,26,0,1,332,387,718,5.67e-132,470,331,331
"83392","Nsylvestris_NODE_33671_length_332_cov_2","Ntome_NODE_30473_length_610_cov_5",94.828,232,11,1,1,231,232,1,3.56e-99,361,230,231
"83393","Nsylvestris_NODE_33674_length_331_cov_190","Ntome_NODE_22609_length_1009_cov_265",93.165,278,19,0,1,278,391,114,1.25e-113,409,277,277
"83396","Nsylvestris_NODE_33677_length_331_cov_10","Ntome_NODE_31497_length_571_cov_53",92.308,65,5,0,11,75,70,6,1.43e-18,93.5,64,64
"83397","Nsylvestris_NODE_33679_length_331_cov_8","Ntome_NODE_12534_length_1895_cov_96",88.716,257,25,2,79,331,570,314,3.63e-84,311,252,256
"83398","Nsylvestris_NODE_33680_length_331_cov_8","Ntome_NODE_19432_length_1239_cov_285",84.431,167,10,3,180,331,255,90,8.37e-36,150,151,165
"83404","Nsylvestris_NODE_33690_length_331_cov_4","Ntome_NODE_5952_length_2861_cov_26",94.833,329,17,0,3,331,2203,1875,2.58e-145,514,328,328
"83405","Nsylvestris_NODE_33692_length_331_cov_3","Ntome_NODE_20382_length_1163_cov_12",92.517,147,11,0,10,156,1017,1163,3.78e-54,211,146,146
"83406","Nsylvestris_NODE_33696_length_331_cov_3","Ntome_NODE_1851_length_4271_cov_133",88.822,331,15,14,12,331,1634,1953,5.86e-107,387,319,319
"83415","Nsylvestris_NODE_33705_length_330_cov_182","Ntome_NODE_4730_length_3152_cov_249",96.61,59,2,0,272,330,603,545,3.06e-20,99,58,58
"83416","Nsylvestris_NODE_33706_length_330_cov_8","Ntome_NODE_5870_length_2879_cov_150",96.049,329,12,1,1,329,1794,1467,1.97e-151,534,328,327
"83417","Nsylvestris_NODE_33710_length_330_cov_5","Ntome_NODE_910_length_5214_cov_141",73.01,289,70,7,4,288,3178,3462,3.96e-19,95.3,284,284
"83418","Nsylvestris_NODE_33713_length_330_cov_5","Ntome_NODE_3337_length_3572_cov_107",96.949,295,8,1,35,329,2118,1825,3.34e-139,494,294,293
"83419","Nsylvestris_NODE_33715_length_330_cov_4","Ntome_NODE_11714_length_1990_cov_46",97.826,322,7,0,9,330,1016,695,4.2e-158,556,321,321
"83420","Nsylvestris_NODE_33717_length_330_cov_4","Ntome_NODE_20000_length_1192_cov_36",85.46,337,20,12,9,324,83,411,4.64e-88,324,315,328
"83426","Nsylvestris_NODE_33720_length_330_cov_3","Ntome_NODE_32399_length_521_cov_8",98.246,57,1,0,96,152,1,57,8.52e-21,100,56,56
"83427","Nsylvestris_NODE_33722_length_330_cov_3","Ntome_NODE_21382_length_1090_cov_9",90.12,334,27,5,1,330,436,767,9.56e-120,429,329,331
"83430","Nsylvestris_NODE_33724_length_330_cov_3","Ntome_NODE_7489_length_2573_cov_86",94.817,328,13,2,1,324,328,1,1.19e-143,508,323,327
"83431","Nsylvestris_NODE_33726_length_330_cov_3","Ntome_NODE_6421_length_2763_cov_99",97.879,330,6,1,1,330,1704,1376,5.4e-162,569,329,328
"83432","Nsylvestris_NODE_33727_length_330_cov_3","Ntome_NODE_14390_length_1697_cov_10",96.154,234,6,2,1,231,1464,1697,9.77e-105,379,230,233
"83433","Nsylvestris_NODE_33728_length_330_cov_3","Ntome_NODE_8769_length_2375_cov_21",95.86,314,11,2,1,312,1880,1567,4.3e-143,507,311,313
"83437","Nsylvestris_NODE_33735_length_330_cov_1","Ntome_NODE_3890_length_3391_cov_91",87.44,207,7,2,120,324,2528,2339,6.27e-57,220,204,189
"83442","Nsylvestris_NODE_33740_length_328_cov_174","Ntome_NODE_30499_length_608_cov_173",94.304,158,7,2,66,222,402,246,4.78e-63,241,156,156
"83443","Nsylvestris_NODE_33741_length_329_cov_51","Ntome_NODE_24578_length_887_cov_204",97.403,231,6,0,44,274,306,76,3.48e-109,394,230,230
"83444","Nsylvestris_NODE_33742_length_329_cov_36","Ntome_NODE_33331_length_455_cov_37",90.036,281,10,10,7,271,385,107,2.75e-95,348,264,278
"83448","Nsylvestris_NODE_33746_length_329_cov_10","Ntome_NODE_3904_length_3385_cov_75",93.684,190,12,0,1,190,3367,3178,2.18e-76,285,189,189
"83452","Nsylvestris_NODE_33749_length_329_cov_8","Ntome_NODE_4845_length_3124_cov_51",84.211,323,47,4,2,322,1257,1577,3.6e-84,311,320,320
"83455","Nsylvestris_NODE_33751_length_329_cov_6","Ntome_NODE_33423_length_450_cov_7",95.324,278,13,0,1,278,352,75,1.22e-123,442,277,277
"83459","Nsylvestris_NODE_33762_length_329_cov_4","Ntome_NODE_6529_length_2743_cov_128",100,28,0,0,6,33,1603,1576,2.41e-06,52.8,27,27
"83460","Nsylvestris_NODE_33763_length_329_cov_4","Ntome_NODE_15743_length_1564_cov_17",90.09,333,23,8,1,328,1518,1191,4.44e-118,424,327,327
"83461","Nsylvestris_NODE_33766_length_329_cov_3","Ntome_NODE_25429_length_837_cov_8",88.35,309,24,5,8,305,182,489,3.53e-99,361,297,307
"83462","Nsylvestris_NODE_33767_length_329_cov_3","Ntome_NODE_5461_length_2972_cov_60",90,330,31,2,1,329,999,1327,1.23e-118,425,328,328
"83463","Nsylvestris_NODE_33769_length_329_cov_3","Ntome_NODE_21794_length_1061_cov_224",92.742,124,6,1,3,126,966,846,1.37e-43,176,123,120
"83466","Nsylvestris_NODE_33778_length_328_cov_12","Ntome_NODE_21777_length_1063_cov_29",89.726,292,30,0,36,327,726,1017,4.52e-103,374,291,291
"83467","Nsylvestris_NODE_33780_length_328_cov_10","Ntome_NODE_16281_length_1511_cov_47",95.89,73,2,1,4,76,283,212,8.4e-26,117,72,71
"83472","Nsylvestris_NODE_33785_length_328_cov_7","Ntome_NODE_35479_length_355_cov_8",77.593,241,41,13,89,323,18,251,8.34e-31,134,234,233
"83476","Nsylvestris_NODE_33789_length_328_cov_6","Ntome_NODE_1123_length_4927_cov_98",96.341,328,12,0,1,328,1250,923,4.21e-153,540,327,327
"83477","Nsylvestris_NODE_33792_length_328_cov_5","Ntome_NODE_5096_length_3055_cov_50",97.256,328,9,0,1,328,503,176,4.18e-158,556,327,327
"83483","Nsylvestris_NODE_33802_length_328_cov_3","Ntome_NODE_36636_length_320_cov_4",93.262,282,19,0,47,328,1,282,7.4e-116,416,281,281
"83484","Nsylvestris_NODE_33804_length_328_cov_3","Ntome_NODE_1477_length_4551_cov_48",88.182,330,36,3,1,328,4192,4520,4.48e-108,390,327,328
"83485","Nsylvestris_NODE_33807_length_328_cov_2","Ntome_NODE_17967_length_1361_cov_45",96.951,328,10,0,1,328,546,873,1.94e-156,551,327,327
"83489","Nsylvestris_NODE_33814_length_327_cov_11","Ntome_NODE_13153_length_1825_cov_33",88.462,104,10,1,55,156,154,257,5e-28,124,101,103
"83498","Nsylvestris_NODE_33823_length_327_cov_6","Ntome_NODE_21218_length_1101_cov_10",94.19,327,8,2,1,327,137,452,1.54e-137,488,326,315
"83499","Nsylvestris_NODE_33824_length_327_cov_5","Ntome_NODE_413_length_6262_cov_150",95.758,330,10,2,1,327,113,441,9.08e-150,529,326,328
"83500","Nsylvestris_NODE_33828_length_327_cov_5","Ntome_NODE_6570_length_2735_cov_106",86.462,325,31,5,7,321,1566,1245,3.53e-94,344,314,321
"83501","Nsylvestris_NODE_33832_length_327_cov_4","Ntome_NODE_28229_length_700_cov_4",89.439,303,22,8,1,294,409,108,4.5e-103,374,293,301
"83502","Nsylvestris_NODE_33833_length_327_cov_4","Ntome_NODE_474_length_6094_cov_95",92.248,258,18,2,4,259,4425,4682,2.71e-100,364,255,257
"83503","Nsylvestris_NODE_33835_length_327_cov_4","Ntome_NODE_1275_length_4754_cov_106",82.315,311,32,16,21,327,4074,3783,2.85e-65,248,306,291
"83504","Nsylvestris_NODE_33842_length_327_cov_3","Ntome_NODE_17803_length_1374_cov_184",100,29,0,0,1,29,206,178,6.66e-07,54.7,28,28
"83505","Nsylvestris_NODE_33845_length_327_cov_2","Ntome_NODE_29973_length_629_cov_10",95.783,332,8,4,1,327,265,595,2.52e-150,531,326,330
"83506","Nsylvestris_NODE_33847_length_327_cov_2","Ntome_NODE_164_length_7676_cov_207",91.667,84,7,0,244,327,4209,4292,8.37e-26,117,83,83
"83510","Nsylvestris_NODE_33849_length_326_cov_200","Ntome_NODE_13196_length_1820_cov_211",96.466,283,8,2,44,326,91,371,7.19e-131,466,282,280
"83514","Nsylvestris_NODE_33855_length_326_cov_8","Ntome_NODE_39426_length_259_cov_5",95.706,163,6,1,1,162,163,1,3.64e-69,261,161,162
"83515","Nsylvestris_NODE_33856_length_326_cov_7","Ntome_NODE_14553_length_1680_cov_16",91.718,326,27,0,1,326,691,366,5.6e-127,453,325,325
"83516","Nsylvestris_NODE_33857_length_326_cov_6","Ntome_NODE_13233_length_1816_cov_186",100,28,0,0,1,28,94,121,2.39e-06,52.8,27,27
"83517","Nsylvestris_NODE_33858_length_326_cov_5","Ntome_NODE_10918_length_2083_cov_99",85.321,327,43,4,4,326,605,280,7.61e-91,333,322,325
"83518","Nsylvestris_NODE_33859_length_326_cov_5","Ntome_NODE_37038_length_310_cov_3",93.092,304,14,3,6,309,14,310,1.57e-122,438,303,296
"83521","Nsylvestris_NODE_33863_length_326_cov_5","Ntome_NODE_13881_length_1748_cov_77",93.808,323,20,0,4,326,1170,1492,5.52e-137,486,322,322
"83522","Nsylvestris_NODE_33865_length_326_cov_5","Ntome_NODE_8785_length_2372_cov_243",100,45,0,0,282,326,1478,1434,8.47e-16,84.2,44,44
"83523","Nsylvestris_NODE_33866_length_326_cov_4","Ntome_NODE_7281_length_2608_cov_57",81.505,319,59,0,1,319,1538,1856,1.01e-69,263,318,318
"83524","Nsylvestris_NODE_33868_length_326_cov_4","Ntome_NODE_1871_length_4259_cov_70",94.512,328,16,1,1,326,801,1128,1.52e-142,505,325,327
"83525","Nsylvestris_NODE_33879_length_326_cov_3","Ntome_NODE_16372_length_1507_cov_165",88.077,260,20,6,59,316,930,680,2.78e-80,298,257,250
"83528","Nsylvestris_NODE_33882_length_326_cov_3","Ntome_NODE_20204_length_1177_cov_8",93.558,326,20,1,1,326,328,4,1.99e-136,484,325,324
"83532","Nsylvestris_NODE_33885_length_326_cov_2","Ntome_NODE_31668_length_565_cov_26",100,31,0,0,16,46,227,257,5.13e-08,58.4,30,30
"83533","Nsylvestris_NODE_33888_length_326_cov_2","Ntome_NODE_12431_length_1905_cov_92",96.933,326,10,0,1,326,1802,1477,2.5e-155,547,325,325
"83534","Nsylvestris_NODE_33890_length_326_cov_2","Ntome_NODE_28348_length_695_cov_13",83.6,250,33,8,44,287,304,57,3.7e-59,228,243,247
"83535","Nsylvestris_NODE_33891_length_325_cov_241","Ntome_NODE_26855_length_765_cov_212",92.857,308,21,1,19,325,475,168,9.34e-125,446,306,307
"83543","Nsylvestris_NODE_33897_length_325_cov_12","Ntome_NODE_20237_length_1174_cov_289",97.619,42,1,0,284,325,1151,1110,1.83e-12,73.1,41,41
"83547","Nsylvestris_NODE_33899_length_325_cov_9","Ntome_NODE_2666_length_3830_cov_76",87.5,56,4,3,184,236,3741,3796,3.95e-09,62.1,52,55
"83548","Nsylvestris_NODE_33902_length_325_cov_6","Ntome_NODE_15752_length_1563_cov_190",93.538,325,16,1,1,325,1310,991,9.21e-135,479,324,319
"83549","Nsylvestris_NODE_33904_length_325_cov_5","Ntome_NODE_9455_length_2274_cov_186",98.148,54,1,0,272,325,1158,1211,3.9e-19,95.3,53,53
"83550","Nsylvestris_NODE_33909_length_325_cov_4","Ntome_NODE_21992_length_1050_cov_42",87.097,62,8,0,17,78,961,1022,6.57e-12,71.3,61,61
"83557","Nsylvestris_NODE_33916_length_325_cov_2","Ntome_NODE_14318_length_1703_cov_159",94.737,323,14,2,1,323,1024,1343,7.07e-141,499,322,319
"83576","Nsylvestris_NODE_33924_length_324_cov_14","Ntome_NODE_10381_length_2148_cov_171",92.926,311,19,3,11,320,2147,1839,7.2e-126,449,309,308
"83577","Nsylvestris_NODE_33925_length_324_cov_10","Ntome_NODE_314_length_6644_cov_63",91.25,320,27,1,1,319,4394,4713,2.02e-121,435,318,319
"83578","Nsylvestris_NODE_33929_length_324_cov_5","Ntome_NODE_29065_length_665_cov_31",77.389,314,43,12,15,324,111,400,3.78e-39,161,309,289
"83579","Nsylvestris_NODE_33931_length_324_cov_5","Ntome_NODE_9871_length_2216_cov_132",100,32,0,0,81,112,1588,1619,1.42e-08,60.2,31,31
"83580","Nsylvestris_NODE_33935_length_324_cov_4","Ntome_NODE_26579_length_778_cov_20",95.286,297,12,2,23,318,1,296,5.52e-132,470,295,295
"83581","Nsylvestris_NODE_33937_length_324_cov_4","Ntome_NODE_9523_length_2267_cov_61",87.037,324,36,3,1,324,1631,1948,3.47e-99,361,323,317
"83582","Nsylvestris_NODE_33938_length_324_cov_3","Ntome_NODE_39566_length_257_cov_2",88.976,127,13,1,199,324,113,239,1.76e-37,156,125,126
"83583","Nsylvestris_NODE_33940_length_324_cov_3","Ntome_NODE_2364_length_3979_cov_169",94.961,258,9,1,2,255,3496,3753,2.04e-111,401,253,257
"83584","Nsylvestris_NODE_33945_length_324_cov_2","Ntome_NODE_794_length_5393_cov_87",79.769,173,35,0,152,324,5303,5131,1.38e-28,126,172,172
"83585","Nsylvestris_NODE_33946_length_324_cov_2","Ntome_NODE_23903_length_931_cov_5",83.713,307,31,13,25,324,312,606,1.67e-72,272,299,294
"83586","Nsylvestris_NODE_33947_length_324_cov_1","Ntome_NODE_5244_length_3019_cov_22",85.588,340,30,10,1,324,1242,906,1.63e-92,339,323,336
"83587","Nsylvestris_NODE_33948_length_323_cov_215","Ntome_NODE_7590_length_2556_cov_129",93.189,323,13,1,1,323,819,1132,7.12e-131,466,322,313
"83605","Nsylvestris_NODE_33967_length_323_cov_4","Ntome_NODE_32767_length_494_cov_4",80.392,255,40,8,69,318,457,208,2.23e-46,185,249,249
"83606","Nsylvestris_NODE_33969_length_323_cov_3","Ntome_NODE_27898_length_715_cov_12",94.326,282,15,1,42,323,639,359,2.6e-120,431,281,280
"83607","Nsylvestris_NODE_33976_length_323_cov_2","Ntome_NODE_12389_length_1910_cov_50",90.448,335,16,5,3,323,356,688,3.36e-119,427,320,332
"83608","Nsylvestris_NODE_33979_length_323_cov_2","Ntome_NODE_1547_length_4486_cov_109",93.411,258,15,2,66,323,258,513,2.65e-105,381,257,255
"83615","Nsylvestris_NODE_33992_length_322_cov_4","Ntome_NODE_38656_length_274_cov_6",93.81,210,13,0,5,214,211,2,7.57e-86,316,209,209
"83616","Nsylvestris_NODE_33999_length_322_cov_3","Ntome_NODE_26934_length_762_cov_14",92.945,326,18,5,1,322,570,246,5.49e-132,470,321,324
"83617","Nsylvestris_NODE_34000_length_322_cov_3","Ntome_NODE_22476_length_1018_cov_94",92.079,101,8,0,205,305,228,328,1.36e-33,143,100,100
"83635","Nsylvestris_NODE_34012_length_321_cov_8","Ntome_NODE_18926_length_1282_cov_25",88.926,298,30,3,6,302,588,293,2.66e-100,364,296,295
"83636","Nsylvestris_NODE_34013_length_321_cov_7","Ntome_NODE_36676_length_319_cov_5",96.386,166,6,0,156,321,319,154,4.6e-73,274,165,165
"83637","Nsylvestris_NODE_34014_length_321_cov_6","Ntome_NODE_4640_length_3174_cov_86",95.114,307,14,1,1,307,2135,1830,7.03e-136,483,306,305
"83641","Nsylvestris_NODE_34017_length_321_cov_5","Ntome_NODE_28805_length_676_cov_11",91.875,320,21,1,2,321,46,360,1.19e-123,442,319,314
"83642","Nsylvestris_NODE_34018_length_321_cov_5","Ntome_NODE_23469_length_957_cov_9",93.789,322,19,1,1,321,198,519,7.03e-136,483,320,321
"83648","Nsylvestris_NODE_34029_length_321_cov_4","Ntome_NODE_8739_length_2379_cov_213",91.447,304,18,3,24,321,1376,1075,3.36e-114,411,297,301
"83649","Nsylvestris_NODE_34032_length_321_cov_4","Ntome_NODE_20784_length_1132_cov_135",96.273,322,7,4,1,321,666,349,4.14e-148,523,320,317
"83650","Nsylvestris_NODE_34033_length_321_cov_3","Ntome_NODE_887_length_5242_cov_20",95.692,325,10,2,1,321,3473,3797,5.35e-147,520,320,324
"83651","Nsylvestris_NODE_34034_length_322_cov_3","Ntome_NODE_28379_length_694_cov_9",77.551,245,39,11,69,301,359,599,8.18e-31,134,232,240
"83652","Nsylvestris_NODE_34036_length_321_cov_3","Ntome_NODE_10917_length_2083_cov_103",81.667,120,19,2,76,195,974,1090,1.07e-19,97.1,119,116
"83655","Nsylvestris_NODE_34043_length_321_cov_3","Ntome_NODE_5042_length_3067_cov_157",90.373,322,19,7,1,321,1791,1481,9.35e-115,412,320,310
"83656","Nsylvestris_NODE_34045_length_321_cov_2","Ntome_NODE_21886_length_1056_cov_10",94.769,325,7,3,1,321,433,115,2.51e-140,497,320,318
"83657","Nsylvestris_NODE_34050_length_320_cov_215","Ntome_NODE_32498_length_513_cov_242",94.485,272,14,1,1,271,513,242,2e-116,418,270,271
"83661","Nsylvestris_NODE_34052_length_320_cov_152","Ntome_NODE_15157_length_1617_cov_240",96.753,154,5,0,167,320,1472,1319,4.62e-68,257,153,153
"83662","Nsylvestris_NODE_34053_length_320_cov_19","Ntome_NODE_19490_length_1235_cov_88",85.714,140,10,3,121,258,1085,954,1.75e-32,139,137,131
"83663","Nsylvestris_NODE_34054_length_320_cov_17","Ntome_NODE_4093_length_3322_cov_235",92.565,269,17,3,52,320,326,61,7.31e-106,383,268,265
"83669","Nsylvestris_NODE_34058_length_320_cov_6","Ntome_NODE_23375_length_961_cov_260",96.078,51,2,0,1,51,534,584,8.3e-16,84.2,50,50
"83670","Nsylvestris_NODE_34062_length_320_cov_4","Ntome_NODE_2141_length_4087_cov_75",93.75,320,20,0,1,320,553,872,2.52e-135,481,319,319
"83671","Nsylvestris_NODE_34065_length_320_cov_4","Ntome_NODE_10788_length_2097_cov_235",76,300,59,10,13,307,83,374,1.35e-33,143,294,291
"83672","Nsylvestris_NODE_34067_length_320_cov_4","Ntome_NODE_9869_length_2216_cov_182",95,120,4,1,201,320,1447,1330,6.15e-47,187,119,117
"83673","Nsylvestris_NODE_34080_length_320_cov_2","Ntome_NODE_27575_length_729_cov_12",90.154,325,21,8,1,320,718,400,9.32e-115,412,319,318
"83674","Nsylvestris_NODE_34082_length_319_cov_149","Ntome_NODE_2148_length_4084_cov_120",91.935,62,4,1,1,62,3043,3103,2.3e-16,86.1,61,60
"83675","Nsylvestris_NODE_34086_length_319_cov_7","Ntome_NODE_29795_length_636_cov_28",96.552,319,10,1,1,319,618,301,3.18e-149,527,318,317
"83678","Nsylvestris_NODE_34089_length_319_cov_6","Ntome_NODE_26203_length_797_cov_17",88.065,310,22,8,1,300,736,432,5.71e-97,353,299,304
"83679","Nsylvestris_NODE_34090_length_319_cov_5","Ntome_NODE_17185_length_1431_cov_34",94.671,319,12,3,1,319,847,534,4.17e-138,490,318,313
"83683","Nsylvestris_NODE_34094_length_319_cov_5","Ntome_NODE_14488_length_1687_cov_36",85.714,182,20,2,97,272,420,601,6.13e-47,187,175,181
"83684","Nsylvestris_NODE_34096_length_319_cov_4","Ntome_NODE_12702_length_1873_cov_76",91.111,45,4,0,273,317,1414,1458,3.87e-09,62.1,44,44
"83685","Nsylvestris_NODE_34097_length_319_cov_4","Ntome_NODE_4222_length_3285_cov_89",94.34,53,1,2,180,232,928,978,1.07e-14,80.5,52,50
"83688","Nsylvestris_NODE_34106_length_319_cov_3","Ntome_NODE_23390_length_961_cov_9",94.953,317,13,3,4,319,848,534,3.22e-139,494,315,314
"83691","Nsylvestris_NODE_34116_length_318_cov_7","Ntome_NODE_36140_length_335_cov_3",100,44,0,0,1,44,44,1,2.96e-15,82.4,43,43
"83692","Nsylvestris_NODE_34117_length_318_cov_6","Ntome_NODE_670_length_5620_cov_99",91.416,233,6,2,87,318,1038,819,4.49e-83,307,231,219
"83700","Nsylvestris_NODE_34124_length_318_cov_5","Ntome_NODE_1691_length_4386_cov_27",94.652,187,10,0,2,188,4098,4284,4.52e-78,291,186,186
"83701","Nsylvestris_NODE_34128_length_318_cov_4","Ntome_NODE_38922_length_269_cov_3",95.597,159,6,1,1,159,112,269,5.94e-67,254,158,157
"83702","Nsylvestris_NODE_34129_length_318_cov_4","Ntome_NODE_23985_length_926_cov_8",95.016,321,13,2,1,318,828,508,1.92e-141,501,317,320
"83703","Nsylvestris_NODE_34130_length_318_cov_4","Ntome_NODE_14990_length_1637_cov_32",90.141,71,7,0,1,71,1188,1118,1.37e-18,93.5,70,70
"83704","Nsylvestris_NODE_34137_length_318_cov_3","Ntome_NODE_22996_length_984_cov_5",93.659,205,13,0,114,318,956,752,4.49e-83,307,204,204
"83705","Nsylvestris_NODE_34138_length_318_cov_3","Ntome_NODE_24040_length_922_cov_71",90.554,307,19,4,1,298,508,203,2.59e-110,398,297,305
"83706","Nsylvestris_NODE_34139_length_318_cov_3","Ntome_NODE_5215_length_3026_cov_95",91.837,147,9,3,1,147,112,255,2.18e-51,202,146,143
"83709","Nsylvestris_NODE_34144_length_318_cov_3","Ntome_NODE_16146_length_1527_cov_28",89.614,337,16,4,1,318,772,1108,3.33e-114,411,317,336
"83710","Nsylvestris_NODE_34150_length_317_cov_50","Ntome_NODE_37018_length_310_cov_22",79.167,288,58,2,18,304,298,12,2.81e-50,198,286,286
"83718","Nsylvestris_NODE_34156_length_317_cov_7","Ntome_NODE_8609_length_2397_cov_272",97.872,47,1,0,1,47,2124,2170,2.95e-15,82.4,46,46
"83719","Nsylvestris_NODE_34162_length_317_cov_4","Ntome_NODE_443_length_6181_cov_115",81.388,317,59,0,1,317,3275,2959,1.27e-68,259,316,316
"83720","Nsylvestris_NODE_34163_length_317_cov_4","Ntome_NODE_4348_length_3250_cov_188",100,44,0,0,274,317,1958,1915,2.95e-15,82.4,43,43
"83724","Nsylvestris_NODE_34170_length_317_cov_4","Ntome_NODE_30339_length_615_cov_12",90.966,321,23,4,1,317,296,614,3.29e-119,427,316,318
"83730","Nsylvestris_NODE_34186_length_316_cov_35","Ntome_NODE_25164_length_853_cov_269",87.375,301,25,9,17,316,546,834,7.36e-91,333,299,288
"83731","Nsylvestris_NODE_34187_length_316_cov_27","Ntome_NODE_27196_length_748_cov_192",92.361,144,10,1,73,215,246,103,6.02e-52,204,142,143
"83732","Nsylvestris_NODE_34189_length_316_cov_11","Ntome_NODE_20973_length_1116_cov_85",100,30,0,0,104,133,201,230,1.78e-07,56.5,29,29
"83736","Nsylvestris_NODE_34193_length_316_cov_6","Ntome_NODE_1134_length_4913_cov_144",94.286,315,17,1,1,314,3047,3361,2.48e-135,481,313,314
"83737","Nsylvestris_NODE_34195_length_316_cov_5","Ntome_NODE_20548_length_1150_cov_12",90.964,332,11,4,1,316,341,13,9.13e-120,429,315,328
"83738","Nsylvestris_NODE_34198_length_316_cov_4","Ntome_NODE_4880_length_3115_cov_200",83.459,266,30,6,1,261,712,456,2.14e-61,235,260,256
"83739","Nsylvestris_NODE_34199_length_316_cov_4","Ntome_NODE_6102_length_2830_cov_197",79.359,281,28,16,41,316,2711,2456,6.11e-42,171,275,255
"83749","Nsylvestris_NODE_34208_length_316_cov_3","Ntome_NODE_4139_length_3311_cov_45",93.987,316,19,0,1,316,1037,1352,8.94e-135,479,315,315
"83758","Nsylvestris_NODE_34217_length_315_cov_219","Ntome_NODE_838_length_5324_cov_297",96.19,315,12,0,1,315,4563,4877,6.79e-146,516,314,314
"83759","Nsylvestris_NODE_34219_length_315_cov_94","Ntome_NODE_30418_length_611_cov_254",85.315,286,13,8,57,315,46,329,2.1e-71,268,258,283
"83762","Nsylvestris_NODE_34222_length_315_cov_11","Ntome_NODE_24748_length_877_cov_28",95.946,148,6,0,1,148,363,216,4.57e-63,241,147,147
"83763","Nsylvestris_NODE_34225_length_315_cov_8","Ntome_NODE_35607_length_351_cov_5",95.254,295,14,0,1,295,295,1,1.93e-131,468,294,294
"83767","Nsylvestris_NODE_34231_length_315_cov_5","Ntome_NODE_26348_length_790_cov_8",93.514,185,12,0,94,278,1,185,1.25e-73,276,184,184
"83768","Nsylvestris_NODE_34232_length_315_cov_5","Ntome_NODE_1180_length_4860_cov_111",92.063,315,21,4,3,315,4473,4161,4.2e-123,440,312,312
"83769","Nsylvestris_NODE_34234_length_315_cov_4","Ntome_NODE_4100_length_3321_cov_170",95.556,315,14,0,1,315,2799,2485,1.47e-142,505,314,314
"83773","Nsylvestris_NODE_34238_length_315_cov_3","Ntome_NODE_19174_length_1261_cov_283",100,312,0,0,4,315,523,212,3.07e-164,577,311,311
"83774","Nsylvestris_NODE_34243_length_315_cov_3","Ntome_NODE_5052_length_3066_cov_56",83.529,85,10,4,13,93,3048,2964,1.37e-13,76.8,80,84
"83775","Nsylvestris_NODE_34245_length_315_cov_3","Ntome_NODE_1912_length_4228_cov_66",95.941,271,10,1,46,315,3900,4170,1.51e-122,438,269,270
"83776","Nsylvestris_NODE_34247_length_315_cov_3","Ntome_NODE_7717_length_2538_cov_44",90.114,263,24,2,45,306,1002,741,4.38e-93,340,261,261
"83787","Nsylvestris_NODE_34255_length_314_cov_148","Ntome_NODE_7770_length_2529_cov_120",98.305,59,0,1,256,314,1215,1158,2.24e-21,102,58,57
"83791","Nsylvestris_NODE_34257_length_314_cov_11","Ntome_NODE_32528_length_511_cov_6",95.094,265,10,3,52,314,445,182,2.54e-115,414,262,263
"83792","Nsylvestris_NODE_34259_length_314_cov_6","Ntome_NODE_9110_length_2322_cov_277",93.75,48,3,0,78,125,110,157,1.76e-12,73.1,47,47
"83793","Nsylvestris_NODE_34260_length_314_cov_6","Ntome_NODE_19235_length_1257_cov_12",83.923,311,50,0,1,311,383,693,2.67e-80,298,310,310
"83794","Nsylvestris_NODE_34262_length_314_cov_6","Ntome_NODE_2540_length_3889_cov_184",95.146,309,14,1,6,314,1211,1518,5.3e-137,486,308,307
"83795","Nsylvestris_NODE_34266_length_314_cov_5","Ntome_NODE_26163_length_799_cov_17",94.983,299,14,1,13,310,19,317,1.92e-131,468,297,298
"83798","Nsylvestris_NODE_34272_length_314_cov_4","Ntome_NODE_22620_length_1009_cov_9",83.544,316,44,6,1,309,662,976,1.61e-77,289,308,314
"83799","Nsylvestris_NODE_34273_length_314_cov_4","Ntome_NODE_8378_length_2430_cov_215",81.961,255,20,15,52,288,1832,2078,1.29e-48,193,236,246
"83804","Nsylvestris_NODE_34278_length_314_cov_4","Ntome_NODE_22894_length_990_cov_191",87.813,320,16,11,1,314,32,334,5.61e-97,353,313,302
"83805","Nsylvestris_NODE_34279_length_314_cov_4","Ntome_NODE_1509_length_4528_cov_22",92.675,314,23,0,1,314,1759,2072,5.38e-127,453,313,313
"83806","Nsylvestris_NODE_34282_length_314_cov_3","Ntome_NODE_24146_length_916_cov_17",93.165,278,11,5,1,273,608,334,1.98e-111,401,272,274
"83807","Nsylvestris_NODE_34285_length_314_cov_3","Ntome_NODE_4033_length_3340_cov_183",92.5,200,12,3,117,314,2807,3005,7.47e-76,283,197,198
"83808","Nsylvestris_NODE_34293_length_314_cov_2","Ntome_NODE_9626_length_2250_cov_11",90.123,324,18,11,1,313,645,325,1.18e-113,409,312,320
"83812","Nsylvestris_NODE_34297_length_313_cov_185","Ntome_NODE_6066_length_2836_cov_220",97.596,208,5,0,71,278,2098,2305,4.32e-98,357,207,207
"83813","Nsylvestris_NODE_34298_length_313_cov_184","Ntome_NODE_5581_length_2943_cov_301",91.549,142,10,1,172,313,2943,2804,3.59e-49,195,141,139
"83814","Nsylvestris_NODE_34299_length_313_cov_165","Ntome_NODE_489_length_6051_cov_92",84.828,145,3,7,188,313,4474,4618,3.69e-29,128,125,144
"83823","Nsylvestris_NODE_34312_length_313_cov_4","Ntome_NODE_31232_length_580_cov_22",96.486,313,10,1,1,313,524,213,6.74e-146,516,312,311
"83824","Nsylvestris_NODE_34317_length_313_cov_3","Ntome_NODE_623_length_5717_cov_69",90.997,311,27,1,2,311,3006,3316,1.96e-116,418,309,310
"83825","Nsylvestris_NODE_34321_length_313_cov_3","Ntome_NODE_543_length_5905_cov_125",93.269,312,20,1,2,313,3400,3710,1.15e-128,459,311,310
"83826","Nsylvestris_NODE_34328_length_313_cov_2","Ntome_NODE_441_length_6188_cov_61",87.126,334,20,8,2,313,5256,5588,4.32e-98,357,311,332
"83829","Nsylvestris_NODE_34333_length_312_cov_7","Ntome_NODE_4604_length_3179_cov_19",92.013,313,23,2,1,312,366,55,1.5e-122,438,311,311
"83830","Nsylvestris_NODE_34335_length_312_cov_6","Ntome_NODE_32527_length_511_cov_7",84,300,33,10,23,312,8,302,4.46e-73,274,289,294
"83831","Nsylvestris_NODE_34338_length_312_cov_5","Ntome_NODE_21143_length_1106_cov_43",88.596,114,13,0,1,114,117,4,1.7e-32,139,113,113
"83832","Nsylvestris_NODE_34342_length_312_cov_5","Ntome_NODE_2722_length_3804_cov_211",88.45,329,17,9,1,312,824,1148,3.31e-104,377,311,324
"83833","Nsylvestris_NODE_34343_length_312_cov_4","Ntome_NODE_12298_length_1924_cov_65",97.959,49,1,0,264,312,1495,1543,2.24e-16,86.1,48,48
"83834","Nsylvestris_NODE_34346_length_312_cov_4","Ntome_NODE_4084_length_3325_cov_179",93.617,282,14,2,1,280,2497,2776,1.95e-116,418,279,279
"83835","Nsylvestris_NODE_34348_length_312_cov_4","Ntome_NODE_11590_length_2004_cov_11",78.846,312,56,8,4,312,82,386,2.14e-51,202,308,304
"83836","Nsylvestris_NODE_34349_length_312_cov_4","Ntome_NODE_17584_length_1395_cov_8",96.129,310,12,0,1,310,1180,871,4.04e-143,507,309,309
"83837","Nsylvestris_NODE_34350_length_312_cov_4","Ntome_NODE_18181_length_1344_cov_57",88.685,327,18,12,1,312,634,956,2.56e-105,381,311,322
"83843","Nsylvestris_NODE_34358_length_312_cov_3","Ntome_NODE_6896_length_2675_cov_49",89.302,215,14,4,100,311,512,720,3.47e-69,261,211,208
"83844","Nsylvestris_NODE_34359_length_312_cov_3","Ntome_NODE_31834_length_559_cov_11",90,280,19,5,1,278,326,54,5.57e-97,353,277,272
"83845","Nsylvestris_NODE_34362_length_312_cov_2","Ntome_NODE_23351_length_963_cov_11",90.594,202,14,2,113,312,371,173,9.66e-70,263,199,198
"83846","Nsylvestris_NODE_34363_length_311_cov_181","Ntome_NODE_16072_length_1533_cov_107",89.63,270,19,2,48,311,1448,1182,2.01e-91,335,263,266
"83847","Nsylvestris_NODE_34364_length_311_cov_173","Ntome_NODE_7583_length_2557_cov_149",92.063,315,19,2,3,311,40,354,1.49e-122,438,308,314
"83848","Nsylvestris_NODE_34365_length_311_cov_136","Ntome_NODE_34391_length_400_cov_134",89.928,278,12,11,1,263,63,339,3.34e-94,344,262,276
"83849","Nsylvestris_NODE_34368_length_311_cov_6","Ntome_NODE_4868_length_3119_cov_119",85.981,321,29,8,1,308,1553,1870,9.36e-90,329,307,317
"83852","Nsylvestris_NODE_34371_length_311_cov_6","Ntome_NODE_1319_length_4710_cov_82",91.857,307,21,1,5,311,2386,2688,1.16e-118,425,306,302
"83859","Nsylvestris_NODE_34376_length_311_cov_5","Ntome_NODE_2487_length_3915_cov_33",93.182,132,9,0,50,181,3891,3760,3.56e-49,195,131,131
"83860","Nsylvestris_NODE_34377_length_311_cov_4","Ntome_NODE_4642_length_3174_cov_75",86.878,221,11,4,91,311,908,706,2.72e-60,231,220,202
"83861","Nsylvestris_NODE_34378_length_311_cov_4","Ntome_NODE_13430_length_1793_cov_18",84.566,311,46,2,1,310,1722,1413,4.39e-83,307,309,309
"83865","Nsylvestris_NODE_34384_length_311_cov_3","Ntome_NODE_95_length_8630_cov_64",96.129,310,10,2,1,309,4715,4407,1.45e-142,505,308,308
"83866","Nsylvestris_NODE_34389_length_311_cov_3","Ntome_NODE_36948_length_312_cov_3",100,132,0,0,180,311,1,132,3.49e-64,244,131,131
"83867","Nsylvestris_NODE_34391_length_311_cov_3","Ntome_NODE_25220_length_850_cov_56",96.519,316,6,3,1,311,596,281,1.86e-146,518,310,315
"83868","Nsylvestris_NODE_34392_length_311_cov_3","Ntome_NODE_637_length_5673_cov_130",88.146,329,7,5,2,311,2467,2152,9.23e-100,363,309,315
"83877","Nsylvestris_NODE_34405_length_311_cov_2","Ntome_NODE_3654_length_3469_cov_118",90.654,321,11,3,1,311,1124,1435,1.17e-113,409,310,311
"83878","Nsylvestris_NODE_34406_length_310_cov_240","Ntome_NODE_5633_length_2931_cov_279",97.742,310,7,0,1,310,647,338,1.84e-151,534,309,309
"83881","Nsylvestris_NODE_34408_length_310_cov_133","Ntome_NODE_16209_length_1520_cov_110",87.324,71,8,1,45,114,1447,1377,1.04e-14,80.5,69,70
"83885","Nsylvestris_NODE_34413_length_310_cov_8","Ntome_NODE_8015_length_2489_cov_127",97.101,138,3,1,158,295,245,381,2.71e-60,231,137,136
"83889","Nsylvestris_NODE_34421_length_310_cov_4","Ntome_NODE_26428_length_786_cov_7",97.106,311,8,1,1,310,497,187,3.99e-148,523,309,310
"83890","Nsylvestris_NODE_34424_length_310_cov_4","Ntome_NODE_4483_length_3214_cov_146",94.949,198,6,2,1,197,634,828,4.37e-83,307,196,194
"83891","Nsylvestris_NODE_34429_length_310_cov_3","Ntome_NODE_19395_length_1243_cov_12",90.336,238,13,6,82,309,1,238,5.65e-82,303,227,237
"83895","Nsylvestris_NODE_34433_length_310_cov_3","Ntome_NODE_209_length_7382_cov_58",82.813,64,10,1,183,245,2019,1956,1.75e-07,56.5,62,63
"83896","Nsylvestris_NODE_34437_length_310_cov_2","Ntome_NODE_13646_length_1773_cov_12",94.551,312,15,2,1,310,681,992,2.43e-135,481,309,311
"83897","Nsylvestris_NODE_34438_length_310_cov_2","Ntome_NODE_32363_length_524_cov_4",91.824,318,12,8,5,310,1,316,2.49e-120,431,305,315
"83898","Nsylvestris_NODE_34441_length_310_cov_2","Ntome_NODE_8977_length_2342_cov_116",90.69,290,22,3,1,286,252,540,2.54e-105,381,285,288
"83899","Nsylvestris_NODE_34442_length_310_cov_2","Ntome_NODE_200_length_7441_cov_62",87.859,313,34,4,1,310,2423,2112,2.56e-100,364,309,311
"83908","Nsylvestris_NODE_34446_length_309_cov_39","Ntome_NODE_19603_length_1225_cov_243",100,54,0,0,256,309,644,591,7.93e-21,100,53,53
"83911","Nsylvestris_NODE_34451_length_309_cov_7","Ntome_NODE_36816_length_315_cov_15",96.117,309,11,1,1,309,1,308,5.17e-142,503,308,307
"83915","Nsylvestris_NODE_34458_length_309_cov_5","Ntome_NODE_36410_length_327_cov_4",92.105,228,17,1,81,307,1,228,5.59e-87,320,226,227
"83916","Nsylvestris_NODE_34461_length_309_cov_4","Ntome_NODE_31377_length_575_cov_12",86.239,109,12,2,1,108,162,56,2.83e-25,115,107,106
"83917","Nsylvestris_NODE_34465_length_309_cov_4","Ntome_NODE_1766_length_4334_cov_186",96.141,311,10,1,1,309,2546,2856,4e-143,507,308,310
"83920","Nsylvestris_NODE_34470_length_309_cov_3","Ntome_NODE_6122_length_2827_cov_191",93.528,309,18,2,2,309,2119,1812,1.14e-128,459,307,307
"83921","Nsylvestris_NODE_34473_length_309_cov_3","Ntome_NODE_29447_length_650_cov_19",94.419,215,12,0,95,309,650,436,2.58e-90,331,214,214
"83925","Nsylvestris_NODE_34475_length_309_cov_3","Ntome_NODE_21610_length_1074_cov_7",90.968,310,24,2,1,309,552,246,2.49e-115,414,308,306
"83926","Nsylvestris_NODE_34476_length_309_cov_3","Ntome_NODE_36864_length_314_cov_4",96.429,140,5,0,170,309,314,175,2.7e-60,231,139,139
"83930","Nsylvestris_NODE_34479_length_309_cov_2","Ntome_NODE_188_length_7497_cov_123",95.785,261,11,0,1,261,4814,4554,1.49e-117,422,260,260
"83934","Nsylvestris_NODE_34482_length_308_cov_63","Ntome_NODE_34567_length_392_cov_154",84.32,338,22,11,1,308,52,388,2.02e-81,302,307,336
"83935","Nsylvestris_NODE_34483_length_308_cov_7","Ntome_NODE_14970_length_1639_cov_56",94.805,308,16,0,1,308,1018,711,2.42e-135,481,307,307
"83941","Nsylvestris_NODE_34488_length_308_cov_5","Ntome_NODE_1020_length_5064_cov_272",85.266,319,24,11,1,308,131,437,4.34e-83,307,307,306
"83942","Nsylvestris_NODE_34489_length_308_cov_4","Ntome_NODE_15112_length_1623_cov_15",92.164,268,9,1,1,268,1322,1577,1.96e-101,368,267,255
"83943","Nsylvestris_NODE_34491_length_308_cov_4","Ntome_NODE_26378_length_788_cov_86",96.753,308,10,0,1,308,533,226,2.38e-145,514,307,307
"83944","Nsylvestris_NODE_34495_length_308_cov_4","Ntome_NODE_15690_length_1569_cov_52",87.879,297,16,5,1,277,167,463,2.58e-90,331,276,296
"83945","Nsylvestris_NODE_34496_length_308_cov_3","Ntome_NODE_7119_length_2635_cov_251",93.243,148,10,0,161,308,2440,2587,2.09e-56,219,147,147
"83946","Nsylvestris_NODE_34497_length_308_cov_3","Ntome_NODE_261_length_7011_cov_115",88.83,188,6,6,28,215,3095,3267,7.52e-56,217,187,172
"83947","Nsylvestris_NODE_34504_length_308_cov_2","Ntome_NODE_39246_length_263_cov_3",98.361,122,2,0,1,122,122,1,2.71e-55,215,121,121
"83953","Nsylvestris_NODE_34509_length_307_cov_201","Ntome_NODE_5908_length_2870_cov_263",95.865,266,11,0,1,266,2522,2787,2.46e-120,431,265,265
"83954","Nsylvestris_NODE_34510_length_307_cov_164","Ntome_NODE_4732_length_3152_cov_181",96.429,56,1,1,1,56,954,900,4.74e-18,91.6,55,54
"83957","Nsylvestris_NODE_34513_length_307_cov_7","Ntome_NODE_7511_length_2569_cov_175",90.385,312,20,7,2,307,2076,2383,1.93e-111,401,305,307
"83958","Nsylvestris_NODE_34514_length_307_cov_7","Ntome_NODE_31885_length_557_cov_9",87.926,323,18,10,1,303,142,463,3.27e-99,361,302,321
"83959","Nsylvestris_NODE_34515_length_307_cov_5","Ntome_NODE_12955_length_1853_cov_45",76.494,251,53,3,1,245,1483,1733,2.79e-30,132,244,250
"83968","Nsylvestris_NODE_34523_length_307_cov_4","Ntome_NODE_34571_length_392_cov_9",94.137,307,14,3,2,307,34,337,2.42e-130,464,305,303
"83969","Nsylvestris_NODE_34524_length_307_cov_3","Ntome_NODE_1952_length_4208_cov_51",94.444,306,17,0,1,306,1097,792,1.45e-132,472,305,305
"83970","Nsylvestris_NODE_34525_length_307_cov_3","Ntome_NODE_15953_length_1543_cov_10",89.216,306,27,4,1,305,744,444,3.25e-104,377,304,300
"83971","Nsylvestris_NODE_34526_length_307_cov_3","Ntome_NODE_21928_length_1053_cov_89",97.527,283,7,0,1,283,571,289,1.86e-136,484,282,282
"83972","Nsylvestris_NODE_34527_length_307_cov_3","Ntome_NODE_37301_length_304_cov_2",93.534,232,12,2,1,230,74,304,1.19e-93,342,229,230
"83975","Nsylvestris_NODE_34531_length_307_cov_3","Ntome_NODE_2417_length_3951_cov_168",83.436,163,26,1,2,164,1204,1043,7.71e-36,150,162,161
"83981","Nsylvestris_NODE_34533_length_307_cov_2","Ntome_NODE_23703_length_943_cov_14",87.903,124,12,3,180,301,836,714,1.29e-33,143,121,122
"83985","Nsylvestris_NODE_34536_length_306_cov_213","Ntome_NODE_9714_length_2238_cov_257",96.078,306,12,0,1,306,103,408,6.62e-141,499,305,305
"83992","Nsylvestris_NODE_34543_length_306_cov_7","Ntome_NODE_10721_length_2105_cov_108",90.938,320,12,8,1,306,1613,1297,2.47e-115,414,305,316
"83995","Nsylvestris_NODE_34553_length_306_cov_5","Ntome_NODE_1767_length_4333_cov_202",78.472,144,24,6,140,279,3196,3056,6.11e-17,87.9,139,140
"83996","Nsylvestris_NODE_34554_length_306_cov_5","Ntome_NODE_5473_length_2969_cov_180",85.766,274,19,10,35,306,502,757,1.57e-72,272,271,255
"84000","Nsylvestris_NODE_34557_length_306_cov_4","Ntome_NODE_1390_length_4643_cov_209",92.542,295,20,2,3,296,3275,2982,1.47e-117,422,293,293
"84001","Nsylvestris_NODE_34561_length_306_cov_4","Ntome_NODE_27760_length_722_cov_6",92.131,305,24,0,2,306,88,392,2.45e-120,431,304,304
"84002","Nsylvestris_NODE_34562_length_306_cov_3","Ntome_NODE_19291_length_1253_cov_9",92.763,304,22,0,3,306,774,471,4.07e-123,440,303,303
"84008","Nsylvestris_NODE_34570_length_306_cov_3","Ntome_NODE_13595_length_1777_cov_141",95.455,88,1,2,1,86,1691,1777,5.98e-32,137,85,86
"84017","Nsylvestris_NODE_34578_length_305_cov_209","Ntome_NODE_18891_length_1284_cov_232",96.393,305,11,0,1,305,343,647,5.1e-142,503,304,304
"84020","Nsylvestris_NODE_34582_length_305_cov_9","Ntome_NODE_9110_length_2322_cov_277",93.22,59,4,0,50,108,110,168,6.09e-17,87.9,58,58
"84025","Nsylvestris_NODE_34590_length_305_cov_5","Ntome_NODE_15932_length_1545_cov_40",88.77,187,10,5,128,305,78,262,2.07e-56,219,177,184
"84026","Nsylvestris_NODE_34591_length_305_cov_5","Ntome_NODE_26653_length_775_cov_36",91.503,306,24,2,1,305,543,239,5.29e-117,420,304,304
"84027","Nsylvestris_NODE_34592_length_305_cov_5","Ntome_NODE_1724_length_4360_cov_97",93.569,311,9,5,1,305,3838,3533,5.21e-127,453,304,305
"84028","Nsylvestris_NODE_34596_length_305_cov_4","Ntome_NODE_12021_length_1955_cov_72",94.426,305,17,0,1,305,585,889,5.17e-132,470,304,304
"84029","Nsylvestris_NODE_34600_length_305_cov_4","Ntome_NODE_1830_length_4287_cov_95",86.905,84,9,2,221,302,136,219,1.31e-18,93.5,81,83
"84030","Nsylvestris_NODE_34601_length_305_cov_4","Ntome_NODE_2685_length_3821_cov_44",85.667,300,41,1,6,305,177,474,2.57e-85,315,299,297
"84034","Nsylvestris_NODE_34603_length_305_cov_4","Ntome_NODE_2141_length_4087_cov_75",90.654,107,2,1,1,99,2201,2307,2.14e-31,135,98,106
"84037","Nsylvestris_NODE_34607_length_305_cov_3","Ntome_NODE_621_length_5720_cov_100",91.667,72,6,0,4,75,649,578,7.82e-21,100,71,71
"84038","Nsylvestris_NODE_34609_length_305_cov_3","Ntome_NODE_2800_length_3771_cov_138",95.13,308,10,4,1,305,1348,1653,2.39e-135,481,304,305
"84039","Nsylvestris_NODE_34610_length_305_cov_3","Ntome_NODE_33038_length_475_cov_9",96.226,53,2,0,1,53,55,3,6.09e-17,87.9,52,52
"84043","Nsylvestris_NODE_34614_length_305_cov_3","Ntome_NODE_25247_length_848_cov_8",94.059,303,18,0,1,303,396,94,3.11e-129,460,302,302
"84046","Nsylvestris_NODE_34620_length_299_cov_204","Ntome_NODE_15875_length_1550_cov_293",88.514,296,11,6,26,299,1484,1190,5.36e-92,337,273,294
"84051","Nsylvestris_NODE_34623_length_304_cov_10","Ntome_NODE_26500_length_782_cov_73",94.203,276,13,3,30,304,743,470,1.89e-116,418,274,273
"84052","Nsylvestris_NODE_34624_length_304_cov_8","Ntome_NODE_10257_length_2162_cov_11",92.532,308,14,5,2,301,844,538,6.77e-121,433,299,306
"84053","Nsylvestris_NODE_34625_length_304_cov_7","Ntome_NODE_25342_length_842_cov_52",94.079,304,18,0,1,304,238,541,8.63e-130,462,303,303
"84054","Nsylvestris_NODE_34626_length_304_cov_7","Ntome_NODE_37976_length_289_cov_2",88.889,135,13,2,1,135,133,1,2.72e-40,165,134,132
"84055","Nsylvestris_NODE_34627_length_304_cov_7","Ntome_NODE_13259_length_1813_cov_71",98.675,302,4,0,1,302,4,305,5.01e-152,536,301,301
"84056","Nsylvestris_NODE_34629_length_304_cov_6","Ntome_NODE_8714_length_2382_cov_168",93.023,301,21,0,1,301,1948,2248,4.04e-123,440,300,300
"84057","Nsylvestris_NODE_34630_length_304_cov_6","Ntome_NODE_7102_length_2622_cov_150",94.737,304,15,1,1,304,1148,846,1.43e-132,472,303,302
"84058","Nsylvestris_NODE_34632_length_304_cov_6","Ntome_NODE_20317_length_1168_cov_27",92.105,304,18,2,1,298,495,798,4.07e-118,424,297,303
"84059","Nsylvestris_NODE_34633_length_304_cov_5","Ntome_NODE_5473_length_2969_cov_180",86.667,255,20,11,60,304,1024,1274,5.61e-72,270,244,250
"84060","Nsylvestris_NODE_34635_length_304_cov_5","Ntome_NODE_456_length_6137_cov_19",96.564,291,10,0,1,291,5112,4822,6.62e-136,483,290,290
"84061","Nsylvestris_NODE_34638_length_304_cov_5","Ntome_NODE_17837_length_1372_cov_68",95.395,304,14,0,1,304,1091,788,1.84e-136,484,303,303
"84062","Nsylvestris_NODE_34642_length_304_cov_4","Ntome_NODE_13723_length_1765_cov_240",94.203,69,4,0,1,69,1468,1536,1.68e-22,106,68,68
"84063","Nsylvestris_NODE_34648_length_304_cov_3","Ntome_NODE_16556_length_1491_cov_22",96.382,304,11,0,1,304,1043,740,1.83e-141,501,303,303
"84064","Nsylvestris_NODE_34649_length_304_cov_3","Ntome_NODE_7081_length_2642_cov_51",92.105,304,23,1,1,303,1610,1913,3.15e-119,427,302,303
"84067","Nsylvestris_NODE_34652_length_304_cov_3","Ntome_NODE_4588_length_3185_cov_67",84.615,286,43,1,20,304,1362,1647,7.21e-76,283,284,285
"84068","Nsylvestris_NODE_34653_length_304_cov_3","Ntome_NODE_1388_length_4646_cov_52",97.039,304,9,0,1,304,2851,2548,8.45e-145,512,303,303
"84072","Nsylvestris_NODE_34659_length_303_cov_287","Ntome_NODE_19603_length_1225_cov_243",98.013,302,6,0,2,303,644,343,1.08e-148,525,301,301
"84075","Nsylvestris_NODE_34662_length_303_cov_167","Ntome_NODE_12425_length_1906_cov_56",98.077,52,1,0,251,302,1668,1719,4.67e-18,91.6,51,51
"84081","Nsylvestris_NODE_34665_length_303_cov_21","Ntome_NODE_23592_length_949_cov_134",84.887,311,16,11,1,283,308,1,2e-76,285,282,307
"84086","Nsylvestris_NODE_34667_length_303_cov_7","Ntome_NODE_8584_length_2401_cov_35",98.02,303,6,0,1,303,351,653,3.01e-149,527,302,302
"84087","Nsylvestris_NODE_34670_length_303_cov_7","Ntome_NODE_2929_length_3725_cov_133",93.092,304,18,3,1,303,1109,1410,1.12e-123,442,302,301
"84088","Nsylvestris_NODE_34671_length_303_cov_6","Ntome_NODE_15684_length_1570_cov_10",93.069,303,9,2,1,303,964,1254,6.74e-121,433,302,290
"84089","Nsylvestris_NODE_34672_length_303_cov_6","Ntome_NODE_72_length_8934_cov_120",91.288,264,23,0,2,265,2328,2591,3.23e-99,361,263,263
"84093","Nsylvestris_NODE_34674_length_303_cov_5","Ntome_NODE_26493_length_783_cov_6",92.739,303,21,1,1,303,309,610,5.21e-122,436,302,301
"84094","Nsylvestris_NODE_34677_length_303_cov_5","Ntome_NODE_3171_length_3630_cov_109",90,300,26,3,5,300,1022,723,1.91e-106,385,295,299
"84097","Nsylvestris_NODE_34683_length_303_cov_4","Ntome_NODE_24938_length_867_cov_16",87.619,105,8,3,191,291,601,498,7.71e-26,117,100,103
"84100","Nsylvestris_NODE_34685_length_303_cov_4","Ntome_NODE_23159_length_974_cov_13",91.419,303,17,5,1,303,669,962,4.09e-113,407,302,293
"84101","Nsylvestris_NODE_34687_length_303_cov_4","Ntome_NODE_1277_length_4754_cov_66",83.819,309,21,15,1,303,416,701,7.24e-71,267,302,285
"84102","Nsylvestris_NODE_34689_length_303_cov_3","Ntome_NODE_11283_length_2040_cov_75",93.355,301,19,1,1,300,1643,1943,3.11e-124,444,299,300
"84103","Nsylvestris_NODE_34690_length_303_cov_3","Ntome_NODE_28497_length_689_cov_9",86.667,150,15,4,147,293,401,548,3.51e-39,161,146,147
"84104","Nsylvestris_NODE_34699_length_303_cov_3","Ntome_NODE_9847_length_2219_cov_38",87.981,208,18,3,32,234,1190,985,1.58e-62,239,202,205
"84107","Nsylvestris_NODE_34702_length_303_cov_2","Ntome_NODE_1152_length_4898_cov_67",92.739,303,11,2,1,303,1092,801,3.14e-119,427,302,291
"84108","Nsylvestris_NODE_34704_length_302_cov_237","Ntome_NODE_4406_length_3236_cov_263",98.344,302,5,0,1,302,1493,1794,2.32e-150,531,301,301
"84109","Nsylvestris_NODE_34705_length_302_cov_228","Ntome_NODE_2359_length_3981_cov_246",97.02,302,9,0,1,302,1356,1657,1.08e-143,508,301,301
"84110","Nsylvestris_NODE_34706_length_302_cov_172","Ntome_NODE_12480_length_1899_cov_270",89.418,189,10,4,1,180,1668,1855,9.46e-60,230,179,187
"84113","Nsylvestris_NODE_34714_length_302_cov_7","Ntome_NODE_719_length_5526_cov_80",82.099,162,7,10,1,162,2571,2432,2.14e-26,119,161,139
"84114","Nsylvestris_NODE_34715_length_302_cov_6","Ntome_NODE_2395_length_3961_cov_109",93.197,294,19,1,4,297,2934,2642,2.42e-120,431,293,292
"84123","Nsylvestris_NODE_34728_length_302_cov_3","Ntome_NODE_16483_length_1497_cov_15",80.678,295,50,5,3,290,548,254,1.58e-57,222,287,294
"84124","Nsylvestris_NODE_34729_length_302_cov_3","Ntome_NODE_4208_length_3291_cov_61",96.026,302,12,0,1,302,239,540,1.09e-138,492,301,301
"84127","Nsylvestris_NODE_34737_length_302_cov_3","Ntome_NODE_4301_length_3261_cov_37",91.935,186,8,2,6,184,793,608,5.61e-67,254,178,185
"84133","Nsylvestris_NODE_34743_length_301_cov_326","Ntome_NODE_1412_length_4613_cov_174",98.007,301,6,0,1,301,1778,2078,3.86e-148,523,300,300
"84134","Nsylvestris_NODE_34744_length_301_cov_217","Ntome_NODE_5791_length_2897_cov_276",97.674,301,7,0,1,301,2078,1778,1.8e-146,518,300,300
"84135","Nsylvestris_NODE_34745_length_301_cov_214","Ntome_NODE_10488_length_2133_cov_219",95.6,250,11,0,1,250,1324,1075,1.89e-111,401,249,249
"84136","Nsylvestris_NODE_34748_length_301_cov_6","Ntome_NODE_22973_length_985_cov_104",86.047,301,34,7,2,301,282,575,7.03e-86,316,299,293
"84143","Nsylvestris_NODE_34753_length_301_cov_5","Ntome_NODE_13865_length_1750_cov_11",94.02,301,18,0,1,301,1031,731,3.97e-128,457,300,300
"84144","Nsylvestris_NODE_34756_length_301_cov_4","Ntome_NODE_4881_length_3115_cov_153",95.294,255,8,1,1,251,2145,2399,1.89e-111,401,250,254
"84145","Nsylvestris_NODE_34759_length_301_cov_4","Ntome_NODE_10027_length_2196_cov_87",95.327,214,9,1,4,216,1977,2190,1.5e-92,339,212,213
"84146","Nsylvestris_NODE_34762_length_301_cov_4","Ntome_NODE_29325_length_655_cov_254",100,301,0,0,1,301,518,218,3.81e-158,556,300,300
"84147","Nsylvestris_NODE_34769_length_301_cov_3","Ntome_NODE_3763_length_3432_cov_96",93.645,299,12,3,1,298,1381,1673,4e-123,440,297,292
"84148","Nsylvestris_NODE_34771_length_301_cov_3","Ntome_NODE_9032_length_2334_cov_125",92.174,115,8,1,185,299,1240,1353,3.49e-39,161,114,113
"84149","Nsylvestris_NODE_34772_length_301_cov_3","Ntome_NODE_623_length_5717_cov_69",95.849,265,9,1,1,265,2249,2511,3.11e-119,427,264,262
"84150","Nsylvestris_NODE_34774_length_301_cov_2","Ntome_NODE_20841_length_1129_cov_7",86.385,213,22,4,15,225,391,184,1.22e-58,226,210,207
"84151","Nsylvestris_NODE_34775_length_301_cov_2","Ntome_NODE_32169_length_538_cov_8",95.154,227,11,0,1,227,239,13,1.15e-98,359,226,226
"84154","Nsylvestris_NODE_34778_length_300_cov_155","Ntome_NODE_2786_length_3775_cov_278",99.123,228,2,0,73,300,1729,1502,3.12e-114,411,227,227
"84158","Nsylvestris_NODE_34781_length_300_cov_7","Ntome_NODE_36778_length_316_cov_8",96.656,299,6,3,1,296,298,1,3.02e-139,494,295,297
"84161","Nsylvestris_NODE_34786_length_300_cov_5","Ntome_NODE_1230_length_4798_cov_56",92.691,301,9,2,1,300,2785,3073,1.44e-117,422,299,288
"84162","Nsylvestris_NODE_34793_length_300_cov_4","Ntome_NODE_25327_length_843_cov_20",79.167,288,49,8,12,298,442,719,1.59e-47,189,286,277
"84163","Nsylvestris_NODE_34794_length_300_cov_4","Ntome_NODE_15620_length_1574_cov_135",94.02,301,16,2,1,300,64,363,1.42e-127,455,299,299
"84164","Nsylvestris_NODE_34797_length_300_cov_4","Ntome_NODE_35257_length_364_cov_3",91.845,233,18,1,34,265,335,103,4.19e-88,324,231,232
"84165","Nsylvestris_NODE_34799_length_300_cov_3","Ntome_NODE_19118_length_1266_cov_73",100,39,0,0,262,300,921,883,1.67e-12,73.1,38,38
"84166","Nsylvestris_NODE_34800_length_300_cov_3","Ntome_NODE_1830_length_4287_cov_95",87.086,302,25,6,1,300,2395,2684,9e-90,329,299,289
"84170","Nsylvestris_NODE_34805_length_300_cov_3","Ntome_NODE_21769_length_1064_cov_9",91.667,300,19,5,1,300,990,697,3.12e-114,411,299,293
"84171","Nsylvestris_NODE_34806_length_300_cov_2","Ntome_NODE_8413_length_2425_cov_59",96.333,300,11,0,1,300,516,217,3.02e-139,494,299,299
"84172","Nsylvestris_NODE_34807_length_300_cov_2","Ntome_NODE_3843_length_3407_cov_14",90.984,244,22,0,1,244,1202,1445,9e-90,329,243,243
"84173","Nsylvestris_NODE_34808_length_299_cov_243","Ntome_NODE_4406_length_3236_cov_263",98.662,299,4,0,1,299,396,694,2.29e-150,531,298,298
"84174","Nsylvestris_NODE_34809_length_299_cov_226","Ntome_NODE_4955_length_3096_cov_101",94.983,299,15,0,1,299,583,881,5.06e-132,470,298,298
"84189","Nsylvestris_NODE_34815_length_299_cov_133","Ntome_NODE_7307_length_2602_cov_212",100,48,0,0,1,48,1298,1251,1.66e-17,89.8,47,47
"84194","Nsylvestris_NODE_34823_length_299_cov_6","Ntome_NODE_34600_length_391_cov_4",95.638,298,13,0,2,299,387,90,8.41e-135,479,297,297
"84195","Nsylvestris_NODE_34824_length_299_cov_5","Ntome_NODE_4912_length_3101_cov_16",92.453,53,4,0,119,171,2087,2035,1.29e-13,76.8,52,52
"84196","Nsylvestris_NODE_34825_length_299_cov_5","Ntome_NODE_15077_length_1627_cov_104",92.642,299,22,0,1,299,916,1214,2.39e-120,431,298,298
"84197","Nsylvestris_NODE_34829_length_299_cov_4","Ntome_NODE_28145_length_704_cov_5",91.837,147,9,2,153,298,36,180,2.04e-51,202,145,144
"84198","Nsylvestris_NODE_34833_length_299_cov_4","Ntome_NODE_9285_length_2298_cov_8",89.831,295,18,2,5,297,369,653,1.9e-101,368,292,284
"84199","Nsylvestris_NODE_34844_length_299_cov_4","Ntome_NODE_21904_length_1055_cov_15",88.525,305,22,9,3,299,648,947,4.11e-98,357,296,299
"84200","Nsylvestris_NODE_34846_length_299_cov_3","Ntome_NODE_31936_length_555_cov_5",92.683,41,3,0,1,41,113,73,1.3e-08,60.2,40,40
"84201","Nsylvestris_NODE_34852_length_299_cov_3","Ntome_NODE_22288_length_1029_cov_16",95.318,299,14,0,1,299,686,388,1.09e-133,475,298,298
"84202","Nsylvestris_NODE_34853_length_299_cov_3","Ntome_NODE_21397_length_1089_cov_11",96.98,298,9,0,1,298,438,141,1.8e-141,501,297,297
"84208","Nsylvestris_NODE_34858_length_299_cov_2","Ntome_NODE_14948_length_1641_cov_158",95.987,299,10,1,1,299,1262,966,1.81e-136,484,298,296
"84209","Nsylvestris_NODE_34860_length_298_cov_220","Ntome_NODE_38337_length_281_cov_77",90.761,184,11,1,30,207,184,1,4.31e-63,241,177,183
"84210","Nsylvestris_NODE_34861_length_298_cov_218","Ntome_NODE_14181_length_1717_cov_172",87.077,325,15,9,1,298,1220,896,1.15e-93,342,297,324
"84217","Nsylvestris_NODE_34869_length_298_cov_6","Ntome_NODE_6143_length_2824_cov_21",91.459,281,24,0,1,281,1070,790,5.23e-107,387,280,280
"84218","Nsylvestris_NODE_34871_length_298_cov_6","Ntome_NODE_38760_length_272_cov_4",89.13,92,9,1,9,100,228,138,9.8e-25,113,91,90
"84224","Nsylvestris_NODE_34879_length_298_cov_4","Ntome_NODE_20976_length_1118_cov_20",93.624,298,19,0,1,298,703,406,8.5e-125,446,297,297
"84225","Nsylvestris_NODE_34883_length_298_cov_3","Ntome_NODE_6522_length_2745_cov_58",97.651,298,7,0,1,298,1138,1435,8.27e-145,512,297,297
"84226","Nsylvestris_NODE_34885_length_298_cov_3","Ntome_NODE_12726_length_1870_cov_14",85.6,125,16,1,44,168,1185,1307,9.73e-30,130,124,122
"84227","Nsylvestris_NODE_34892_length_298_cov_3","Ntome_NODE_13708_length_1767_cov_53",92.617,298,22,0,1,298,1606,1309,8.56e-120,429,297,297
"84228","Nsylvestris_NODE_34894_length_298_cov_3","Ntome_NODE_34989_length_375_cov_5",92.806,139,10,0,1,139,181,43,2.03e-51,202,138,138
"84229","Nsylvestris_NODE_34896_length_298_cov_2","Ntome_NODE_17616_length_1392_cov_43",93.158,190,7,3,1,188,803,618,4.25e-73,274,187,185
"84233","Nsylvestris_NODE_34901_length_297_cov_161","Ntome_NODE_11074_length_2064_cov_290",98.324,179,3,0,119,297,1481,1303,2.49e-85,315,178,178
"84234","Nsylvestris_NODE_34902_length_297_cov_89","Ntome_NODE_16180_length_1523_cov_124",96.364,55,2,0,1,55,1134,1080,4.57e-18,91.6,54,54
"84242","Nsylvestris_NODE_34908_length_297_cov_7","Ntome_NODE_10814_length_2094_cov_221",92.157,306,14,7,1,297,437,133,3.97e-118,424,296,304
"84243","Nsylvestris_NODE_34910_length_297_cov_6","Ntome_NODE_27331_length_742_cov_6",96.599,294,10,0,4,297,499,206,1.39e-137,488,293,293
"84244","Nsylvestris_NODE_34911_length_297_cov_5","Ntome_NODE_11720_length_1989_cov_191",94.422,251,9,4,30,277,1881,1633,2.42e-105,381,247,248
"84245","Nsylvestris_NODE_34912_length_297_cov_5","Ntome_NODE_6706_length_2713_cov_129",91.167,317,8,5,1,297,504,188,8.59e-115,412,296,316
"84246","Nsylvestris_NODE_34917_length_297_cov_5","Ntome_NODE_577_length_5817_cov_148",90.756,238,20,2,61,297,4285,4049,6.93e-86,316,236,236
"84247","Nsylvestris_NODE_34918_length_297_cov_5","Ntome_NODE_933_length_5188_cov_206",93.603,297,15,2,1,297,2791,3083,3.94e-123,440,296,292
"84250","Nsylvestris_NODE_34924_length_297_cov_4","Ntome_NODE_36797_length_316_cov_4",94.915,295,12,2,1,295,13,304,1.09e-128,459,294,291
"84251","Nsylvestris_NODE_34925_length_297_cov_4","Ntome_NODE_17468_length_1406_cov_58",94.932,296,11,2,2,297,1351,1060,3.03e-129,460,295,291
"84252","Nsylvestris_NODE_34927_length_297_cov_3","Ntome_NODE_4077_length_3328_cov_143",88.704,301,19,8,1,297,1564,1275,5.28e-97,353,296,289
"84256","Nsylvestris_NODE_34931_length_297_cov_3","Ntome_NODE_9060_length_2329_cov_54",92.763,304,15,2,1,297,1985,1682,6.6e-121,433,296,303
"84266","Nsylvestris_NODE_34941_length_296_cov_213","Ntome_NODE_97_length_8622_cov_119",98.182,55,1,0,1,55,6921,6867,9.79e-20,97.1,54,54
"84269","Nsylvestris_NODE_34943_length_296_cov_190","Ntome_NODE_3437_length_3533_cov_289",96.761,247,7,1,51,296,156,402,3.08e-114,411,245,246
"84272","Nsylvestris_NODE_34945_length_296_cov_168","Ntome_NODE_29814_length_635_cov_207",87.866,239,18,6,1,235,278,47,5.45e-72,270,234,231
"84273","Nsylvestris_NODE_34946_length_296_cov_19","Ntome_NODE_35293_length_362_cov_116",89.764,127,6,2,80,200,1,126,1.59e-37,156,120,125
"84274","Nsylvestris_NODE_34948_length_296_cov_11","Ntome_NODE_8886_length_2357_cov_138",81.949,277,29,11,30,287,532,806,2.59e-55,215,257,274
"84275","Nsylvestris_NODE_34952_length_296_cov_6","Ntome_NODE_35122_length_369_cov_7",83.399,253,14,10,44,296,44,268,1.21e-53,209,252,224
"84279","Nsylvestris_NODE_34956_length_296_cov_5","Ntome_NODE_25081_length_859_cov_9",92.256,297,17,4,1,296,501,792,6.62e-116,416,295,291
"84280","Nsylvestris_NODE_34959_length_296_cov_4","Ntome_NODE_18740_length_1297_cov_75",81.679,131,17,5,49,175,616,743,2.11e-21,102,126,127
"84281","Nsylvestris_NODE_34961_length_296_cov_4","Ntome_NODE_39111_length_265_cov_4",95.055,182,8,1,114,295,9,189,1.95e-76,285,181,180
"84282","Nsylvestris_NODE_34968_length_296_cov_3","Ntome_NODE_622_length_5719_cov_37",85.489,317,22,7,1,294,1242,927,1.16e-83,309,293,315
"84283","Nsylvestris_NODE_34969_length_296_cov_3","Ntome_NODE_5096_length_3055_cov_50",94.257,296,15,1,1,296,2542,2249,1.81e-126,451,295,293
"84284","Nsylvestris_NODE_34972_length_296_cov_3","Ntome_NODE_1161_length_4886_cov_55",94.932,296,15,0,1,296,4293,4588,2.33e-130,464,295,295
"84285","Nsylvestris_NODE_34978_length_296_cov_3","Ntome_NODE_12654_length_1880_cov_184",82.282,333,17,5,1,296,431,104,7.1e-66,250,295,327
"84286","Nsylvestris_NODE_34979_length_296_cov_3","Ntome_NODE_1575_length_4475_cov_133",100,52,0,0,1,52,3402,3453,9.79e-20,97.1,51,51
"84289","Nsylvestris_NODE_34981_length_296_cov_3","Ntome_NODE_28993_length_668_cov_41",88.215,297,21,5,1,296,332,615,1.14e-93,342,295,283
"84290","Nsylvestris_NODE_34984_length_296_cov_2","Ntome_NODE_31384_length_575_cov_6",93.636,220,14,0,51,270,1,220,8.87e-90,329,219,219
"84302","Nsylvestris_NODE_34997_length_295_cov_8","Ntome_NODE_12314_length_1920_cov_258",80.69,145,20,6,41,181,1547,1687,1.62e-22,106,140,140
"84303","Nsylvestris_NODE_34999_length_295_cov_5","Ntome_NODE_16998_length_1449_cov_11",95.593,295,13,0,1,295,56,350,3.86e-133,473,294,294
"84306","Nsylvestris_NODE_35006_length_295_cov_4","Ntome_NODE_108_length_8380_cov_158",93.898,295,15,1,1,295,7733,7442,1.09e-123,442,294,291
"84307","Nsylvestris_NODE_35010_length_295_cov_4","Ntome_NODE_7605_length_2553_cov_152",88.088,319,13,8,1,295,2334,2017,1.46e-97,355,294,317
"84311","Nsylvestris_NODE_35021_length_295_cov_3","Ntome_NODE_17865_length_1370_cov_9",93.688,301,10,2,4,295,956,656,1.09e-123,442,291,300
"84312","Nsylvestris_NODE_35022_length_295_cov_2","Ntome_NODE_29794_length_636_cov_54",96.271,295,11,0,1,295,461,167,1.78e-136,484,294,294
"84313","Nsylvestris_NODE_35023_length_295_cov_2","Ntome_NODE_27091_length_754_cov_9",91.753,291,20,2,3,290,362,73,1.85e-111,401,287,289
"84318","Nsylvestris_NODE_35028_length_294_cov_10","Ntome_NODE_8125_length_2471_cov_290",92,225,17,1,52,275,1371,1147,2.47e-85,315,223,224
"84319","Nsylvestris_NODE_35030_length_294_cov_6","Ntome_NODE_157_length_7738_cov_110",96.599,294,5,4,1,294,3508,3220,6.39e-136,483,293,288
"84320","Nsylvestris_NODE_35031_length_294_cov_6","Ntome_NODE_7282_length_2608_cov_22",82.787,244,28,7,4,234,2428,2186,1.55e-52,206,230,242
"84321","Nsylvestris_NODE_35032_length_294_cov_6","Ntome_NODE_18702_length_1300_cov_278",93.878,245,10,4,3,244,243,1,2.41e-100,364,241,242
"84322","Nsylvestris_NODE_35033_length_294_cov_6","Ntome_NODE_14584_length_1677_cov_121",97.279,294,8,0,1,294,997,1290,6.34e-141,499,293,293
"84323","Nsylvestris_NODE_35037_length_294_cov_4","Ntome_NODE_5688_length_2921_cov_20",100,28,0,0,267,294,320,347,2.13e-06,52.8,27,27
"84324","Nsylvestris_NODE_35038_length_294_cov_4","Ntome_NODE_10488_length_2133_cov_219",93.902,82,5,0,144,225,1992,1911,4.46e-28,124,81,81
"84331","Nsylvestris_NODE_35048_length_294_cov_3","Ntome_NODE_22761_length_999_cov_29",94.576,295,15,1,1,294,665,959,1.39e-127,455,293,294
"84332","Nsylvestris_NODE_35054_length_294_cov_3","Ntome_NODE_17199_length_1430_cov_74",94.898,294,15,0,1,294,1126,833,2.99e-129,460,293,293
"84333","Nsylvestris_NODE_35058_length_293_cov_134","Ntome_NODE_39531_length_257_cov_5",100,52,0,0,1,52,206,257,9.69e-20,97.1,51,51
"84336","Nsylvestris_NODE_35063_length_293_cov_6","Ntome_NODE_33627_length_438_cov_6",92.056,214,15,2,81,293,338,126,6.88e-81,300,212,212
"84337","Nsylvestris_NODE_35066_length_293_cov_5","Ntome_NODE_22309_length_1027_cov_271",100,44,0,0,1,44,371,414,2.71e-15,82.4,43,43
"84343","Nsylvestris_NODE_35071_length_293_cov_5","Ntome_NODE_18181_length_1344_cov_57",95.904,293,11,1,1,293,614,323,3.83e-133,473,292,291
"84344","Nsylvestris_NODE_35072_length_293_cov_5","Ntome_NODE_15790_length_1559_cov_53",100,28,0,0,29,56,979,1006,2.13e-06,52.8,27,27
"84345","Nsylvestris_NODE_35073_length_293_cov_4","Ntome_NODE_39354_length_260_cov_3",91.463,164,13,1,131,293,260,97,4.26e-58,224,162,163
"84346","Nsylvestris_NODE_35085_length_293_cov_3","Ntome_NODE_9310_length_2294_cov_139",86.275,255,23,7,40,293,189,432,6.98e-71,267,253,243
"84349","Nsylvestris_NODE_35093_length_293_cov_2","Ntome_NODE_11127_length_2057_cov_12",96.246,293,11,0,1,293,1220,928,2.29e-135,481,292,292
"84350","Nsylvestris_NODE_35094_length_293_cov_2","Ntome_NODE_2729_length_3800_cov_281",91.126,293,24,2,2,293,2338,2047,8.53e-110,396,291,291
"84351","Nsylvestris_NODE_35096_length_293_cov_2","Ntome_NODE_28118_length_705_cov_8",86.466,133,11,5,2,134,17,142,1.59e-32,139,132,125
"84352","Nsylvestris_NODE_35100_length_292_cov_160","Ntome_NODE_5164_length_3041_cov_165",87.308,260,5,14,1,257,2606,2372,1.49e-72,272,256,234
"84359","Nsylvestris_NODE_35105_length_292_cov_8","Ntome_NODE_15197_length_1614_cov_195",97.586,290,7,0,1,290,998,709,2.26e-140,497,289,289
"84362","Nsylvestris_NODE_35111_length_292_cov_6","Ntome_NODE_39375_length_260_cov_6",90.909,143,11,2,62,203,118,259,4.3e-48,191,141,141
"84363","Nsylvestris_NODE_35113_length_292_cov_5","Ntome_NODE_2235_length_4043_cov_113",90.169,295,23,5,1,292,3273,3564,8.56e-105,379,291,291
"84379","Nsylvestris_NODE_35129_length_292_cov_3","Ntome_NODE_7123_length_2635_cov_89",93.151,292,20,0,1,292,1757,2048,8.38e-120,429,291,291
"84384","Nsylvestris_NODE_35137_length_292_cov_3","Ntome_NODE_1768_length_4333_cov_28",79.863,293,55,4,2,292,3998,3708,3.3e-54,211,290,290
"84385","Nsylvestris_NODE_35139_length_292_cov_3","Ntome_NODE_8972_length_2343_cov_42",95.548,292,13,0,1,292,2076,1785,1.78e-131,468,291,291
"84386","Nsylvestris_NODE_35147_length_292_cov_3","Ntome_NODE_21508_length_1081_cov_20",96.259,294,8,2,1,292,71,363,8.2e-135,479,291,292
"84390","Nsylvestris_NODE_35150_length_292_cov_3","Ntome_NODE_22637_length_1008_cov_10",88.636,220,18,6,8,221,776,994,3.23e-69,261,213,218
"84396","Nsylvestris_NODE_35154_length_291_cov_209","Ntome_NODE_12592_length_1888_cov_185",98.625,291,4,0,1,291,52,342,6.23e-146,516,290,290
"84402","Nsylvestris_NODE_35159_length_291_cov_10","Ntome_NODE_12913_length_1851_cov_23",94.074,135,4,2,2,133,724,591,1.98e-51,202,131,133
"84405","Nsylvestris_NODE_35161_length_291_cov_9","Ntome_NODE_24010_length_924_cov_46",88.552,297,14,7,1,291,420,702,1.12e-93,342,290,282
"84414","Nsylvestris_NODE_35179_length_291_cov_4","Ntome_NODE_8090_length_2476_cov_128",89.619,289,27,3,4,291,2038,1752,2.39e-100,364,287,286
"84415","Nsylvestris_NODE_35184_length_291_cov_3","Ntome_NODE_21285_length_1096_cov_5",97.595,291,7,0,1,291,743,1033,6.27e-141,499,290,290
"84416","Nsylvestris_NODE_35185_length_291_cov_3","Ntome_NODE_5136_length_3047_cov_101",92.857,266,18,1,1,266,1231,1495,1.83e-106,385,265,264
"84419","Nsylvestris_NODE_35189_length_291_cov_3","Ntome_NODE_29280_length_657_cov_16",93.471,291,18,1,1,291,156,445,2.32e-120,431,290,289
"84420","Nsylvestris_NODE_35190_length_291_cov_3","Ntome_NODE_9871_length_2216_cov_132",90.429,303,17,6,1,291,1252,950,1.42e-107,388,290,302
"84421","Nsylvestris_NODE_35192_length_291_cov_3","Ntome_NODE_30341_length_615_cov_9",93.836,292,9,7,4,290,51,338,2.32e-120,431,286,287
"84425","Nsylvestris_NODE_35197_length_291_cov_2","Ntome_NODE_26398_length_787_cov_73",83.446,296,44,4,1,291,507,212,5.35e-72,270,290,295
"84436","Nsylvestris_NODE_35206_length_290_cov_8","Ntome_NODE_22600_length_1010_cov_41",90,290,29,0,1,290,427,138,1.1e-103,375,289,289
"84437","Nsylvestris_NODE_35208_length_290_cov_6","Ntome_NODE_436_length_6212_cov_90",96.516,287,9,1,1,287,3466,3751,3.79e-133,473,286,285
"84441","Nsylvestris_NODE_35213_length_290_cov_5","Ntome_NODE_10089_length_2188_cov_45",97.08,137,4,0,135,271,1390,1254,2.52e-60,231,136,136
"84442","Nsylvestris_NODE_35214_length_290_cov_5","Ntome_NODE_990_length_5103_cov_82",90.842,273,19,2,7,273,4367,4095,3.08e-99,361,266,272
"84443","Nsylvestris_NODE_35215_length_290_cov_5","Ntome_NODE_33_length_10458_cov_194",89.754,244,20,4,45,287,1261,1500,4.06e-83,307,242,239
"84444","Nsylvestris_NODE_35217_length_290_cov_4","Ntome_NODE_2012_length_4165_cov_30",87.889,289,29,6,7,290,1284,997,1.86e-91,335,283,287
"84445","Nsylvestris_NODE_35219_length_290_cov_4","Ntome_NODE_925_length_5198_cov_131",88.095,294,26,7,1,290,2375,2663,4.01e-93,340,289,288
"84446","Nsylvestris_NODE_35221_length_290_cov_4","Ntome_NODE_19430_length_1240_cov_19",89.31,290,24,4,3,290,649,933,3.98e-98,357,287,284
"84447","Nsylvestris_NODE_35225_length_290_cov_4","Ntome_NODE_485_length_6067_cov_75",93.75,64,4,0,126,189,1782,1719,9.58e-20,97.1,63,63
"84448","Nsylvestris_NODE_35233_length_290_cov_3","Ntome_NODE_17130_length_1437_cov_124",94.483,290,15,1,1,290,1371,1083,8.26e-125,446,289,288
"84449","Nsylvestris_NODE_35235_length_290_cov_3","Ntome_NODE_234_length_7183_cov_167",91.016,256,16,3,35,290,5812,5564,1.44e-92,339,255,248
"84453","Nsylvestris_NODE_35240_length_289_cov_248","Ntome_NODE_1190_length_4849_cov_237",93.993,283,13,1,11,289,4166,3884,1.07e-118,425,278,282
"84454","Nsylvestris_NODE_35241_length_289_cov_237","Ntome_NODE_1396_length_4636_cov_255",97.578,289,7,0,1,289,3388,3100,8.05e-140,496,288,288
"84457","Nsylvestris_NODE_35245_length_289_cov_13","Ntome_NODE_11527_length_2011_cov_104",85.776,232,15,6,7,227,1221,1445,9.02e-60,230,220,224
"84463","Nsylvestris_NODE_35250_length_289_cov_6","Ntome_NODE_32952_length_481_cov_80",86.592,179,24,0,1,179,179,1,2.54e-50,198,178,178
"84466","Nsylvestris_NODE_35252_length_289_cov_6","Ntome_NODE_95_length_8630_cov_64",96.396,222,8,0,65,286,2872,3093,6.59e-101,366,221,221
"84467","Nsylvestris_NODE_35255_length_289_cov_5","Ntome_NODE_19856_length_1205_cov_9",94.444,288,14,2,4,289,437,150,1.06e-123,442,285,287
"84468","Nsylvestris_NODE_35257_length_289_cov_5","Ntome_NODE_19366_length_1246_cov_10",95.486,288,12,1,1,288,371,85,1.06e-128,459,287,286
"84469","Nsylvestris_NODE_35258_length_289_cov_4","Ntome_NODE_10051_length_2193_cov_276",100,36,0,0,254,289,1605,1640,7.48e-11,67.6,35,35
"84472","Nsylvestris_NODE_35261_length_289_cov_4","Ntome_NODE_26734_length_771_cov_29",97.222,36,0,1,70,105,271,305,1.25e-08,60.2,35,34
"84478","Nsylvestris_NODE_35267_length_289_cov_3","Ntome_NODE_2838_length_3761_cov_141",95.417,240,11,0,50,289,2517,2278,6.54e-106,383,239,239
"84479","Nsylvestris_NODE_35268_length_289_cov_3","Ntome_NODE_39595_length_256_cov_4",95.862,145,5,1,59,203,113,256,6.97e-61,233,144,143
"84486","Nsylvestris_NODE_35271_length_289_cov_3","Ntome_NODE_13268_length_1812_cov_13",94.048,252,12,3,23,271,844,1095,8.46e-105,379,248,251
"84489","Nsylvestris_NODE_35274_length_289_cov_3","Ntome_NODE_14025_length_1735_cov_127",93.989,183,10,1,107,288,966,784,1.14e-73,276,181,182
"84490","Nsylvestris_NODE_35284_length_289_cov_2","Ntome_NODE_32386_length_522_cov_6",88.235,221,24,2,68,288,522,304,8.89e-70,263,220,218
"84496","Nsylvestris_NODE_35287_length_288_cov_240","Ntome_NODE_8946_length_2346_cov_237",91.919,297,12,3,1,288,1427,1720,1.39e-112,405,287,293
"84506","Nsylvestris_NODE_35293_length_288_cov_10","Ntome_NODE_810_length_5367_cov_248",88.66,291,7,10,1,288,309,42,2.39e-90,331,287,267
"84513","Nsylvestris_NODE_35301_length_288_cov_5","Ntome_NODE_7877_length_2511_cov_56",86,300,29,5,1,288,1672,1970,1.12e-83,309,287,298
"84514","Nsylvestris_NODE_35305_length_288_cov_5","Ntome_NODE_13402_length_1796_cov_203",96.875,32,1,0,1,32,1006,975,5.8e-07,54.7,31,31
"84515","Nsylvestris_NODE_35306_length_288_cov_5","Ntome_NODE_21886_length_1056_cov_10",96.023,176,6,1,113,288,1054,880,1.89e-76,285,175,174
"84516","Nsylvestris_NODE_35308_length_288_cov_5","Ntome_NODE_4220_length_3286_cov_301",96.377,276,10,0,1,276,639,364,1.36e-127,455,275,275
"84517","Nsylvestris_NODE_35310_length_288_cov_5","Ntome_NODE_32582_length_507_cov_73",84.252,254,33,6,23,272,133,383,4.15e-63,241,249,250
"84518","Nsylvestris_NODE_35314_length_288_cov_4","Ntome_NODE_30717_length_599_cov_75",100,37,0,0,252,288,157,121,2.07e-11,69.4,36,36
"84524","Nsylvestris_NODE_35325_length_288_cov_3","Ntome_NODE_1312_length_4715_cov_189",86.957,115,9,3,176,285,2327,2440,4.36e-28,124,109,113
"84525","Nsylvestris_NODE_35326_length_288_cov_3","Ntome_NODE_18402_length_1325_cov_203",96.503,286,9,1,1,285,1265,980,1.35e-132,472,284,285
"84526","Nsylvestris_NODE_35327_length_288_cov_3","Ntome_NODE_24289_length_907_cov_38",92.683,287,18,3,1,285,382,667,2.99e-114,411,284,285
"84527","Nsylvestris_NODE_35329_length_288_cov_3","Ntome_NODE_27068_length_755_cov_23",89.691,291,23,5,1,288,544,258,2.36e-100,364,287,286
"84533","Nsylvestris_NODE_35339_length_287_cov_233","Ntome_NODE_26212_length_796_cov_264",90.244,287,25,1,1,287,588,305,1.41e-102,372,286,283
"84537","Nsylvestris_NODE_35341_length_287_cov_163","Ntome_NODE_29190_length_660_cov_209",84.834,211,21,2,9,219,15,214,1.95e-51,202,210,199
"84541","Nsylvestris_NODE_35348_length_287_cov_6","Ntome_NODE_10097_length_2187_cov_73",94.554,202,11,0,1,202,1733,1934,8.64e-85,313,201,201
"84542","Nsylvestris_NODE_35349_length_287_cov_6","Ntome_NODE_5460_length_2972_cov_87",91.93,285,20,2,2,283,887,1171,8.34e-110,396,281,284
"84543","Nsylvestris_NODE_35351_length_287_cov_5","Ntome_NODE_15326_length_1602_cov_30",97.909,287,6,0,1,287,1510,1224,2.22e-140,497,286,286
"84544","Nsylvestris_NODE_35352_length_287_cov_5","Ntome_NODE_17815_length_1373_cov_122",95.122,287,14,0,1,287,159,445,4.88e-127,453,286,286
"84545","Nsylvestris_NODE_35354_length_287_cov_5","Ntome_NODE_36864_length_314_cov_4",97.238,181,5,0,1,181,181,1,4.02e-83,307,180,180
"84546","Nsylvestris_NODE_35355_length_287_cov_5","Ntome_NODE_31010_length_589_cov_6",87.108,287,22,10,1,284,160,434,3.11e-84,311,283,274
"84547","Nsylvestris_NODE_35359_length_287_cov_4","Ntome_NODE_6136_length_2825_cov_87",88.435,294,17,6,1,287,1108,825,1.43e-92,339,286,283
"84548","Nsylvestris_NODE_35363_length_287_cov_4","Ntome_NODE_12121_length_1943_cov_13",88.591,298,18,4,1,287,1032,1324,2.37e-95,348,286,292
"84549","Nsylvestris_NODE_35365_length_287_cov_4","Ntome_NODE_7948_length_2498_cov_283",94.138,290,14,1,1,287,1667,1956,1.37e-122,438,286,289
"84553","Nsylvestris_NODE_35373_length_287_cov_3","Ntome_NODE_1162_length_4885_cov_170",100,81,0,0,206,286,955,1035,7.17e-36,150,80,80
"84554","Nsylvestris_NODE_35375_length_287_cov_3","Ntome_NODE_1742_length_4352_cov_47",86.124,209,22,4,37,238,1508,1716,1.94e-56,219,201,208
"84555","Nsylvestris_NODE_35377_length_287_cov_3","Ntome_NODE_12496_length_1897_cov_212",89.241,158,8,6,94,250,1377,1526,1.52e-47,189,156,149
"84559","Nsylvestris_NODE_35382_length_286_cov_234","Ntome_NODE_4732_length_3152_cov_181",96.82,283,9,0,4,286,903,1185,3.73e-133,473,282,282
"84560","Nsylvestris_NODE_35383_length_286_cov_196","Ntome_NODE_8859_length_2360_cov_260",97.458,236,6,0,1,236,588,823,4.96e-112,403,235,235
"84561","Nsylvestris_NODE_35384_length_286_cov_44","Ntome_NODE_7039_length_2648_cov_269",89.706,272,9,5,2,269,258,2,8.54e-90,329,267,256
"84562","Nsylvestris_NODE_35386_length_286_cov_9","Ntome_NODE_1726_length_4360_cov_17",91.111,270,17,7,21,285,1148,881,1.09e-98,359,264,267
"84563","Nsylvestris_NODE_35391_length_286_cov_6","Ntome_NODE_6867_length_2682_cov_37",95.455,286,13,0,1,286,1662,1377,3.76e-128,457,285,285
"84564","Nsylvestris_NODE_35392_length_286_cov_6","Ntome_NODE_14058_length_1729_cov_55",81.988,322,13,14,1,285,659,972,2.48e-60,231,284,313
"84572","Nsylvestris_NODE_35398_length_286_cov_5","Ntome_NODE_38862_length_270_cov_4",89.655,232,18,5,54,285,260,35,4.03e-78,291,231,225
"84573","Nsylvestris_NODE_35399_length_286_cov_4","Ntome_NODE_28581_length_685_cov_15",84.321,287,24,5,1,286,586,320,3.16e-69,261,285,266
"84574","Nsylvestris_NODE_35402_length_286_cov_4","Ntome_NODE_779_length_5422_cov_68",94.718,284,13,1,1,284,2095,1814,3.78e-123,440,283,281
"84579","Nsylvestris_NODE_35413_length_286_cov_3","Ntome_NODE_12462_length_1901_cov_222",88.764,89,6,3,4,88,3,91,1.57e-22,106,84,88
"84580","Nsylvestris_NODE_35418_length_286_cov_3","Ntome_NODE_887_length_5242_cov_20",87.458,295,22,6,1,286,4815,5103,1.11e-88,326,285,288
"84581","Nsylvestris_NODE_35421_length_286_cov_3","Ntome_NODE_1230_length_4798_cov_56",93.793,290,10,3,1,286,2718,2433,8.19e-120,429,285,285
"84582","Nsylvestris_NODE_35424_length_286_cov_2","Ntome_NODE_5641_length_2930_cov_18",94.898,294,7,1,1,286,1112,819,4.86e-127,453,285,293
"84590","Nsylvestris_NODE_35430_length_285_cov_165","Ntome_NODE_3235_length_3608_cov_280",95.789,285,12,0,1,285,2478,2762,2.89e-129,460,284,284
"84594","Nsylvestris_NODE_35433_length_285_cov_50","Ntome_NODE_7175_length_2626_cov_192",91.25,240,10,4,28,265,240,10,6.63e-86,316,237,230
"84595","Nsylvestris_NODE_35434_length_285_cov_41","Ntome_NODE_5903_length_2871_cov_197",92.245,245,14,2,2,241,247,3,1.09e-93,342,239,244
"84601","Nsylvestris_NODE_35438_length_285_cov_6","Ntome_NODE_17555_length_1397_cov_239",98.182,55,1,0,231,285,476,422,9.4e-20,97.1,54,54
"84602","Nsylvestris_NODE_35440_length_285_cov_6","Ntome_NODE_6509_length_2746_cov_210",100,47,0,0,1,47,2473,2519,5.66e-17,87.9,46,46
"84603","Nsylvestris_NODE_35442_length_285_cov_5","Ntome_NODE_33938_length_422_cov_5",96.629,267,9,0,2,268,267,1,2.91e-124,444,266,266
"84604","Nsylvestris_NODE_35447_length_285_cov_5","Ntome_NODE_6924_length_2669_cov_45",91.958,286,19,3,1,285,559,841,2.3e-110,398,284,282
"84605","Nsylvestris_NODE_35449_length_285_cov_4","Ntome_NODE_13865_length_1750_cov_11",97.544,285,7,0,1,285,1475,1191,1.33e-137,488,284,284
"84606","Nsylvestris_NODE_35459_length_285_cov_3","Ntome_NODE_17582_length_1395_cov_22",95.545,202,8,1,1,201,675,474,1.42e-87,322,200,201
"84617","Nsylvestris_NODE_35473_length_284_cov_105","Ntome_NODE_11803_length_1980_cov_265",91.144,271,22,2,1,270,325,56,6.46e-101,366,269,269
"84622","Nsylvestris_NODE_35476_length_284_cov_7","Ntome_NODE_8494_length_2414_cov_38",93.878,49,3,0,154,202,1476,1428,4.39e-13,75,48,48
"84623","Nsylvestris_NODE_35478_length_284_cov_7","Ntome_NODE_24504_length_892_cov_101",94.425,287,11,5,1,284,280,564,4.86e-122,436,283,284
"84624","Nsylvestris_NODE_35482_length_284_cov_6","Ntome_NODE_5221_length_3024_cov_45",77.559,254,35,11,45,280,280,529,7.14e-31,134,235,249
"84625","Nsylvestris_NODE_35483_length_284_cov_5","Ntome_NODE_23518_length_954_cov_44",95.07,284,14,0,1,284,283,566,2.24e-125,448,283,283
"84626","Nsylvestris_NODE_35485_length_284_cov_5","Ntome_NODE_24395_length_899_cov_155",97.297,37,1,0,1,37,611,575,9.5e-10,63.9,36,36
"84627","Nsylvestris_NODE_35486_length_284_cov_5","Ntome_NODE_2538_length_3890_cov_78",88.596,228,24,2,1,227,1473,1247,1.12e-73,276,226,226
"84628","Nsylvestris_NODE_35487_length_284_cov_5","Ntome_NODE_264_length_6990_cov_236",94.444,288,9,6,1,284,4560,4844,4.86e-122,436,283,284
"84631","Nsylvestris_NODE_35493_length_284_cov_4","Ntome_NODE_13075_length_1834_cov_25",98.592,71,1,0,213,283,1301,1371,1.19e-28,126,70,70
"84635","Nsylvestris_NODE_35502_length_284_cov_4","Ntome_NODE_517_length_5975_cov_229",85.185,108,13,2,74,179,2157,2263,4.32e-23,108,105,106
"84641","Nsylvestris_NODE_35510_length_284_cov_3","Ntome_NODE_16747_length_1471_cov_104",92.281,285,20,2,1,284,922,639,4.93e-112,403,283,283
"84647","Nsylvestris_NODE_35518_length_284_cov_2","Ntome_NODE_27295_length_744_cov_5",95.423,284,13,0,1,284,626,343,4.82e-127,453,283,283
"84648","Nsylvestris_NODE_35520_length_284_cov_2","Ntome_NODE_5410_length_2984_cov_31",96.429,168,5,1,4,171,2632,2466,1.12e-73,276,167,166
"84649","Nsylvestris_NODE_35523_length_283_cov_198","Ntome_NODE_19048_length_1272_cov_116",93.007,286,17,1,1,283,373,88,2.27e-115,414,282,285
"84655","Nsylvestris_NODE_35532_length_283_cov_6","Ntome_NODE_6370_length_2774_cov_11",85.882,170,13,1,1,170,1747,1905,5.42e-42,171,169,158
"84661","Nsylvestris_NODE_35552_length_283_cov_4","Ntome_NODE_10286_length_2158_cov_71",90.036,281,22,3,6,283,851,574,1.08e-98,359,277,277
"84662","Nsylvestris_NODE_35553_length_283_cov_3","Ntome_NODE_22638_length_1008_cov_7",92.883,281,17,2,3,283,645,922,1.36e-112,405,280,277
"84671","Nsylvestris_NODE_35558_length_283_cov_3","Ntome_NODE_8398_length_2428_cov_30",96.831,284,7,2,1,283,1186,1468,3.69e-133,473,282,282
"84672","Nsylvestris_NODE_35560_length_283_cov_3","Ntome_NODE_12955_length_1853_cov_45",82.759,290,43,5,1,283,1654,1365,1.88e-66,252,282,289
"84677","Nsylvestris_NODE_35570_length_283_cov_1","Ntome_NODE_26100_length_802_cov_18",94.7,283,15,0,1,283,468,750,3.74e-123,440,282,282
"84685","Nsylvestris_NODE_35574_length_282_cov_95","Ntome_NODE_6274_length_2792_cov_281",88.492,252,18,8,40,282,119,368,3.07e-79,294,242,249
"84686","Nsylvestris_NODE_35577_length_282_cov_8","Ntome_NODE_16235_length_1518_cov_7",95.423,284,8,2,1,282,179,459,2.23e-125,448,281,280
"84687","Nsylvestris_NODE_35578_length_282_cov_8","Ntome_NODE_18901_length_1284_cov_19",90.813,283,12,4,1,282,588,857,6.41e-101,366,281,269
"84690","Nsylvestris_NODE_35581_length_282_cov_6","Ntome_NODE_18183_length_1344_cov_13",83.73,252,31,10,18,261,970,721,8.78e-60,230,243,249
"84691","Nsylvestris_NODE_35584_length_282_cov_5","Ntome_NODE_12494_length_1897_cov_245",90.728,151,7,3,136,282,1897,1750,3.2e-49,195,146,147
"84692","Nsylvestris_NODE_35593_length_282_cov_4","Ntome_NODE_3024_length_3690_cov_16",92.933,283,17,3,1,280,693,411,1.05e-113,409,279,282
"84693","Nsylvestris_NODE_35595_length_282_cov_4","Ntome_NODE_4658_length_3168_cov_132",95.484,155,7,0,124,278,1249,1403,2.42e-65,248,154,154
"84705","Nsylvestris_NODE_35607_length_282_cov_3","Ntome_NODE_16556_length_1491_cov_22",95.374,281,13,0,1,281,474,754,2.23e-125,448,280,280
"84706","Nsylvestris_NODE_35616_length_281_cov_180","Ntome_NODE_25048_length_860_cov_237",96.078,255,7,3,29,281,36,289,8.09e-115,412,252,253
"84707","Nsylvestris_NODE_35617_length_281_cov_147","Ntome_NODE_32016_length_549_cov_6",87.791,172,14,5,1,172,208,44,3.19e-49,195,171,164
"84711","Nsylvestris_NODE_35623_length_276_cov_9","Ntome_NODE_15010_length_1634_cov_130",97.826,46,1,0,231,276,343,388,9.14e-15,80.5,45,45
"84712","Nsylvestris_NODE_35626_length_281_cov_8","Ntome_NODE_4845_length_3124_cov_51",87.843,255,31,0,26,280,1138,1392,6.57e-81,300,254,254
"84713","Nsylvestris_NODE_35627_length_281_cov_6","Ntome_NODE_4876_length_3116_cov_186",97.674,43,1,0,26,68,970,928,4.34e-13,75,42,42
"84718","Nsylvestris_NODE_35630_length_281_cov_5","Ntome_NODE_12710_length_1872_cov_92",93.662,284,15,2,1,281,514,231,1.34e-117,422,280,283
"84719","Nsylvestris_NODE_35632_length_281_cov_4","Ntome_NODE_18444_length_1322_cov_9",95.73,281,12,0,1,281,842,562,4.77e-127,453,280,280
"84720","Nsylvestris_NODE_35637_length_281_cov_4","Ntome_NODE_13685_length_1769_cov_96",95.035,282,13,1,1,281,943,1224,1.03e-123,442,280,281
"84721","Nsylvestris_NODE_35638_length_281_cov_4","Ntome_NODE_69_length_9046_cov_201",91.051,257,12,1,25,281,3984,3739,5.01e-92,337,256,245
"84722","Nsylvestris_NODE_35640_length_281_cov_3","Ntome_NODE_26032_length_805_cov_8",93.594,281,18,0,1,281,488,208,4.83e-117,420,280,280
"84723","Nsylvestris_NODE_35643_length_281_cov_3","Ntome_NODE_5952_length_2861_cov_26",94.326,141,7,1,1,141,2318,2457,2.45e-55,215,140,139
"84745","Nsylvestris_NODE_35658_length_280_cov_6","Ntome_NODE_30704_length_600_cov_14",95.714,70,2,1,208,277,145,213,3.29e-24,111,69,68
"84746","Nsylvestris_NODE_35659_length_280_cov_6","Ntome_NODE_28090_length_706_cov_32",89.273,289,21,4,1,280,22,309,4.95e-97,353,279,287
"84747","Nsylvestris_NODE_35661_length_280_cov_5","Ntome_NODE_11121_length_2057_cov_242",94.306,281,14,2,1,280,1146,867,8e-120,429,279,279
"84748","Nsylvestris_NODE_35663_length_280_cov_5","Ntome_NODE_16555_length_1491_cov_110",96.429,280,10,0,1,280,327,606,7.89e-130,462,279,279
"84749","Nsylvestris_NODE_35668_length_280_cov_4","Ntome_NODE_34457_length_397_cov_4",82.784,273,21,6,34,280,397,125,5.24e-57,220,246,272
"84750","Nsylvestris_NODE_35674_length_280_cov_4","Ntome_NODE_2838_length_3761_cov_141",93.262,282,16,2,1,280,2297,2017,8.06e-115,412,279,280
"84751","Nsylvestris_NODE_35676_length_280_cov_4","Ntome_NODE_22510_length_1016_cov_11",95.714,280,10,2,1,280,472,195,6.14e-126,449,279,277
"84752","Nsylvestris_NODE_35681_length_280_cov_3","Ntome_NODE_23868_length_932_cov_227",97.826,46,1,0,235,280,427,472,9.28e-15,80.5,45,45
"84753","Nsylvestris_NODE_35684_length_280_cov_3","Ntome_NODE_7843_length_2517_cov_222",93.548,93,5,1,188,280,193,284,5.43e-32,137,92,91
"84754","Nsylvestris_NODE_35685_length_280_cov_3","Ntome_NODE_3674_length_3460_cov_187",93.487,261,13,2,2,258,1939,1679,1.76e-106,385,256,260
"84755","Nsylvestris_NODE_35687_length_280_cov_3","Ntome_NODE_314_length_6644_cov_63",92.883,281,13,2,1,280,5358,5084,1.74e-111,401,279,274
"84767","Nsylvestris_NODE_35699_length_279_cov_186","Ntome_NODE_30191_length_620_cov_252",91.188,261,11,4,30,279,615,356,2.97e-94,344,249,259
"84770","Nsylvestris_NODE_35710_length_279_cov_5","Ntome_NODE_1172_length_4871_cov_174",96.057,279,10,1,1,279,3042,3319,4.73e-127,453,278,277
"84771","Nsylvestris_NODE_35712_length_279_cov_5","Ntome_NODE_37126_length_308_cov_5",92.578,256,10,5,30,279,1,253,1.06e-98,359,249,252
"84777","Nsylvestris_NODE_35715_length_279_cov_4","Ntome_NODE_4402_length_3238_cov_53",93.165,278,19,0,1,278,423,146,1.04e-113,409,277,277
"84781","Nsylvestris_NODE_35719_length_279_cov_4","Ntome_NODE_25799_length_816_cov_21",89.753,283,16,3,1,279,292,565,6.38e-96,350,278,273
"84782","Nsylvestris_NODE_35721_length_279_cov_3","Ntome_NODE_3275_length_3598_cov_76",94.326,282,13,1,1,279,3033,3314,7.97e-120,429,278,281
"84783","Nsylvestris_NODE_35722_length_279_cov_3","Ntome_NODE_17660_length_1387_cov_172",83.784,185,17,5,70,254,250,421,8.93e-40,163,184,171
"84784","Nsylvestris_NODE_35723_length_278_cov_3","Ntome_NODE_16132_length_1528_cov_123",90.795,239,13,3,48,278,1086,849,3e-84,311,230,237
"84791","Nsylvestris_NODE_35728_length_279_cov_3","Ntome_NODE_10206_length_2170_cov_13",91.057,123,10,1,1,122,1531,1409,2.48e-40,165,121,122
"84792","Nsylvestris_NODE_35729_length_279_cov_3","Ntome_NODE_1341_length_4691_cov_248",81.588,277,48,1,3,279,3062,3335,1.12e-58,226,276,273
"84793","Nsylvestris_NODE_35730_length_279_cov_3","Ntome_NODE_38012_length_288_cov_4",97.512,201,5,0,71,271,1,201,2.97e-94,344,200,200
"84794","Nsylvestris_NODE_35731_length_279_cov_3","Ntome_NODE_25273_length_846_cov_261",80.952,168,19,11,117,279,55,214,5.45e-27,121,162,159
"84804","Nsylvestris_NODE_35740_length_278_cov_206","Ntome_NODE_1748_length_4345_cov_298",98.201,278,5,0,1,278,1474,1197,4.64e-137,486,277,277
"84805","Nsylvestris_NODE_35741_length_278_cov_134","Ntome_NODE_23905_length_930_cov_166",97.273,110,3,0,1,110,484,375,5.28e-47,187,109,109
"84806","Nsylvestris_NODE_35743_length_278_cov_12","Ntome_NODE_28276_length_698_cov_59",90.517,232,15,1,36,267,698,474,6.49e-81,300,231,224
"84807","Nsylvestris_NODE_35749_length_278_cov_6","Ntome_NODE_10087_length_2188_cov_245",97.101,276,8,0,3,278,592,317,6.05e-131,466,275,275
"84808","Nsylvestris_NODE_35752_length_278_cov_5","Ntome_NODE_6868_length_2682_cov_13",94.619,223,11,1,1,222,2460,2682,2.96e-94,344,221,222
"84809","Nsylvestris_NODE_35756_length_278_cov_5","Ntome_NODE_19085_length_1268_cov_213",91.367,278,23,1,1,278,172,448,8.11e-105,379,277,276
"84813","Nsylvestris_NODE_35758_length_278_cov_5","Ntome_NODE_35993_length_339_cov_2",95.21,167,6,1,112,278,339,175,8.52e-70,263,166,164
"84814","Nsylvestris_NODE_35761_length_278_cov_4","Ntome_NODE_20391_length_1162_cov_38",96.4,250,9,0,2,251,1098,849,8e-115,412,249,249
"84815","Nsylvestris_NODE_35762_length_278_cov_4","Ntome_NODE_11722_length_1989_cov_101",92.718,206,15,0,72,277,876,1081,2.34e-80,298,205,205
"84816","Nsylvestris_NODE_35764_length_278_cov_4","Ntome_NODE_1921_length_4224_cov_179",96.763,278,9,0,1,278,2428,2705,2.18e-130,464,277,277
"84820","Nsylvestris_NODE_35771_length_278_cov_4","Ntome_NODE_33880_length_425_cov_7",91.2,125,11,0,154,278,1,125,5.31e-42,171,124,124
"84821","Nsylvestris_NODE_35773_length_278_cov_4","Ntome_NODE_9492_length_2271_cov_101",92.806,278,20,0,1,278,59,336,4.81e-112,403,277,277
"84822","Nsylvestris_NODE_35774_length_278_cov_4","Ntome_NODE_4602_length_3182_cov_108",85.425,247,15,4,47,278,2418,2658,5.16e-62,237,231,240
"84828","Nsylvestris_NODE_35778_length_278_cov_3","Ntome_NODE_22740_length_1001_cov_119",96.985,199,6,0,80,278,45,243,1.78e-91,335,198,198
"84829","Nsylvestris_NODE_35781_length_278_cov_3","Ntome_NODE_32649_length_502_cov_10",92.086,278,18,3,1,277,407,133,1.35e-107,388,276,274
"84830","Nsylvestris_NODE_35782_length_278_cov_3","Ntome_NODE_8709_length_2383_cov_85",86.093,302,16,8,1,278,1102,803,1.81e-81,302,277,299
"84831","Nsylvestris_NODE_35787_length_278_cov_3","Ntome_NODE_31653_length_566_cov_5",94.245,278,16,0,1,278,57,334,1.03e-118,425,277,277
"84835","Nsylvestris_NODE_35789_length_278_cov_3","Ntome_NODE_3920_length_3380_cov_285",94.828,58,1,2,165,220,2889,2832,1.53e-17,89.8,55,57
"84839","Nsylvestris_NODE_35794_length_278_cov_2","Ntome_NODE_23882_length_932_cov_20",93.772,289,7,4,1,278,631,343,3.69e-118,424,277,288
"84840","Nsylvestris_NODE_35796_length_277_cov_11","Ntome_NODE_5271_length_3014_cov_123",93.776,241,11,3,39,277,1863,1625,1.05e-98,359,238,238
"84841","Nsylvestris_NODE_35800_length_277_cov_7","Ntome_NODE_34724_length_386_cov_4",91.176,272,21,3,4,275,101,369,6.29e-101,366,271,268
"84845","Nsylvestris_NODE_35802_length_277_cov_5","Ntome_NODE_33472_length_448_cov_4",97.5,40,1,0,238,277,150,111,1.99e-11,69.4,39,39
"84846","Nsylvestris_NODE_35803_length_277_cov_5","Ntome_NODE_7932_length_2499_cov_160",93.274,223,13,2,1,222,2402,2181,2.97e-89,327,221,221
"84847","Nsylvestris_NODE_35805_length_277_cov_4","Ntome_NODE_19755_length_1214_cov_59",93.077,260,16,2,18,275,1084,825,8.08e-105,379,257,259
"84856","Nsylvestris_NODE_35814_length_277_cov_4","Ntome_NODE_23406_length_960_cov_27",84.871,271,15,8,31,277,343,75,6.61e-66,250,246,268
"84859","Nsylvestris_NODE_35823_length_277_cov_3","Ntome_NODE_19798_length_1210_cov_119",97.222,36,0,1,170,205,608,574,1.2e-08,60.2,35,34
"84865","Nsylvestris_NODE_35828_length_277_cov_3","Ntome_NODE_40_length_10198_cov_97",85.664,286,21,10,1,277,5962,6236,6.51e-76,283,276,274
"84869","Nsylvestris_NODE_35830_length_277_cov_1","Ntome_NODE_12246_length_1927_cov_211",98.805,251,2,1,27,277,771,522,7.85e-125,446,250,249
"84875","Nsylvestris_NODE_35834_length_276_cov_172","Ntome_NODE_2947_length_3719_cov_173",95.556,225,8,1,52,276,1983,1761,1.05e-98,359,224,222
"84879","Nsylvestris_NODE_35842_length_276_cov_6","Ntome_NODE_6136_length_2825_cov_87",93.455,275,14,4,2,276,2547,2817,1.33e-112,405,274,270
"84885","Nsylvestris_NODE_35860_length_276_cov_4","Ntome_NODE_16204_length_1521_cov_17",86.434,258,11,7,41,275,88,344,3.04e-69,261,234,256
"84888","Nsylvestris_NODE_35863_length_276_cov_4","Ntome_NODE_2034_length_4150_cov_214",91.481,270,20,1,1,270,752,1018,1.74e-101,368,269,266
"84889","Nsylvestris_NODE_35865_length_276_cov_4","Ntome_NODE_5646_length_2929_cov_119",91.5,200,17,0,77,276,138,337,1.09e-73,276,199,199
"84890","Nsylvestris_NODE_35870_length_276_cov_3","Ntome_NODE_773_length_5429_cov_147",96.226,106,1,1,171,276,3158,3056,5.27e-42,171,105,102
"84891","Nsylvestris_NODE_35871_length_276_cov_3","Ntome_NODE_10081_length_2189_cov_197",92.806,278,16,3,1,276,1196,921,6.18e-111,399,275,275
"84892","Nsylvestris_NODE_35872_length_276_cov_3","Ntome_NODE_4378_length_3244_cov_200",86.716,271,32,4,1,269,2198,2466,2.32e-80,298,268,268
"84893","Nsylvestris_NODE_35875_length_276_cov_3","Ntome_NODE_34131_length_409_cov_3",94.301,193,10,1,84,276,68,259,3e-79,294,192,191
"84894","Nsylvestris_NODE_35877_length_276_cov_2","Ntome_NODE_6316_length_2785_cov_106",91.273,275,22,2,1,274,2106,1833,3.74e-103,374,273,273
"84906","Nsylvestris_NODE_35887_length_275_cov_7","Ntome_NODE_9209_length_2308_cov_22",92.727,275,13,4,1,275,1664,1397,3.7e-108,390,274,267
"84907","Nsylvestris_NODE_35894_length_275_cov_5","Ntome_NODE_13862_length_1750_cov_23",90.391,281,19,4,1,274,472,751,8.07e-100,363,273,279
"84908","Nsylvestris_NODE_35895_length_275_cov_5","Ntome_NODE_8381_length_2430_cov_106",85.321,109,14,2,1,108,493,386,3.23e-24,111,107,107
"84909","Nsylvestris_NODE_35898_length_275_cov_4","Ntome_NODE_4563_length_3193_cov_169",88.889,279,23,5,1,275,2164,1890,4.89e-92,337,274,274
"84910","Nsylvestris_NODE_35899_length_275_cov_4","Ntome_NODE_12397_length_1909_cov_31",89.03,237,19,5,46,275,116,352,5e-77,287,229,236
"84911","Nsylvestris_NODE_35900_length_275_cov_4","Ntome_NODE_2776_length_3778_cov_125",97.753,89,2,0,12,100,3684,3772,5.29e-37,154,88,88
"84912","Nsylvestris_NODE_35901_length_275_cov_4","Ntome_NODE_32386_length_522_cov_6",88.889,108,10,1,1,106,199,92,2.48e-30,132,105,107
"84913","Nsylvestris_NODE_35904_length_275_cov_4","Ntome_NODE_22387_length_1024_cov_6",96.653,239,8,0,37,275,938,700,2.21e-110,398,238,238
"84916","Nsylvestris_NODE_35911_length_275_cov_3","Ntome_NODE_38718_length_273_cov_4",97.209,215,6,0,1,215,215,1,2.24e-100,364,214,214
"84917","Nsylvestris_NODE_35915_length_275_cov_3","Ntome_NODE_25854_length_813_cov_9",94.118,85,3,1,5,87,392,308,3.2e-29,128,82,84
"84918","Nsylvestris_NODE_35917_length_275_cov_3","Ntome_NODE_3834_length_3408_cov_282",100,275,0,0,1,275,2357,2083,9.8e-144,508,274,274
"84919","Nsylvestris_NODE_35919_length_275_cov_3","Ntome_NODE_26548_length_780_cov_12",87.008,254,31,1,2,255,193,444,1.8e-76,285,253,251
"84920","Nsylvestris_NODE_35923_length_275_cov_3","Ntome_NODE_32730_length_496_cov_14",94.928,276,10,4,1,275,478,206,7.85e-120,429,274,272
"84921","Nsylvestris_NODE_35926_length_275_cov_3","Ntome_NODE_5485_length_2965_cov_110",93.704,270,15,2,7,275,1940,1672,4.76e-112,403,268,268
"84922","Nsylvestris_NODE_35930_length_275_cov_1","Ntome_NODE_2447_length_3932_cov_152",88.339,283,24,3,1,275,1432,1713,2.28e-90,331,274,281
"84927","Nsylvestris_NODE_35933_length_274_cov_73","Ntome_NODE_10428_length_2142_cov_208",100,33,0,0,242,274,306,338,3.28e-09,62.1,32,32
"84928","Nsylvestris_NODE_35935_length_274_cov_10","Ntome_NODE_11253_length_2043_cov_280",90.826,218,10,1,8,215,1967,1750,6.44e-76,283,207,217
"84929","Nsylvestris_NODE_35941_length_274_cov_5","Ntome_NODE_6513_length_2746_cov_148",92.857,42,3,0,225,266,1,42,3.28e-09,62.1,41,41
"84935","Nsylvestris_NODE_35948_length_274_cov_4","Ntome_NODE_5610_length_2936_cov_178",94.891,274,14,0,1,274,1905,2178,7.81e-120,429,273,273
"84936","Nsylvestris_NODE_35951_length_274_cov_4","Ntome_NODE_262_length_7011_cov_223",96.833,221,7,0,54,274,5509,5729,4.8e-102,370,220,220
"84937","Nsylvestris_NODE_35952_length_274_cov_4","Ntome_NODE_3201_length_3621_cov_63",95.62,274,11,1,1,274,1592,1320,1.3e-122,438,273,272
"84938","Nsylvestris_NODE_35955_length_274_cov_4","Ntome_NODE_3184_length_3626_cov_40",94.161,274,16,0,1,274,510,783,1.69e-116,418,273,273
"84939","Nsylvestris_NODE_35957_length_274_cov_4","Ntome_NODE_970_length_5129_cov_136",97.818,275,5,1,1,274,1527,1801,3.56e-133,473,273,274
"84948","Nsylvestris_NODE_35964_length_274_cov_3","Ntome_NODE_22512_length_1016_cov_6",93.333,270,16,2,1,270,590,323,2.2e-110,398,269,267
"84949","Nsylvestris_NODE_35967_length_274_cov_2","Ntome_NODE_39872_length_251_cov_4",96.216,185,7,0,4,188,67,251,4.94e-82,303,184,184
"84952","Nsylvestris_NODE_35972_length_273_cov_199","Ntome_NODE_13884_length_1747_cov_284",96.703,273,9,0,1,273,670,398,1.28e-127,455,272,272
"84953","Nsylvestris_NODE_35973_length_273_cov_153","Ntome_NODE_1357_length_4673_cov_175",92.481,133,2,3,85,217,1665,1789,6.69e-46,183,132,124
"84954","Nsylvestris_NODE_35975_length_273_cov_8","Ntome_NODE_27946_length_713_cov_29",100,101,0,0,13,113,685,585,5.17e-47,187,100,100
"84960","Nsylvestris_NODE_35981_length_273_cov_5","Ntome_NODE_2482_length_3916_cov_62",86.667,150,9,1,25,163,1256,1405,1.46e-37,156,138,149
"84961","Nsylvestris_NODE_35982_length_273_cov_4","Ntome_NODE_11499_length_2014_cov_126",86.486,74,10,0,199,272,1028,1101,2.51e-15,82.4,73,73
"84962","Nsylvestris_NODE_35984_length_273_cov_4","Ntome_NODE_5952_length_2861_cov_26",93.773,273,16,1,1,272,920,648,1.01e-113,409,271,272
"84963","Nsylvestris_NODE_35988_length_273_cov_4","Ntome_NODE_7205_length_2621_cov_184",94.872,273,14,0,1,273,933,661,2.8e-119,427,272,272
"84964","Nsylvestris_NODE_35997_length_273_cov_4","Ntome_NODE_9568_length_2258_cov_43",89.818,275,26,1,1,273,535,261,1.73e-96,351,272,274
"84965","Nsylvestris_NODE_35999_length_272_cov_3","Ntome_NODE_4912_length_3101_cov_16",100,206,0,0,1,206,2027,1822,2.2e-105,381,205,205
"84966","Nsylvestris_NODE_36000_length_273_cov_3","Ntome_NODE_3499_length_3517_cov_202",84.496,129,7,8,1,128,2795,2911,2.48e-25,115,127,116
"84975","Nsylvestris_NODE_36011_length_273_cov_3","Ntome_NODE_6217_length_2807_cov_97",97.436,273,7,0,1,273,1406,1678,5.93e-131,466,272,272
"84976","Nsylvestris_NODE_36013_length_273_cov_2","Ntome_NODE_17969_length_1361_cov_13",97.436,273,7,0,1,273,1314,1042,5.93e-131,466,272,272
"84977","Nsylvestris_NODE_36014_length_273_cov_2","Ntome_NODE_13630_length_1774_cov_22",84.937,239,19,7,41,264,202,438,1.1e-58,226,223,236
"84978","Nsylvestris_NODE_36016_length_273_cov_2","Ntome_NODE_23469_length_957_cov_9",92.975,242,17,0,32,273,721,480,4.82e-97,353,241,241
"84979","Nsylvestris_NODE_36018_length_272_cov_303","Ntome_NODE_975_length_5123_cov_110",97.794,272,6,0,1,272,2459,2188,4.57e-132,470,271,271
"84980","Nsylvestris_NODE_36019_length_272_cov_259","Ntome_NODE_7667_length_2545_cov_304",93.359,256,12,4,21,272,2187,2441,3.68e-103,374,251,254
"84988","Nsylvestris_NODE_36025_length_272_cov_71","Ntome_NODE_13050_length_1836_cov_91",94.884,215,10,1,1,214,418,632,1.74e-91,335,213,214
"84989","Nsylvestris_NODE_36028_length_272_cov_10","Ntome_NODE_14438_length_1692_cov_104",88.768,276,26,3,1,272,49,323,6.25e-91,333,271,274
"84990","Nsylvestris_NODE_36029_length_272_cov_9","Ntome_NODE_23500_length_955_cov_12",93.13,262,18,0,10,271,881,620,1.7e-106,385,261,261
"84991","Nsylvestris_NODE_36031_length_272_cov_7","Ntome_NODE_890_length_5241_cov_95",89.928,139,13,1,132,269,5241,5103,3.1e-44,178,137,138
"84994","Nsylvestris_NODE_36036_length_272_cov_5","Ntome_NODE_31355_length_576_cov_3",97.647,85,2,0,183,267,525,441,8.74e-35,147,84,84
"84995","Nsylvestris_NODE_36039_length_272_cov_5","Ntome_NODE_26141_length_802_cov_16",87.226,274,25,6,1,272,310,575,4.9e-82,303,271,265
"84996","Nsylvestris_NODE_36041_length_272_cov_5","Ntome_NODE_21109_length_1108_cov_29",90.37,270,23,3,6,272,380,111,1.73e-96,351,266,269
"84997","Nsylvestris_NODE_36044_length_272_cov_5","Ntome_NODE_544_length_5904_cov_263",90.909,253,19,4,1,252,5451,5202,4.83e-92,337,251,249
"84998","Nsylvestris_NODE_36047_length_272_cov_4","Ntome_NODE_25489_length_834_cov_14",91.078,269,18,6,7,272,1,266,1.03e-98,359,265,265
"84999","Nsylvestris_NODE_36049_length_272_cov_4","Ntome_NODE_24105_length_918_cov_37",87.17,265,31,3,9,272,608,346,2.28e-80,298,263,262
"85000","Nsylvestris_NODE_36053_length_272_cov_4","Ntome_NODE_2440_length_3936_cov_291",100,34,0,0,1,34,407,374,9.06e-10,63.9,33,33
"85001","Nsylvestris_NODE_36056_length_272_cov_4","Ntome_NODE_6305_length_2787_cov_87",84.669,287,18,4,1,272,1771,2046,8.32e-70,263,271,275
"85004","Nsylvestris_NODE_36064_length_272_cov_3","Ntome_NODE_16054_length_1535_cov_33",93.043,115,5,3,2,113,73,187,2.41e-40,165,111,114
"85009","Nsylvestris_NODE_36069_length_272_cov_3","Ntome_NODE_24798_length_875_cov_7",96.691,272,6,1,1,272,314,46,5.95e-126,449,271,268
"85012","Nsylvestris_NODE_36071_length_272_cov_3","Ntome_NODE_30627_length_603_cov_10",91.903,247,18,2,1,245,249,3,2.89e-94,344,244,246
"85013","Nsylvestris_NODE_36078_length_271_cov_23","Ntome_NODE_38838_length_270_cov_14",92.969,256,15,2,13,268,15,267,4.75e-102,370,255,252
"85014","Nsylvestris_NODE_36080_length_271_cov_12","Ntome_NODE_8671_length_2389_cov_226",97.297,185,4,1,82,265,2,186,8.11e-85,313,183,184
"85015","Nsylvestris_NODE_36088_length_271_cov_5","Ntome_NODE_11170_length_2053_cov_26",93.467,199,13,0,71,269,115,313,8.17e-80,296,198,198
"85024","Nsylvestris_NODE_36098_length_271_cov_4","Ntome_NODE_2650_length_3838_cov_10",88.39,267,30,1,6,271,3720,3454,4.85e-87,320,265,266
"85028","Nsylvestris_NODE_36101_length_271_cov_4","Ntome_NODE_8212_length_2458_cov_200",94.096,271,16,0,1,271,187,457,7.78e-115,412,270,270
"85029","Nsylvestris_NODE_36103_length_271_cov_4","Ntome_NODE_14880_length_1646_cov_39",95.911,269,9,2,1,268,407,140,1.66e-121,435,267,267
"85030","Nsylvestris_NODE_36104_length_271_cov_4","Ntome_NODE_39780_length_253_cov_2",96.444,225,8,0,1,225,27,251,1.32e-102,372,224,224
"85031","Nsylvestris_NODE_36105_length_271_cov_3","Ntome_NODE_2092_length_4115_cov_79",91.636,275,8,10,1,268,3629,3895,6.14e-101,366,267,266
"85037","Nsylvestris_NODE_36110_length_271_cov_3","Ntome_NODE_2932_length_3724_cov_51",88.104,269,15,4,4,271,1716,1464,4.88e-82,303,267,252
"85046","Nsylvestris_NODE_36120_length_270_cov_156","Ntome_NODE_4164_length_3305_cov_114",96.296,270,10,0,1,270,2880,2611,2.75e-124,444,269,269
"85047","Nsylvestris_NODE_36123_length_270_cov_16","Ntome_NODE_11035_length_2068_cov_101",83.036,224,7,6,35,254,1884,1688,3.98e-43,174,219,196
"85056","Nsylvestris_NODE_36129_length_270_cov_6","Ntome_NODE_18150_length_1347_cov_21",85.561,187,18,4,2,179,421,235,5.11e-47,187,177,186
"85057","Nsylvestris_NODE_36131_length_270_cov_5","Ntome_NODE_19981_length_1193_cov_216",91.544,272,20,3,1,270,620,890,1.31e-102,372,269,270
"85058","Nsylvestris_NODE_36132_length_270_cov_5","Ntome_NODE_6264_length_2794_cov_183",94.382,267,11,3,3,269,15,277,3.6e-113,407,266,262
"85059","Nsylvestris_NODE_36134_length_270_cov_5","Ntome_NODE_542_length_5906_cov_220",100,41,0,0,174,214,5862,5902,1.15e-13,76.8,40,40
"85060","Nsylvestris_NODE_36136_length_270_cov_5","Ntome_NODE_230_length_7208_cov_37",90.076,262,24,1,1,262,5152,4893,1.33e-92,339,261,259
"85061","Nsylvestris_NODE_36138_length_270_cov_4","Ntome_NODE_13646_length_1773_cov_12",90.741,270,20,3,1,270,1014,1278,1.32e-97,355,269,264
"85062","Nsylvestris_NODE_36140_length_270_cov_4","Ntome_NODE_11071_length_2065_cov_44",96.629,267,9,0,4,270,2006,1740,2.75e-124,444,266,266
"85063","Nsylvestris_NODE_36141_length_270_cov_4","Ntome_NODE_28658_length_682_cov_7",87.823,271,24,4,8,270,302,571,1.05e-83,309,262,269
"85064","Nsylvestris_NODE_36144_length_270_cov_4","Ntome_NODE_7422_length_2582_cov_212",91.852,270,22,0,1,270,1798,2067,2.82e-104,377,269,269
"85070","Nsylvestris_NODE_36149_length_270_cov_3","Ntome_NODE_2265_length_4023_cov_249",91.057,246,17,4,1,242,2694,2450,2.89e-89,327,241,244
"85071","Nsylvestris_NODE_36151_length_270_cov_3","Ntome_NODE_22272_length_1030_cov_13",93.382,136,9,0,79,214,138,3,1.82e-51,202,135,135
"85072","Nsylvestris_NODE_36152_length_270_cov_3","Ntome_NODE_8462_length_2419_cov_59",96.679,271,5,1,1,267,719,989,2.12e-125,448,266,270
"85073","Nsylvestris_NODE_36154_length_270_cov_3","Ntome_NODE_33084_length_471_cov_8",97.778,270,6,0,1,270,178,447,5.86e-131,466,269,269
"85074","Nsylvestris_NODE_36157_length_270_cov_2","Ntome_NODE_35139_length_367_cov_11",93.836,146,9,0,1,146,146,1,5.04e-57,220,145,145
"85081","Nsylvestris_NODE_36161_length_269_cov_61","Ntome_NODE_16067_length_1533_cov_272",93.392,227,10,4,13,234,255,29,2.22e-90,331,221,226
"85085","Nsylvestris_NODE_36164_length_269_cov_7","Ntome_NODE_2926_length_3725_cov_232",92.05,239,17,2,33,269,3487,3725,1.72e-91,335,236,238
"85089","Nsylvestris_NODE_36167_length_269_cov_5","Ntome_NODE_26070_length_803_cov_257",94.444,36,2,0,1,36,747,712,1.5e-07,56.5,35,35
"85093","Nsylvestris_NODE_36181_length_269_cov_4","Ntome_NODE_21905_length_1055_cov_9",94.779,249,10,1,3,248,949,701,1.68e-106,385,245,248
"85094","Nsylvestris_NODE_36182_length_269_cov_4","Ntome_NODE_6960_length_2661_cov_279",93.015,272,16,2,1,269,668,397,2.79e-109,394,268,271
"85095","Nsylvestris_NODE_36183_length_269_cov_4","Ntome_NODE_3761_length_3433_cov_44",88.727,275,23,6,3,269,1042,768,7.99e-90,329,266,274
"85098","Nsylvestris_NODE_36186_length_269_cov_3","Ntome_NODE_1525_length_4517_cov_41",92.969,128,8,1,114,241,736,610,1.83e-46,185,127,126
"85099","Nsylvestris_NODE_36193_length_269_cov_3","Ntome_NODE_22321_length_1027_cov_36",90,220,14,5,1,219,274,62,2.94e-74,278,218,212
"85102","Nsylvestris_NODE_36198_length_268_cov_239","Ntome_NODE_16634_length_1483_cov_239",95.539,269,8,2,1,268,689,424,2.74e-119,427,267,265
"85108","Nsylvestris_NODE_36201_length_268_cov_203","Ntome_NODE_7619_length_2551_cov_291",94.403,268,15,0,1,268,687,420,7.68e-115,412,267,267
"85116","Nsylvestris_NODE_36208_length_268_cov_7","Ntome_NODE_23502_length_955_cov_9",97.849,93,2,0,176,268,1,93,3.07e-39,161,92,92
"85117","Nsylvestris_NODE_36209_length_268_cov_7","Ntome_NODE_9374_length_2286_cov_10",82.746,284,29,2,3,266,1947,2230,1.78e-61,235,263,283
"85121","Nsylvestris_NODE_36216_length_268_cov_5","Ntome_NODE_8402_length_2427_cov_74",93.976,249,9,6,1,247,2120,2364,1.3e-102,372,246,244
"85122","Nsylvestris_NODE_36217_length_262_cov_5","Ntome_NODE_8463_length_2419_cov_51",83.942,274,29,5,1,260,500,228,2.24e-65,248,259,272
"85123","Nsylvestris_NODE_36219_length_268_cov_5","Ntome_NODE_23026_length_982_cov_11",85.294,272,32,6,1,268,453,720,3.78e-73,274,267,267
"85124","Nsylvestris_NODE_36222_length_268_cov_4","Ntome_NODE_1123_length_4927_cov_98",94.34,265,15,0,1,265,674,938,3.57e-113,407,264,264
"85125","Nsylvestris_NODE_36223_length_268_cov_4","Ntome_NODE_23980_length_926_cov_30",93.657,268,15,1,1,268,306,41,5.98e-111,399,267,265
"85126","Nsylvestris_NODE_36226_length_268_cov_4","Ntome_NODE_10504_length_2132_cov_31",98.214,56,1,0,57,112,725,670,2.44e-20,99,55,55
"85130","Nsylvestris_NODE_36235_length_268_cov_3","Ntome_NODE_60_length_9492_cov_100",98.881,268,2,1,1,268,6307,6041,2.69e-134,477,267,266
"85131","Nsylvestris_NODE_36238_length_268_cov_3","Ntome_NODE_14985_length_1637_cov_9",97.761,268,6,0,1,268,428,161,7.52e-130,462,267,267
"85132","Nsylvestris_NODE_36243_length_268_cov_2","Ntome_NODE_3635_length_3474_cov_61",96.642,268,8,1,1,267,767,1034,2.72e-124,444,266,267
"85145","Nsylvestris_NODE_36249_length_267_cov_157","Ntome_NODE_17833_length_1372_cov_182",86.802,197,23,1,1,197,120,313,6.44e-56,217,196,193
"85148","Nsylvestris_NODE_36255_length_267_cov_7","Ntome_NODE_1377_length_4653_cov_237",100,267,0,0,1,267,3054,3320,2.66e-139,494,266,266
"85152","Nsylvestris_NODE_36259_length_267_cov_5","Ntome_NODE_13998_length_1738_cov_91",95.131,267,13,0,1,267,605,871,1.27e-117,422,266,266
"85156","Nsylvestris_NODE_36264_length_267_cov_5","Ntome_NODE_6387_length_2769_cov_31",91.144,271,20,1,1,267,2355,2625,2.17e-100,364,266,270
"85157","Nsylvestris_NODE_36267_length_267_cov_4","Ntome_NODE_27050_length_756_cov_11",81.323,257,23,16,7,257,388,625,1.82e-46,185,250,237
"85158","Nsylvestris_NODE_36268_length_267_cov_4","Ntome_NODE_15622_length_1574_cov_51",89.354,263,23,3,1,263,647,904,1.03e-88,326,262,257
"85159","Nsylvestris_NODE_36269_length_267_cov_4","Ntome_NODE_527_length_5944_cov_103",86.466,266,28,7,6,267,963,702,1.74e-76,285,261,261
"85160","Nsylvestris_NODE_36274_length_267_cov_4","Ntome_NODE_23229_length_970_cov_7",96.255,267,9,1,1,267,493,758,4.54e-122,436,266,265
"85164","Nsylvestris_NODE_36280_length_267_cov_3","Ntome_NODE_13483_length_1788_cov_127",86.94,268,30,5,1,266,414,678,8.04e-80,296,265,264
"85165","Nsylvestris_NODE_36283_length_267_cov_2","Ntome_NODE_26697_length_773_cov_34",95.506,267,12,0,1,267,555,289,2.73e-119,427,266,266
"85172","Nsylvestris_NODE_36287_length_267_cov_1","Ntome_NODE_175_length_7589_cov_297",97.297,37,1,0,1,37,613,649,8.87e-10,63.9,36,36
"85175","Nsylvestris_NODE_36289_length_266_cov_198","Ntome_NODE_17051_length_1443_cov_282",100,55,0,0,1,55,1187,1241,1.87e-21,102,54,54
"85176","Nsylvestris_NODE_36290_length_266_cov_173","Ntome_NODE_13782_length_1759_cov_223",92.727,55,1,2,1,55,1488,1437,1.14e-13,76.8,54,51
"85177","Nsylvestris_NODE_36291_length_266_cov_15","Ntome_NODE_598_length_5777_cov_147",90.845,142,13,0,71,212,2354,2495,3.89e-48,191,141,141
"85178","Nsylvestris_NODE_36293_length_266_cov_10","Ntome_NODE_11807_length_1980_cov_181",97.872,47,1,0,1,47,1212,1166,2.44e-15,82.4,46,46
"85179","Nsylvestris_NODE_36295_length_266_cov_7","Ntome_NODE_37961_length_289_cov_4",100,43,0,0,2,44,247,289,8.78e-15,80.5,42,42
"85180","Nsylvestris_NODE_36299_length_266_cov_7","Ntome_NODE_19914_length_1199_cov_70",88.406,276,21,4,1,265,827,1102,1.32e-87,322,264,275
"85183","Nsylvestris_NODE_36303_length_266_cov_5","Ntome_NODE_15476_length_1586_cov_35",96.07,229,7,2,1,227,291,63,1.29e-102,372,226,228
"85187","Nsylvestris_NODE_36309_length_266_cov_4","Ntome_NODE_17461_length_1407_cov_18",92.784,194,10,2,54,245,1042,1233,2.9e-74,278,191,191
"85191","Nsylvestris_NODE_36316_length_266_cov_4","Ntome_NODE_37172_length_307_cov_4",93.82,178,11,0,61,238,129,306,1.74e-71,268,177,177
"85194","Nsylvestris_NODE_36323_length_266_cov_3","Ntome_NODE_18980_length_1278_cov_52",88.39,267,30,1,1,266,243,509,4.75e-87,320,265,266
"85198","Nsylvestris_NODE_36330_length_266_cov_3","Ntome_NODE_1710_length_4374_cov_103",93.633,267,16,1,1,266,2629,2895,2.13e-110,398,265,266
"85199","Nsylvestris_NODE_36332_length_266_cov_2","Ntome_NODE_5641_length_2930_cov_18",93.985,266,13,3,1,266,140,402,5.93e-111,399,265,262
"85200","Nsylvestris_NODE_36333_length_266_cov_2","Ntome_NODE_5573_length_2945_cov_138",85.771,253,35,1,2,253,2304,2052,6.28e-71,267,251,252
"85209","Nsylvestris_NODE_36338_length_265_cov_214","Ntome_NODE_16384_length_1506_cov_253",97.358,265,7,0,1,265,634,898,1.61e-126,451,264,264
"85215","Nsylvestris_NODE_36352_length_265_cov_5","Ntome_NODE_4521_length_3205_cov_256",96.226,53,2,0,213,265,2044,2096,5.22e-17,87.9,52,52
"85216","Nsylvestris_NODE_36354_length_265_cov_5","Ntome_NODE_5886_length_2874_cov_116",81.203,266,38,7,12,265,1496,1761,4.97e-52,204,253,265
"85217","Nsylvestris_NODE_36358_length_265_cov_5","Ntome_NODE_3385_length_3556_cov_15",87.64,267,29,4,1,265,556,292,3.68e-83,307,264,264
"85224","Nsylvestris_NODE_36362_length_265_cov_4","Ntome_NODE_1976_length_4189_cov_165",89.583,240,17,7,1,239,1370,1138,2.22e-80,298,238,232
"85225","Nsylvestris_NODE_36363_length_265_cov_4","Ntome_NODE_1869_length_4260_cov_22",93.043,115,4,3,1,113,2486,2374,2.35e-40,165,112,112
"85226","Nsylvestris_NODE_36364_length_266_cov_4","Ntome_NODE_2259_length_4029_cov_220",91.7,253,14,3,1,253,1120,875,2.82e-94,344,252,245
"85227","Nsylvestris_NODE_36366_length_265_cov_4","Ntome_NODE_26658_length_775_cov_13",92.029,276,9,6,2,265,395,669,9.95e-104,375,263,274
"85231","Nsylvestris_NODE_36368_length_265_cov_4","Ntome_NODE_34979_length_375_cov_10",88.312,154,13,4,5,157,3,152,8.38e-45,180,152,149
"85232","Nsylvestris_NODE_36370_length_264_cov_4","Ntome_NODE_1150_length_4898_cov_30",83.571,280,30,4,1,264,139,418,2.25e-65,248,263,279
"85233","Nsylvestris_NODE_36371_length_265_cov_3","Ntome_NODE_25139_length_855_cov_13",92.279,272,8,7,1,259,444,173,3.58e-103,374,258,271
"85234","Nsylvestris_NODE_36372_length_265_cov_3","Ntome_NODE_4193_length_3298_cov_116",91.544,272,10,2,6,265,1556,1826,7.75e-100,363,259,270
"85240","Nsylvestris_NODE_36380_length_264_cov_222","Ntome_NODE_7455_length_2577_cov_171",96.591,264,9,0,1,264,1985,1722,1.25e-122,438,263,263
"85248","Nsylvestris_NODE_36392_length_264_cov_5","Ntome_NODE_15244_length_1610_cov_19",95.038,262,11,2,1,261,777,1037,2.72e-114,411,260,260
"85251","Nsylvestris_NODE_36395_length_264_cov_5","Ntome_NODE_13688_length_1769_cov_42",88.492,252,20,4,14,261,1263,1509,7.94e-80,296,247,246
"85252","Nsylvestris_NODE_36396_length_264_cov_5","Ntome_NODE_4097_length_3322_cov_98",93.182,44,2,1,103,145,398,355,8.76e-10,63.9,42,43
"85253","Nsylvestris_NODE_36398_length_264_cov_5","Ntome_NODE_19144_length_1264_cov_31",90.943,265,17,4,1,264,564,306,6.01e-96,350,263,258
"85254","Nsylvestris_NODE_36403_length_264_cov_4","Ntome_NODE_1891_length_4244_cov_152",95.802,262,11,0,3,264,2932,2671,3.49e-118,424,261,261
"85255","Nsylvestris_NODE_36409_length_264_cov_3","Ntome_NODE_4249_length_3278_cov_55",86.726,226,24,6,42,264,1472,1694,8.11e-65,246,222,222
"85256","Nsylvestris_NODE_36410_length_264_cov_3","Ntome_NODE_36217_length_333_cov_2",99.621,264,1,0,1,264,327,64,5.68e-136,483,263,263
"85257","Nsylvestris_NODE_36416_length_264_cov_3","Ntome_NODE_15311_length_1604_cov_12",95.539,269,7,1,1,264,530,798,9.7e-119,425,263,268
"85258","Nsylvestris_NODE_36421_length_264_cov_2","Ntome_NODE_15501_length_1583_cov_109",85.124,242,8,13,1,242,1181,968,1.37e-57,222,241,213
"85259","Nsylvestris_NODE_36423_length_264_cov_2","Ntome_NODE_5573_length_2945_cov_138",89.961,259,26,0,3,261,1400,1658,1.68e-91,335,258,258
"85260","Nsylvestris_NODE_36427_length_263_cov_229","Ntome_NODE_20034_length_1189_cov_142",96.958,263,8,0,1,263,912,650,9.6e-124,442,262,262
"85268","Nsylvestris_NODE_36438_length_263_cov_6","Ntome_NODE_15901_length_1548_cov_26",87.111,225,15,4,47,263,539,757,1.04e-63,243,216,218
"85269","Nsylvestris_NODE_36440_length_263_cov_5","Ntome_NODE_26934_length_762_cov_14",93.878,196,7,2,70,261,762,568,3.68e-78,291,191,194
"85270","Nsylvestris_NODE_36444_length_263_cov_5","Ntome_NODE_36932_length_312_cov_5",95.42,262,9,3,3,263,1,260,2.09e-115,414,260,259
"85275","Nsylvestris_NODE_36452_length_263_cov_4","Ntome_NODE_35266_length_363_cov_7",100,42,0,0,1,42,322,363,3.12e-14,78.7,41,41
"85276","Nsylvestris_NODE_36456_length_263_cov_4","Ntome_NODE_30828_length_595_cov_17",95.455,264,11,1,1,263,563,300,4.5e-117,420,262,263
"85277","Nsylvestris_NODE_36459_length_263_cov_4","Ntome_NODE_15261_length_1609_cov_8",85.614,285,19,13,1,263,967,1251,7.96e-75,279,262,284
"85278","Nsylvestris_NODE_36465_length_263_cov_3","Ntome_NODE_11220_length_2047_cov_121",91.912,136,11,0,81,216,721,856,3.84e-48,191,135,135
"85279","Nsylvestris_NODE_36468_length_263_cov_3","Ntome_NODE_36917_length_313_cov_2",92.045,264,20,1,1,263,266,3,4.59e-102,370,262,263
"85283","Nsylvestris_NODE_36474_length_263_cov_3","Ntome_NODE_38411_length_280_cov_3",90.21,143,13,1,120,262,277,136,1.79e-46,185,142,141
"85284","Nsylvestris_NODE_36476_length_263_cov_2","Ntome_NODE_33901_length_424_cov_5",94.444,234,13,0,30,263,1,234,2.76e-99,361,233,233
"85294","Nsylvestris_NODE_36488_length_262_cov_5","Ntome_NODE_34737_length_385_cov_15",84.685,222,13,6,1,222,185,385,1.77e-51,202,221,200
"85295","Nsylvestris_NODE_36491_length_262_cov_4","Ntome_NODE_4483_length_3214_cov_146",97.683,259,6,0,4,262,723,465,7.39e-125,446,258,258
"85296","Nsylvestris_NODE_36494_length_262_cov_4","Ntome_NODE_3913_length_3383_cov_14",87.838,74,9,0,189,262,555,628,5.16e-17,87.9,73,73
"85300","Nsylvestris_NODE_36499_length_262_cov_4","Ntome_NODE_12280_length_1924_cov_18",98.092,262,5,0,1,262,225,486,3.41e-128,457,261,261
"85304","Nsylvestris_NODE_36503_length_262_cov_3","Ntome_NODE_21905_length_1055_cov_9",94.505,91,5,0,171,261,663,573,3.9e-33,141,90,90
"85307","Nsylvestris_NODE_36516_length_262_cov_3","Ntome_NODE_9480_length_2272_cov_33",95.42,262,12,0,1,262,697,436,1.61e-116,418,261,261
"85308","Nsylvestris_NODE_36518_length_262_cov_3","Ntome_NODE_17860_length_1370_cov_114",96.109,257,10,0,6,262,646,902,4.48e-117,420,256,256
"85309","Nsylvestris_NODE_36522_length_262_cov_2","Ntome_NODE_39923_length_250_cov_4",92.105,190,12,2,75,261,245,56,2.22e-70,265,186,189
"85310","Nsylvestris_NODE_36524_length_261_cov_153","Ntome_NODE_23248_length_968_cov_118",92.216,167,13,0,3,169,713,879,4.82e-62,237,166,166
"85315","Nsylvestris_NODE_36528_length_261_cov_9","Ntome_NODE_10568_length_2124_cov_158",93.511,262,11,4,1,259,1420,1678,1.63e-106,385,258,258
"85316","Nsylvestris_NODE_36529_length_261_cov_8","Ntome_NODE_1779_length_4328_cov_231",91.221,262,22,1,1,261,2704,2443,1.28e-97,355,260,261
"85317","Nsylvestris_NODE_36530_length_261_cov_7","Ntome_NODE_34955_length_376_cov_5",95.618,251,3,4,11,260,40,283,7.51e-110,396,249,243
"85318","Nsylvestris_NODE_36532_length_261_cov_6","Ntome_NODE_17294_length_1421_cov_25",96.835,158,5,0,1,158,302,459,2.21e-70,265,157,157
"85319","Nsylvestris_NODE_36536_length_261_cov_5","Ntome_NODE_1227_length_4802_cov_140",89.434,265,15,6,2,261,1432,1176,1.29e-87,322,259,256
"85325","Nsylvestris_NODE_36544_length_261_cov_4","Ntome_NODE_5870_length_2879_cov_150",92.776,263,12,3,1,261,1412,1155,3.52e-103,374,260,257
"85326","Nsylvestris_NODE_36551_length_261_cov_4","Ntome_NODE_7235_length_2617_cov_181",90.456,241,22,1,1,240,651,891,6.02e-86,316,239,240
"85327","Nsylvestris_NODE_36555_length_261_cov_4","Ntome_NODE_11651_length_1997_cov_23",95.769,260,11,0,1,260,1680,1939,4.46e-117,420,259,259
"85328","Nsylvestris_NODE_36556_length_261_cov_4","Ntome_NODE_8435_length_2422_cov_233",100,28,0,0,234,261,1870,1897,1.87e-06,52.8,27,27
"85329","Nsylvestris_NODE_36557_length_261_cov_4","Ntome_NODE_359_length_6467_cov_181",97.74,177,4,0,1,177,6283,6107,1.3e-82,305,176,176
"85330","Nsylvestris_NODE_36560_length_260_cov_3","Ntome_NODE_103_length_8474_cov_37",90.164,244,20,3,4,245,6292,6051,2.16e-85,315,241,241
"85331","Nsylvestris_NODE_36564_length_261_cov_3","Ntome_NODE_31087_length_586_cov_4",80.524,267,39,8,1,258,78,340,1.06e-48,193,257,262
"85339","Nsylvestris_NODE_36577_length_260_cov_11","Ntome_NODE_8979_length_2342_cov_37",87.442,215,20,4,53,260,273,59,3.71e-63,241,207,214
"85340","Nsylvestris_NODE_36579_length_260_cov_6","Ntome_NODE_37724_length_294_cov_9",93.436,259,17,0,2,260,293,35,1.62e-106,385,258,258
"85341","Nsylvestris_NODE_36581_length_260_cov_5","Ntome_NODE_2838_length_3761_cov_141",94.615,260,14,0,1,260,1747,1488,4.47e-112,403,259,259
"85342","Nsylvestris_NODE_36583_length_260_cov_5","Ntome_NODE_1225_length_4807_cov_19",95.769,260,11,0,1,260,2047,2306,4.44e-117,420,259,259
"85348","Nsylvestris_NODE_36588_length_260_cov_4","Ntome_NODE_349_length_6512_cov_123",96.875,192,3,3,1,191,3736,3925,1.67e-86,318,190,189
"85349","Nsylvestris_NODE_36590_length_260_cov_4","Ntome_NODE_19275_length_1254_cov_11",96.319,163,6,0,98,260,253,91,1.7e-71,268,162,162
"85350","Nsylvestris_NODE_36591_length_260_cov_3","Ntome_NODE_21679_length_1069_cov_12",93.522,247,11,2,14,260,812,571,7.59e-100,363,246,241
"85353","Nsylvestris_NODE_36596_length_260_cov_3","Ntome_NODE_33966_length_421_cov_3",96.154,260,10,0,1,260,162,421,9.54e-119,425,259,259
"85354","Nsylvestris_NODE_36600_length_260_cov_3","Ntome_NODE_7754_length_2532_cov_61",97.5,40,1,0,216,255,1972,2011,1.85e-11,69.4,39,39
"85355","Nsylvestris_NODE_36603_length_260_cov_2","Ntome_NODE_2355_length_3983_cov_58",93.487,261,12,4,3,260,2766,3024,5.82e-106,383,257,258
"85358","Nsylvestris_NODE_36605_length_260_cov_2","Ntome_NODE_17678_length_1386_cov_14",89.231,260,27,1,1,259,867,608,3.58e-88,324,258,259
"85359","Nsylvestris_NODE_36607_length_259_cov_240","Ntome_NODE_10591_length_2121_cov_239",96.525,259,9,0,1,259,781,1039,7.35e-120,429,258,258
"85360","Nsylvestris_NODE_36608_length_259_cov_221","Ntome_NODE_8534_length_2408_cov_47",94.318,176,5,3,1,172,222,396,2.19e-70,265,171,174
"85361","Nsylvestris_NODE_36609_length_259_cov_42","Ntome_NODE_12008_length_1957_cov_60",87.5,240,22,7,23,259,1604,1370,4.71e-72,270,236,234
"85362","Nsylvestris_NODE_36611_length_259_cov_15","Ntome_NODE_10295_length_2157_cov_152",94.715,246,12,1,15,259,590,835,2.09e-105,381,244,245
"85367","Nsylvestris_NODE_36617_length_259_cov_6","Ntome_NODE_5137_length_3047_cov_88",98.456,259,4,0,1,259,1859,2117,3.37e-128,457,258,258
"85368","Nsylvestris_NODE_36621_length_259_cov_6","Ntome_NODE_29913_length_631_cov_31",91.016,256,21,2,4,257,325,70,2.74e-94,344,253,255
"85369","Nsylvestris_NODE_36622_length_259_cov_5","Ntome_NODE_1728_length_4360_cov_146",83.2,250,29,4,11,259,3558,3321,6.23e-56,217,248,237
"85370","Nsylvestris_NODE_36623_length_259_cov_5","Ntome_NODE_24798_length_875_cov_7",98.462,65,1,0,1,65,811,875,2.34e-25,115,64,64
"85371","Nsylvestris_NODE_36627_length_259_cov_5","Ntome_NODE_1812_length_4298_cov_239",96.17,235,6,1,25,259,1964,2195,2.09e-105,381,234,231
"85372","Nsylvestris_NODE_36628_length_259_cov_4","Ntome_NODE_22129_length_1039_cov_78",95.349,86,4,0,152,237,1,86,4.99e-32,137,85,85
"85376","Nsylvestris_NODE_36632_length_259_cov_4","Ntome_NODE_33570_length_442_cov_2",92.899,169,8,2,18,184,276,442,1.03e-63,243,166,166
"85377","Nsylvestris_NODE_36633_length_259_cov_4","Ntome_NODE_13513_length_1785_cov_19",81.338,284,28,8,1,259,1666,1383,3.75e-53,207,258,283
"85378","Nsylvestris_NODE_36635_length_259_cov_4","Ntome_NODE_39537_length_257_cov_4",97.98,198,2,1,64,259,257,60,9.84e-94,342,195,197
"85379","Nsylvestris_NODE_36636_length_259_cov_4","Ntome_NODE_31972_length_552_cov_11",94.231,260,11,3,1,259,349,93,2.68e-109,394,258,256
"85380","Nsylvestris_NODE_36637_length_259_cov_4","Ntome_NODE_750_length_5458_cov_223",82.677,127,6,1,1,111,3759,3885,2.35e-20,99,110,126
"85381","Nsylvestris_NODE_36641_length_259_cov_3","Ntome_NODE_29124_length_663_cov_45",93.208,265,12,4,1,259,564,300,1.61e-106,385,258,264
"85382","Nsylvestris_NODE_36643_length_259_cov_3","Ntome_NODE_2274_length_4019_cov_109",92.278,259,18,2,1,259,1761,1505,5.84e-101,366,258,256
"85383","Nsylvestris_NODE_36647_length_259_cov_3","Ntome_NODE_6186_length_2814_cov_194",89.831,59,2,3,196,252,2258,2202,1.43e-12,73.1,56,56
"85384","Nsylvestris_NODE_36648_length_259_cov_2","Ntome_NODE_5321_length_3003_cov_49",90.734,259,21,1,1,259,1133,1388,9.84e-94,342,258,255
"85385","Nsylvestris_NODE_36652_length_258_cov_247","Ntome_NODE_3819_length_3413_cov_161",97.287,258,7,0,1,258,999,1256,1.22e-122,438,257,257
"85388","Nsylvestris_NODE_36654_length_258_cov_223","Ntome_NODE_4406_length_3236_cov_263",99.231,260,0,1,1,258,1094,835,1.55e-131,468,257,259
"85389","Nsylvestris_NODE_36655_length_258_cov_219","Ntome_NODE_10461_length_2137_cov_25",95.736,258,11,0,1,258,642,899,5.69e-116,416,257,257
"85392","Nsylvestris_NODE_36657_length_258_cov_211","Ntome_NODE_19946_length_1196_cov_243",97.674,258,6,0,1,258,204,461,2.61e-124,444,257,257
"85395","Nsylvestris_NODE_36659_length_258_cov_209","Ntome_NODE_13884_length_1747_cov_284",92.337,261,17,1,1,258,448,188,1.62e-101,368,257,260
"85399","Nsylvestris_NODE_36662_length_258_cov_164","Ntome_NODE_32393_length_521_cov_195",85.259,251,12,7,32,258,1,250,1.71e-61,235,226,249
"85400","Nsylvestris_NODE_36663_length_258_cov_156","Ntome_NODE_1121_length_4927_cov_151",85.211,142,4,7,1,126,4652,4792,8.31e-30,130,125,140
"85401","Nsylvestris_NODE_36664_length_258_cov_117","Ntome_NODE_456_length_6137_cov_19",85.714,259,33,4,2,258,1263,1007,4.69e-72,270,256,256
"85402","Nsylvestris_NODE_36666_length_258_cov_25","Ntome_NODE_36964_length_311_cov_12",94.922,256,7,3,8,258,1,255,7.42e-110,396,250,254
"85403","Nsylvestris_NODE_36671_length_258_cov_6","Ntome_NODE_11984_length_1960_cov_8",93.077,260,16,2,1,258,1330,1071,7.47e-105,379,257,259
"85410","Nsylvestris_NODE_36681_length_258_cov_4","Ntome_NODE_21508_length_1081_cov_20",96.139,259,9,1,1,258,909,651,1.22e-117,422,257,258
"85411","Nsylvestris_NODE_36682_length_258_cov_4","Ntome_NODE_3852_length_3404_cov_177",93.893,262,12,2,1,258,2412,2151,9.6e-109,392,257,261
"85412","Nsylvestris_NODE_36688_length_258_cov_4","Ntome_NODE_37222_length_306_cov_3",91.111,225,5,8,1,216,62,280,3.6e-78,291,215,218
"85413","Nsylvestris_NODE_36692_length_258_cov_3","Ntome_NODE_5818_length_2891_cov_148",83.099,142,14,8,125,258,2266,2127,5e-27,121,133,139
"85425","Nsylvestris_NODE_36702_length_258_cov_3","Ntome_NODE_2872_length_3749_cov_27",84.252,254,27,9,10,258,1332,1577,1.71e-61,235,248,245
"85426","Nsylvestris_NODE_36704_length_257_cov_239","Ntome_NODE_6981_length_2658_cov_196",94.163,257,15,0,1,257,576,320,9.55e-109,392,256,256
"85430","Nsylvestris_NODE_36706_length_257_cov_221","Ntome_NODE_6212_length_2808_cov_137",94.872,78,4,0,60,137,1826,1749,1.38e-27,122,77,77
"85431","Nsylvestris_NODE_36707_length_257_cov_158","Ntome_NODE_2751_length_3789_cov_182",93.385,257,17,0,1,257,2869,3125,2.07e-105,381,256,256
"85432","Nsylvestris_NODE_36708_length_257_cov_11","Ntome_NODE_9426_length_2277_cov_235",90.756,119,7,4,140,257,3,118,1.36e-37,156,117,115
"85438","Nsylvestris_NODE_36719_length_257_cov_5","Ntome_NODE_1131_length_4916_cov_178",100,45,0,0,213,257,3749,3705,6.53e-16,84.2,44,44
"85439","Nsylvestris_NODE_36721_length_257_cov_5","Ntome_NODE_28563_length_686_cov_6",94.762,210,10,1,48,256,669,460,9.83e-89,326,208,209
"85446","Nsylvestris_NODE_36731_length_257_cov_3","Ntome_NODE_7931_length_2500_cov_175",80.309,259,29,13,1,239,765,1021,1.05e-43,176,238,256
"85447","Nsylvestris_NODE_36734_length_257_cov_3","Ntome_NODE_3203_length_3621_cov_181",95.669,254,6,2,4,257,1652,1900,4.41e-112,403,253,248
"85448","Nsylvestris_NODE_36735_length_257_cov_3","Ntome_NODE_37383_length_302_cov_3",96.241,133,5,0,124,256,302,170,1.72e-56,219,132,132
"85451","Nsylvestris_NODE_36742_length_257_cov_2","Ntome_NODE_3504_length_3516_cov_77",89.453,256,19,3,1,256,1745,1992,5.92e-86,316,255,247
"85452","Nsylvestris_NODE_36743_length_257_cov_2","Ntome_NODE_23739_length_941_cov_14",91.566,83,6,1,176,257,51,133,8.33e-25,113,81,82
"85455","Nsylvestris_NODE_36750_length_256_cov_17","Ntome_NODE_21490_length_1081_cov_44",84.135,208,31,2,49,255,56,262,6.19e-51,200,206,206
"85456","Nsylvestris_NODE_36753_length_256_cov_6","Ntome_NODE_28556_length_686_cov_12",94.068,236,12,2,21,256,596,363,3.47e-98,357,235,233
"85457","Nsylvestris_NODE_36754_length_256_cov_6","Ntome_NODE_8219_length_2456_cov_180",96.875,256,8,0,1,256,810,555,7.25e-120,429,255,255
"85458","Nsylvestris_NODE_36755_length_256_cov_6","Ntome_NODE_69_length_9046_cov_201",98.039,255,3,2,3,256,1789,2042,9.31e-124,442,253,253
"85459","Nsylvestris_NODE_36758_length_256_cov_4","Ntome_NODE_768_length_5437_cov_290",100,43,0,0,1,43,2750,2708,8.41e-15,80.5,42,42
"85463","Nsylvestris_NODE_36764_length_256_cov_4","Ntome_NODE_11326_length_2033_cov_285",92.593,243,15,2,16,256,1999,1758,7.51e-95,346,240,241
"85475","Nsylvestris_NODE_36778_length_256_cov_3","Ntome_NODE_681_length_5598_cov_82",86.561,253,33,1,1,252,2312,2564,2.78e-74,278,251,252
"85476","Nsylvestris_NODE_36779_length_256_cov_3","Ntome_NODE_2726_length_3802_cov_160",91.406,256,21,1,2,256,1202,947,5.81e-96,350,254,255
"85477","Nsylvestris_NODE_36781_length_256_cov_3","Ntome_NODE_282_length_6848_cov_137",91.358,243,20,1,14,256,4817,5058,2.1e-90,331,242,241
"85478","Nsylvestris_NODE_36782_length_256_cov_3","Ntome_NODE_9892_length_2214_cov_126",97.976,247,5,0,1,247,1036,1282,7.25e-120,429,246,246
"85491","Nsylvestris_NODE_36792_length_255_cov_218","Ntome_NODE_3235_length_3608_cov_280",95.294,255,12,0,1,255,543,797,1.22e-112,405,254,254
"85497","Nsylvestris_NODE_36798_length_255_cov_12","Ntome_NODE_18119_length_1347_cov_20",84.848,132,19,1,14,145,985,1115,2.28e-30,132,131,130
"85498","Nsylvestris_NODE_36800_length_255_cov_12","Ntome_NODE_40_length_10198_cov_97",90.625,256,16,6,1,255,6875,6627,5.82e-91,333,254,248
"85499","Nsylvestris_NODE_36801_length_255_cov_8","Ntome_NODE_2315_length_4000_cov_98",86.312,263,22,1,1,249,1488,1226,3.58e-73,274,248,262
"85505","Nsylvestris_NODE_36806_length_255_cov_7","Ntome_NODE_18779_length_1294_cov_26",95.669,254,10,1,1,254,644,896,3.38e-113,407,253,252
"85506","Nsylvestris_NODE_36807_length_255_cov_7","Ntome_NODE_26695_length_773_cov_39",86.058,208,28,1,4,211,472,678,1.32e-57,222,207,206
"85510","Nsylvestris_NODE_36818_length_255_cov_5","Ntome_NODE_19274_length_1254_cov_20",88.06,268,12,9,1,253,138,400,5.91e-81,300,252,262
"85511","Nsylvestris_NODE_36826_length_255_cov_4","Ntome_NODE_24347_length_903_cov_129",96.094,256,9,1,1,255,212,467,5.62e-116,416,254,255
"85512","Nsylvestris_NODE_36827_length_255_cov_4","Ntome_NODE_4331_length_3253_cov_189",87.868,272,14,4,1,254,125,395,1.64e-81,302,253,270
"85513","Nsylvestris_NODE_36828_length_255_cov_4","Ntome_NODE_33490_length_447_cov_4",98.99,99,1,0,157,255,447,349,2.89e-44,178,98,98
"85521","Nsylvestris_NODE_36843_length_255_cov_3","Ntome_NODE_11876_length_1973_cov_14",93.252,163,8,2,1,160,1673,1835,4.7e-62,237,159,162
"85527","Nsylvestris_NODE_36850_length_255_cov_2","Ntome_NODE_9810_length_2224_cov_47",81.215,181,22,5,66,246,1400,1232,1.76e-31,135,180,168
"85528","Nsylvestris_NODE_36852_length_255_cov_2","Ntome_NODE_829_length_5345_cov_184",100,29,0,0,1,29,1608,1636,5.08e-07,54.7,28,28
"85529","Nsylvestris_NODE_36853_length_254_cov_262","Ntome_NODE_4406_length_3236_cov_263",99.606,254,1,0,1,254,2378,2631,1.97e-130,464,253,253
"85530","Nsylvestris_NODE_36854_length_254_cov_250","Ntome_NODE_3994_length_3353_cov_253",97.638,254,6,0,1,254,1096,1349,4.3e-122,436,253,253
"85531","Nsylvestris_NODE_36855_length_254_cov_211","Ntome_NODE_8457_length_2419_cov_292",95.918,245,9,1,10,254,2365,2122,7.29e-110,396,244,243
"85540","Nsylvestris_NODE_36859_length_254_cov_162","Ntome_NODE_19821_length_1208_cov_58",98.113,53,1,0,202,254,1042,1094,1.07e-18,93.5,52,52
"85541","Nsylvestris_NODE_36860_length_254_cov_132","Ntome_NODE_9715_length_2238_cov_254",95.413,109,3,2,51,157,1613,1505,1.34e-42,172,106,108
"85544","Nsylvestris_NODE_36862_length_254_cov_6","Ntome_NODE_28186_length_702_cov_11",91.589,107,8,1,149,254,567,673,8.11e-35,147,105,106
"85550","Nsylvestris_NODE_36869_length_254_cov_5","Ntome_NODE_19438_length_1239_cov_94",92.053,151,12,0,104,254,376,226,7.88e-55,213,150,150
"85551","Nsylvestris_NODE_36870_length_254_cov_5","Ntome_NODE_13951_length_1742_cov_18",93.902,246,14,1,10,254,1082,1327,4.42e-102,370,244,245
"85555","Nsylvestris_NODE_36873_length_254_cov_4","Ntome_NODE_25977_length_807_cov_20",88.889,81,8,1,39,118,111,31,2.3e-20,99,79,80
"85556","Nsylvestris_NODE_36875_length_254_cov_4","Ntome_NODE_29565_length_646_cov_5",97.619,42,1,0,1,42,572,613,1.4e-12,73.1,41,41
"85560","Nsylvestris_NODE_36886_length_254_cov_3","Ntome_NODE_27836_length_717_cov_9",92.063,189,14,1,1,189,538,351,2.15e-70,265,188,187
"85561","Nsylvestris_NODE_36887_length_254_cov_3","Ntome_NODE_7182_length_2625_cov_48",89.354,263,19,3,1,254,197,459,1.26e-87,322,253,262
"85562","Nsylvestris_NODE_36888_length_254_cov_3","Ntome_NODE_20630_length_1143_cov_38",92.432,185,14,0,1,185,880,1064,2.15e-70,265,184,184
"85566","Nsylvestris_NODE_36899_length_254_cov_1","Ntome_NODE_9040_length_2331_cov_202",92.035,113,5,3,62,170,1232,1344,1.35e-37,156,108,112
"85567","Nsylvestris_NODE_36900_length_253_cov_263","Ntome_NODE_14964_length_1639_cov_187",97.628,253,6,0,1,253,165,417,1.54e-121,435,252,252
"85568","Nsylvestris_NODE_36901_length_253_cov_235","Ntome_NODE_4114_length_3316_cov_231",99.605,253,1,0,1,253,2196,1944,7.06e-130,462,252,252
"85573","Nsylvestris_NODE_36905_length_253_cov_189","Ntome_NODE_975_length_5123_cov_110",83.529,255,35,5,1,253,3566,3815,2.17e-60,231,252,249
"85576","Nsylvestris_NODE_36907_length_253_cov_152","Ntome_NODE_4364_length_3247_cov_124",96.552,58,2,0,194,251,1046,1103,8.25e-20,97.1,57,57
"85584","Nsylvestris_NODE_36912_length_253_cov_8","Ntome_NODE_17497_length_1404_cov_20",94.841,252,11,1,1,252,975,726,9.39e-109,392,251,249
"85585","Nsylvestris_NODE_36916_length_253_cov_5","Ntome_NODE_1315_length_4714_cov_107",96.476,227,8,0,1,227,2810,2584,9.46e-104,375,226,226
"85586","Nsylvestris_NODE_36917_length_252_cov_5","Ntome_NODE_5641_length_2930_cov_18",95.506,178,8,0,1,178,578,401,1.63e-76,285,177,177
"85587","Nsylvestris_NODE_36923_length_253_cov_4","Ntome_NODE_4284_length_3266_cov_177",86.802,197,24,2,59,253,2637,2441,1.69e-56,219,194,196
"85588","Nsylvestris_NODE_36924_length_253_cov_4","Ntome_NODE_18925_length_1282_cov_31",84.462,251,31,6,1,250,1152,909,3.6e-63,241,249,243
"85589","Nsylvestris_NODE_36928_length_253_cov_4","Ntome_NODE_6264_length_2794_cov_183",94.466,253,14,0,1,253,1202,950,3.38e-108,390,252,252
"85592","Nsylvestris_NODE_36932_length_253_cov_4","Ntome_NODE_13510_length_1785_cov_77",91.837,49,4,0,197,245,1172,1220,1.8e-11,69.4,48,48
"85595","Nsylvestris_NODE_36943_length_253_cov_3","Ntome_NODE_13820_length_1756_cov_13",80.976,205,28,10,31,230,718,916,1.74e-36,152,199,198
"85596","Nsylvestris_NODE_36945_length_253_cov_2","Ntome_NODE_35733_length_347_cov_3",80.952,147,25,3,107,252,145,1,8.19e-25,113,145,144
"85597","Nsylvestris_NODE_36950_length_252_cov_255","Ntome_NODE_7751_length_2532_cov_291",98.81,252,3,0,1,252,2454,2203,5.47e-126,449,251,251
"85603","Nsylvestris_NODE_36953_length_252_cov_227","Ntome_NODE_12308_length_1921_cov_95",94.841,252,13,0,1,252,940,1191,2.6e-109,394,251,251
"85617","Nsylvestris_NODE_36963_length_252_cov_6","Ntome_NODE_1927_length_4221_cov_220",97.222,252,7,0,1,252,1329,1078,2.56e-119,427,251,251
"85621","Nsylvestris_NODE_36973_length_252_cov_5","Ntome_NODE_497_length_6027_cov_104",95.6,250,11,0,1,250,4093,4342,1.55e-111,401,249,249
"85622","Nsylvestris_NODE_36975_length_252_cov_5","Ntome_NODE_8268_length_2447_cov_25",88.716,257,23,6,1,252,922,1177,9.69e-84,309,251,255
"85626","Nsylvestris_NODE_36977_length_252_cov_4","Ntome_NODE_27423_length_737_cov_5",94.737,171,7,1,1,169,171,1,2.13e-70,265,168,170
"85627","Nsylvestris_NODE_36982_length_252_cov_4","Ntome_NODE_2693_length_3817_cov_121",95.556,45,2,0,6,50,3770,3814,1.38e-12,73.1,44,44
"85628","Nsylvestris_NODE_36988_length_251_cov_4","Ntome_NODE_17526_length_1400_cov_26",82.564,195,16,7,75,251,265,71,1.33e-37,156,176,194
"85631","Nsylvestris_NODE_36990_length_252_cov_3","Ntome_NODE_22811_length_996_cov_9",92.095,253,18,2,1,252,715,966,1.23e-97,355,251,251
"85632","Nsylvestris_NODE_36991_length_252_cov_3","Ntome_NODE_33271_length_459_cov_7",90.647,139,13,0,1,139,229,367,1.7e-46,185,138,138
"85638","Nsylvestris_NODE_36997_length_252_cov_3","Ntome_NODE_5629_length_2931_cov_118",90.076,262,16,5,1,252,2349,2088,2.07e-90,331,251,261
"85644","Nsylvestris_NODE_37001_length_251_cov_232","Ntome_NODE_10023_length_2198_cov_25",95.331,257,6,2,1,251,903,1159,4.3e-112,403,250,256
"85645","Nsylvestris_NODE_37002_length_251_cov_227","Ntome_NODE_21301_length_1094_cov_316",97.211,251,7,0,1,251,808,558,9.18e-119,425,250,250
"85646","Nsylvestris_NODE_37003_length_251_cov_224","Ntome_NODE_28745_length_678_cov_33",100,31,0,0,14,44,70,40,3.86e-08,58.4,30,30
"85647","Nsylvestris_NODE_37004_length_251_cov_215","Ntome_NODE_2947_length_3719_cov_173",89.922,258,15,5,1,251,1545,1798,1.24e-87,322,250,253
"85651","Nsylvestris_NODE_37011_length_251_cov_7","Ntome_NODE_2110_length_4103_cov_276",87.387,111,13,1,93,203,2377,2486,1.04e-28,126,110,109
"85652","Nsylvestris_NODE_37016_length_251_cov_6","Ntome_NODE_135_length_8007_cov_44",88.306,248,28,1,1,247,7256,7009,7.51e-80,296,246,247
"85653","Nsylvestris_NODE_37019_length_251_cov_6","Ntome_NODE_4792_length_3135_cov_211",92.46,252,18,1,1,251,3013,2762,9.44e-99,359,250,251
"85654","Nsylvestris_NODE_37020_length_251_cov_6","Ntome_NODE_13914_length_1745_cov_85",88.189,254,27,2,1,251,850,597,5.8e-81,300,250,253
"85655","Nsylvestris_NODE_37024_length_251_cov_5","Ntome_NODE_1363_length_4663_cov_158",90.476,63,5,1,1,63,175,236,2.29e-15,82.4,62,61
"85658","Nsylvestris_NODE_37026_length_251_cov_5","Ntome_NODE_2395_length_3961_cov_109",91.321,265,9,4,1,251,2370,2106,5.68e-96,350,250,264
"85659","Nsylvestris_NODE_37028_length_251_cov_5","Ntome_NODE_23159_length_974_cov_13",95.181,166,7,1,1,166,326,490,2.74e-69,261,165,164
"85660","Nsylvestris_NODE_37029_length_251_cov_5","Ntome_NODE_264_length_6990_cov_236",94.422,251,10,1,1,251,3966,3720,5.6e-106,383,250,246
"85661","Nsylvestris_NODE_37033_length_251_cov_5","Ntome_NODE_25716_length_820_cov_59",91.2,250,20,2,1,250,57,304,1.23e-92,339,249,247
"85662","Nsylvestris_NODE_37034_length_251_cov_4","Ntome_NODE_13231_length_1816_cov_244",100,37,0,0,1,37,1504,1540,1.78e-11,69.4,36,36
"85674","Nsylvestris_NODE_37046_length_251_cov_3","Ntome_NODE_34499_length_395_cov_7",84.016,244,27,5,3,246,292,61,3.59e-58,224,243,231
"85675","Nsylvestris_NODE_37047_length_251_cov_3","Ntome_NODE_14711_length_1665_cov_9",95.021,241,12,0,1,241,259,499,7.25e-105,379,240,240
"85676","Nsylvestris_NODE_37050_length_251_cov_3","Ntome_NODE_1304_length_4720_cov_94",91.667,108,9,0,1,108,4429,4536,6.19e-36,150,107,107
"85677","Nsylvestris_NODE_37051_length_251_cov_3","Ntome_NODE_432_length_6222_cov_146",92.233,103,8,0,149,251,3707,3809,8e-35,147,102,102
"85678","Nsylvestris_NODE_37054_length_251_cov_2","Ntome_NODE_17596_length_1394_cov_23",88.259,247,26,3,6,250,299,54,9.71e-79,292,244,245
"85679","Nsylvestris_NODE_37056_length_251_cov_2","Ntome_NODE_5061_length_3062_cov_238",90.873,252,18,4,1,251,1973,2220,5.72e-91,333,250,247
"85689","Nsylvestris_NODE_37062_length_250_cov_6","Ntome_NODE_26052_length_804_cov_29",95.51,245,9,1,6,250,498,256,3.33e-108,390,244,242
"85690","Nsylvestris_NODE_37065_length_250_cov_5","Ntome_NODE_18009_length_1356_cov_44",85.039,127,17,2,1,126,88,213,2.89e-29,128,125,125
"85691","Nsylvestris_NODE_37068_length_250_cov_5","Ntome_NODE_17726_length_1381_cov_88",96.813,251,6,2,1,250,810,561,1.53e-116,418,249,249
"85692","Nsylvestris_NODE_37069_length_250_cov_5","Ntome_NODE_13881_length_1748_cov_77",93.574,249,16,0,2,250,546,298,1.21e-102,372,248,248
"85693","Nsylvestris_NODE_37071_length_250_cov_5","Ntome_NODE_20189_length_1178_cov_9",78.972,214,25,13,19,213,407,195,2.89e-29,128,194,212
"85694","Nsylvestris_NODE_37072_length_250_cov_4","Ntome_NODE_6585_length_2733_cov_58",90.135,223,15,5,1,216,291,513,5.82e-76,283,215,222
"85698","Nsylvestris_NODE_37079_length_250_cov_4","Ntome_NODE_308_length_6669_cov_209",96.4,250,9,0,1,250,2308,2059,7.11e-115,412,249,249
"85699","Nsylvestris_NODE_37081_length_250_cov_4","Ntome_NODE_12710_length_1872_cov_92",93.6,250,12,2,1,250,1566,1321,4.34e-102,370,249,245
"85700","Nsylvestris_NODE_37084_length_250_cov_3","Ntome_NODE_4707_length_3158_cov_187",79.459,185,28,9,5,184,2239,2418,1.34e-27,122,179,179
"85701","Nsylvestris_NODE_37086_length_250_cov_3","Ntome_NODE_19893_length_1202_cov_10",93.574,249,12,3,1,248,242,487,1.56e-101,368,247,245
"85702","Nsylvestris_NODE_37087_length_250_cov_3","Ntome_NODE_4404_length_3237_cov_141",90.625,160,13,1,91,250,2961,3118,2.79e-54,211,159,157
"85703","Nsylvestris_NODE_37088_length_250_cov_3","Ntome_NODE_27970_length_712_cov_13",97.396,192,5,0,59,250,265,456,2.65e-89,327,191,191
"85709","Nsylvestris_NODE_37092_length_250_cov_2","Ntome_NODE_20745_length_1135_cov_74",96.653,239,8,0,12,250,901,663,1.99e-110,398,238,238
"85710","Nsylvestris_NODE_37098_length_250_cov_1","Ntome_NODE_17645_length_1389_cov_49",97.794,136,3,0,20,155,1008,1143,1.65e-61,235,135,135
