,Query.seq.ID,Subject.seq.ID,X.ID,Alignment.length,X..mismatches,X..gap.openings,start.in.query,end.in.query,start.in.subject,end.in.subject,evalue,bitscore,match.length.query,match.length.subject
183,Nsylvestris_NODE_31_length_10192_cov_149,Ntome_NODE_41_length_10213_cov_186,97.736,10157,195,8,40,10175,71,10213,0,17450,10135,10142
640,Nsylvestris_NODE_122_length_8122_cov_92,Ntome_NODE_138_length_7978_cov_141,97.722,7989,141,13,62,8022,1,7976,0,13706,7960,7975
649,Nsylvestris_NODE_124_length_8100_cov_69,Ntome_NODE_2522_length_3898_cov_200,86.614,127,16,1,70,196,571,696,4.75E-31,139,126,125
1303,Nsylvestris_NODE_263_length_6934_cov_93,Ntome_NODE_311_length_6659_cov_97,95.917,6612,208,18,194,6799,55,6610,0,10658,6605,6555
1736,Nsylvestris_NODE_359_length_6446_cov_171,Ntome_NODE_351_length_6498_cov_169,97.08,6405,159,12,33,6427,36,6422,0,10767,6394,6386
2074,Nsylvestris_NODE_429_length_6174_cov_233,Ntome_NODE_454_length_6143_cov_308,97.895,5892,103,7,244,6120,5888,3,0,10174,5876,5885
2290,Nsylvestris_NODE_481_length_6006_cov_227,Ntome_NODE_442_length_6185_cov_261,98.062,5986,83,9,7,5981,88,6051,0,10381,5974,5963
2836,Nsylvestris_NODE_600_length_5707_cov_34,Ntome_NODE_9819_length_2222_cov_239,92.469,239,12,2,5036,5273,1614,1381,1.10E-90,337,237,233
2972,Nsylvestris_NODE_632_length_5617_cov_228,Ntome_NODE_569_length_5831_cov_290,96.078,5635,161,27,20,5612,169,5785,0,9127,5592,5616
3299,Nsylvestris_NODE_710_length_5408_cov_215,Ntome_NODE_796_length_5390_cov_268,96.411,5377,135,16,19,5375,43,5381,0,8807,5356,5338
3367,Nsylvestris_NODE_726_length_5395_cov_45,Ntome_NODE_37071_length_309_cov_4,90.566,318,20,6,3333,3649,309,1,1.69E-113,412,316,308
3453,Nsylvestris_NODE_749_length_5353_cov_163,Ntome_NODE_875_length_5260_cov_302,80,105,16,5,2784,2886,3211,3312,3.22E-11,73.1,102,101
3853,Nsylvestris_NODE_845_length_5164_cov_145,Ntome_NODE_2778_length_3777_cov_226,95.896,3338,135,1,106,3443,92,3427,0,5404,3337,3335
3966,Nsylvestris_NODE_872_length_5122_cov_205,Ntome_NODE_866_length_5276_cov_251,95.885,5128,155,27,4,5088,29,5143,0,8250,5084,5114
4257,Nsylvestris_NODE_925_length_5053_cov_43,Ntome_NODE_1132_length_4916_cov_30,96.469,4899,158,7,1,4898,4885,1,0,8074,4897,4884
4482,Nsylvestris_NODE_989_length_4970_cov_182,Ntome_NODE_1143_length_4904_cov_140,96.394,4908,121,27,109,4970,4902,5,0,8032,4861,4897
4753,Nsylvestris_NODE_1054_length_4875_cov_139,Ntome_NODE_1183_length_4859_cov_78,94.595,37,2,0,2680,2716,3897,3861,8.21E-07,58.4,36,36
5201,Nsylvestris_NODE_1158_length_4748_cov_123,Ntome_NODE_1099_length_4946_cov_245,96.375,4662,149,7,52,4698,81,4737,0,7655,4646,4656
5340,Nsylvestris_NODE_1191_length_4709_cov_224,Ntome_NODE_1139_length_4908_cov_252,97.342,4627,92,13,2,4625,4599,1,0,7834,4623,4598
5393,Nsylvestris_NODE_1205_length_4701_cov_118,Ntome_NODE_35011_length_374_cov_4,91.733,375,30,1,3926,4300,374,1,8.40E-146,520,374,373
5472,Nsylvestris_NODE_1227_length_4677_cov_68,Ntome_NODE_38371_length_281_cov_2,88.06,134,11,2,3304,3432,267,134,9.77E-36,154,128,133
6447,Nsylvestris_NODE_1454_length_4445_cov_170,Ntome_NODE_1752_length_4341_cov_22,96.204,4347,140,13,73,4403,4,4341,0,7090,4330,4337
6527,Nsylvestris_NODE_1475_length_4421_cov_114,Ntome_NODE_2286_length_4014_cov_121,95.832,3959,122,12,447,4378,42,3984,0,6357,3931,3942
6555,Nsylvestris_NODE_1483_length_4412_cov_12,Ntome_NODE_1417_length_4614_cov_68,93.462,4451,233,14,1,4412,4578,147,0,6554,4411,4431
6607,Nsylvestris_NODE_1496_length_4403_cov_97,Ntome_NODE_1676_length_4407_cov_65,95.602,4184,151,7,52,4216,238,4407,0,6676,4164,4169
6630,Nsylvestris_NODE_1502_length_4395_cov_193,Ntome_NODE_2523_length_3897_cov_215,96.717,3868,91,14,371,4217,45,3897,0,6407,3846,3852
6738,Nsylvestris_NODE_1525_length_4376_cov_205,Ntome_NODE_1555_length_4491_cov_264,97.62,4328,89,10,61,4376,4462,137,0,7409,4315,4325
6783,Nsylvestris_NODE_1536_length_4371_cov_182,Ntome_NODE_2791_length_3774_cov_273,94.692,3674,145,21,733,4367,3664,2,0,5659,3634,3662
7122,Nsylvestris_NODE_1624_length_4314_cov_47,Ntome_NODE_32858_length_488_cov_4,87.309,457,50,8,3819,4271,488,36,9.98E-145,516,452,452
7132,Nsylvestris_NODE_1626_length_4313_cov_129,Ntome_NODE_1900_length_4235_cov_126,97.548,4241,83,7,58,4294,1,4224,0,7236,4236,4223
7743,Nsylvestris_NODE_1774_length_4193_cov_175,Ntome_NODE_2615_length_3852_cov_263,96.987,3585,94,3,3,3573,94,3678,0,6010,3570,3584
7788,Nsylvestris_NODE_1784_length_4187_cov_161,Ntome_NODE_5398_length_2985_cov_273,96.873,2686,62,8,1403,4068,2778,95,0,4475,2665,2683
7842,Nsylvestris_NODE_1798_length_4179_cov_146,Ntome_NODE_2072_length_4128_cov_235,95.311,4073,131,28,58,4107,42,4077,0,6408,4049,4035
8081,Nsylvestris_NODE_1853_length_4147_cov_145,Ntome_NODE_1653_length_4420_cov_228,97.283,4086,102,7,69,4147,4294,211,0,6922,4078,4083
8271,Nsylvestris_NODE_1896_length_4120_cov_101,Ntome_NODE_2060_length_4135_cov_74,94.483,4133,149,46,32,4120,4135,38,0,6296,4088,4097
8335,Nsylvestris_NODE_1913_length_4104_cov_108,Ntome_NODE_2121_length_4098_cov_51,96.76,3920,120,4,95,4013,4047,134,0,6529,3918,3913
8632,Nsylvestris_NODE_1988_length_4063_cov_181,Ntome_NODE_1913_length_4227_cov_203,95.864,4038,127,18,1,4017,166,4184,0,6495,4016,4018
8807,Nsylvestris_NODE_2035_length_4032_cov_82,Ntome_NODE_1819_length_4295_cov_49,95.907,3982,118,7,3,3982,18,3956,0,6408,3979,3938
8942,Nsylvestris_NODE_2070_length_4011_cov_26,Ntome_NODE_38927_length_269_cov_3,97.77,269,6,0,2606,2874,269,1,3.41E-129,464,268,268
9013,Nsylvestris_NODE_2093_length_3999_cov_136,Ntome_NODE_2457_length_3927_cov_57,95.732,3889,122,19,1,3869,3923,59,0,6222,3868,3864
9031,Nsylvestris_NODE_2097_length_3995_cov_89,Ntome_NODE_31960_length_553_cov_6,94.595,37,1,1,713,749,174,139,2.42E-06,56.5,36,35
9259,Nsylvestris_NODE_2148_length_3965_cov_56,Ntome_NODE_2253_length_4032_cov_53,94.908,3947,191,5,1,3946,95,4032,0,6167,3945,3937
9442,Nsylvestris_NODE_2190_length_3940_cov_200,Ntome_NODE_3875_length_3395_cov_278,96.163,3362,94,7,71,3408,1,3351,0,5461,3337,3350
9686,Nsylvestris_NODE_2253_length_3913_cov_88,Ntome_NODE_1332_length_4699_cov_92,98.827,3581,42,0,273,3853,3583,3,0,6381,3580,3580
9712,Nsylvestris_NODE_2260_length_3910_cov_75,Ntome_NODE_10517_length_2130_cov_196,96.979,1920,56,2,1908,3826,1,1919,0,3223,1918,1918
9795,Nsylvestris_NODE_2280_length_3902_cov_113,Ntome_NODE_2688_length_3820_cov_60,95.492,3394,111,23,288,3644,58,3446,0,5382,3356,3388
9831,Nsylvestris_NODE_2290_length_3898_cov_70,Ntome_NODE_2425_length_3946_cov_63,95.56,3671,136,6,251,3898,3671,5,0,5851,3647,3666
9968,Nsylvestris_NODE_2329_length_3881_cov_160,Ntome_NODE_3138_length_3643_cov_49,95.339,3669,119,20,41,3683,3643,1,0,5781,3642,3642
9980,Nsylvestris_NODE_2333_length_3881_cov_52,Ntome_NODE_2102_length_4109_cov_77,94.986,3829,187,3,53,3881,4060,237,0,6002,3828,3823
10076,Nsylvestris_NODE_2360_length_3867_cov_34,Ntome_NODE_13165_length_1824_cov_17,94.577,1807,86,4,2023,3826,1,1798,0,2784,1803,1797
10210,Nsylvestris_NODE_2395_length_3842_cov_210,Ntome_NODE_2550_length_3884_cov_245,97.416,3792,82,7,1,3780,56,3843,0,6445,3779,3787
10331,Nsylvestris_NODE_2424_length_3829_cov_166,Ntome_NODE_2921_length_3728_cov_42,95.975,3627,86,18,49,3620,107,3728,0,5834,3571,3621
10355,Nsylvestris_NODE_2431_length_3825_cov_140,Ntome_NODE_2085_length_4115_cov_260,94.453,3714,119,31,4,3680,128,3791,0,5637,3676,3663
10480,Nsylvestris_NODE_2460_length_3809_cov_226,Ntome_NODE_3025_length_3689_cov_260,96.499,3656,88,12,159,3788,46,3687,0,6006,3629,3641
10760,Nsylvestris_NODE_2526_length_3780_cov_208,Ntome_NODE_2870_length_3749_cov_250,95.389,3687,109,21,109,3770,50,3700,0,5810,3661,3650
10946,Nsylvestris_NODE_2573_length_3759_cov_153,Ntome_NODE_4832_length_3126_cov_18,97.618,3148,51,4,212,3357,1,3126,0,5376,3145,3125
11073,Nsylvestris_NODE_2604_length_3744_cov_34,Ntome_NODE_2543_length_3888_cov_80,95.828,3691,136,5,61,3744,77,3756,0,5947,3683,3679
11161,Nsylvestris_NODE_2625_length_3730_cov_103,Ntome_NODE_33358_length_454_cov_4,96.744,430,14,0,813,1242,1,430,0,717,429,429
11274,Nsylvestris_NODE_2651_length_3722_cov_83,Ntome_NODE_3716_length_3445_cov_78,97.667,3300,72,3,236,3533,50,3346,0,5662,3297,3296
11285,Nsylvestris_NODE_2654_length_3721_cov_230,Ntome_NODE_3093_length_3660_cov_296,97.765,3624,68,4,1,3622,3660,48,0,6231,3621,3612
11352,Nsylvestris_NODE_2673_length_3714_cov_138,Ntome_NODE_2911_length_3732_cov_164,90.729,3689,218,57,77,3706,47,3670,0,4804,3629,3623
11411,Nsylvestris_NODE_2688_length_3710_cov_68,Ntome_NODE_3009_length_3696_cov_35,96.145,3709,118,7,1,3701,4,3695,0,6034,3700,3691
11480,Nsylvestris_NODE_2708_length_3701_cov_37,Ntome_NODE_2853_length_3755_cov_60,96.643,3724,81,11,1,3701,3751,49,0,6144,3700,3702
11485,Nsylvestris_NODE_2710_length_3700_cov_109,Ntome_NODE_2737_length_3798_cov_115,95.12,3627,136,14,24,3616,3697,78,0,5679,3592,3619
11509,Nsylvestris_NODE_2718_length_3697_cov_88,Ntome_NODE_3360_length_3566_cov_65,97.51,3494,80,3,36,3526,3566,77,0,5963,3490,3489
11759,Nsylvestris_NODE_2783_length_3671_cov_183,Ntome_NODE_2469_length_3921_cov_71,95.424,3584,150,6,49,3621,341,3921,0,5698,3572,3580
11782,Nsylvestris_NODE_2790_length_3666_cov_158,Ntome_NODE_3662_length_3466_cov_240,97.349,3470,85,3,113,3579,3466,1,0,5891,3466,3465
11890,Nsylvestris_NODE_2819_length_3654_cov_52,Ntome_NODE_4346_length_3251_cov_16,97.919,3219,65,2,49,3267,3251,35,0,5572,3218,3216
12005,Nsylvestris_NODE_2845_length_3639_cov_205,Ntome_NODE_2971_length_3711_cov_283,96.415,3654,82,17,19,3639,54,3691,0,5976,3620,3637
12306,Nsylvestris_NODE_2929_length_3610_cov_54,Ntome_NODE_3160_length_3634_cov_51,95.116,3563,166,7,33,3588,3632,71,0,5609,3555,3561
12320,Nsylvestris_NODE_2934_length_3609_cov_15,Ntome_NODE_6553_length_2738_cov_13,95.642,2685,113,4,304,2985,2684,1,0,4307,2681,2683
12548,Nsylvestris_NODE_2999_length_3588_cov_69,Ntome_NODE_3065_length_3672_cov_96,98.134,3484,64,1,1,3484,3533,51,0,6072,3483,3482
12679,Nsylvestris_NODE_3033_length_3574_cov_154,Ntome_NODE_3406_length_3545_cov_180,97.629,3501,67,8,54,3543,3496,1,0,5991,3489,3495
12811,Nsylvestris_NODE_3070_length_3555_cov_66,Ntome_NODE_2640_length_3844_cov_44,94.847,3474,155,5,56,3508,90,3560,0,5402,3452,3470
12851,Nsylvestris_NODE_3081_length_3549_cov_195,Ntome_NODE_3211_length_3618_cov_191,96.544,3443,102,5,57,3486,3475,37,0,5683,3429,3438
12958,Nsylvestris_NODE_3111_length_3539_cov_191,Ntome_NODE_3502_length_3516_cov_177,96.365,3466,98,8,6,3443,1,3466,0,5677,3437,3465
13035,Nsylvestris_NODE_3129_length_3534_cov_114,Ntome_NODE_3940_length_3375_cov_76,94.92,3366,129,23,186,3525,3352,3,0,5230,3339,3349
13175,Nsylvestris_NODE_3169_length_3518_cov_171,Ntome_NODE_3135_length_3645_cov_11,96.346,3476,116,6,24,3498,1,3466,0,5705,3474,3465
13540,Nsylvestris_NODE_3256_length_3487_cov_203,Ntome_NODE_4587_length_3185_cov_86,96.321,3044,101,4,316,3349,47,3089,0,4990,3033,3042
13544,Nsylvestris_NODE_3258_length_3487_cov_43,Ntome_NODE_3195_length_3623_cov_69,95.931,3441,120,7,4,3438,19,3445,0,5561,3434,3426
13624,Nsylvestris_NODE_3280_length_3481_cov_185,Ntome_NODE_3293_length_3590_cov_84,97.466,3433,63,10,23,3447,3466,50,0,5836,3424,3416
13766,Nsylvestris_NODE_3321_length_3468_cov_119,Ntome_NODE_4415_length_3234_cov_105,95.369,3153,134,12,33,3180,3197,52,0,5003,3147,3145
14119,Nsylvestris_NODE_3409_length_3434_cov_42,Ntome_NODE_3061_length_3674_cov_66,92.982,3420,171,26,13,3396,3499,113,0,4922,3383,3386
14167,Nsylvestris_NODE_3423_length_3428_cov_231,Ntome_NODE_3745_length_3436_cov_222,97.816,3389,68,4,40,3427,49,3432,0,5843,3387,3383
14388,Nsylvestris_NODE_3480_length_3408_cov_17,Ntome_NODE_3736_length_3439_cov_26,95.602,3320,138,7,90,3407,124,3437,0,5315,3317,3313
14399,Nsylvestris_NODE_3483_length_3406_cov_194,Ntome_NODE_4160_length_3305_cov_210,95.984,3237,115,13,38,3261,3288,54,0,5243,3223,3234
14457,Nsylvestris_NODE_3498_length_3402_cov_221,Ntome_NODE_3813_length_3415_cov_241,96.505,3376,91,16,39,3400,1,3363,0,5555,3361,3362
14630,Nsylvestris_NODE_3536_length_3387_cov_181,Ntome_NODE_3864_length_3400_cov_92,94.847,3377,148,8,1,3369,38,3396,0,5249,3368,3358
14654,Nsylvestris_NODE_3545_length_3385_cov_168,Ntome_NODE_3356_length_3566_cov_181,97.408,3318,79,4,1,3316,73,3385,0,5644,3315,3312
14720,Nsylvestris_NODE_3565_length_3378_cov_116,Ntome_NODE_3780_length_3427_cov_29,94.321,3381,135,15,1,3333,3423,52,0,5127,3332,3371
14880,Nsylvestris_NODE_3609_length_3361_cov_218,Ntome_NODE_4260_length_3274_cov_215,95.626,3269,131,6,89,3354,7,3266,0,5234,3265,3259
14908,Nsylvestris_NODE_3616_length_3360_cov_171,Ntome_NODE_3856_length_3402_cov_309,94.778,3313,160,1,25,3324,28,3340,0,5147,3299,3312
15113,Nsylvestris_NODE_3670_length_3344_cov_147,Ntome_NODE_3426_length_3539_cov_176,97.4,3269,71,7,28,3282,3356,88,0,5553,3254,3268
15326,Nsylvestris_NODE_3731_length_3326_cov_51,Ntome_NODE_4611_length_3181_cov_76,95.467,2934,124,9,397,3326,2971,43,0,4673,2929,2928
15391,Nsylvestris_NODE_3752_length_3318_cov_153,Ntome_NODE_3638_length_3471_cov_110,97.088,3056,77,3,1,3049,3104,54,0,5140,3048,3050
15461,Nsylvestris_NODE_3772_length_3312_cov_63,Ntome_NODE_4318_length_3256_cov_87,92.885,3289,165,15,3,3265,3246,1,0,4713,3262,3245
15613,Nsylvestris_NODE_3815_length_3296_cov_72,Ntome_NODE_14069_length_1731_cov_27,83.684,190,23,6,1949,2136,1270,1087,1.90E-41,172,187,183
15789,Nsylvestris_NODE_3864_length_3280_cov_151,Ntome_NODE_1593_length_4459_cov_160,97.212,3192,82,3,95,3279,4410,1219,0,5395,3184,3191
15934,Nsylvestris_NODE_3900_length_3268_cov_175,Ntome_NODE_8211_length_2458_cov_236,96.574,2306,51,11,255,2556,6,2287,0,3795,2301,2281
15940,Nsylvestris_NODE_3902_length_3266_cov_141,Ntome_NODE_34491_length_396_cov_2,84.487,419,29,16,1587,1993,396,2,2.87E-104,381,406,394
16063,Nsylvestris_NODE_3936_length_3256_cov_141,Ntome_NODE_3883_length_3393_cov_141,96.956,3022,77,4,190,3211,3189,183,0,5057,3021,3006
16140,Nsylvestris_NODE_3959_length_3246_cov_183,Ntome_NODE_4186_length_3300_cov_252,95.278,3198,137,7,1,3195,35,3221,0,5057,3194,3186
16210,Nsylvestris_NODE_3978_length_3239_cov_19,Ntome_NODE_39529_length_257_cov_5,93.385,257,17,0,90,346,257,1,2.85E-104,381,256,256
16245,Nsylvestris_NODE_3988_length_3236_cov_33,Ntome_NODE_33702_length_434_cov_44,85.821,134,19,0,7,140,31,164,1.46E-32,143,133,133
16529,Nsylvestris_NODE_4066_length_3215_cov_76,Ntome_NODE_36300_length_330_cov_6,90,60,4,2,566,625,283,226,1.49E-12,76.8,59,57
16593,Nsylvestris_NODE_4083_length_3209_cov_107,Ntome_NODE_2898_length_3737_cov_129,94.073,3138,131,23,49,3173,3160,65,0,4713,3124,3095
16594,Nsylvestris_NODE_4084_length_3208_cov_128,Ntome_NODE_5432_length_2978_cov_35,95.534,2978,115,7,203,3165,2975,1,0,4747,2962,2974
16632,Nsylvestris_NODE_4095_length_3204_cov_107,Ntome_NODE_4181_length_3301_cov_161,95.251,3201,120,19,1,3196,3288,115,0,5040,3195,3173
16646,Nsylvestris_NODE_4099_length_3203_cov_50,Ntome_NODE_13106_length_1831_cov_25,94.194,1843,86,3,95,1934,1825,1,0,2791,1839,1824
16812,Nsylvestris_NODE_4145_length_3190_cov_135,Ntome_NODE_4399_length_3239_cov_104,96.305,3004,99,6,55,3046,3059,56,0,4922,2991,3003
16936,Nsylvestris_NODE_4180_length_3181_cov_174,Ntome_NODE_4414_length_3234_cov_164,97.585,3106,66,7,53,3154,132,3232,0,5312,3101,3100
16963,Nsylvestris_NODE_4188_length_3179_cov_43,Ntome_NODE_4990_length_3085_cov_33,96.036,3078,110,6,60,3133,16,3085,0,4998,3073,3069
17000,Nsylvestris_NODE_4199_length_3176_cov_199,Ntome_NODE_3262_length_3601_cov_213,97.603,3004,52,8,55,3055,3599,613,0,5131,3000,2986
17418,Nsylvestris_NODE_4312_length_3147_cov_26,Ntome_NODE_7084_length_2642_cov_14,92.768,2641,188,3,434,3074,5,2642,0,3816,2640,2637
17419,Nsylvestris_NODE_4313_length_3146_cov_236,Ntome_NODE_4534_length_3201_cov_155,93.763,2966,135,21,202,3146,49,2985,0,4407,2944,2936
17472,Nsylvestris_NODE_4327_length_3144_cov_158,Ntome_NODE_5107_length_3053_cov_49,95.437,3068,119,5,37,3098,1,3053,0,4870,3061,3052
17568,Nsylvestris_NODE_4353_length_3139_cov_67,Ntome_NODE_37436_length_301_cov_3,81.776,214,24,6,1873,2071,293,80,3.02E-39,165,198,213
17635,Nsylvestris_NODE_4374_length_3133_cov_196,Ntome_NODE_4947_length_3098_cov_246,96.36,2967,79,13,174,3133,2966,22,0,4854,2959,2944
17698,Nsylvestris_NODE_4393_length_3128_cov_96,Ntome_NODE_17568_length_1396_cov_92,84.483,116,14,3,1026,1139,1057,1170,3.98E-23,111,113,113
17870,Nsylvestris_NODE_4443_length_3111_cov_80,Ntome_NODE_7536_length_2565_cov_33,90.25,1159,94,13,37,1185,2154,1005,0,1496,1148,1149
17928,Nsylvestris_NODE_4458_length_3108_cov_33,Ntome_NODE_4796_length_3134_cov_87,96.34,3060,101,7,55,3108,8,3062,0,5020,3053,3054
18004,Nsylvestris_NODE_4480_length_3103_cov_226,Ntome_NODE_4531_length_3201_cov_292,97.348,3054,56,15,3,3044,3192,152,0,5168,3041,3040
18009,Nsylvestris_NODE_4482_length_3103_cov_205,Ntome_NODE_5282_length_3011_cov_289,94.249,3008,98,25,22,3008,2998,45,0,4527,2986,2953
18052,Nsylvestris_NODE_4494_length_3101_cov_145,Ntome_NODE_15741_length_1564_cov_18,94.426,1525,74,5,93,1617,1563,50,0,2335,1524,1513
18269,Nsylvestris_NODE_4555_length_3084_cov_230,Ntome_NODE_4678_length_3163_cov_294,95.711,3031,77,14,29,3043,39,3032,0,4828,3014,2993
18279,Nsylvestris_NODE_4558_length_3083_cov_185,Ntome_NODE_4262_length_3273_cov_206,96.511,3038,76,12,1,3011,3086,52,0,4996,3010,3034
18441,Nsylvestris_NODE_4603_length_3072_cov_226,Ntome_NODE_4061_length_3331_cov_262,96.409,2701,78,7,162,2850,2757,64,0,4433,2688,2693
18442,Nsylvestris_NODE_4604_length_3072_cov_118,Ntome_NODE_4430_length_3227_cov_156,96.721,3019,95,3,1,3015,160,3178,0,5024,3014,3018
18499,Nsylvestris_NODE_4620_length_3067_cov_197,Ntome_NODE_5041_length_3067_cov_178,95.4,3022,93,16,1,2994,61,3064,0,4769,2993,3003
18524,Nsylvestris_NODE_4627_length_3066_cov_109,Ntome_NODE_4715_length_3156_cov_204,96.323,2801,61,7,101,2901,3040,282,0,4564,2800,2758
18625,Nsylvestris_NODE_4655_length_3055_cov_192,Ntome_NODE_5934_length_2865_cov_140,93.993,2697,119,11,141,2812,72,2750,0,4043,2671,2678
18742,Nsylvestris_NODE_4689_length_3047_cov_190,Ntome_NODE_5670_length_2923_cov_171,94.39,2959,85,23,4,2920,3,2922,0,4470,2916,2919
18810,Nsylvestris_NODE_4713_length_3042_cov_55,Ntome_NODE_32933_length_483_cov_4,95.807,477,17,1,1561,2034,482,6,0,767,473,476
18938,Nsylvestris_NODE_4753_length_3033_cov_126,Ntome_NODE_6383_length_2770_cov_221,93.897,2507,145,5,42,2544,2718,216,0,3775,2502,2502
18963,Nsylvestris_NODE_4760_length_3031_cov_150,Ntome_NODE_4319_length_3255_cov_289,96.701,2971,79,3,28,2979,33,3003,0,4926,2951,2970
18992,Nsylvestris_NODE_4770_length_3029_cov_199,Ntome_NODE_5767_length_2904_cov_226,98.561,2502,34,2,1,2500,36,2537,0,4420,2499,2501
19073,Nsylvestris_NODE_4794_length_3023_cov_155,Ntome_NODE_30347_length_615_cov_3,90.076,524,37,8,2437,2957,3,514,0,665,520,511
19076,Nsylvestris_NODE_4796_length_3022_cov_225,Ntome_NODE_5033_length_3068_cov_299,94.34,2915,149,11,95,3005,2929,27,0,4455,2910,2902
19291,Nsylvestris_NODE_4858_length_3006_cov_16,Ntome_NODE_4300_length_3261_cov_38,95.148,2906,128,12,45,2947,364,3259,0,4573,2902,2895
19522,Nsylvestris_NODE_4921_length_2991_cov_228,Ntome_NODE_5948_length_2861_cov_275,94.244,2797,132,19,51,2842,2819,47,0,4246,2791,2772
19615,Nsylvestris_NODE_4947_length_2987_cov_37,Ntome_NODE_3664_length_3466_cov_92,89.48,2386,182,27,4,2361,48,2392,0,2952,2357,2344
19689,Nsylvestris_NODE_4971_length_2980_cov_211,Ntome_NODE_6173_length_2817_cov_242,96.796,2778,52,12,165,2912,47,2817,0,4602,2747,2770
19757,Nsylvestris_NODE_4994_length_2974_cov_114,Ntome_NODE_5471_length_2970_cov_38,94.597,2980,107,13,21,2957,2969,1,0,4562,2936,2968
19982,Nsylvestris_NODE_5060_length_2958_cov_70,Ntome_NODE_3119_length_3650_cov_176,95.914,2692,97,7,5,2692,65,2747,0,4349,2687,2682
19983,Nsylvestris_NODE_5061_length_2957_cov_226,Ntome_NODE_5456_length_2972_cov_214,94.749,2952,134,7,7,2956,2933,1,0,4573,2949,2932
20000,Nsylvestris_NODE_5066_length_2956_cov_176,Ntome_NODE_5458_length_2972_cov_207,97.431,2958,69,4,1,2956,2958,6,0,5035,2955,2952
20412,Nsylvestris_NODE_5180_length_2930_cov_155,Ntome_NODE_8452_length_2420_cov_27,95.82,2416,88,5,504,2910,2420,9,0,3890,2406,2411
20636,Nsylvestris_NODE_5243_length_2917_cov_91,Ntome_NODE_20400_length_1161_cov_193,92.262,840,29,8,2078,2915,72,877,0,1158,837,805
20824,Nsylvestris_NODE_5292_length_2907_cov_184,Ntome_NODE_6295_length_2789_cov_59,95.294,2805,84,19,84,2859,2789,4,0,4405,2775,2785
20954,Nsylvestris_NODE_5330_length_2900_cov_172,Ntome_NODE_5642_length_2929_cov_288,96.113,2624,76,12,104,2704,309,2929,0,4257,2600,2620
21066,Nsylvestris_NODE_5367_length_2893_cov_70,Ntome_NODE_25964_length_807_cov_205,87.034,725,39,20,2146,2831,759,51,0,767,685,708
21101,Nsylvestris_NODE_5377_length_2891_cov_64,Ntome_NODE_4984_length_3087_cov_42,94.06,2761,118,19,119,2859,330,3064,0,4148,2740,2734
21323,Nsylvestris_NODE_5442_length_2875_cov_206,Ntome_NODE_4799_length_3133_cov_210,96.1,2692,77,13,45,2734,148,2813,0,4364,2689,2665
21354,Nsylvestris_NODE_5451_length_2873_cov_45,Ntome_NODE_4573_length_3189_cov_33,96.741,2792,90,1,1,2791,381,3172,0,4650,2790,2791
21357,Nsylvestris_NODE_5453_length_2873_cov_23,Ntome_NODE_7509_length_2570_cov_45,95.932,2286,92,1,586,2870,2366,81,0,3705,2284,2285
21485,Nsylvestris_NODE_5490_length_2864_cov_89,Ntome_NODE_7180_length_2625_cov_161,95.946,2590,84,8,28,2609,1,2577,0,4181,2581,2576
21532,Nsylvestris_NODE_5504_length_2861_cov_158,Ntome_NODE_6956_length_2657_cov_203,97.158,2604,64,6,102,2702,2,2598,0,4390,2600,2596
21599,Nsylvestris_NODE_5520_length_2858_cov_108,Ntome_NODE_4840_length_3123_cov_285,93.682,2833,135,25,56,2857,2866,47,0,4200,2801,2819
21633,Nsylvestris_NODE_5530_length_2855_cov_224,Ntome_NODE_4706_length_3158_cov_238,96.27,2842,94,9,1,2830,2843,2,0,4650,2829,2841
21650,Nsylvestris_NODE_5536_length_2855_cov_36,Ntome_NODE_7154_length_2630_cov_20,95.404,2633,117,3,124,2755,1,2630,0,4189,2631,2629
21664,Nsylvestris_NODE_5542_length_2852_cov_228,Ntome_NODE_5557_length_2948_cov_290,94.423,2618,132,7,196,2804,2948,336,0,4013,2608,2612
21858,Nsylvestris_NODE_5595_length_2841_cov_151,Ntome_NODE_5331_length_3000_cov_225,96.112,2855,74,14,1,2841,40,2871,0,4623,2840,2831
21934,Nsylvestris_NODE_5618_length_2835_cov_153,Ntome_NODE_1071_length_4997_cov_170,96.465,2433,77,6,393,2823,2579,154,0,4008,2430,2425
21961,Nsylvestris_NODE_5627_length_2832_cov_223,Ntome_NODE_6004_length_2846_cov_261,96.401,2806,72,7,14,2812,2784,1,0,4595,2798,2783
21997,Nsylvestris_NODE_5638_length_2831_cov_29,Ntome_NODE_5962_length_2857_cov_24,97.272,2273,49,3,29,2300,90,2350,0,3842,2271,2260
22070,Nsylvestris_NODE_5661_length_2825_cov_50,Ntome_NODE_29308_length_656_cov_24,84.286,210,23,5,2601,2808,438,639,9.64E-49,196,207,201
22127,Nsylvestris_NODE_5677_length_2823_cov_29,Ntome_NODE_5658_length_2925_cov_283,95.993,2720,85,10,1,2711,2833,129,0,4397,2710,2704
22153,Nsylvestris_NODE_5687_length_2822_cov_26,Ntome_NODE_5070_length_3061_cov_113,93.748,2751,141,14,53,2775,248,2995,0,4098,2722,2747
22215,Nsylvestris_NODE_5708_length_2818_cov_224,Ntome_NODE_5634_length_2931_cov_260,96.503,2774,85,8,48,2818,96,2860,0,4575,2770,2764
22237,Nsylvestris_NODE_5714_length_2818_cov_31,Ntome_NODE_35553_length_353_cov_2,95.751,353,13,1,2324,2674,1,353,1.77E-160,568,350,352
22292,Nsylvestris_NODE_5729_length_2816_cov_153,Ntome_NODE_7022_length_2652_cov_36,95.677,2614,111,2,4,2615,2614,1,0,4200,2611,2613
22369,Nsylvestris_NODE_5751_length_2810_cov_131,Ntome_NODE_6543_length_2739_cov_285,94.39,2674,118,9,150,2810,46,2700,0,4078,2660,2654
22455,Nsylvestris_NODE_5777_length_2805_cov_192,Ntome_NODE_7466_length_2575_cov_189,94.635,2535,112,12,59,2582,1,2522,0,3906,2523,2521
22589,Nsylvestris_NODE_5814_length_2798_cov_95,Ntome_NODE_6680_length_2716_cov_133,96.502,2659,84,4,47,2701,1,2654,0,4386,2654,2653
22692,Nsylvestris_NODE_5846_length_2793_cov_69,Ntome_NODE_5801_length_2894_cov_95,94.434,2767,102,24,52,2792,2808,68,0,4209,2740,2740
22912,Nsylvestris_NODE_5911_length_2779_cov_210,Ntome_NODE_5153_length_3043_cov_258,96.933,2739,65,9,46,2773,178,2908,0,4575,2727,2730
22960,Nsylvestris_NODE_5923_length_2776_cov_136,Ntome_NODE_26373_length_788_cov_235,95.779,616,23,3,1,613,3,618,0,990,612,615
23052,Nsylvestris_NODE_5950_length_2769_cov_206,Ntome_NODE_6844_length_2686_cov_194,96.426,2686,70,6,70,2732,2683,1,0,4405,2662,2682
23059,Nsylvestris_NODE_5952_length_2769_cov_161,Ntome_NODE_5725_length_2912_cov_227,94.691,2769,138,3,1,2767,2808,47,0,4290,2766,2761
23081,Nsylvestris_NODE_5960_length_2768_cov_59,Ntome_NODE_6821_length_2690_cov_145,94.819,2683,110,15,19,2685,1,2670,0,4157,2666,2669
23152,Nsylvestris_NODE_5980_length_2765_cov_72,Ntome_NODE_3942_length_3375_cov_34,95.841,2573,97,8,117,2685,2567,1,0,4150,2568,2566
23206,Nsylvestris_NODE_5996_length_2761_cov_139,Ntome_NODE_15819_length_1556_cov_160,95.401,1435,56,7,1232,2663,78,1505,0,2276,1431,1427
23284,Nsylvestris_NODE_6019_length_2757_cov_97,Ntome_NODE_5916_length_2868_cov_112,94.488,2413,130,3,188,2599,404,2814,0,3716,2411,2410
23301,Nsylvestris_NODE_6025_length_2755_cov_179,Ntome_NODE_5370_length_2993_cov_168,96.938,2711,61,9,5,2711,187,2879,0,4527,2706,2692
23348,Nsylvestris_NODE_6038_length_2753_cov_209,Ntome_NODE_6849_length_2685_cov_119,95.335,2658,110,3,82,2734,2650,2,0,4209,2652,2648
23389,Nsylvestris_NODE_6048_length_2750_cov_146,Ntome_NODE_6065_length_2836_cov_222,95.398,2716,115,4,42,2750,44,2756,0,4314,2708,2712
23432,Nsylvestris_NODE_6060_length_2747_cov_34,Ntome_NODE_6755_length_2703_cov_38,94.205,2709,132,8,1,2699,8,2701,0,4109,2698,2693
23489,Nsylvestris_NODE_6079_length_2742_cov_155,Ntome_NODE_8513_length_2411_cov_236,93.66,2161,108,10,538,2677,2236,84,0,3205,2139,2152
23505,Nsylvestris_NODE_6085_length_2741_cov_95,Ntome_NODE_7346_length_2595_cov_137,94.636,2442,59,19,2,2380,2580,148,0,3718,2378,2432
23563,Nsylvestris_NODE_6101_length_2737_cov_164,Ntome_NODE_16055_length_1535_cov_18,95.652,1495,62,2,537,2031,1,1492,0,2398,1494,1491
23690,Nsylvestris_NODE_6138_length_2728_cov_155,Ntome_NODE_7234_length_2617_cov_189,93.953,2580,126,20,120,2688,13,2573,0,3873,2568,2560
23708,Nsylvestris_NODE_6144_length_2727_cov_95,Ntome_NODE_11377_length_2028_cov_105,92.279,1865,77,20,838,2672,1941,114,0,2584,1834,1827
23717,Nsylvestris_NODE_6147_length_2727_cov_26,Ntome_NODE_10415_length_2144_cov_43,79.227,905,153,31,921,1814,1522,642,2.18E-169,597,893,880
23797,Nsylvestris_NODE_6173_length_2722_cov_72,Ntome_NODE_1696_length_4385_cov_34,91.137,1918,124,12,770,2664,2491,4385,0,2558,1894,1894
23885,Nsylvestris_NODE_6201_length_2717_cov_44,Ntome_NODE_7400_length_2585_cov_99,97.297,2368,55,2,348,2715,215,2573,0,4010,2367,2358
23905,Nsylvestris_NODE_6208_length_2715_cov_79,Ntome_NODE_6778_length_2698_cov_63,93.129,2707,166,7,18,2713,1,2698,0,3951,2695,2697
24121,Nsylvestris_NODE_6267_length_2704_cov_103,Ntome_NODE_8065_length_2481_cov_122,97.437,2068,51,2,7,2073,2374,308,0,3524,2066,2066
24142,Nsylvestris_NODE_6273_length_2703_cov_54,Ntome_NODE_8339_length_2437_cov_11,97.542,2360,58,0,270,2629,2361,2,0,4037,2359,2359
24197,Nsylvestris_NODE_6289_length_2699_cov_224,Ntome_NODE_6895_length_2675_cov_282,95.133,2630,121,5,40,2668,2624,1,0,4141,2628,2623
24209,Nsylvestris_NODE_6293_length_2698_cov_227,Ntome_NODE_6627_length_2724_cov_267,96.848,2665,56,15,9,2655,2663,9,0,4431,2646,2654
24318,Nsylvestris_NODE_6326_length_2693_cov_67,Ntome_NODE_6392_length_2769_cov_86,94.059,2693,134,9,22,2693,8,2695,0,4063,2671,2687
24367,Nsylvestris_NODE_6341_length_2690_cov_235,Ntome_NODE_6957_length_2662_cov_108,95.884,2648,68,17,17,2648,15,2637,0,4248,2631,2622
24525,Nsylvestris_NODE_6383_length_2682_cov_110,Ntome_NODE_8542_length_2407_cov_26,89.203,2019,193,10,372,2370,312,2325,0,2497,1998,2013
24584,Nsylvestris_NODE_6400_length_2680_cov_156,Ntome_NODE_7064_length_2644_cov_287,96.227,2465,93,0,7,2471,2518,54,0,4037,2464,2464
24706,Nsylvestris_NODE_6437_length_2671_cov_158,Ntome_NODE_7262_length_2611_cov_228,93.89,2553,127,15,4,2534,2605,60,0,3823,2530,2545
25147,Nsylvestris_NODE_6572_length_2648_cov_59,Ntome_NODE_6611_length_2728_cov_200,95.51,2695,58,24,1,2648,40,2718,0,4248,2647,2678
25257,Nsylvestris_NODE_6604_length_2641_cov_186,Ntome_NODE_7520_length_2567_cov_157,94.435,2408,100,19,70,2466,2465,81,0,3674,2396,2384
25267,Nsylvestris_NODE_6607_length_2641_cov_154,Ntome_NODE_7912_length_2504_cov_244,94.208,2210,107,9,204,2398,2284,81,0,3352,2194,2203
25309,Nsylvestris_NODE_6621_length_2638_cov_188,Ntome_NODE_8410_length_2425_cov_185,96.089,2327,76,9,222,2541,2319,1,0,3779,2319,2318
25356,Nsylvestris_NODE_6633_length_2636_cov_207,Ntome_NODE_7544_length_2564_cov_121,93.93,2356,121,10,113,2454,173,2520,0,3539,2341,2347
25357,Nsylvestris_NODE_6634_length_2636_cov_172,Ntome_NODE_6732_length_2706_cov_250,94.319,2658,101,29,1,2636,2684,55,0,4026,2635,2629
25457,Nsylvestris_NODE_6664_length_2631_cov_136,Ntome_NODE_6628_length_2724_cov_251,91.504,2554,134,34,49,2566,2547,41,0,3437,2517,2506
25596,Nsylvestris_NODE_6710_length_2620_cov_53,Ntome_NODE_8963_length_2344_cov_12,94.062,2223,115,8,98,2319,2266,60,0,3358,2221,2206
25597,Nsylvestris_NODE_6711_length_2620_cov_28,Ntome_NODE_4317_length_3256_cov_116,95.25,2463,107,2,168,2620,3205,743,0,3892,2452,2462
25647,Nsylvestris_NODE_6726_length_2617_cov_36,Ntome_NODE_7753_length_2532_cov_79,94.261,2457,94,23,185,2617,66,2499,0,3712,2432,2433
25766,Nsylvestris_NODE_6761_length_2611_cov_169,Ntome_NODE_14374_length_1698_cov_100,94.745,1256,66,0,1332,2587,1258,3,0,1954,1255,1255
25796,Nsylvestris_NODE_6772_length_2609_cov_44,Ntome_NODE_6619_length_2726_cov_40,94.045,2351,128,9,138,2480,328,2674,0,3555,2342,2346
25847,Nsylvestris_NODE_6789_length_2605_cov_142,Ntome_NODE_8004_length_2490_cov_248,94.335,2383,107,13,67,2423,2381,1,0,3627,2356,2380
25959,Nsylvestris_NODE_6817_length_2601_cov_33,Ntome_NODE_9385_length_2284_cov_66,96.295,2159,65,6,455,2599,2279,122,0,3530,2144,2157
26006,Nsylvestris_NODE_6830_length_2598_cov_165,Ntome_NODE_6991_length_2656_cov_173,94.315,2533,116,10,37,2554,1,2520,0,3855,2517,2519
26091,Nsylvestris_NODE_6854_length_2593_cov_232,Ntome_NODE_7832_length_2518_cov_269,94.047,2503,111,9,88,2584,48,2518,0,3762,2496,2470
26126,Nsylvestris_NODE_6864_length_2592_cov_57,Ntome_NODE_18113_length_1349_cov_149,85.088,456,50,7,1615,2069,503,65,6.14E-125,449,454,438
26156,Nsylvestris_NODE_6877_length_2588_cov_231,Ntome_NODE_4606_length_3181_cov_254,95.875,2570,76,10,3,2548,498,3061,0,4132,2545,2563
26209,Nsylvestris_NODE_6894_length_2586_cov_205,Ntome_NODE_6021_length_2843_cov_285,96.331,2589,91,3,1,2586,2831,244,0,4252,2585,2587
26306,Nsylvestris_NODE_6921_length_2582_cov_16,Ntome_NODE_8032_length_2486_cov_44,93.224,2450,101,21,1,2419,2462,47,0,3544,2418,2415
26337,Nsylvestris_NODE_6928_length_2580_cov_228,Ntome_NODE_6879_length_2678_cov_254,95.624,2582,84,11,1,2562,2578,6,0,4115,2561,2572
26408,Nsylvestris_NODE_6950_length_2577_cov_58,Ntome_NODE_7332_length_2598_cov_59,94.941,2530,122,4,52,2577,2598,71,0,3958,2525,2527
26627,Nsylvestris_NODE_7016_length_2567_cov_108,Ntome_NODE_6481_length_2751_cov_246,96.003,2527,77,14,51,2562,83,2600,0,4085,2511,2517
26706,Nsylvestris_NODE_7042_length_2563_cov_31,Ntome_NODE_8921_length_2351_cov_30,95.389,2342,88,8,135,2468,2351,22,0,3709,2333,2329
26812,Nsylvestris_NODE_7075_length_2558_cov_132,Ntome_NODE_6605_length_2729_cov_185,97.654,2558,55,2,1,2558,2594,42,0,4386,2557,2552
26912,Nsylvestris_NODE_7103_length_2553_cov_97,Ntome_NODE_7707_length_2539_cov_45,96.229,2466,76,9,49,2505,2458,1,0,4023,2456,2457
26967,Nsylvestris_NODE_7120_length_2550_cov_62,Ntome_NODE_16637_length_1483_cov_14,97.367,1481,39,0,689,2169,1483,3,0,2519,1480,1480
26971,Nsylvestris_NODE_7122_length_2550_cov_45,Ntome_NODE_7168_length_2628_cov_84,96.471,2550,78,3,4,2550,2543,3,0,4200,2546,2540
27016,Nsylvestris_NODE_7133_length_2549_cov_20,Ntome_NODE_6426_length_2762_cov_71,96.4,2500,86,2,46,2545,2654,159,0,4115,2499,2495
27049,Nsylvestris_NODE_7142_length_2546_cov_202,Ntome_NODE_10173_length_2174_cov_284,94.214,2022,75,21,446,2433,106,2119,0,3048,1987,2013
27140,Nsylvestris_NODE_7167_length_2540_cov_216,Ntome_NODE_7293_length_2605_cov_292,96.697,2452,42,10,30,2469,1,2425,0,4043,2439,2424
27220,Nsylvestris_NODE_7194_length_2536_cov_40,Ntome_NODE_13526_length_1784_cov_3,92.999,1814,92,23,553,2361,1,1784,0,2614,1808,1783
27268,Nsylvestris_NODE_7208_length_2532_cov_183,Ntome_NODE_7407_length_2584_cov_243,95.474,2541,58,25,11,2508,2532,6,0,4002,2497,2526
27283,Nsylvestris_NODE_7213_length_2531_cov_226,Ntome_NODE_7601_length_2553_cov_294,96.862,2390,62,6,105,2484,23,2409,0,3986,2379,2386
27322,Nsylvestris_NODE_7227_length_2530_cov_64,Ntome_NODE_7926_length_2502_cov_72,97.889,2511,43,4,19,2528,2502,1,0,4335,2509,2501
27389,Nsylvestris_NODE_7249_length_2527_cov_102,Ntome_NODE_19809_length_1209_cov_141,91.803,1159,63,14,1367,2519,50,1182,0,1585,1152,1132
27397,Nsylvestris_NODE_7252_length_2526_cov_201,Ntome_NODE_8019_length_2488_cov_296,95.452,2199,95,2,132,2325,239,2437,0,3502,2193,2198
27527,Nsylvestris_NODE_7287_length_2521_cov_103,Ntome_NODE_8058_length_2482_cov_96,95.395,2454,72,19,29,2469,2431,6,0,3868,2440,2425
27597,Nsylvestris_NODE_7307_length_2518_cov_222,Ntome_NODE_7822_length_2520_cov_288,93.783,2445,116,16,1,2436,2474,57,0,3640,2435,2417
27598,Nsylvestris_NODE_7308_length_2518_cov_219,Ntome_NODE_8262_length_2447_cov_291,95.562,2321,59,6,40,2335,31,2332,0,3675,2295,2301
27655,Nsylvestris_NODE_7327_length_2516_cov_59,Ntome_NODE_8091_length_2476_cov_122,97.217,2479,63,2,1,2479,2473,1,0,4191,2478,2472
27673,Nsylvestris_NODE_7333_length_2515_cov_87,Ntome_NODE_19317_length_1250_cov_251,94.956,1031,47,1,116,1146,64,1089,0,1611,1030,1025
27713,Nsylvestris_NODE_7346_length_2513_cov_190,Ntome_NODE_8466_length_2417_cov_269,94.659,2378,76,23,125,2476,32,2384,0,3640,2351,2352
27950,Nsylvestris_NODE_7414_length_2502_cov_199,Ntome_NODE_7749_length_2533_cov_71,95.376,2422,89,11,37,2439,2418,1,0,3831,2402,2417
27969,Nsylvestris_NODE_7420_length_2501_cov_169,Ntome_NODE_5957_length_2859_cov_229,97.144,2451,47,3,53,2492,83,2521,0,4117,2439,2438
28085,Nsylvestris_NODE_7456_length_2494_cov_226,Ntome_NODE_8772_length_2374_cov_104,95.487,2393,78,12,90,2476,6,2374,0,3794,2386,2368
28209,Nsylvestris_NODE_7494_length_2486_cov_172,Ntome_NODE_7992_length_2491_cov_283,95.52,2232,82,7,1,2217,125,2353,0,3552,2216,2228
28306,Nsylvestris_NODE_7527_length_2481_cov_184,Ntome_NODE_8128_length_2471_cov_218,94.408,2414,67,28,32,2410,41,2421,0,3648,2378,2380
28409,Nsylvestris_NODE_7556_length_2476_cov_198,Ntome_NODE_8140_length_2469_cov_257,96.907,2425,59,11,1,2412,2469,48,0,4048,2411,2421
28574,Nsylvestris_NODE_7601_length_2470_cov_221,Ntome_NODE_7446_length_2578_cov_247,97.743,2348,41,6,110,2449,2349,6,0,4032,2339,2343
28611,Nsylvestris_NODE_7616_length_2468_cov_210,Ntome_NODE_7678_length_2544_cov_195,94.652,2431,95,13,3,2410,49,2467,0,3736,2407,2418
28755,Nsylvestris_NODE_7661_length_2459_cov_170,Ntome_NODE_7557_length_2562_cov_160,94.53,2468,109,15,14,2459,39,2502,0,3786,2445,2463
28759,Nsylvestris_NODE_7663_length_2459_cov_77,Ntome_NODE_10283_length_2158_cov_191,95.952,2100,67,6,372,2459,52,2145,0,3391,2087,2093
28776,Nsylvestris_NODE_7669_length_2458_cov_60,Ntome_NODE_20194_length_1177_cov_134,94.316,1038,52,2,52,1089,52,1082,0,1583,1037,1030
28797,Nsylvestris_NODE_7678_length_2457_cov_94,Ntome_NODE_9150_length_2318_cov_71,94.895,2057,75,14,47,2086,2265,222,0,3190,2039,2043
28845,Nsylvestris_NODE_7691_length_2454_cov_166,Ntome_NODE_13799_length_1758_cov_9,96.016,1757,70,0,496,2252,2,1758,0,2857,1756,1756
28888,Nsylvestris_NODE_7706_length_2452_cov_78,Ntome_NODE_8757_length_2377_cov_65,95.298,2382,107,4,67,2448,1,2377,0,3773,2381,2376
28905,Nsylvestris_NODE_7711_length_2451_cov_96,Ntome_NODE_9874_length_2216_cov_81,96.798,2186,51,4,64,2231,2216,32,0,3631,2167,2184
29088,Nsylvestris_NODE_7763_length_2443_cov_162,Ntome_NODE_8043_length_2484_cov_270,95.077,2417,85,6,4,2420,2383,1,0,3773,2416,2382
29118,Nsylvestris_NODE_7772_length_2442_cov_115,Ntome_NODE_8295_length_2442_cov_147,96.352,2111,73,2,3,2113,34,2140,0,3469,2110,2106
29300,Nsylvestris_NODE_7826_length_2433_cov_75,Ntome_NODE_7918_length_2504_cov_111,95.74,2418,62,15,45,2423,2417,2,0,3856,2378,2415
29335,Nsylvestris_NODE_7838_length_2430_cov_207,Ntome_NODE_8902_length_2353_cov_289,94.418,2096,108,6,290,2380,200,2291,0,3214,2090,2091
29395,Nsylvestris_NODE_7856_length_2427_cov_74,Ntome_NODE_7804_length_2524_cov_132,91.069,2497,120,40,1,2424,2493,27,0,3280,2423,2466
29446,Nsylvestris_NODE_7871_length_2425_cov_207,Ntome_NODE_12112_length_1943_cov_178,97.745,1951,33,4,14,1961,1943,1,0,3349,1947,1942
29470,Nsylvestris_NODE_7879_length_2424_cov_112,Ntome_NODE_10587_length_2122_cov_56,95.724,2128,85,1,217,2344,2122,1,0,3421,2127,2121
29475,Nsylvestris_NODE_7881_length_2423_cov_225,Ntome_NODE_8997_length_2339_cov_263,96.898,2353,47,8,79,2423,2338,4,0,3917,2344,2334
29515,Nsylvestris_NODE_7894_length_2422_cov_99,Ntome_NODE_6411_length_2765_cov_113,94.768,2389,66,10,37,2379,1,2376,0,3664,2342,2375
29560,Nsylvestris_NODE_7911_length_2418_cov_228,Ntome_NODE_8018_length_2488_cov_298,94.826,2358,93,18,34,2367,2413,61,0,3651,2333,2352
29566,Nsylvestris_NODE_7914_length_2418_cov_82,Ntome_NODE_8240_length_2453_cov_182,97.358,1930,51,0,349,2278,2262,333,0,3282,1929,1929
29630,Nsylvestris_NODE_7931_length_2415_cov_20,Ntome_NODE_9949_length_2206_cov_6,95.188,2203,102,2,198,2396,1,2203,0,3478,2198,2202
29640,Nsylvestris_NODE_7935_length_2414_cov_105,Ntome_NODE_36910_length_313_cov_3,93.311,299,19,1,109,407,313,16,3.44E-122,440,298,297
29678,Nsylvestris_NODE_7948_length_2412_cov_219,Ntome_NODE_7743_length_2533_cov_286,97.703,2394,49,4,22,2409,120,2513,0,4111,2387,2393
29746,Nsylvestris_NODE_7968_length_2410_cov_97,Ntome_NODE_7200_length_2622_cov_120,96.599,2411,71,8,1,2408,2593,191,0,3988,2407,2402
29750,Nsylvestris_NODE_7971_length_2409_cov_199,Ntome_NODE_7085_length_2641_cov_248,95.525,2324,82,13,37,2343,2588,270,0,3696,2306,2318
29812,Nsylvestris_NODE_7991_length_2405_cov_125,Ntome_NODE_8314_length_2440_cov_110,96.077,2396,68,10,19,2405,2440,62,0,3880,2386,2378
29816,Nsylvestris_NODE_7993_length_2405_cov_45,Ntome_NODE_14001_length_1738_cov_17,97.296,1738,42,4,296,2031,1,1735,0,2944,1735,1734
29842,Nsylvestris_NODE_8003_length_2403_cov_123,Ntome_NODE_13346_length_1803_cov_125,94.814,1832,60,12,520,2347,1803,3,0,2824,1827,1800
29933,Nsylvestris_NODE_8030_length_2398_cov_130,Ntome_NODE_10230_length_2166_cov_32,92.801,2167,137,8,122,2270,2166,1,0,3120,2148,2165
30024,Nsylvestris_NODE_8061_length_2393_cov_40,Ntome_NODE_6424_length_2762_cov_236,95.596,2384,89,10,1,2382,2610,241,0,3807,2381,2369
30052,Nsylvestris_NODE_8070_length_2392_cov_29,Ntome_NODE_18536_length_1313_cov_10,92.639,1345,67,8,402,1746,1313,1,0,1906,1344,1312
30141,Nsylvestris_NODE_8099_length_2387_cov_188,Ntome_NODE_11972_length_1961_cov_180,94.027,1825,82,9,264,2067,55,1873,0,2741,1803,1818
30189,Nsylvestris_NODE_8117_length_2385_cov_86,Ntome_NODE_24767_length_876_cov_152,96.257,668,24,1,1633,2300,667,1,0,1094,667,666
30210,Nsylvestris_NODE_8123_length_2384_cov_47,Ntome_NODE_17910_length_1365_cov_231,96.524,633,22,0,1546,2178,995,363,0,1048,632,632
30220,Nsylvestris_NODE_8128_length_2383_cov_172,Ntome_NODE_7797_length_2525_cov_226,94.256,2385,121,10,3,2383,140,2512,0,3631,2380,2372
30277,Nsylvestris_NODE_8146_length_2381_cov_140,Ntome_NODE_4733_length_3152_cov_178,95.742,2372,88,4,20,2381,2943,575,0,3808,2361,2368
30304,Nsylvestris_NODE_8155_length_2379_cov_208,Ntome_NODE_8287_length_2443_cov_283,95.354,2389,77,16,5,2379,2369,1,0,3766,2374,2368
30337,Nsylvestris_NODE_8166_length_2376_cov_75,Ntome_NODE_6705_length_2713_cov_131,92.527,2355,129,14,46,2371,276,2612,0,3330,2325,2336
30347,Nsylvestris_NODE_8170_length_2375_cov_201,Ntome_NODE_8227_length_2454_cov_283,96.119,2190,79,4,188,2375,2408,223,0,3568,2187,2185
30368,Nsylvestris_NODE_8175_length_2375_cov_65,Ntome_NODE_8166_length_2465_cov_233,95.398,2347,95,9,31,2373,2382,45,0,3723,2342,2337
30409,Nsylvestris_NODE_8193_length_2372_cov_193,Ntome_NODE_33453_length_449_cov_4,99.777,449,1,0,966,1414,1,449,0,824,448,448
30410,Nsylvestris_NODE_8194_length_2372_cov_193,Ntome_NODE_7933_length_2500_cov_155,94.996,2378,85,17,3,2369,2363,9,0,3701,2366,2354
30601,Nsylvestris_NODE_8256_length_2362_cov_153,Ntome_NODE_11624_length_2000_cov_211,88.992,1944,109,46,41,1938,116,2000,0,2307,1897,1884
30680,Nsylvestris_NODE_8280_length_2358_cov_42,Ntome_NODE_11562_length_2007_cov_28,77.778,225,35,8,791,1013,766,977,3.84E-27,124,222,211
30763,Nsylvestris_NODE_8308_length_2354_cov_136,Ntome_NODE_8941_length_2347_cov_142,93.498,2307,97,24,3,2294,2345,77,0,3380,2291,2268
30801,Nsylvestris_NODE_8320_length_2353_cov_31,Ntome_NODE_35203_length_366_cov_5,88.503,374,23,6,1898,2271,366,13,1.56E-120,435,373,353
30805,Nsylvestris_NODE_8322_length_2352_cov_223,Ntome_NODE_10457_length_2137_cov_295,97.685,1944,36,1,170,2113,203,2137,0,3332,1943,1934
30870,Nsylvestris_NODE_8341_length_2349_cov_221,Ntome_NODE_9370_length_2286_cov_292,96.792,2213,54,8,141,2348,2224,24,0,3677,2207,2200
30876,Nsylvestris_NODE_8344_length_2349_cov_195,Ntome_NODE_7973_length_2494_cov_227,94.789,2303,91,12,1,2292,2424,140,0,3561,2291,2284
30960,Nsylvestris_NODE_8372_length_2345_cov_18,Ntome_NODE_9482_length_2272_cov_18,92.391,1945,121,17,374,2301,312,2246,0,2747,1927,1934
31032,Nsylvestris_NODE_8392_length_2342_cov_97,Ntome_NODE_9885_length_2215_cov_87,93.579,2087,129,3,102,2187,2135,53,0,3107,2085,2082
31106,Nsylvestris_NODE_8416_length_2337_cov_65,Ntome_NODE_8553_length_2406_cov_53,89.104,670,38,8,1501,2144,939,279,0,800,643,660
31277,Nsylvestris_NODE_8468_length_2330_cov_23,Ntome_NODE_7031_length_2650_cov_79,95.662,2236,88,4,46,2278,2230,1,0,3583,2232,2229
31387,Nsylvestris_NODE_8510_length_2323_cov_142,Ntome_NODE_8778_length_2373_cov_184,91.942,2358,131,31,1,2323,28,2361,0,3247,2322,2333
31399,Nsylvestris_NODE_8514_length_2322_cov_196,Ntome_NODE_10699_length_2106_cov_284,92.449,2013,99,25,171,2155,51,2038,0,2826,1984,1987
31457,Nsylvestris_NODE_8532_length_2321_cov_28,Ntome_NODE_10935_length_2082_cov_14,95.926,2111,48,8,201,2302,2082,1,0,3387,2101,2081
31686,Nsylvestris_NODE_8608_length_2308_cov_49,Ntome_NODE_14042_length_1734_cov_9,91.806,1672,132,3,501,2171,4,1671,0,2324,1670,1667
31719,Nsylvestris_NODE_8619_length_2306_cov_217,Ntome_NODE_7076_length_2642_cov_288,94.73,2258,112,3,48,2305,2284,34,0,3504,2257,2250
31735,Nsylvestris_NODE_8626_length_2306_cov_35,Ntome_NODE_38256_length_283_cov_4,97.509,281,7,0,958,1238,283,3,1.94E-134,481,280,280
31761,Nsylvestris_NODE_8635_length_2304_cov_28,Ntome_NODE_9242_length_2303_cov_119,94.228,2183,84,14,10,2167,63,2228,0,3295,2157,2165
31863,Nsylvestris_NODE_8669_length_2298_cov_125,Ntome_NODE_10687_length_2108_cov_224,94.464,2023,95,6,237,2243,2059,38,0,3099,2006,2021
32114,Nsylvestris_NODE_8747_length_2288_cov_224,Ntome_NODE_10232_length_2165_cov_309,96.006,2103,80,2,190,2288,2103,1,0,3415,2098,2102
32175,Nsylvestris_NODE_8768_length_2285_cov_10,Ntome_NODE_8756_length_2377_cov_97,96.435,2188,77,1,98,2285,123,2309,0,3607,2187,2186
32186,Nsylvestris_NODE_8772_length_2284_cov_101,Ntome_NODE_13918_length_1745_cov_18,95.528,1744,68,4,432,2166,1745,3,0,2780,1734,1742
32213,Nsylvestris_NODE_8782_length_2282_cov_141,Ntome_NODE_9198_length_2308_cov_253,96.251,2214,74,3,23,2236,1,2205,0,3620,2213,2204
32276,Nsylvestris_NODE_8803_length_2279_cov_69,Ntome_NODE_9089_length_2325_cov_32,95.386,1734,69,5,551,2277,1830,101,0,2748,1726,1729
32345,Nsylvestris_NODE_8824_length_2276_cov_16,Ntome_NODE_36521_length_324_cov_2,97.368,228,6,0,2049,2276,313,86,1.19E-106,388,227,227
32357,Nsylvestris_NODE_8828_length_2275_cov_193,Ntome_NODE_9044_length_2331_cov_289,95.149,2247,105,3,3,2246,38,2283,0,3542,2243,2245
32412,Nsylvestris_NODE_8847_length_2273_cov_24,Ntome_NODE_9273_length_2300_cov_31,95.679,2268,85,5,8,2273,10,2266,0,3633,2265,2256
32429,Nsylvestris_NODE_8854_length_2272_cov_17,Ntome_NODE_33429_length_450_cov_4,93.612,454,18,3,270,721,6,450,0,667,451,444
32446,Nsylvestris_NODE_8860_length_2273_cov_145,Ntome_NODE_11154_length_2054_cov_216,93.414,1822,110,7,167,1979,1843,23,0,2691,1812,1820
32447,Nsylvestris_NODE_8861_length_2270_cov_67,Ntome_NODE_39817_length_251_cov_4,90.98,255,17,3,914,1168,2,250,1.21E-91,339,254,248
32485,Nsylvestris_NODE_8875_length_2267_cov_201,Ntome_NODE_14866_length_1647_cov_277,95.635,1535,53,10,694,2222,97,1623,0,2451,1528,1526
32494,Nsylvestris_NODE_8878_length_2267_cov_80,Ntome_NODE_7977_length_2494_cov_137,95.418,2226,86,10,4,2217,6,2227,0,3531,2213,2221
32549,Nsylvestris_NODE_8893_length_2265_cov_49,Ntome_NODE_8633_length_2394_cov_126,97.071,2219,63,2,1,2218,2293,76,0,3736,2217,2217
32586,Nsylvestris_NODE_8906_length_2263_cov_90,Ntome_NODE_9338_length_2291_cov_49,97.098,2240,64,1,21,2260,1,2239,0,3775,2239,2238
32830,Nsylvestris_NODE_8988_length_2253_cov_11,Ntome_NODE_37215_length_306_cov_3,94.578,166,9,0,94,259,166,1,3.47E-67,257,165,165
32920,Nsylvestris_NODE_9015_length_2249_cov_160,Ntome_NODE_14261_length_1709_cov_223,92.641,1685,84,15,125,1776,32,1709,0,2388,1651,1677
32921,Nsylvestris_NODE_9016_length_2249_cov_145,Ntome_NODE_11023_length_2070_cov_16,94.879,2070,85,7,89,2138,2069,1,0,3216,2049,2068
32971,Nsylvestris_NODE_9038_length_2246_cov_129,Ntome_NODE_9783_length_2228_cov_45,95.418,2008,64,12,127,2111,217,2219,0,3173,1984,2002
32996,Nsylvestris_NODE_9047_length_2245_cov_74,Ntome_NODE_12599_length_1887_cov_20,95.977,1889,72,3,189,2075,1887,1,0,3064,1886,1886
33116,Nsylvestris_NODE_9088_length_2239_cov_216,Ntome_NODE_11611_length_2001_cov_225,95.631,2014,60,11,191,2189,1,2001,0,3206,1998,2000
33133,Nsylvestris_NODE_9097_length_2237_cov_142,Ntome_NODE_10036_length_2195_cov_133,95.618,2191,73,13,50,2223,11,2195,0,3493,2173,2184
33136,Nsylvestris_NODE_9099_length_2237_cov_96,Ntome_NODE_18375_length_1328_cov_22,96.758,987,32,0,375,1361,1284,298,0,1646,986,986
33153,Nsylvestris_NODE_9105_length_2236_cov_94,Ntome_NODE_11866_length_1974_cov_128,95.942,1651,61,2,591,2236,257,1906,0,2673,1645,1649
33277,Nsylvestris_NODE_9145_length_2230_cov_203,Ntome_NODE_8938_length_2347_cov_281,95.86,2198,62,14,11,2182,2289,95,0,3528,2171,2194
33305,Nsylvestris_NODE_9154_length_2229_cov_198,Ntome_NODE_10418_length_2143_cov_231,97.2,2107,44,4,41,2145,2143,50,0,3550,2104,2093
33339,Nsylvestris_NODE_9165_length_2228_cov_179,Ntome_NODE_18611_length_1307_cov_265,93.772,578,23,3,1534,2108,692,1259,0,856,574,567
33423,Nsylvestris_NODE_9192_length_2225_cov_44,Ntome_NODE_10121_length_2183_cov_45,94.627,2066,81,10,150,2212,2047,9,0,3173,2062,2038
33424,Nsylvestris_NODE_9193_length_2224_cov_222,Ntome_NODE_9969_length_2203_cov_293,95.758,2169,74,7,40,2191,36,2203,0,3480,2151,2167
33433,Nsylvestris_NODE_9197_length_2224_cov_125,Ntome_NODE_13095_length_1832_cov_63,94.079,1807,67,15,388,2172,2,1790,0,2708,1784,1788
33443,Nsylvestris_NODE_9201_length_2223_cov_36,Ntome_NODE_14725_length_1663_cov_9,95.364,1661,76,1,130,1789,1,1661,0,2639,1659,1660
33509,Nsylvestris_NODE_9223_length_2220_cov_80,Ntome_NODE_11395_length_2026_cov_80,93.375,1932,84,19,5,1911,1913,1,0,2819,1906,1912
33691,Nsylvestris_NODE_9284_length_2209_cov_95,Ntome_NODE_23215_length_970_cov_256,94.944,890,35,8,39,923,1,885,0,1386,884,884
33742,Nsylvestris_NODE_9302_length_2207_cov_98,Ntome_NODE_11169_length_2053_cov_31,95.04,1976,86,5,33,1997,2022,48,0,3096,1964,1974
33777,Nsylvestris_NODE_9314_length_2206_cov_77,Ntome_NODE_10692_length_2108_cov_15,95.553,2114,73,10,69,2179,2103,8,0,3363,2110,2095
33778,Nsylvestris_NODE_9315_length_2206_cov_39,Ntome_NODE_10786_length_2098_cov_12,93.379,2054,109,9,145,2180,2058,14,0,3014,2035,2044
33827,Nsylvestris_NODE_9330_length_2203_cov_185,Ntome_NODE_8096_length_2475_cov_190,94.224,2095,88,15,47,2127,2297,222,0,3168,2080,2075
33867,Nsylvestris_NODE_9338_length_2202_cov_177,Ntome_NODE_9621_length_2250_cov_264,93.753,2241,96,12,3,2202,2250,13,0,3323,2199,2237
33912,Nsylvestris_NODE_9352_length_2200_cov_198,Ntome_NODE_10052_length_2193_cov_229,95.471,2208,62,13,1,2194,2,2185,0,3489,2193,2183
33996,Nsylvestris_NODE_9380_length_2196_cov_222,Ntome_NODE_37755_length_294_cov_3,88.496,113,10,3,1262,1371,1,113,5.94E-30,134,109,112
34076,Nsylvestris_NODE_9409_length_2192_cov_85,Ntome_NODE_12875_length_1854_cov_27,94.167,1800,76,9,354,2145,1795,17,0,2715,1791,1778
34195,Nsylvestris_NODE_9448_length_2186_cov_43,Ntome_NODE_15435_length_1591_cov_23,95.185,1620,49,12,203,1822,1,1591,0,2532,1619,1590
34624,Nsylvestris_NODE_9584_length_2166_cov_66,Ntome_NODE_11810_length_1980_cov_123,97.445,1918,46,3,249,2165,48,1963,0,3267,1916,1915
34644,Nsylvestris_NODE_9592_length_2165_cov_209,Ntome_NODE_9038_length_2332_cov_217,96.388,2104,68,5,56,2158,2,2098,0,3458,2102,2096
34769,Nsylvestris_NODE_9632_length_2161_cov_8,Ntome_NODE_38923_length_269_cov_3,97.297,148,4,0,1,148,122,269,1.55E-65,252,147,147
34782,Nsylvestris_NODE_9636_length_2160_cov_29,Ntome_NODE_10354_length_2152_cov_19,95.366,2050,70,6,43,2089,94,2121,0,3236,2046,2027
34793,Nsylvestris_NODE_9641_length_2159_cov_203,Ntome_NODE_712_length_5539_cov_171,95.06,2085,67,14,29,2102,3422,5481,0,3247,2073,2059
34899,Nsylvestris_NODE_9677_length_2156_cov_24,Ntome_NODE_34689_length_387_cov_2,97.416,387,10,0,755,1141,1,387,0,660,386,386
34906,Nsylvestris_NODE_9680_length_2155_cov_191,Ntome_NODE_10810_length_2094_cov_279,92.906,2044,89,21,106,2118,23,2041,0,2920,2012,2018
34941,Nsylvestris_NODE_9691_length_2153_cov_124,Ntome_NODE_12682_length_1877_cov_36,94.544,1888,64,9,79,1946,1870,2,0,2880,1867,1868
35070,Nsylvestris_NODE_9736_length_2149_cov_81,Ntome_NODE_8990_length_2340_cov_170,94.556,2149,100,6,7,2149,2325,188,0,3304,2142,2137
35090,Nsylvestris_NODE_9743_length_2147_cov_189,Ntome_NODE_37480_length_300_cov_3,95.802,262,6,5,642,900,40,299,1.43E-115,418,258,259
35112,Nsylvestris_NODE_9751_length_2147_cov_17,Ntome_NODE_10597_length_2121_cov_17,96.59,2082,68,1,13,2094,2101,23,0,3448,2081,2078
35182,Nsylvestris_NODE_9773_length_2144_cov_182,Ntome_NODE_12162_length_1938_cov_249,97.076,1847,41,7,99,1936,1,1843,0,3099,1837,1842
35190,Nsylvestris_NODE_9777_length_2143_cov_231,Ntome_NODE_9330_length_2291_cov_295,95.2,2146,78,15,1,2143,1,2124,0,3369,2142,2123
35196,Nsylvestris_NODE_9780_length_2143_cov_111,Ntome_NODE_7347_length_2595_cov_137,93.372,2052,73,19,2,2033,5,2013,0,2977,2031,2008
35200,Nsylvestris_NODE_9782_length_2142_cov_228,Ntome_NODE_10480_length_2134_cov_226,94.312,2145,84,18,16,2142,2133,9,0,3251,2126,2124
35224,Nsylvestris_NODE_9791_length_2141_cov_209,Ntome_NODE_10771_length_2099_cov_84,95.394,2106,71,13,7,2098,6,2099,0,3328,2091,2093
35283,Nsylvestris_NODE_9808_length_2139_cov_50,Ntome_NODE_6836_length_2687_cov_206,93.988,2129,94,15,1,2123,43,2143,0,3192,2122,2100
35300,Nsylvestris_NODE_9815_length_2138_cov_173,Ntome_NODE_9555_length_2260_cov_126,95.015,1986,77,16,120,2092,45,2021,0,3099,1972,1976
35354,Nsylvestris_NODE_9832_length_2135_cov_217,Ntome_NODE_11017_length_2070_cov_275,94.45,2018,87,9,119,2135,9,2002,0,3083,2016,1993
35395,Nsylvestris_NODE_9847_length_2134_cov_196,Ntome_NODE_17988_length_1358_cov_246,92.264,1047,59,13,1045,2074,11,1052,0,1465,1029,1041
35516,Nsylvestris_NODE_9887_length_2129_cov_189,Ntome_NODE_11244_length_2044_cov_210,95.339,1974,74,10,48,2011,1,1966,0,3120,1963,1965
35541,Nsylvestris_NODE_9897_length_2128_cov_159,Ntome_NODE_9912_length_2211_cov_266,94.062,2105,98,11,18,2119,97,2177,0,3169,2101,2080
35568,Nsylvestris_NODE_9906_length_2127_cov_24,Ntome_NODE_9769_length_2229_cov_147,95.841,2140,62,10,4,2124,2173,42,0,3434,2120,2131
35619,Nsylvestris_NODE_9926_length_2125_cov_139,Ntome_NODE_10816_length_2094_cov_170,94.089,2064,63,22,52,2093,40,2066,0,3081,2041,2026
35624,Nsylvestris_NODE_9928_length_2125_cov_41,Ntome_NODE_13077_length_1834_cov_8,97.219,1834,48,1,232,2062,1834,1,0,3101,1830,1833
35831,Nsylvestris_NODE_9992_length_2117_cov_78,Ntome_NODE_9809_length_2224_cov_70,97.505,2084,52,0,1,2084,14,2097,0,3561,2083,2083
35919,Nsylvestris_NODE_10021_length_2113_cov_116,Ntome_NODE_11503_length_2014_cov_90,97.165,1975,56,0,139,2113,10,1984,0,3338,1974,1974
36022,Nsylvestris_NODE_10055_length_2110_cov_115,Ntome_NODE_10957_length_2079_cov_155,95.033,1953,64,17,1,1946,2063,137,0,3038,1945,1926
36111,Nsylvestris_NODE_10089_length_2104_cov_175,Ntome_NODE_9451_length_2274_cov_281,95.684,2039,83,5,70,2104,12,2049,0,3273,2034,2037
36116,Nsylvestris_NODE_10091_length_2104_cov_71,Ntome_NODE_14097_length_1731_cov_5,95.168,1573,75,1,532,2103,1724,152,0,2483,1571,1572
36238,Nsylvestris_NODE_10135_length_2098_cov_204,Ntome_NODE_9851_length_2218_cov_244,94.857,2061,89,14,1,2053,2169,118,0,3203,2052,2051
36315,Nsylvestris_NODE_10159_length_2094_cov_14,Ntome_NODE_11175_length_2052_cov_167,92.065,1903,123,19,1,1898,1925,46,0,2652,1897,1879
36426,Nsylvestris_NODE_10198_length_2088_cov_224,Ntome_NODE_10130_length_2181_cov_268,97.793,2084,42,3,9,2088,2,2085,0,3591,2079,2083
36436,Nsylvestris_NODE_10201_length_2088_cov_18,Ntome_NODE_14475_length_1688_cov_25,97.532,1661,41,0,409,2069,1661,1,0,2841,1660,1660
36542,Nsylvestris_NODE_10233_length_2084_cov_105,Ntome_NODE_10792_length_2097_cov_112,97.382,1719,42,3,367,2083,1772,55,0,2922,1716,1717
36554,Nsylvestris_NODE_10237_length_2083_cov_212,Ntome_NODE_9525_length_2266_cov_286,94.61,1985,84,3,118,2083,60,2040,0,3051,1965,1980
36706,Nsylvestris_NODE_10288_length_2077_cov_159,Ntome_NODE_7062_length_2645_cov_35,94.975,2010,84,7,43,2045,2343,344,0,3136,2002,1999
36771,Nsylvestris_NODE_10310_length_2074_cov_143,Ntome_NODE_10512_length_2130_cov_287,92.379,1837,86,35,109,1895,1915,83,0,2567,1786,1832
36872,Nsylvestris_NODE_10343_length_2070_cov_45,Ntome_NODE_12703_length_1873_cov_61,96.107,1824,60,5,36,1853,5,1823,0,2964,1817,1818
36924,Nsylvestris_NODE_10360_length_2068_cov_73,Ntome_NODE_14168_length_1720_cov_11,95.531,1544,69,0,319,1862,1640,97,0,2470,1543,1543
37030,Nsylvestris_NODE_10395_length_2063_cov_14,Ntome_NODE_12238_length_1929_cov_27,90.328,1923,104,30,159,2062,1879,20,0,2446,1903,1859
37095,Nsylvestris_NODE_10417_length_2060_cov_137,Ntome_NODE_11605_length_2002_cov_273,95.995,1648,62,1,355,1998,168,1815,0,2675,1643,1647
37096,Nsylvestris_NODE_10418_length_2060_cov_114,Ntome_NODE_12995_length_1843_cov_104,94.89,1683,50,7,323,1987,177,1841,0,2599,1664,1664
37127,Nsylvestris_NODE_10426_length_2059_cov_166,Ntome_NODE_10635_length_2114_cov_173,97.701,2044,43,2,1,2040,27,2070,0,3511,2039,2043
37128,Nsylvestris_NODE_10428_length_2058_cov_162,Ntome_NODE_10868_length_2088_cov_216,94.075,2076,79,10,13,2058,2088,27,0,3112,2045,2061
37216,Nsylvestris_NODE_10456_length_2056_cov_18,Ntome_NODE_15327_length_1602_cov_15,97.502,1601,40,0,335,1935,1601,1,0,2736,1600,1600
37226,Nsylvestris_NODE_10459_length_2055_cov_159,Ntome_NODE_12173_length_1937_cov_167,91.501,1906,114,24,56,1935,1937,54,0,2579,1879,1883
37230,Nsylvestris_NODE_10461_length_2055_cov_82,Ntome_NODE_9878_length_2215_cov_258,94.105,1934,68,12,2,1895,95,2022,0,2898,1893,1927
37300,Nsylvestris_NODE_10483_length_2052_cov_214,Ntome_NODE_11390_length_2026_cov_277,92.949,2014,70,34,82,2052,17,2001,0,2867,1970,1984
37376,Nsylvestris_NODE_10506_length_2050_cov_28,Ntome_NODE_34796_length_383_cov_2,94.643,392,12,1,546,937,383,1,4.55E-170,599,391,382
37382,Nsylvestris_NODE_10509_length_2049_cov_198,Ntome_NODE_11039_length_2067_cov_264,95.311,2026,78,9,27,2047,2066,53,0,3199,2020,2013
37441,Nsylvestris_NODE_10528_length_2047_cov_34,Ntome_NODE_10285_length_2158_cov_99,91.385,2043,149,16,12,2045,101,2125,0,2772,2033,2024
37468,Nsylvestris_NODE_10537_length_2046_cov_129,Ntome_NODE_10422_length_2143_cov_67,94.553,2038,57,23,18,2020,11,2029,0,3099,2002,2018
37544,Nsylvestris_NODE_10564_length_2042_cov_28,Ntome_NODE_14577_length_1678_cov_32,93.379,1601,79,18,390,1977,46,1632,0,2344,1587,1586
37586,Nsylvestris_NODE_10580_length_2040_cov_131,Ntome_NODE_17005_length_1448_cov_103,97.056,951,27,1,580,1530,388,1337,0,1600,950,949
37613,Nsylvestris_NODE_10589_length_2039_cov_52,Ntome_NODE_38542_length_277_cov_4,97.473,277,7,0,366,642,1,277,2.86E-132,473,276,276
37617,Nsylvestris_NODE_10591_length_2039_cov_47,Ntome_NODE_9842_length_2220_cov_23,94.023,1673,96,4,85,1755,2220,550,0,2532,1670,1670
37676,Nsylvestris_NODE_10611_length_2036_cov_26,Ntome_NODE_36570_length_322_cov_4,95.886,316,13,0,541,856,322,7,6.05E-144,512,315,315
37689,Nsylvestris_NODE_10616_length_2035_cov_161,Ntome_NODE_12140_length_1941_cov_142,96.007,1753,53,4,62,1798,114,1865,0,2833,1736,1751
37768,Nsylvestris_NODE_10647_length_2032_cov_22,Ntome_NODE_12056_length_1951_cov_9,94.427,1866,99,3,61,1925,46,1907,0,2865,1864,1861
37781,Nsylvestris_NODE_10650_length_2031_cov_196,Ntome_NODE_11378_length_2028_cov_70,96.66,1976,60,5,15,1986,50,2023,0,3278,1971,1973
37856,Nsylvestris_NODE_10677_length_2029_cov_42,Ntome_NODE_11312_length_2036_cov_55,94.279,2010,57,16,1,1984,1990,13,0,3022,1983,1977
37927,Nsylvestris_NODE_10700_length_2025_cov_216,Ntome_NODE_12199_length_1931_cov_283,95.922,1888,61,6,120,2005,51,1924,0,3046,1885,1873
37931,Nsylvestris_NODE_10703_length_2025_cov_132,Ntome_NODE_11882_length_1972_cov_219,95.303,1831,85,1,20,1850,141,1970,0,2904,1830,1829
37932,Nsylvestris_NODE_10704_length_2025_cov_127,Ntome_NODE_22867_length_992_cov_42,97.241,870,24,0,1120,1989,874,5,0,1474,869,869
37945,Nsylvestris_NODE_10710_length_2024_cov_126,Ntome_NODE_11459_length_2018_cov_217,93.064,2033,73,26,1,1981,2,2018,0,2911,1980,2016
37977,Nsylvestris_NODE_10724_length_2023_cov_46,Ntome_NODE_11287_length_2039_cov_148,93.057,1930,101,14,6,1912,1993,74,0,2791,1906,1919
38021,Nsylvestris_NODE_10740_length_2021_cov_87,Ntome_NODE_14642_length_1673_cov_93,92.502,1467,85,14,519,1972,125,1579,0,2076,1453,1454
38054,Nsylvestris_NODE_10753_length_2019_cov_62,Ntome_NODE_10928_length_2082_cov_117,95.028,1951,74,13,70,2012,2032,97,0,3044,1942,1935
38083,Nsylvestris_NODE_10761_length_2018_cov_99,Ntome_NODE_23304_length_965_cov_71,92.808,584,18,3,432,1015,965,406,0,824,583,559
38146,Nsylvestris_NODE_10780_length_2016_cov_104,Ntome_NODE_12729_length_1869_cov_236,93.778,1816,92,12,1,1808,1846,44,0,2708,1807,1802
38152,Nsylvestris_NODE_10783_length_2016_cov_31,Ntome_NODE_12424_length_1906_cov_60,92.9,1676,86,9,367,2016,1856,188,0,2405,1649,1668
38203,Nsylvestris_NODE_10802_length_2013_cov_184,Ntome_NODE_12484_length_1899_cov_92,98.162,1850,34,0,76,1925,1897,48,0,3229,1849,1849
38328,Nsylvestris_NODE_10840_length_2009_cov_19,Ntome_NODE_11800_length_1981_cov_48,94.319,1813,75,7,199,2009,182,1968,0,2752,1810,1786
38358,Nsylvestris_NODE_10853_length_2007_cov_19,Ntome_NODE_22208_length_1034_cov_9,93.907,1034,63,0,763,1796,1,1034,0,1561,1033,1033
38440,Nsylvestris_NODE_10879_length_2003_cov_111,Ntome_NODE_12758_length_1867_cov_31,96.356,1866,68,0,1,1866,1867,2,0,3070,1865,1865
38447,Nsylvestris_NODE_10882_length_2002_cov_215,Ntome_NODE_2868_length_3750_cov_151,95.113,1719,72,10,130,1846,1758,50,0,2699,1716,1708
38484,Nsylvestris_NODE_10894_length_2001_cov_175,Ntome_NODE_12029_length_1954_cov_122,95.476,1901,43,13,56,1920,1945,52,0,2994,1864,1893
38596,Nsylvestris_NODE_10931_length_1996_cov_184,Ntome_NODE_10019_length_2197_cov_195,95.278,1906,78,7,49,1947,2003,103,0,3011,1898,1900
38663,Nsylvestris_NODE_10957_length_1993_cov_190,Ntome_NODE_13124_length_1828_cov_238,97.475,1822,36,2,8,1829,1,1812,0,3101,1821,1811
38668,Nsylvestris_NODE_10959_length_1993_cov_86,Ntome_NODE_12725_length_1870_cov_20,97.385,1874,43,4,20,1891,1870,1,0,3184,1871,1869
38751,Nsylvestris_NODE_10990_length_1989_cov_135,Ntome_NODE_11954_length_1963_cov_67,94.266,1866,67,19,47,1902,114,1949,0,2817,1855,1835
38824,Nsylvestris_NODE_11019_length_1985_cov_42,Ntome_NODE_29487_length_649_cov_4,93.178,557,30,4,1406,1959,97,648,0,811,553,551
38903,Nsylvestris_NODE_11044_length_1982_cov_185,Ntome_NODE_11013_length_2071_cov_161,95.944,1849,52,6,93,1938,54,1882,0,2977,1845,1828
39008,Nsylvestris_NODE_11078_length_1979_cov_121,Ntome_NODE_16006_length_1538_cov_250,95.646,1401,52,6,580,1979,1394,2,0,2241,1399,1392
39025,Nsylvestris_NODE_11086_length_1978_cov_77,Ntome_NODE_13034_length_1838_cov_15,97.594,1704,32,3,113,1813,140,1837,0,2911,1700,1697
39043,Nsylvestris_NODE_11093_length_1977_cov_102,Ntome_NODE_12765_length_1866_cov_87,94.499,1836,75,15,47,1878,53,1866,0,2808,1831,1813
39054,Nsylvestris_NODE_11096_length_1977_cov_11,Ntome_NODE_30346_length_615_cov_5,96.585,615,21,0,935,1549,615,1,0,1020,614,614
39172,Nsylvestris_NODE_11136_length_1971_cov_83,Ntome_NODE_11191_length_2050_cov_246,94.786,1918,96,1,49,1966,136,2049,0,2985,1917,1913
39522,Nsylvestris_NODE_11257_length_1956_cov_197,Ntome_NODE_12028_length_1954_cov_178,94.498,1854,83,6,119,1956,1,1851,0,2841,1837,1850
39542,Nsylvestris_NODE_11265_length_1955_cov_184,Ntome_NODE_11404_length_2025_cov_228,93.776,1912,85,15,10,1894,2011,107,0,2841,1884,1904
39549,Nsylvestris_NODE_11270_length_1955_cov_54,Ntome_NODE_14213_length_1714_cov_143,94.128,1686,76,6,89,1751,28,1713,0,2543,1662,1685
39560,Nsylvestris_NODE_11275_length_1954_cov_161,Ntome_NODE_14999_length_1635_cov_278,96.194,1550,48,6,328,1869,1635,89,0,2525,1541,1546
39713,Nsylvestris_NODE_11327_length_1948_cov_224,Ntome_NODE_18199_length_1342_cov_283,95.224,1005,48,0,469,1473,1210,206,0,1591,1004,1004
39725,Nsylvestris_NODE_11333_length_1948_cov_114,Ntome_NODE_17114_length_1438_cov_87,87.532,1171,88,23,49,1193,1191,53,0,1301,1144,1138
39930,Nsylvestris_NODE_11396_length_1942_cov_148,Ntome_NODE_11815_length_1979_cov_247,95.838,1946,75,6,1,1942,6,1949,0,3140,1941,1943
39945,Nsylvestris_NODE_11401_length_1942_cov_11,Ntome_NODE_5736_length_2909_cov_151,95.984,1942,78,0,1,1942,860,2801,0,3155,1941,1941
39951,Nsylvestris_NODE_11404_length_1941_cov_196,Ntome_NODE_11192_length_2050_cov_230,92.845,1747,95,19,124,1846,197,1937,0,2507,1722,1740
40049,Nsylvestris_NODE_11440_length_1937_cov_68,Ntome_NODE_12423_length_1906_cov_77,88.822,1825,137,32,124,1896,1833,24,0,2178,1772,1809
40067,Nsylvestris_NODE_11446_length_1936_cov_163,Ntome_NODE_10152_length_2177_cov_200,95.338,1952,70,7,3,1936,2177,229,0,3081,1933,1948
40068,Nsylvestris_NODE_11447_length_1936_cov_163,Ntome_NODE_11543_length_2009_cov_113,96.083,1838,48,7,101,1932,1939,120,0,2974,1831,1819
40070,Nsylvestris_NODE_11449_length_1936_cov_127,Ntome_NODE_13258_length_1813_cov_98,95.238,1827,55,17,127,1935,1,1813,0,2863,1808,1812
40071,Nsylvestris_NODE_11450_length_1936_cov_113,Ntome_NODE_12911_length_1851_cov_38,94.351,1841,97,4,40,1879,1835,1,0,2817,1839,1834
40072,Nsylvestris_NODE_11451_length_1936_cov_99,Ntome_NODE_36098_length_336_cov_3,86.798,356,20,7,1247,1602,331,3,1.02E-101,372,355,328
40073,Nsylvestris_NODE_11452_length_1936_cov_84,Ntome_NODE_12588_length_1889_cov_18,97.739,1548,31,3,346,1890,1889,343,0,2662,1544,1546
40103,Nsylvestris_NODE_11462_length_1935_cov_16,Ntome_NODE_6768_length_2700_cov_53,97.09,1821,51,2,1,1821,221,2039,0,3068,1820,1818
40127,Nsylvestris_NODE_11470_length_1933_cov_208,Ntome_NODE_10831_length_2092_cov_213,92.352,1922,84,26,7,1881,76,1981,0,2676,1874,1905
40263,Nsylvestris_NODE_11512_length_1929_cov_111,Ntome_NODE_11913_length_1968_cov_235,94.984,1854,90,3,79,1929,72,1925,0,2905,1850,1853
40375,Nsylvestris_NODE_11551_length_1924_cov_207,Ntome_NODE_14709_length_1665_cov_21,96.029,1662,57,1,104,1765,1665,13,0,2695,1661,1652
40401,Nsylvestris_NODE_11559_length_1923_cov_179,Ntome_NODE_16058_length_1534_cov_269,94.049,1546,63,16,233,1761,1,1534,0,2318,1528,1533
40402,Nsylvestris_NODE_11560_length_1923_cov_170,Ntome_NODE_15279_length_1607_cov_53,94.804,1559,72,6,222,1776,1,1554,0,2422,1554,1553
40418,Nsylvestris_NODE_11566_length_1922_cov_202,Ntome_NODE_12743_length_1868_cov_171,94.872,1677,85,1,50,1725,89,1765,0,2619,1675,1676
40546,Nsylvestris_NODE_11613_length_1917_cov_216,Ntome_NODE_11236_length_2045_cov_236,93.288,1907,92,11,2,1903,99,1974,0,2780,1901,1875
40622,Nsylvestris_NODE_11637_length_1914_cov_193,Ntome_NODE_7611_length_2552_cov_257,96.87,1885,42,11,1,1877,2541,666,0,3138,1876,1875
40628,Nsylvestris_NODE_11640_length_1914_cov_143,Ntome_NODE_12378_length_1911_cov_217,94.188,1910,79,17,21,1914,3,1896,0,2883,1893,1893
40874,Nsylvestris_NODE_11722_length_1902_cov_176,Ntome_NODE_12061_length_1950_cov_56,96.483,1905,64,1,1,1902,2,1906,0,3144,1901,1904
41003,Nsylvestris_NODE_11766_length_1897_cov_213,Ntome_NODE_11843_length_1976_cov_138,92.04,1784,83,27,7,1748,1875,109,0,2453,1741,1766
41052,Nsylvestris_NODE_11782_length_1895_cov_172,Ntome_NODE_17793_length_1375_cov_159,94.809,1098,54,1,423,1520,9,1103,0,1709,1097,1094
41065,Nsylvestris_NODE_11787_length_1895_cov_50,Ntome_NODE_13503_length_1786_cov_31,94.223,1679,80,5,175,1850,114,1778,0,2547,1675,1664
41072,Nsylvestris_NODE_11790_length_1894_cov_170,Ntome_NODE_13779_length_1759_cov_281,95.202,1459,47,4,180,1634,1489,50,0,2285,1454,1439
41165,Nsylvestris_NODE_11823_length_1890_cov_30,Ntome_NODE_10403_length_2145_cov_61,95.031,1791,82,2,100,1890,324,2107,0,2808,1790,1783
41261,Nsylvestris_NODE_11858_length_1885_cov_53,Ntome_NODE_14778_length_1658_cov_25,95.221,1653,79,0,163,1815,1,1653,0,2615,1652,1652
41273,Nsylvestris_NODE_11865_length_1884_cov_184,Ntome_NODE_12868_length_1854_cov_191,96.438,1853,56,6,36,1880,3,1853,0,3048,1844,1850
41293,Nsylvestris_NODE_11875_length_1883_cov_7,Ntome_NODE_12167_length_1938_cov_14,95.749,1882,77,1,1,1879,1887,6,0,3029,1878,1881
41336,Nsylvestris_NODE_11887_length_1881_cov_123,Ntome_NODE_16762_length_1469_cov_238,96.361,1319,31,3,47,1364,1,1303,0,2154,1317,1302
41385,Nsylvestris_NODE_11906_length_1879_cov_222,Ntome_NODE_11489_length_2015_cov_286,95.158,1838,75,6,1,1831,1945,115,0,2889,1830,1830
41437,Nsylvestris_NODE_11926_length_1877_cov_225,Ntome_NODE_12145_length_1940_cov_273,94.913,1848,81,7,5,1844,95,1937,0,2880,1839,1842
41465,Nsylvestris_NODE_11936_length_1876_cov_219,Ntome_NODE_13700_length_1768_cov_31,92.988,1797,81,15,66,1852,3,1764,0,2579,1786,1761
41500,Nsylvestris_NODE_11947_length_1875_cov_192,Ntome_NODE_11872_length_1973_cov_267,93.139,1574,85,16,23,1583,1728,165,0,2287,1560,1563
41543,Nsylvestris_NODE_11964_length_1874_cov_179,Ntome_NODE_14703_length_1665_cov_249,97.038,1553,41,3,1,1552,1589,41,0,2608,1551,1548
41581,Nsylvestris_NODE_11975_length_1873_cov_168,Ntome_NODE_18149_length_1347_cov_27,96.22,1270,44,1,61,1326,1344,75,0,2076,1265,1269
41615,Nsylvestris_NODE_11989_length_1871_cov_46,Ntome_NODE_12515_length_1896_cov_66,94.74,1844,84,5,33,1871,16,1851,0,2856,1838,1835
41639,Nsylvestris_NODE_11999_length_1870_cov_137,Ntome_NODE_12681_length_1877_cov_40,95.213,1713,78,2,113,1821,1,1713,0,2706,1708,1712
41662,Nsylvestris_NODE_12008_length_1869_cov_17,Ntome_NODE_18760_length_1295_cov_56,84.054,1041,158,6,255,1288,53,1092,0,996,1033,1039
41905,Nsylvestris_NODE_12095_length_1858_cov_217,Ntome_NODE_8940_length_2347_cov_195,92.677,1707,74,16,65,1747,1694,15,0,2412,1682,1679
41993,Nsylvestris_NODE_12121_length_1855_cov_213,Ntome_NODE_10409_length_2144_cov_229,93.923,1810,67,7,7,1806,61,1837,0,2693,1799,1776
42001,Nsylvestris_NODE_12124_length_1855_cov_42,Ntome_NODE_12788_length_1864_cov_66,93.787,1851,83,11,28,1852,1,1845,0,2752,1824,1844
42120,Nsylvestris_NODE_12169_length_1851_cov_94,Ntome_NODE_13641_length_1773_cov_90,92.915,1736,74,12,70,1798,80,1773,0,2479,1728,1693
42157,Nsylvestris_NODE_12182_length_1849_cov_212,Ntome_NODE_12549_length_1892_cov_289,93.607,1752,63,16,64,1779,1789,51,0,2569,1715,1738
42167,Nsylvestris_NODE_12185_length_1849_cov_148,Ntome_NODE_13672_length_1770_cov_103,92.133,1627,99,14,180,1795,43,1651,0,2268,1615,1608
42173,Nsylvestris_NODE_12189_length_1849_cov_44,Ntome_NODE_16093_length_1532_cov_5,95.294,1530,67,5,217,1744,1532,6,0,2422,1527,1526
42220,Nsylvestris_NODE_12205_length_1848_cov_27,Ntome_NODE_14449_length_1691_cov_13,93.804,1630,73,12,82,1688,1685,61,0,2425,1606,1624
42268,Nsylvestris_NODE_12226_length_1845_cov_155,Ntome_NODE_15353_length_1598_cov_242,92.996,1599,69,26,68,1653,19,1587,0,2292,1585,1568
42274,Nsylvestris_NODE_12228_length_1845_cov_98,Ntome_NODE_14846_length_1651_cov_78,88.455,1126,113,5,50,1174,1318,209,0,1343,1124,1109
42281,Nsylvestris_NODE_12231_length_1844_cov_182,Ntome_NODE_15695_length_1568_cov_233,95.245,1472,47,7,364,1814,1568,99,0,2309,1450,1469
42285,Nsylvestris_NODE_12233_length_1844_cov_143,Ntome_NODE_9359_length_2288_cov_107,92.071,1526,105,8,193,1706,728,2249,0,2134,1513,1521
42308,Nsylvestris_NODE_12242_length_1843_cov_36,Ntome_NODE_12566_length_1883_cov_152,93.136,1792,100,8,58,1843,1809,35,0,2606,1785,1774
42341,Nsylvestris_NODE_12256_length_1842_cov_42,Ntome_NODE_10704_length_2106_cov_234,95.185,1537,58,7,20,1546,100,1630,0,2414,1526,1530
42348,Nsylvestris_NODE_12261_length_1841_cov_194,Ntome_NODE_11699_length_1991_cov_239,95.133,1808,62,13,1,1794,1953,158,0,2828,1793,1795
42352,Nsylvestris_NODE_12263_length_1841_cov_152,Ntome_NODE_13229_length_1816_cov_263,95.507,1736,70,5,54,1781,1754,19,0,2767,1727,1735
42413,Nsylvestris_NODE_12285_length_1839_cov_136,Ntome_NODE_13743_length_1763_cov_124,93.938,1765,72,16,92,1839,9,1755,0,2634,1747,1746
42417,Nsylvestris_NODE_12287_length_1838_cov_219,Ntome_NODE_11131_length_2056_cov_243,94.364,1792,85,9,1,1790,82,1859,0,2736,1789,1777
42531,Nsylvestris_NODE_12330_length_1834_cov_88,Ntome_NODE_19436_length_1239_cov_145,92.444,675,29,7,1120,1789,762,105,0,944,669,657
42560,Nsylvestris_NODE_12340_length_1833_cov_214,Ntome_NODE_12322_length_1918_cov_261,97.787,1672,33,2,161,1832,4,1671,0,2880,1671,1667
42632,Nsylvestris_NODE_12363_length_1831_cov_98,Ntome_NODE_14891_length_1645_cov_27,95.75,1553,66,0,207,1759,1645,93,0,2503,1552,1552
42809,Nsylvestris_NODE_12426_length_1823_cov_138,Ntome_NODE_17717_length_1382_cov_156,93.21,1296,64,4,195,1485,57,1333,0,1884,1290,1276
42810,Nsylvestris_NODE_12427_length_1824_cov_109,Ntome_NODE_23378_length_961_cov_102,94.366,781,30,3,773,1550,961,192,0,1186,777,769
42827,Nsylvestris_NODE_12434_length_1823_cov_209,Ntome_NODE_12597_length_1887_cov_47,90.417,1774,89,37,42,1773,111,1845,0,2259,1731,1734
42899,Nsylvestris_NODE_12459_length_1821_cov_28,Ntome_NODE_4268_length_3272_cov_34,95.677,1573,68,0,94,1666,463,2035,0,2529,1572,1572
42907,Nsylvestris_NODE_12463_length_1820_cov_125,Ntome_NODE_14458_length_1690_cov_41,96.816,1476,38,1,193,1668,1544,78,0,2457,1475,1466
42990,Nsylvestris_NODE_12495_length_1816_cov_30,Ntome_NODE_12570_length_1891_cov_55,92.799,1847,82,16,1,1812,1864,34,0,2627,1811,1830
43040,Nsylvestris_NODE_12514_length_1813_cov_183,Ntome_NODE_14445_length_1691_cov_213,94.338,1678,47,14,90,1730,1686,20,0,2529,1640,1666
43134,Nsylvestris_NODE_12539_length_1811_cov_25,Ntome_NODE_14285_length_1707_cov_15,94.852,1593,56,4,64,1646,1678,102,0,2464,1582,1576
43167,Nsylvestris_NODE_12552_length_1809_cov_111,Ntome_NODE_15537_length_1580_cov_282,94.748,1447,45,10,362,1799,1526,102,0,2222,1437,1424
43177,Nsylvestris_NODE_12556_length_1809_cov_10,Ntome_NODE_13556_length_1781_cov_31,92.486,173,11,2,1638,1809,1405,1234,6.02E-64,246,171,171
43183,Nsylvestris_NODE_12558_length_1808_cov_220,Ntome_NODE_1282_length_4750_cov_151,96.014,1430,54,2,168,1597,4675,3249,0,2322,1429,1426
43190,Nsylvestris_NODE_12561_length_1808_cov_210,Ntome_NODE_13480_length_1788_cov_224,95.655,1749,63,7,71,1808,1782,36,0,2796,1737,1746
43217,Nsylvestris_NODE_12572_length_1808_cov_57,Ntome_NODE_31224_length_581_cov_5,96.902,581,18,0,1002,1582,581,1,0,974,580,580
43262,Nsylvestris_NODE_12588_length_1806_cov_204,Ntome_NODE_13396_length_1797_cov_266,95.057,1740,67,12,11,1738,58,1790,0,2719,1727,1732
43275,Nsylvestris_NODE_12593_length_1806_cov_10,Ntome_NODE_13216_length_1818_cov_11,94.553,1487,73,4,56,1536,39,1523,0,2290,1480,1484
43307,Nsylvestris_NODE_12607_length_1804_cov_148,Ntome_NODE_14605_length_1676_cov_50,95.183,1557,64,6,42,1594,11,1560,0,2449,1552,1549
43393,Nsylvestris_NODE_12633_length_1802_cov_129,Ntome_NODE_20705_length_1138_cov_8,93.942,1139,55,4,406,1531,1138,1,0,1709,1125,1137
43403,Nsylvestris_NODE_12637_length_1802_cov_65,Ntome_NODE_13251_length_1814_cov_53,91.881,1675,111,10,2,1675,7,1657,0,2316,1673,1650
43465,Nsylvestris_NODE_12657_length_1800_cov_43,Ntome_NODE_13493_length_1787_cov_157,95.221,1632,64,1,1,1632,28,1645,0,2569,1631,1617
43496,Nsylvestris_NODE_12670_length_1798_cov_231,Ntome_NODE_12894_length_1852_cov_124,95.623,1759,58,4,20,1768,29,1778,0,2804,1748,1749
43501,Nsylvestris_NODE_12672_length_1798_cov_224,Ntome_NODE_13919_length_1744_cov_281,95.033,1671,74,5,9,1671,9,1678,0,2617,1662,1669
43514,Nsylvestris_NODE_12677_length_1798_cov_102,Ntome_NODE_32930_length_483_cov_5,91.429,490,34,3,1195,1683,1,483,0,665,488,482
43539,Nsylvestris_NODE_12687_length_1797_cov_148,Ntome_NODE_14897_length_1644_cov_245,94.464,1391,65,6,382,1769,263,1644,0,2132,1387,1381
43547,Nsylvestris_NODE_12691_length_1796_cov_225,Ntome_NODE_12816_length_1859_cov_279,94.167,1783,82,2,3,1782,70,1833,0,2697,1779,1763
43557,Nsylvestris_NODE_12694_length_1796_cov_79,Ntome_NODE_12689_length_1875_cov_28,94.752,1772,78,7,19,1783,42,1805,0,2743,1764,1763
43741,Nsylvestris_NODE_12757_length_1791_cov_70,Ntome_NODE_13135_length_1827_cov_175,95.845,1733,60,8,61,1791,56,1778,0,2791,1730,1722
43767,Nsylvestris_NODE_12768_length_1790_cov_39,Ntome_NODE_13146_length_1826_cov_21,94.074,1603,70,2,75,1674,246,1826,0,2410,1599,1580
43768,Nsylvestris_NODE_12769_length_1790_cov_13,Ntome_NODE_36951_length_312_cov_3,96.795,312,10,0,1405,1716,312,1,8.83E-147,521,311,311
43780,Nsylvestris_NODE_12775_length_1789_cov_147,Ntome_NODE_11138_length_2056_cov_81,95.558,1756,53,15,40,1789,73,1809,0,2787,1749,1736
43786,Nsylvestris_NODE_12777_length_1789_cov_104,Ntome_NODE_11738_length_1988_cov_107,96.456,1693,53,5,36,1721,1971,279,0,2787,1685,1692
43802,Nsylvestris_NODE_12784_length_1788_cov_148,Ntome_NODE_15080_length_1627_cov_24,94.954,1625,67,2,166,1775,1,1625,0,2532,1609,1624
43838,Nsylvestris_NODE_12798_length_1784_cov_216,Ntome_NODE_15564_length_1578_cov_287,97.971,1331,25,2,185,1513,248,1578,0,2307,1328,1330
43839,Nsylvestris_NODE_12799_length_1786_cov_215,Ntome_NODE_15255_length_1609_cov_41,94.097,1440,59,11,69,1497,4,1428,0,2165,1428,1424
43918,Nsylvestris_NODE_12821_length_1784_cov_128,Ntome_NODE_14152_length_1721_cov_176,93.382,1511,67,13,41,1525,1715,212,0,2206,1484,1503
43952,Nsylvestris_NODE_12835_length_1782_cov_206,Ntome_NODE_15350_length_1599_cov_246,94.942,1542,63,8,195,1726,1538,2,0,2401,1531,1536
43953,Nsylvestris_NODE_12836_length_1782_cov_150,Ntome_NODE_11734_length_1988_cov_178,95.444,1690,52,9,1,1668,1768,82,0,2671,1667,1686
43964,Nsylvestris_NODE_12840_length_1782_cov_57,Ntome_NODE_13074_length_1834_cov_46,89.806,1648,116,27,175,1779,1640,2,0,2065,1604,1638
44084,Nsylvestris_NODE_12891_length_1776_cov_45,Ntome_NODE_11182_length_2051_cov_132,94.477,1684,74,5,78,1747,276,1954,0,2577,1669,1678
44145,Nsylvestris_NODE_12915_length_1772_cov_230,Ntome_NODE_35805_length_345_cov_3,95.115,348,14,1,838,1185,345,1,5.19E-154,545,347,344
44149,Nsylvestris_NODE_12918_length_1772_cov_195,Ntome_NODE_15195_length_1614_cov_244,90.584,1593,95,28,82,1652,55,1614,0,2060,1570,1559
44165,Nsylvestris_NODE_12925_length_1771_cov_219,Ntome_NODE_12495_length_1897_cov_226,94.975,1771,54,9,8,1771,1838,96,0,2745,1763,1742
44192,Nsylvestris_NODE_12935_length_1771_cov_17,Ntome_NODE_13489_length_1788_cov_23,95.303,1767,73,7,6,1769,1760,1,0,2795,1763,1759
44242,Nsylvestris_NODE_12952_length_1768_cov_153,Ntome_NODE_11700_length_1991_cov_220,94.363,1437,62,9,50,1467,1991,555,0,2187,1417,1436
44401,Nsylvestris_NODE_13006_length_1763_cov_87,Ntome_NODE_21872_length_1056_cov_204,95.049,1030,36,9,730,1749,25,1049,0,1605,1019,1024
44468,Nsylvestris_NODE_13031_length_1760_cov_84,Ntome_NODE_13321_length_1806_cov_109,94.959,1726,80,4,6,1724,1785,60,0,2699,1718,1725
44568,Nsylvestris_NODE_13071_length_1755_cov_71,Ntome_NODE_14008_length_1737_cov_36,94.256,1654,86,5,51,1703,21,1666,0,2519,1652,1645
44583,Nsylvestris_NODE_13077_length_1753_cov_157,Ntome_NODE_15210_length_1613_cov_115,95.97,1588,60,3,43,1626,1,1588,0,2575,1583,1587
44584,Nsylvestris_NODE_13078_length_1753_cov_147,Ntome_NODE_14561_length_1679_cov_132,96.075,1325,45,6,390,1713,340,1658,0,2152,1323,1318
44627,Nsylvestris_NODE_13092_length_1752_cov_58,Ntome_NODE_34769_length_384_cov_3,97.479,357,6,1,1213,1569,31,384,2.32E-172,606,356,353
44670,Nsylvestris_NODE_13110_length_1750_cov_32,Ntome_NODE_19691_length_1219_cov_21,90.127,1185,99,11,386,1567,1170,1,0,1524,1181,1169
44686,Nsylvestris_NODE_13116_length_1749_cov_125,Ntome_NODE_15236_length_1610_cov_203,96.765,1484,48,0,237,1720,1608,125,0,2475,1483,1483
44815,Nsylvestris_NODE_13168_length_1742_cov_81,Ntome_NODE_13697_length_1768_cov_61,94.043,1729,67,16,42,1742,1767,47,0,2590,1700,1720
44839,Nsylvestris_NODE_13177_length_1741_cov_104,Ntome_NODE_10718_length_2105_cov_214,94.158,1763,69,14,1,1741,10,1760,0,2654,1740,1750
44848,Nsylvestris_NODE_13182_length_1740_cov_211,Ntome_NODE_15735_length_1565_cov_90,95.131,1561,71,4,101,1661,2,1557,0,2457,1560,1555
44880,Nsylvestris_NODE_13194_length_1739_cov_200,Ntome_NODE_13714_length_1766_cov_219,94.975,1592,50,9,51,1616,45,1632,0,2470,1565,1587
45027,Nsylvestris_NODE_13247_length_1734_cov_195,Ntome_NODE_14371_length_1698_cov_212,97.55,1592,38,1,107,1698,2,1592,0,2723,1591,1590
45049,Nsylvestris_NODE_13260_length_1732_cov_56,Ntome_NODE_13663_length_1771_cov_119,93.038,1738,86,7,1,1732,42,1750,0,2507,1731,1708
45056,Nsylvestris_NODE_13263_length_1732_cov_50,Ntome_NODE_15516_length_1583_cov_25,91.88,1601,88,19,120,1696,1,1583,0,2198,1576,1582
45060,Nsylvestris_NODE_13265_length_1732_cov_19,Ntome_NODE_12608_length_1886_cov_29,94.223,1731,94,4,1,1729,1753,27,0,2638,1728,1726
45115,Nsylvestris_NODE_13283_length_1730_cov_63,Ntome_NODE_14904_length_1644_cov_102,95.258,1645,68,5,1,1640,1640,1,0,2597,1639,1639
45131,Nsylvestris_NODE_13288_length_1729_cov_210,Ntome_NODE_13906_length_1746_cov_260,95.828,1606,53,5,6,1599,1650,47,0,2582,1593,1603
45200,Nsylvestris_NODE_13311_length_1726_cov_32,Ntome_NODE_15725_length_1566_cov_7,93.45,1481,85,3,61,1541,98,1566,0,2187,1480,1468
45225,Nsylvestris_NODE_13322_length_1726_cov_174,Ntome_NODE_14383_length_1697_cov_133,94.504,1692,62,18,23,1690,1,1685,0,2580,1667,1684
45289,Nsylvestris_NODE_13343_length_1724_cov_189,Ntome_NODE_13356_length_1801_cov_205,94.641,1101,50,6,538,1634,1136,41,0,1698,1096,1095
45424,Nsylvestris_NODE_13392_length_1718_cov_16,Ntome_NODE_11897_length_1970_cov_158,93.219,1696,106,5,3,1695,1907,218,0,2486,1692,1689
45440,Nsylvestris_NODE_13398_length_1717_cov_148,Ntome_NODE_16865_length_1459_cov_241,94.721,1326,51,6,395,1711,1351,36,0,2043,1316,1315
45478,Nsylvestris_NODE_13412_length_1716_cov_23,Ntome_NODE_14194_length_1716_cov_14,94.391,1676,77,4,8,1683,49,1707,0,2558,1675,1658
45509,Nsylvestris_NODE_13421_length_1715_cov_155,Ntome_NODE_13126_length_1828_cov_233,96.694,1724,42,8,1,1714,1737,19,0,2854,1713,1718
45517,Nsylvestris_NODE_13425_length_1715_cov_56,Ntome_NODE_13629_length_1774_cov_29,95.313,1728,60,5,4,1715,1758,36,0,2723,1711,1722
45661,Nsylvestris_NODE_13471_length_1710_cov_31,Ntome_NODE_13608_length_1776_cov_53,93.662,1704,87,12,11,1698,20,1718,0,2529,1687,1698
45741,Nsylvestris_NODE_13495_length_1706_cov_227,Ntome_NODE_13535_length_1782_cov_267,92.959,1676,93,19,40,1702,1684,21,0,2418,1662,1663
45754,Nsylvestris_NODE_13501_length_1706_cov_83,Ntome_NODE_8450_length_2420_cov_178,93.363,226,15,0,1473,1698,302,77,1.18E-90,335,225,225
45755,Nsylvestris_NODE_13502_length_1706_cov_57,Ntome_NODE_39022_length_267_cov_2,98.127,267,5,0,784,1050,267,1,4.00E-130,466,266,266
45783,Nsylvestris_NODE_13511_length_1705_cov_54,Ntome_NODE_16861_length_1461_cov_12,96.177,1465,49,6,86,1547,1,1461,0,2388,1461,1460
45912,Nsylvestris_NODE_13554_length_1700_cov_178,Ntome_NODE_15104_length_1623_cov_176,92.116,1522,83,18,82,1571,62,1578,0,2111,1489,1516
45945,Nsylvestris_NODE_13566_length_1699_cov_193,Ntome_NODE_14557_length_1679_cov_236,95.684,1622,58,6,10,1623,1665,48,0,2597,1613,1617
45966,Nsylvestris_NODE_13573_length_1699_cov_116,Ntome_NODE_15881_length_1550_cov_45,96.025,1459,34,8,79,1526,105,1550,0,2351,1447,1445
46017,Nsylvestris_NODE_13597_length_1696_cov_198,Ntome_NODE_13326_length_1805_cov_220,92.924,1611,78,7,73,1657,1627,27,0,2311,1584,1600
46036,Nsylvestris_NODE_13605_length_1695_cov_190,Ntome_NODE_14912_length_1643_cov_259,96.027,1636,47,7,60,1695,1637,20,0,2645,1635,1617
46055,Nsylvestris_NODE_13613_length_1694_cov_209,Ntome_NODE_13537_length_1782_cov_220,92.141,1565,87,13,1,1539,1757,203,0,2176,1538,1554
46162,Nsylvestris_NODE_13656_length_1690_cov_76,Ntome_NODE_39488_length_258_cov_4,85.714,259,13,10,1044,1279,1,258,1.21E-65,252,235,257
46229,Nsylvestris_NODE_13681_length_1688_cov_38,Ntome_NODE_14811_length_1655_cov_34,94.667,1669,63,10,11,1667,1655,1,0,2566,1656,1654
46260,Nsylvestris_NODE_13695_length_1685_cov_201,Ntome_NODE_13759_length_1761_cov_257,93.709,1685,100,4,2,1685,1761,82,0,2519,1683,1679
46340,Nsylvestris_NODE_13725_length_1682_cov_161,Ntome_NODE_14483_length_1687_cov_178,95.487,1551,49,8,105,1640,1637,93,0,2457,1535,1544
46378,Nsylvestris_NODE_13738_length_1680_cov_215,Ntome_NODE_14592_length_1676_cov_260,94.059,1515,85,3,85,1594,162,1676,0,2294,1509,1514
46442,Nsylvestris_NODE_13760_length_1678_cov_48,Ntome_NODE_14278_length_1708_cov_25,96.344,1641,52,7,19,1653,1679,41,0,2691,1634,1638
46470,Nsylvestris_NODE_13768_length_1677_cov_45,Ntome_NODE_38352_length_281_cov_5,80.702,285,31,12,134,398,1,281,4.40E-50,200,264,280
46533,Nsylvestris_NODE_13791_length_1674_cov_95,Ntome_NODE_35341_length_360_cov_7,96.667,360,9,1,181,537,360,1,4.79E-169,595,356,359
46572,Nsylvestris_NODE_13808_length_1672_cov_194,Ntome_NODE_14546_length_1680_cov_238,95.717,1611,55,7,76,1672,1632,22,0,2580,1596,1610
46585,Nsylvestris_NODE_13812_length_1672_cov_108,Ntome_NODE_39815_length_252_cov_4,89.72,214,10,6,547,760,51,252,5.51E-69,263,213,201
46614,Nsylvestris_NODE_13824_length_1670_cov_81,Ntome_NODE_14082_length_1729_cov_73,94.723,1554,64,4,108,1659,1561,24,0,2399,1551,1537
46622,Nsylvestris_NODE_13828_length_1671_cov_19,Ntome_NODE_13852_length_1751_cov_51,93.04,1566,87,12,128,1671,1627,62,0,2268,1543,1565
46690,Nsylvestris_NODE_13852_length_1668_cov_131,Ntome_NODE_13931_length_1744_cov_24,96.072,1604,62,1,31,1633,1708,105,0,2612,1602,1603
46725,Nsylvestris_NODE_13866_length_1666_cov_215,Ntome_NODE_13897_length_1746_cov_271,94.981,1554,62,8,119,1666,1575,32,0,2423,1547,1543
46757,Nsylvestris_NODE_13878_length_1665_cov_213,Ntome_NODE_14185_length_1716_cov_284,93.548,1643,86,7,28,1665,25,1652,0,2429,1637,1627
46760,Nsylvestris_NODE_13880_length_1665_cov_204,Ntome_NODE_16485_length_1497_cov_271,95.361,1509,44,10,67,1561,1,1497,0,2375,1494,1496
46808,Nsylvestris_NODE_13896_length_1663_cov_125,Ntome_NODE_12552_length_1892_cov_197,95.647,1539,53,6,70,1598,1889,355,0,2459,1528,1534
46858,Nsylvestris_NODE_13914_length_1661_cov_177,Ntome_NODE_12536_length_1894_cov_91,96.545,1621,44,1,1,1609,274,1894,0,2673,1608,1620
46874,Nsylvestris_NODE_13924_length_1659_cov_220,Ntome_NODE_10380_length_2148_cov_187,85.653,467,63,4,1078,1542,588,124,8.29E-137,488,464,464
46899,Nsylvestris_NODE_13936_length_1658_cov_194,Ntome_NODE_11462_length_2018_cov_200,95.184,1225,58,1,306,1530,1972,749,0,1934,1224,1223
47009,Nsylvestris_NODE_13974_length_1653_cov_114,Ntome_NODE_15142_length_1619_cov_203,93.867,1598,75,6,7,1597,1582,1,0,2386,1590,1581
47023,Nsylvestris_NODE_13980_length_1652_cov_223,Ntome_NODE_15202_length_1604_cov_302,95.244,1535,64,5,37,1566,1565,35,0,2422,1529,1530
47026,Nsylvestris_NODE_13982_length_1652_cov_147,Ntome_NODE_13230_length_1816_cov_247,93.397,1469,73,11,192,1645,1514,55,0,2154,1453,1459
47108,Nsylvestris_NODE_14016_length_1647_cov_214,Ntome_NODE_15302_length_1604_cov_289,96.794,1591,44,6,58,1645,1602,16,0,2649,1587,1586
47132,Nsylvestris_NODE_14027_length_1646_cov_183,Ntome_NODE_15583_length_1577_cov_251,94.485,1505,65,9,88,1588,81,1571,0,2303,1500,1490
47151,Nsylvestris_NODE_14035_length_1646_cov_46,Ntome_NODE_15656_length_1571_cov_237,92.678,1516,89,11,141,1640,1510,1,0,2165,1499,1509
47296,Nsylvestris_NODE_14085_length_1641_cov_190,Ntome_NODE_6104_length_2830_cov_50,93.6,1500,64,11,72,1565,1,1474,0,2209,1493,1473
47342,Nsylvestris_NODE_14105_length_1640_cov_14,Ntome_NODE_14586_length_1677_cov_114,95.455,1056,41,3,99,1150,1274,222,0,1677,1051,1052
47346,Nsylvestris_NODE_14107_length_1639_cov_228,Ntome_NODE_13620_length_1774_cov_274,93.871,1550,78,10,101,1639,77,1620,0,2320,1538,1543
47374,Nsylvestris_NODE_14115_length_1639_cov_113,Ntome_NODE_33764_length_431_cov_26,92.188,128,10,0,1053,1180,171,298,1.56E-44,182,127,127
47405,Nsylvestris_NODE_14127_length_1638_cov_36,Ntome_NODE_27902_length_715_cov_2,97.203,715,20,0,612,1326,715,1,0,1210,714,714
47492,Nsylvestris_NODE_14152_length_1635_cov_101,Ntome_NODE_14000_length_1738_cov_28,93.491,1521,67,14,47,1546,1596,87,0,2231,1499,1509
47558,Nsylvestris_NODE_14175_length_1633_cov_22,Ntome_NODE_15664_length_1571_cov_25,95.647,1585,49,4,33,1612,2,1571,0,2527,1579,1569
47574,Nsylvestris_NODE_14183_length_1632_cov_56,Ntome_NODE_27556_length_730_cov_10,85.915,568,46,18,50,600,695,145,6.09E-163,575,550,550
47587,Nsylvestris_NODE_14190_length_1631_cov_85,Ntome_NODE_26772_length_769_cov_27,79.016,386,55,12,860,1222,299,681,2.52E-62,241,362,382
47588,Nsylvestris_NODE_14192_length_1631_cov_33,Ntome_NODE_23531_length_953_cov_21,94.671,957,35,3,679,1631,3,947,0,1471,952,944
47598,Nsylvestris_NODE_14197_length_1630_cov_30,Ntome_NODE_14588_length_1677_cov_47,93.719,1608,94,6,27,1628,1675,69,0,2403,1601,1606
47620,Nsylvestris_NODE_14209_length_1628_cov_143,Ntome_NODE_16791_length_1467_cov_149,97.825,1471,28,2,119,1589,1,1467,0,2536,1470,1466
47685,Nsylvestris_NODE_14237_length_1625_cov_124,Ntome_NODE_14765_length_1659_cov_181,96.398,1610,54,2,18,1624,1,1609,0,2649,1606,1608
47711,Nsylvestris_NODE_14248_length_1624_cov_206,Ntome_NODE_15294_length_1605_cov_273,96.185,1494,32,10,70,1563,1598,130,0,2420,1493,1468
47782,Nsylvestris_NODE_14272_length_1622_cov_192,Ntome_NODE_16443_length_1501_cov_238,94.97,1491,53,15,136,1612,11,1493,0,2318,1476,1482
47783,Nsylvestris_NODE_14273_length_1622_cov_181,Ntome_NODE_10962_length_2078_cov_100,91.053,1643,97,25,1,1622,1707,94,0,2174,1621,1613
47823,Nsylvestris_NODE_14286_length_1621_cov_213,Ntome_NODE_14320_length_1703_cov_115,94.627,1433,55,12,153,1583,1461,49,0,2200,1430,1412
47945,Nsylvestris_NODE_14328_length_1618_cov_222,Ntome_NODE_14466_length_1689_cov_205,90.869,1599,96,22,9,1597,1609,51,0,2098,1588,1558
47980,Nsylvestris_NODE_14342_length_1615_cov_211,Ntome_NODE_16150_length_1526_cov_193,91.505,1542,97,18,34,1560,1,1523,0,2091,1526,1522
48023,Nsylvestris_NODE_14361_length_1614_cov_68,Ntome_NODE_15198_length_1614_cov_154,93.871,1550,69,20,11,1548,1536,1,0,2313,1537,1535
48025,Nsylvestris_NODE_14364_length_1615_cov_25,Ntome_NODE_23649_length_946_cov_89,93.885,278,10,6,1339,1615,852,581,5.00E-114,412,276,271
48070,Nsylvestris_NODE_14383_length_1612_cov_25,Ntome_NODE_16298_length_1512_cov_130,91.957,1492,91,13,139,1612,1509,29,0,2063,1473,1480
48101,Nsylvestris_NODE_14393_length_1611_cov_35,Ntome_NODE_16348_length_1509_cov_20,93.305,1434,78,14,43,1466,1428,3,0,2100,1423,1425
48102,Nsylvestris_NODE_14394_length_1611_cov_11,Ntome_NODE_12497_length_1897_cov_177,96.201,1632,40,4,1,1610,218,1849,0,2651,1609,1631
48121,Nsylvestris_NODE_14401_length_1610_cov_113,Ntome_NODE_15409_length_1593_cov_111,94.862,1265,48,6,350,1601,1264,4,0,1960,1251,1260
48131,Nsylvestris_NODE_14405_length_1610_cov_15,Ntome_NODE_39731_length_254_cov_1,95.669,254,11,0,965,1218,254,1,6.44E-113,409,253,253
48151,Nsylvestris_NODE_14410_length_1609_cov_127,Ntome_NODE_16077_length_1533_cov_25,92.524,1351,82,8,39,1384,148,1484,0,1917,1345,1336
48174,Nsylvestris_NODE_14418_length_1609_cov_26,Ntome_NODE_16551_length_1492_cov_10,95.007,1402,56,6,93,1493,1,1389,0,2189,1400,1388
48184,Nsylvestris_NODE_14423_length_1608_cov_152,Ntome_NODE_17535_length_1399_cov_259,95.227,1299,48,8,110,1397,1359,64,0,2043,1287,1295
48217,Nsylvestris_NODE_14435_length_1607_cov_45,Ntome_NODE_18530_length_1314_cov_18,96.071,1120,44,0,227,1346,1120,1,0,1825,1119,1119
48221,Nsylvestris_NODE_14437_length_1606_cov_193,Ntome_NODE_15219_length_1612_cov_97,94.202,1604,68,9,2,1603,1581,1,0,2423,1601,1580
48246,Nsylvestris_NODE_14446_length_1606_cov_11,Ntome_NODE_11446_length_2020_cov_35,94.763,1394,73,0,1,1394,1672,279,0,2170,1393,1393
48296,Nsylvestris_NODE_14468_length_1603_cov_216,Ntome_NODE_12974_length_1845_cov_11,94.366,1562,79,6,1,1555,1600,41,0,2388,1554,1559
48305,Nsylvestris_NODE_14471_length_1603_cov_48,Ntome_NODE_15345_length_1600_cov_27,95.145,1586,71,2,1,1583,16,1598,0,2497,1582,1582
48340,Nsylvestris_NODE_14487_length_1601_cov_157,Ntome_NODE_14573_length_1678_cov_129,94.788,1439,44,8,35,1447,1485,52,0,2213,1412,1433
48361,Nsylvestris_NODE_14496_length_1600_cov_212,Ntome_NODE_7538_length_2564_cov_290,97.878,1555,27,4,45,1597,971,2521,0,2684,1552,1550
48362,Nsylvestris_NODE_14497_length_1600_cov_208,Ntome_NODE_16820_length_1464_cov_59,91.565,1470,91,14,22,1478,1,1450,0,1997,1456,1449
48363,Nsylvestris_NODE_14498_length_1600_cov_204,Ntome_NODE_17026_length_1446_cov_186,95.783,1399,56,2,154,1549,47,1445,0,2254,1395,1398
48386,Nsylvestris_NODE_14507_length_1599_cov_136,Ntome_NODE_17819_length_1373_cov_48,96.8,1375,28,5,71,1431,1,1373,0,2281,1360,1372
48420,Nsylvestris_NODE_14519_length_1598_cov_111,Ntome_NODE_13123_length_1828_cov_275,91.587,1569,78,24,1,1542,7,1548,0,2117,1541,1541
48424,Nsylvestris_NODE_14521_length_1598_cov_93,Ntome_NODE_14248_length_1710_cov_235,95.215,1442,69,0,50,1491,269,1710,0,2281,1441,1441
48430,Nsylvestris_NODE_14524_length_1597_cov_224,Ntome_NODE_14234_length_1711_cov_276,95.551,1506,54,9,21,1525,1,1494,0,2398,1504,1493
48550,Nsylvestris_NODE_14560_length_1593_cov_198,Ntome_NODE_16484_length_1497_cov_300,95.917,1445,42,6,10,1445,10,1446,0,2326,1435,1436
48562,Nsylvestris_NODE_14565_length_1593_cov_31,Ntome_NODE_18861_length_1287_cov_8,86.279,1188,97,21,328,1488,3,1151,0,1230,1160,1148
48611,Nsylvestris_NODE_14580_length_1591_cov_63,Ntome_NODE_16834_length_1462_cov_50,96.514,1463,49,2,108,1569,1,1462,0,2418,1461,1461
48644,Nsylvestris_NODE_14593_length_1589_cov_200,Ntome_NODE_14751_length_1660_cov_225,95.925,1546,47,6,2,1535,1653,112,0,2492,1533,1541
48702,Nsylvestris_NODE_14616_length_1587_cov_127,Ntome_NODE_20241_length_1174_cov_153,96.137,673,26,0,765,1437,673,1,0,1099,672,672
48704,Nsylvestris_NODE_14618_length_1587_cov_104,Ntome_NODE_13772_length_1760_cov_168,94.168,1526,44,13,15,1529,1528,37,0,2283,1514,1491
48707,Nsylvestris_NODE_14621_length_1587_cov_65,Ntome_NODE_14746_length_1661_cov_53,93.56,1615,52,16,6,1586,63,1659,0,2359,1580,1596
48850,Nsylvestris_NODE_14679_length_1581_cov_147,Ntome_NODE_17431_length_1409_cov_115,94.264,1046,57,3,55,1098,1,1045,0,1596,1043,1044
48895,Nsylvestris_NODE_14698_length_1579_cov_200,Ntome_NODE_15694_length_1568_cov_249,95.016,1565,55,6,1,1554,12,1564,0,2436,1553,1552
48896,Nsylvestris_NODE_14699_length_1579_cov_172,Ntome_NODE_15619_length_1574_cov_139,90.689,1407,83,19,200,1572,1393,1,0,1829,1372,1392
48909,Nsylvestris_NODE_14704_length_1579_cov_41,Ntome_NODE_18426_length_1323_cov_229,93.399,1318,56,18,228,1532,1323,24,0,1923,1304,1299
48910,Nsylvestris_NODE_14705_length_1579_cov_29,Ntome_NODE_19106_length_1267_cov_29,93.14,1239,55,12,300,1536,1,1211,0,1790,1236,1210
48955,Nsylvestris_NODE_14725_length_1577_cov_29,Ntome_NODE_15181_length_1615_cov_243,92.421,1491,46,18,97,1577,156,1589,0,2065,1480,1433
49012,Nsylvestris_NODE_14745_length_1575_cov_81,Ntome_NODE_18746_length_1296_cov_113,95.734,1172,28,11,423,1575,54,1222,0,1868,1152,1168
49054,Nsylvestris_NODE_14761_length_1573_cov_214,Ntome_NODE_16610_length_1485_cov_264,93.542,1471,51,17,66,1525,1459,22,0,2150,1459,1437
49084,Nsylvestris_NODE_14773_length_1573_cov_25,Ntome_NODE_17134_length_1437_cov_8,95.49,1419,59,3,2,1416,16,1433,0,2261,1414,1417
49095,Nsylvestris_NODE_14777_length_1572_cov_56,Ntome_NODE_15560_length_1579_cov_113,95.493,1531,61,4,19,1542,1530,1,0,2438,1523,1529
49128,Nsylvestris_NODE_14791_length_1570_cov_117,Ntome_NODE_19983_length_1193_cov_169,91.736,1210,67,8,233,1427,2,1193,0,1650,1194,1191
49191,Nsylvestris_NODE_14814_length_1568_cov_86,Ntome_NODE_14626_length_1674_cov_79,93.207,1428,71,10,1,1408,1588,167,0,2076,1407,1421
49205,Nsylvestris_NODE_14821_length_1567_cov_201,Ntome_NODE_15340_length_1600_cov_226,91.467,1547,67,23,13,1496,56,1600,0,2065,1483,1544
49210,Nsylvestris_NODE_14823_length_1567_cov_153,Ntome_NODE_14956_length_1640_cov_73,93.571,1571,68,15,23,1567,1637,74,0,2311,1544,1563
49256,Nsylvestris_NODE_14843_length_1565_cov_186,Ntome_NODE_13383_length_1799_cov_248,94.834,1510,64,5,5,1507,1746,244,0,2344,1502,1502
49302,Nsylvestris_NODE_14857_length_1564_cov_186,Ntome_NODE_16332_length_1510_cov_81,94.806,1444,58,9,128,1562,1,1436,0,2235,1434,1435
49324,Nsylvestris_NODE_14867_length_1563_cov_203,Ntome_NODE_14843_length_1650_cov_241,89.176,1589,80,34,1,1547,66,1604,0,1897,1546,1538
49325,Nsylvestris_NODE_14868_length_1563_cov_199,Ntome_NODE_19540_length_1231_cov_42,92.327,1225,94,0,287,1511,1231,7,0,1742,1224,1224
49329,Nsylvestris_NODE_14870_length_1563_cov_190,Ntome_NODE_17058_length_1443_cov_25,80.925,173,28,5,176,347,225,393,1.52E-29,132,171,168
49375,Nsylvestris_NODE_14889_length_1561_cov_212,Ntome_NODE_15076_length_1627_cov_269,96.164,1564,41,8,1,1561,60,1607,0,2538,1560,1547
49376,Nsylvestris_NODE_14890_length_1561_cov_210,Ntome_NODE_12960_length_1845_cov_237,93.652,1528,79,9,51,1561,272,1798,0,2268,1510,1526
49382,Nsylvestris_NODE_14893_length_1561_cov_58,Ntome_NODE_15100_length_1624_cov_18,96.441,1461,49,2,57,1514,1600,140,0,2407,1457,1460
49488,Nsylvestris_NODE_14932_length_1557_cov_31,Ntome_NODE_19513_length_1233_cov_55,91.132,1263,73,11,65,1320,1231,1,0,1676,1255,1230
49503,Nsylvestris_NODE_14939_length_1556_cov_107,Ntome_NODE_26613_length_777_cov_15,92.636,679,48,1,273,949,71,749,0,976,676,678
49537,Nsylvestris_NODE_14950_length_1555_cov_183,Ntome_NODE_11962_length_1962_cov_97,95.16,1529,73,1,11,1539,1737,210,0,2412,1528,1527
49713,Nsylvestris_NODE_15017_length_1548_cov_221,Ntome_NODE_14877_length_1646_cov_276,93.412,1533,94,6,1,1530,88,1616,0,2265,1529,1528
49721,Nsylvestris_NODE_15021_length_1548_cov_131,Ntome_NODE_15644_length_1572_cov_228,91.194,1499,99,17,1,1485,1532,53,0,2006,1484,1479
49737,Nsylvestris_NODE_15026_length_1548_cov_61,Ntome_NODE_20455_length_1157_cov_178,95.5,1089,40,7,302,1381,45,1133,0,1731,1079,1088
49739,Nsylvestris_NODE_15029_length_1547_cov_234,Ntome_NODE_15269_length_1607_cov_280,94.293,1542,65,9,16,1547,3,1531,0,2338,1531,1528
49776,Nsylvestris_NODE_15042_length_1547_cov_28,Ntome_NODE_14351_length_1700_cov_90,95.346,1504,66,1,1,1500,155,1658,0,2386,1499,1503
49777,Nsylvestris_NODE_15043_length_1547_cov_20,Ntome_NODE_21648_length_1071_cov_35,95.326,1027,47,1,459,1485,1028,3,0,1629,1026,1025
49780,Nsylvestris_NODE_15046_length_1546_cov_221,Ntome_NODE_18584_length_1309_cov_267,96.337,1092,37,2,9,1099,1303,214,0,1792,1090,1089
49790,Nsylvestris_NODE_15052_length_1546_cov_48,Ntome_NODE_36083_length_336_cov_4,94.925,335,17,0,871,1205,335,1,5.88E-148,525,334,334
49827,Nsylvestris_NODE_15068_length_1544_cov_223,Ntome_NODE_14107_length_1726_cov_196,94.367,1509,59,12,48,1544,1519,25,0,2292,1496,1494
49835,Nsylvestris_NODE_15071_length_1544_cov_195,Ntome_NODE_19377_length_1245_cov_10,93.902,1230,44,6,88,1289,1227,1,0,1827,1201,1226
49849,Nsylvestris_NODE_15078_length_1544_cov_30,Ntome_NODE_17982_length_1360_cov_8,92.962,952,54,7,574,1516,392,1339,0,1375,942,947
49854,Nsylvestris_NODE_15080_length_1543_cov_181,Ntome_NODE_17575_length_1395_cov_288,92.421,1293,59,17,247,1517,1277,2,0,1808,1270,1275
49914,Nsylvestris_NODE_15103_length_1540_cov_198,Ntome_NODE_16532_length_1493_cov_265,92.439,1402,70,18,3,1382,1451,64,0,1969,1379,1387
49921,Nsylvestris_NODE_15108_length_1540_cov_119,Ntome_NODE_14714_length_1664_cov_257,90.71,1550,86,27,1,1536,138,1643,0,2012,1535,1505
49935,Nsylvestris_NODE_15115_length_1539_cov_150,Ntome_NODE_10865_length_2089_cov_9,76.22,1148,219,36,341,1461,1,1121,5.77E-158,558,1120,1120
49972,Nsylvestris_NODE_15126_length_1537_cov_88,Ntome_NODE_16816_length_1464_cov_189,95.77,922,39,0,155,1076,1464,543,0,1487,921,921
50006,Nsylvestris_NODE_15142_length_1535_cov_214,Ntome_NODE_17023_length_1446_cov_265,94.078,1334,41,16,18,1335,1446,135,0,1991,1317,1311
50021,Nsylvestris_NODE_15148_length_1535_cov_98,Ntome_NODE_29107_length_664_cov_10,87.5,96,11,1,421,516,497,403,6.97E-23,110,95,94
50066,Nsylvestris_NODE_15166_length_1534_cov_47,Ntome_NODE_17666_length_1387_cov_20,94.317,1390,53,7,27,1396,1384,1,0,2106,1369,1383
50126,Nsylvestris_NODE_15187_length_1532_cov_25,Ntome_NODE_38798_length_271_cov_5,95.572,271,12,0,374,644,271,1,1.01E-120,435,270,270
50151,Nsylvestris_NODE_15197_length_1531_cov_135,Ntome_NODE_15484_length_1585_cov_197,94.067,1500,65,10,49,1530,1533,40,0,2255,1481,1493
50192,Nsylvestris_NODE_15212_length_1530_cov_195,Ntome_NODE_17463_length_1406_cov_265,93.38,1420,61,21,52,1452,1,1406,0,2071,1400,1405
50201,Nsylvestris_NODE_15216_length_1530_cov_79,Ntome_NODE_14431_length_1692_cov_258,93.759,1362,68,10,174,1528,1422,71,0,2028,1354,1351
50234,Nsylvestris_NODE_15230_length_1529_cov_45,Ntome_NODE_20265_length_1172_cov_31,95.263,1161,51,3,117,1273,1161,1,0,1836,1156,1160
50276,Nsylvestris_NODE_15247_length_1526_cov_193,Ntome_NODE_20256_length_1173_cov_177,89.642,1033,62,16,136,1162,133,1126,0,1273,1026,993
50302,Nsylvestris_NODE_15257_length_1526_cov_17,Ntome_NODE_14506_length_1685_cov_92,93.25,1526,74,11,22,1526,1607,90,0,2220,1504,1517
50309,Nsylvestris_NODE_15261_length_1525_cov_167,Ntome_NODE_15958_length_1542_cov_221,92.333,1539,60,21,21,1525,9,1523,0,2135,1504,1514
50310,Nsylvestris_NODE_15262_length_1525_cov_100,Ntome_NODE_20813_length_1131_cov_59,95.848,1132,34,7,44,1164,2,1131,0,1818,1120,1129
50318,Nsylvestris_NODE_15266_length_1525_cov_13,Ntome_NODE_16666_length_1480_cov_71,94.881,1387,65,3,27,1409,51,1435,0,2163,1382,1384
50328,Nsylvestris_NODE_15270_length_1524_cov_211,Ntome_NODE_16039_length_1536_cov_64,91.26,1476,84,21,29,1496,1536,98,0,1969,1467,1438
50375,Nsylvestris_NODE_15288_length_1522_cov_118,Ntome_NODE_18559_length_1311_cov_104,92.268,1151,80,6,379,1522,1264,116,0,1624,1143,1148
50419,Nsylvestris_NODE_15304_length_1521_cov_42,Ntome_NODE_15285_length_1606_cov_87,92.67,1296,72,5,75,1364,274,1552,0,1845,1289,1278
50460,Nsylvestris_NODE_15322_length_1520_cov_27,Ntome_NODE_17301_length_1420_cov_160,93.433,670,36,3,802,1464,393,1061,0,987,662,668
50465,Nsylvestris_NODE_15325_length_1520_cov_21,Ntome_NODE_9503_length_2269_cov_217,97.237,1520,37,2,1,1519,315,1830,0,2569,1518,1515
50485,Nsylvestris_NODE_15332_length_1519_cov_116,Ntome_NODE_15172_length_1616_cov_118,89.956,1364,90,19,1,1364,1480,164,0,1716,1363,1316
50552,Nsylvestris_NODE_15358_length_1516_cov_56,Ntome_NODE_6711_length_2712_cov_143,92.686,752,26,11,401,1142,1468,2200,0,1057,741,732
50555,Nsylvestris_NODE_15360_length_1517_cov_41,Ntome_NODE_18656_length_1304_cov_104,93.394,1105,70,3,249,1351,151,1254,0,1633,1102,1103
50645,Nsylvestris_NODE_15395_length_1513_cov_78,Ntome_NODE_20691_length_1139_cov_4,95.414,1112,51,0,363,1474,1,1112,0,1772,1111,1111
50695,Nsylvestris_NODE_15414_length_1511_cov_145,Ntome_NODE_1065_length_5003_cov_107,86.493,422,54,3,29,449,4920,4501,1.64E-128,460,420,419
50707,Nsylvestris_NODE_15420_length_1510_cov_218,Ntome_NODE_16476_length_1498_cov_227,93.667,1500,67,16,28,1508,1498,8,0,2218,1480,1490
50712,Nsylvestris_NODE_15423_length_1510_cov_198,Ntome_NODE_16823_length_1463_cov_178,94.777,1436,58,6,7,1435,1,1426,0,2220,1428,1425
50725,Nsylvestris_NODE_15430_length_1510_cov_34,Ntome_NODE_14423_length_1693_cov_170,93.329,1514,85,10,1,1501,183,1693,0,2222,1500,1510
50755,Nsylvestris_NODE_15439_length_1509_cov_46,Ntome_NODE_14145_length_1722_cov_197,95.19,1476,45,8,2,1469,1606,149,0,2309,1467,1457
50764,Nsylvestris_NODE_15446_length_1507_cov_214,Ntome_NODE_20372_length_1163_cov_249,95.19,1185,33,8,232,1414,1,1163,0,1851,1182,1162
50771,Nsylvestris_NODE_15449_length_1507_cov_164,Ntome_NODE_15629_length_1573_cov_268,94.952,1446,61,7,1,1435,1467,23,0,2255,1434,1444
50779,Nsylvestris_NODE_15453_length_1507_cov_80,Ntome_NODE_14382_length_1697_cov_158,90.082,1472,93,33,10,1460,59,1498,0,1860,1450,1439
50838,Nsylvestris_NODE_15476_length_1505_cov_147,Ntome_NODE_15159_length_1617_cov_214,95.792,1212,26,2,283,1491,1303,114,0,1932,1208,1189
50839,Nsylvestris_NODE_15477_length_1505_cov_86,Ntome_NODE_23827_length_935_cov_238,88.244,689,49,8,699,1355,880,192,0,795,656,688
50930,Nsylvestris_NODE_15495_length_1503_cov_205,Ntome_NODE_15383_length_1595_cov_261,94.993,1358,59,3,87,1436,47,1403,0,2122,1349,1356
50971,Nsylvestris_NODE_15508_length_1501_cov_144,Ntome_NODE_11665_length_1995_cov_209,95.384,1473,61,4,12,1478,468,1939,0,2337,1466,1471
50975,Nsylvestris_NODE_15510_length_1501_cov_48,Ntome_NODE_18892_length_1284_cov_200,91.076,874,66,6,81,950,246,1111,0,1171,869,865
50976,Nsylvestris_NODE_15511_length_1501_cov_37,Ntome_NODE_30106_length_623_cov_226,93.814,291,16,2,1052,1342,344,56,2.75E-121,436,290,288
51000,Nsylvestris_NODE_15521_length_1500_cov_42,Ntome_NODE_14535_length_1682_cov_58,94.481,1504,76,3,1,1499,66,1567,0,2311,1498,1501
51049,Nsylvestris_NODE_15541_length_1497_cov_205,Ntome_NODE_16274_length_1514_cov_278,92.569,1440,68,16,51,1454,1437,1,0,2030,1403,1436
51065,Nsylvestris_NODE_15547_length_1497_cov_13,Ntome_NODE_32814_length_491_cov_5,88.889,72,5,2,82,153,367,299,1.15E-15,86.1,71,68
51178,Nsylvestris_NODE_15584_length_1492_cov_157,Ntome_NODE_15453_length_1588_cov_217,89.839,1427,108,17,82,1481,1513,97,0,1797,1399,1416
51188,Nsylvestris_NODE_15588_length_1492_cov_23,Ntome_NODE_6989_length_2657_cov_91,94.58,1439,32,15,69,1491,1443,35,0,2183,1422,1408
51195,Nsylvestris_NODE_15591_length_1492_cov_7,Ntome_NODE_16860_length_1460_cov_22,94.136,1313,63,9,15,1323,158,1460,0,1986,1308,1302
51208,Nsylvestris_NODE_15596_length_1491_cov_170,Ntome_NODE_14720_length_1663_cov_275,94.088,1370,68,10,2,1362,1606,241,0,2069,1360,1365
51227,Nsylvestris_NODE_15605_length_1490_cov_63,Ntome_NODE_20778_length_1133_cov_7,94.278,1136,62,1,29,1164,1133,1,0,1735,1135,1132
51298,Nsylvestris_NODE_15630_length_1487_cov_112,Ntome_NODE_16975_length_1451_cov_85,89.706,1428,92,23,73,1473,1,1400,0,1772,1400,1399
51309,Nsylvestris_NODE_15636_length_1486_cov_91,Ntome_NODE_20130_length_1182_cov_101,94.737,760,38,1,685,1442,1033,274,0,1181,757,759
51389,Nsylvestris_NODE_15669_length_1483_cov_174,Ntome_NODE_14100_length_1727_cov_242,95.455,1188,54,0,219,1406,237,1424,0,1895,1187,1187
51416,Nsylvestris_NODE_15682_length_1481_cov_223,Ntome_NODE_15586_length_1577_cov_245,96.496,1427,37,6,1,1426,56,1470,0,2346,1425,1414
51462,Nsylvestris_NODE_15700_length_1480_cov_79,Ntome_NODE_16427_length_1503_cov_18,94.01,1369,70,8,68,1431,3,1364,0,2063,1363,1361
51593,Nsylvestris_NODE_15749_length_1475_cov_113,Ntome_NODE_38693_length_274_cov_1,92.62,271,17,2,199,466,271,1,2.76E-106,387,267,270
51602,Nsylvestris_NODE_15754_length_1474_cov_190,Ntome_NODE_15944_length_1543_cov_136,93.038,1422,62,11,84,1474,1487,72,0,2043,1390,1415
51611,Nsylvestris_NODE_15759_length_1487_cov_94,Ntome_NODE_8321_length_2439_cov_131,90.39,1436,63,32,3,1371,851,2278,0,1818,1368,1427
51679,Nsylvestris_NODE_15786_length_1471_cov_201,Ntome_NODE_16193_length_1521_cov_265,93.333,1425,60,9,56,1471,4,1402,0,2073,1415,1398
51687,Nsylvestris_NODE_15790_length_1471_cov_26,Ntome_NODE_12910_length_1851_cov_165,93.165,1507,62,16,1,1471,267,1768,0,2174,1470,1501
51697,Nsylvestris_NODE_15795_length_1470_cov_116,Ntome_NODE_15492_length_1585_cov_67,94.18,1512,46,5,1,1470,63,1574,0,2266,1469,1511
51719,Nsylvestris_NODE_15805_length_1469_cov_169,Ntome_NODE_16951_length_1452_cov_265,92.515,1376,68,18,85,1450,71,1421,0,1938,1365,1350
51726,Nsylvestris_NODE_15809_length_1469_cov_74,Ntome_NODE_21345_length_1092_cov_46,89.474,1007,55,11,471,1428,82,1086,0,1225,957,1004
51763,Nsylvestris_NODE_15826_length_1466_cov_158,Ntome_NODE_16613_length_1485_cov_142,91.892,1369,73,14,55,1385,114,1482,0,1879,1330,1368
51845,Nsylvestris_NODE_15851_length_1464_cov_7,Ntome_NODE_28356_length_695_cov_3,89.937,636,56,6,828,1458,1,633,0,813,630,632
51853,Nsylvestris_NODE_15854_length_1463_cov_196,Ntome_NODE_16340_length_1509_cov_148,94.354,1470,45,13,1,1463,68,1506,0,2220,1462,1438
51854,Nsylvestris_NODE_15855_length_1463_cov_192,Ntome_NODE_16967_length_1451_cov_222,94.508,1402,62,9,1,1398,1426,36,0,2148,1397,1390
51876,Nsylvestris_NODE_15862_length_1463_cov_22,Ntome_NODE_21644_length_1073_cov_4,97.61,1046,25,0,1,1046,25,1070,0,1794,1045,1045
51950,Nsylvestris_NODE_15887_length_1461_cov_206,Ntome_NODE_16745_length_1471_cov_285,97.3,1185,24,2,228,1409,1308,129,0,2004,1181,1179
51992,Nsylvestris_NODE_15903_length_1460_cov_59,Ntome_NODE_15947_length_1543_cov_109,93.671,1422,64,15,4,1409,28,1439,0,2104,1405,1411
51993,Nsylvestris_NODE_15904_length_1460_cov_47,Ntome_NODE_15135_length_1620_cov_86,93.858,1335,73,6,126,1455,1487,157,0,2002,1329,1330
52034,Nsylvestris_NODE_15918_length_1458_cov_173,Ntome_NODE_21967_length_1051_cov_270,92.089,986,47,7,225,1207,981,24,0,1360,982,957
52118,Nsylvestris_NODE_15952_length_1454_cov_223,Ntome_NODE_16537_length_1493_cov_210,90.973,1285,101,6,138,1407,1444,160,0,1716,1269,1284
52145,Nsylvestris_NODE_15963_length_1453_cov_192,Ntome_NODE_17056_length_1443_cov_88,95.963,1288,39,6,131,1407,1432,147,0,2078,1276,1285
52232,Nsylvestris_NODE_15999_length_1449_cov_144,Ntome_NODE_16503_length_1496_cov_162,93.191,1454,79,14,1,1449,53,1491,0,2119,1448,1438
52247,Nsylvestris_NODE_16005_length_1449_cov_48,Ntome_NODE_22341_length_1026_cov_45,90.26,770,42,8,50,795,817,57,0,976,745,760
52298,Nsylvestris_NODE_16027_length_1447_cov_150,Ntome_NODE_15532_length_1581_cov_98,93.921,1464,51,14,2,1444,1,1447,0,2176,1442,1446
52310,Nsylvestris_NODE_16032_length_1447_cov_17,Ntome_NODE_28309_length_697_cov_15,86.325,468,41,10,852,1312,572,121,7.22E-137,488,460,451
52370,Nsylvestris_NODE_16057_length_1444_cov_96,Ntome_NODE_16765_length_1469_cov_126,96.157,1405,49,3,3,1405,65,1466,0,2290,1402,1401
52394,Nsylvestris_NODE_16066_length_1443_cov_121,Ntome_NODE_23515_length_954_cov_114,95.013,742,29,2,11,744,791,50,0,1158,733,741
52452,Nsylvestris_NODE_16091_length_1441_cov_149,Ntome_NODE_16780_length_1468_cov_77,95.672,1109,48,0,1,1109,1154,46,0,1783,1108,1108
52496,Nsylvestris_NODE_16108_length_1439_cov_106,Ntome_NODE_17856_length_1370_cov_211,96.88,1282,33,5,1,1281,1276,1,0,2139,1280,1275
52508,Nsylvestris_NODE_16115_length_1439_cov_10,Ntome_NODE_16681_length_1478_cov_49,90.593,489,44,1,8,496,121,607,0,647,488,486
52515,Nsylvestris_NODE_16119_length_1437_cov_213,Ntome_NODE_16773_length_1468_cov_272,95.507,1291,50,7,140,1426,140,1426,0,2056,1286,1286
52541,Nsylvestris_NODE_16130_length_1437_cov_49,Ntome_NODE_13551_length_1781_cov_136,93.372,1388,84,6,1,1387,33,1413,0,2047,1386,1380
52607,Nsylvestris_NODE_16153_length_1434_cov_220,Ntome_NODE_16137_length_1527_cov_261,94.788,1439,57,10,1,1433,1513,87,0,2226,1432,1426
52819,Nsylvestris_NODE_16223_length_1427_cov_206,Ntome_NODE_19551_length_1229_cov_105,88.484,1207,98,12,80,1278,1182,9,0,1421,1198,1173
52854,Nsylvestris_NODE_16235_length_1426_cov_180,Ntome_NODE_15572_length_1578_cov_120,94.807,1425,66,7,2,1424,2,1420,0,2215,1422,1418
52855,Nsylvestris_NODE_16236_length_1426_cov_91,Ntome_NODE_36600_length_321_cov_4,97.196,321,9,0,809,1129,1,321,1.50E-153,544,320,320
52890,Nsylvestris_NODE_16252_length_1424_cov_118,Ntome_NODE_23590_length_949_cov_229,87.205,891,72,13,97,946,53,942,0,976,849,889
52936,Nsylvestris_NODE_16271_length_1422_cov_104,Ntome_NODE_8926_length_2350_cov_61,91.176,782,36,11,245,997,782,1559,0,1031,752,777
53012,Nsylvestris_NODE_16298_length_1420_cov_22,Ntome_NODE_23389_length_961_cov_10,92.029,966,60,4,232,1186,2,961,0,1341,954,959
53025,Nsylvestris_NODE_16302_length_1418_cov_154,Ntome_NODE_17297_length_1420_cov_240,90.943,1082,55,12,9,1078,64,1114,0,1415,1069,1050
53048,Nsylvestris_NODE_16311_length_1418_cov_129,Ntome_NODE_35974_length_339_cov_5,95.575,339,15,0,597,935,339,1,1.49E-153,544,338,338
53071,Nsylvestris_NODE_16319_length_1417_cov_50,Ntome_NODE_16481_length_1498_cov_98,93.849,1203,51,7,46,1238,45,1234,0,1790,1192,1189
53109,Nsylvestris_NODE_16335_length_1416_cov_30,Ntome_NODE_13578_length_1779_cov_53,96.358,1373,41,3,53,1416,1434,62,0,2250,1363,1372
53110,Nsylvestris_NODE_16336_length_1416_cov_24,Ntome_NODE_14890_length_1645_cov_70,94.126,1379,77,3,33,1408,231,1608,0,2095,1375,1377
53152,Nsylvestris_NODE_16354_length_1414_cov_188,Ntome_NODE_21187_length_1103_cov_115,95.949,1012,30,5,356,1364,1,1004,0,1631,1008,1003
53159,Nsylvestris_NODE_16357_length_1414_cov_113,Ntome_NODE_39344_length_261_cov_3,95.263,190,9,0,1110,1299,261,72,9.86E-81,302,189,189
53160,Nsylvestris_NODE_16358_length_1414_cov_75,Ntome_NODE_37361_length_302_cov_6,85.354,198,17,6,1056,1243,1,196,1.72E-48,195,187,195
53185,Nsylvestris_NODE_16369_length_1413_cov_30,Ntome_NODE_21093_length_1109_cov_29,88.636,132,14,1,263,394,1096,966,6.27E-38,159,131,130
53212,Nsylvestris_NODE_16383_length_1411_cov_142,Ntome_NODE_16940_length_1453_cov_134,95.18,1307,43,11,106,1411,163,1450,0,2047,1305,1287
53248,Nsylvestris_NODE_16397_length_1410_cov_22,Ntome_NODE_36796_length_316_cov_4,92.434,304,17,2,849,1149,1,301,4.32E-119,429,300,300
53312,Nsylvestris_NODE_16423_length_1400_cov_176,Ntome_NODE_13418_length_1794_cov_174,90.549,1111,62,26,304,1394,687,1774,0,1430,1090,1087
53321,Nsylvestris_NODE_16427_length_1407_cov_111,Ntome_NODE_13407_length_1796_cov_68,95.337,1351,41,12,13,1359,2,1334,0,2126,1346,1332
53348,Nsylvestris_NODE_16436_length_1406_cov_157,Ntome_NODE_19034_length_1273_cov_202,95.341,1159,47,5,233,1386,47,1203,0,1834,1153,1156
53391,Nsylvestris_NODE_16454_length_1404_cov_199,Ntome_NODE_13955_length_1741_cov_198,95.552,1349,42,11,59,1398,24,1363,0,2143,1339,1339
53397,Nsylvestris_NODE_16457_length_1404_cov_29,Ntome_NODE_24001_length_925_cov_7,95.264,929,40,2,73,1001,925,1,0,1469,928,924
53456,Nsylvestris_NODE_16477_length_1402_cov_9,Ntome_NODE_37795_length_293_cov_3,95.563,293,10,2,223,515,4,293,3.27E-130,466,292,289
53470,Nsylvestris_NODE_16484_length_1401_cov_82,Ntome_NODE_15950_length_1543_cov_33,94.498,1345,51,6,8,1351,1523,201,0,2052,1343,1322
53471,Nsylvestris_NODE_16485_length_1401_cov_58,Ntome_NODE_13963_length_1741_cov_25,96.53,1412,33,3,6,1401,207,1618,0,2322,1395,1411
53497,Nsylvestris_NODE_16495_length_1400_cov_63,Ntome_NODE_21937_length_1053_cov_17,94.156,1061,30,13,355,1396,1053,6,0,1587,1041,1047
53501,Nsylvestris_NODE_16497_length_1400_cov_39,Ntome_NODE_12223_length_1930_cov_99,93.397,1151,67,8,1,1150,80,1222,0,1696,1149,1142
53530,Nsylvestris_NODE_16510_length_1399_cov_27,Ntome_NODE_17806_length_1374_cov_48,91.089,1313,55,20,79,1372,5,1274,0,1720,1293,1269
53544,Nsylvestris_NODE_16516_length_1398_cov_201,Ntome_NODE_15913_length_1546_cov_266,94.565,1196,61,4,159,1352,1281,88,0,1845,1193,1193
53550,Nsylvestris_NODE_16519_length_1398_cov_122,Ntome_NODE_18494_length_1317_cov_222,95.37,1296,46,7,1,1294,15,1298,0,2049,1293,1283
53559,Nsylvestris_NODE_16523_length_1398_cov_15,Ntome_NODE_36572_length_321_cov_4,91.489,329,16,3,432,757,2,321,5.50E-123,442,325,319
53633,Nsylvestris_NODE_16550_length_1395_cov_186,Ntome_NODE_17002_length_1448_cov_254,95.399,1304,49,6,44,1339,1441,141,0,2065,1295,1300
53637,Nsylvestris_NODE_16552_length_1395_cov_172,Ntome_NODE_17926_length_1364_cov_228,93.765,1267,66,10,53,1310,102,1364,0,1890,1257,1262
53638,Nsylvestris_NODE_16553_length_1395_cov_151,Ntome_NODE_16669_length_1479_cov_172,91.753,1358,49,19,54,1395,1311,1,0,1829,1341,1310
53681,Nsylvestris_NODE_16568_length_1394_cov_113,Ntome_NODE_17290_length_1421_cov_102,95.424,1180,39,5,1,1173,7,1178,0,1866,1172,1171
53728,Nsylvestris_NODE_16587_length_1392_cov_166,Ntome_NODE_7730_length_2536_cov_106,95.426,962,41,1,381,1342,1055,97,0,1530,961,958
53735,Nsylvestris_NODE_16590_length_1392_cov_44,Ntome_NODE_16990_length_1450_cov_74,95.795,1403,36,12,8,1392,1,1398,0,2242,1384,1397
53748,Nsylvestris_NODE_16595_length_1391_cov_211,Ntome_NODE_17432_length_1409_cov_82,96.04,1212,46,2,182,1391,1237,26,0,1971,1209,1211
53788,Nsylvestris_NODE_16609_length_1390_cov_209,Ntome_NODE_17893_length_1367_cov_88,92.53,1352,56,17,1,1348,8,1318,0,1895,1347,1310
53794,Nsylvestris_NODE_16612_length_1390_cov_145,Ntome_NODE_18428_length_1323_cov_111,88.93,1355,71,13,6,1330,1306,1,0,1598,1324,1305
53795,Nsylvestris_NODE_16613_length_1390_cov_133,Ntome_NODE_20978_length_1118_cov_6,91.682,1118,58,15,57,1172,1118,34,0,1517,1115,1084
53802,Nsylvestris_NODE_16616_length_1390_cov_92,Ntome_NODE_37693_length_295_cov_4,97.966,295,6,0,449,743,295,1,4.11E-144,512,294,294
53851,Nsylvestris_NODE_16630_length_1388_cov_190,Ntome_NODE_17488_length_1404_cov_270,94.349,1398,62,9,1,1388,1,1391,0,2128,1387,1390
53974,Nsylvestris_NODE_16676_length_1383_cov_93,Ntome_NODE_19039_length_1273_cov_97,95.093,1182,49,1,158,1330,1237,56,0,1853,1172,1181
54010,Nsylvestris_NODE_16691_length_1382_cov_28,Ntome_NODE_16303_length_1512_cov_62,93.463,1392,66,7,7,1374,1436,46,0,2043,1367,1390
54069,Nsylvestris_NODE_16705_length_1381_cov_22,Ntome_NODE_17664_length_1387_cov_25,95.977,1367,51,2,7,1369,1367,1,0,2217,1362,1366
54081,Nsylvestris_NODE_16712_length_1380_cov_180,Ntome_NODE_15168_length_1616_cov_212,91.47,973,52,5,429,1380,1189,227,0,1308,951,962
54110,Nsylvestris_NODE_16722_length_1379_cov_81,Ntome_NODE_17298_length_1420_cov_228,93.913,1265,63,12,81,1342,1419,166,0,1897,1261,1253
54138,Nsylvestris_NODE_16733_length_1378_cov_48,Ntome_NODE_30487_length_609_cov_35,89.176,619,34,8,52,664,592,1,0,741,612,591
54139,Nsylvestris_NODE_16734_length_1378_cov_26,Ntome_NODE_20866_length_1127_cov_23,94.844,1125,57,1,201,1324,3,1127,0,1755,1123,1124
54164,Nsylvestris_NODE_16739_length_1377_cov_208,Ntome_NODE_17674_length_1386_cov_83,93.285,1236,78,5,89,1321,16,1249,0,1818,1232,1233
54197,Nsylvestris_NODE_16754_length_1376_cov_211,Ntome_NODE_15552_length_1579_cov_249,95.94,1330,38,6,13,1336,1363,44,0,2143,1323,1319
54201,Nsylvestris_NODE_16756_length_1373_cov_144,Ntome_NODE_18044_length_1354_cov_129,95.715,1237,43,5,38,1273,119,1346,0,1982,1235,1227
54277,Nsylvestris_NODE_16790_length_1373_cov_182,Ntome_NODE_16902_length_1456_cov_219,90.538,1226,81,19,166,1368,1300,87,0,1589,1202,1213
54336,Nsylvestris_NODE_16814_length_1371_cov_174,Ntome_NODE_21770_length_1063_cov_244,92.338,1018,65,9,332,1345,55,1063,0,1435,1013,1008
54403,Nsylvestris_NODE_16839_length_1369_cov_19,Ntome_NODE_32598_length_506_cov_8,90.323,93,8,1,1272,1364,223,132,2.87E-26,121,92,91
54451,Nsylvestris_NODE_16857_length_1367_cov_194,Ntome_NODE_18505_length_1316_cov_259,93.286,1266,68,9,1,1249,51,1316,0,1851,1248,1265
54455,Nsylvestris_NODE_16860_length_1367_cov_145,Ntome_NODE_20072_length_1186_cov_172,95.14,1111,51,2,83,1193,1,1108,0,1749,1110,1107
54474,Nsylvestris_NODE_16867_length_1367_cov_63,Ntome_NODE_19868_length_1204_cov_10,93.383,1209,54,13,141,1331,4,1204,0,1766,1190,1200
54477,Nsylvestris_NODE_16869_length_1367_cov_48,Ntome_NODE_14819_length_1654_cov_67,91.81,1392,81,17,1,1367,1651,268,0,1908,1366,1383
54497,Nsylvestris_NODE_16879_length_1366_cov_134,Ntome_NODE_18920_length_1282_cov_136,89.837,1289,69,23,68,1331,1,1252,0,1598,1263,1251
54498,Nsylvestris_NODE_16881_length_1366_cov_85,Ntome_NODE_16228_length_1518_cov_243,91.783,1363,68,22,2,1332,57,1407,0,1857,1330,1350
54506,Nsylvestris_NODE_16886_length_1366_cov_34,Ntome_NODE_13097_length_1832_cov_13,94.849,1262,63,2,51,1311,519,1779,0,1969,1260,1260
54511,Nsylvestris_NODE_16889_length_1366_cov_5,Ntome_NODE_33460_length_448_cov_13,94.152,171,10,0,843,1013,207,37,1.61E-68,261,170,170
54532,Nsylvestris_NODE_16897_length_1365_cov_87,Ntome_NODE_18687_length_1302_cov_29,90.625,1280,61,15,62,1310,1252,1,0,1644,1248,1251
54538,Nsylvestris_NODE_16900_length_1365_cov_69,Ntome_NODE_39195_length_264_cov_2,92.893,197,14,0,1121,1317,1,197,2.66E-76,287,196,196
54539,Nsylvestris_NODE_16901_length_1365_cov_64,Ntome_NODE_27256_length_746_cov_8,95.699,744,32,0,569,1312,746,3,0,1197,743,743
54568,Nsylvestris_NODE_16914_length_1364_cov_50,Ntome_NODE_34411_length_400_cov_2,90.647,417,12,4,205,612,1,399,4.00E-149,529,407,398
54579,Nsylvestris_NODE_16920_length_1363_cov_187,Ntome_NODE_16194_length_1521_cov_238,94.254,1340,50,13,1,1327,1443,118,0,2023,1326,1325
54591,Nsylvestris_NODE_16927_length_1363_cov_15,Ntome_NODE_17570_length_1396_cov_33,95.158,1363,60,3,1,1363,1357,1,0,2146,1362,1356
54598,Nsylvestris_NODE_16931_length_1362_cov_172,Ntome_NODE_17892_length_1367_cov_141,92.188,1216,79,11,4,1208,1318,108,0,1705,1204,1210
54624,Nsylvestris_NODE_16943_length_1355_cov_115,Ntome_NODE_17950_length_1363_cov_23,96.755,1325,43,0,21,1345,1325,1,0,2209,1324,1324
54625,Nsylvestris_NODE_16944_length_1361_cov_67,Ntome_NODE_16422_length_1503_cov_127,93.5,1277,69,10,7,1281,188,1452,0,1886,1274,1264
54660,Nsylvestris_NODE_16960_length_1360_cov_24,Ntome_NODE_35456_length_356_cov_5,97.183,284,8,0,1077,1360,2,285,1.13E-134,481,283,283
54661,Nsylvestris_NODE_16961_length_1360_cov_23,Ntome_NODE_17275_length_1422_cov_253,93.684,1045,66,0,51,1095,1342,298,0,1565,1044,1044
54664,Nsylvestris_NODE_16965_length_1360_cov_8,Ntome_NODE_35420_length_357_cov_6,91.573,356,30,0,613,968,356,1,5.24E-138,492,355,355
54683,Nsylvestris_NODE_16973_length_1359_cov_134,Ntome_NODE_19754_length_1214_cov_140,92.632,1208,47,17,163,1359,1192,16,0,1700,1196,1176
54697,Nsylvestris_NODE_16979_length_1359_cov_15,Ntome_NODE_34760_length_384_cov_7,97.598,333,8,0,997,1329,383,51,6.53E-162,571,332,332
54736,Nsylvestris_NODE_16992_length_1358_cov_170,Ntome_NODE_20381_length_1163_cov_14,95.193,1165,53,2,54,1217,1,1163,0,1838,1163,1162
54795,Nsylvestris_NODE_17014_length_1356_cov_162,Ntome_NODE_27296_length_744_cov_2,95.302,745,25,7,534,1274,1,739,0,1173,740,738
54814,Nsylvestris_NODE_17023_length_1355_cov_201,Ntome_NODE_15795_length_1558_cov_277,91.753,1358,62,14,2,1328,157,1495,0,1842,1326,1338
54828,Nsylvestris_NODE_17028_length_1355_cov_75,Ntome_NODE_18723_length_1298_cov_145,92.105,1178,83,6,180,1350,1253,79,0,1652,1170,1174
54847,Nsylvestris_NODE_17035_length_1354_cov_106,Ntome_NODE_20251_length_1173_cov_293,92.589,958,41,14,111,1038,7,964,0,1349,927,957
54862,Nsylvestris_NODE_17041_length_1354_cov_24,Ntome_NODE_17421_length_1411_cov_111,95.174,1181,48,6,58,1235,1221,47,0,1857,1177,1174
54870,Nsylvestris_NODE_17047_length_1353_cov_182,Ntome_NODE_19549_length_1229_cov_289,92.07,1198,65,9,25,1211,1,1179,0,1659,1186,1178
54921,Nsylvestris_NODE_17068_length_1351_cov_69,Ntome_NODE_31844_length_559_cov_5,92.308,559,22,7,291,828,1,559,0,774,537,558
55065,Nsylvestris_NODE_17118_length_1347_cov_42,Ntome_NODE_16447_length_1501_cov_154,91.205,1319,103,7,42,1347,67,1385,0,1781,1305,1318
55097,Nsylvestris_NODE_17131_length_1346_cov_105,Ntome_NODE_25023_length_862_cov_32,94.016,869,27,8,476,1326,1,862,0,1293,850,861
55158,Nsylvestris_NODE_17159_length_1343_cov_171,Ntome_NODE_10570_length_2124_cov_80,93.702,1302,57,10,1,1293,801,2086,0,1927,1292,1285
55183,Nsylvestris_NODE_17173_length_1342_cov_93,Ntome_NODE_22970_length_985_cov_127,94.688,979,35,7,32,994,981,4,0,1504,962,977
55186,Nsylvestris_NODE_17175_length_1342_cov_88,Ntome_NODE_18601_length_1308_cov_202,92.914,1129,54,14,57,1160,1258,131,0,1618,1103,1127
55202,Nsylvestris_NODE_17182_length_1342_cov_16,Ntome_NODE_12938_length_1848_cov_56,91.818,1320,106,2,23,1342,1750,433,0,1838,1319,1317
55215,Nsylvestris_NODE_17187_length_1341_cov_215,Ntome_NODE_18952_length_1280_cov_250,95.185,1163,52,2,63,1221,1209,47,0,1834,1158,1162
55236,Nsylvestris_NODE_17195_length_1341_cov_9,Ntome_NODE_7777_length_2528_cov_63,92.132,1182,93,0,4,1185,2386,1205,0,1668,1181,1181
55241,Nsylvestris_NODE_17197_length_1340_cov_198,Ntome_NODE_19387_length_1243_cov_254,95.522,871,30,4,124,994,1240,379,0,1384,870,861
55265,Nsylvestris_NODE_17206_length_1341_cov_15,Ntome_NODE_31971_length_552_cov_23,86.364,352,43,3,467,815,188,537,4.19E-104,379,348,349
55288,Nsylvestris_NODE_17216_length_1339_cov_37,Ntome_NODE_20482_length_1155_cov_16,92.514,1082,58,9,20,1086,1154,81,0,1528,1066,1073
55301,Nsylvestris_NODE_17224_length_1338_cov_206,Ntome_NODE_16803_length_1465_cov_263,94.829,1315,38,5,12,1297,1465,152,0,2025,1285,1313
55306,Nsylvestris_NODE_17227_length_1338_cov_141,Ntome_NODE_19555_length_1229_cov_10,92.421,1227,56,10,127,1319,1224,1,0,1716,1192,1223
55327,Nsylvestris_NODE_17235_length_1337_cov_188,Ntome_NODE_18335_length_1331_cov_236,94.804,1251,59,3,1,1248,42,1289,0,1945,1247,1247
55330,Nsylvestris_NODE_17237_length_1337_cov_135,Ntome_NODE_7365_length_2592_cov_69,91.736,1319,80,5,22,1337,2451,1159,0,1805,1315,1292
55345,Nsylvestris_NODE_17243_length_1337_cov_22,Ntome_NODE_39072_length_266_cov_2,98.496,266,4,0,628,893,266,1,2.41E-131,470,265,265
55388,Nsylvestris_NODE_17262_length_1335_cov_172,Ntome_NODE_24080_length_919_cov_263,95.517,870,23,3,54,922,872,18,0,1376,868,854
55396,Nsylvestris_NODE_17265_length_1335_cov_104,Ntome_NODE_24088_length_919_cov_78,90.642,919,47,16,416,1304,10,919,0,1184,888,909
55416,Nsylvestris_NODE_17272_length_1334_cov_218,Ntome_NODE_16262_length_1515_cov_224,91.673,1297,87,12,54,1334,124,1415,0,1777,1280,1291
55419,Nsylvestris_NODE_17274_length_1334_cov_201,Ntome_NODE_18362_length_1329_cov_71,94.406,1287,64,4,15,1297,1,1283,0,1971,1282,1282
55431,Nsylvestris_NODE_17278_length_1334_cov_173,Ntome_NODE_20271_length_1171_cov_240,96.233,1115,41,1,3,1117,1163,50,0,1825,1114,1113
55500,Nsylvestris_NODE_17305_length_1331_cov_164,Ntome_NODE_20683_length_1139_cov_209,96.269,1099,38,3,234,1331,1139,43,0,1799,1097,1096
55594,Nsylvestris_NODE_17339_length_1328_cov_167,Ntome_NODE_16385_length_1506_cov_230,93.622,1270,50,6,88,1328,214,1481,0,1868,1240,1267
55629,Nsylvestris_NODE_17353_length_1327_cov_79,Ntome_NODE_17818_length_1373_cov_82,91.82,1308,61,20,43,1325,1287,1,0,1781,1282,1286
55636,Nsylvestris_NODE_17356_length_1327_cov_16,Ntome_NODE_27591_length_728_cov_143,89.032,310,30,4,631,938,1,308,1.15E-104,381,307,307
55854,Nsylvestris_NODE_17449_length_1318_cov_212,Ntome_NODE_19400_length_1242_cov_244,91.771,1118,63,15,30,1146,1233,144,0,1528,1116,1089
55856,Nsylvestris_NODE_17451_length_1318_cov_181,Ntome_NODE_17842_length_1371_cov_269,91.25,1280,53,16,27,1266,78,1338,0,1688,1239,1260
55966,Nsylvestris_NODE_17483_length_1315_cov_190,Ntome_NODE_20654_length_1141_cov_162,92.231,1107,61,10,120,1222,2,1087,0,1544,1102,1085
56038,Nsylvestris_NODE_17512_length_1312_cov_136,Ntome_NODE_16888_length_1457_cov_277,91.808,1294,88,11,26,1311,1351,68,0,1786,1285,1283
56059,Nsylvestris_NODE_17521_length_1311_cov_61,Ntome_NODE_12476_length_1900_cov_119,93.548,1209,44,10,10,1186,1736,530,0,1770,1176,1206
56067,Nsylvestris_NODE_17526_length_1311_cov_23,Ntome_NODE_17080_length_1441_cov_114,91.37,1321,73,21,1,1311,102,1391,0,1770,1310,1289
56079,Nsylvestris_NODE_17532_length_1310_cov_52,Ntome_NODE_30083_length_624_cov_135,80,370,59,5,544,900,368,1,5.56E-68,259,356,367
56125,Nsylvestris_NODE_17553_length_1308_cov_38,Ntome_NODE_21865_length_1057_cov_14,95.902,1025,41,1,270,1294,1,1024,0,1659,1024,1023
56129,Nsylvestris_NODE_17555_length_1308_cov_25,Ntome_NODE_21624_length_1073_cov_18,94.051,975,58,0,315,1289,997,23,0,1480,974,974
56216,Nsylvestris_NODE_17590_length_1304_cov_159,Ntome_NODE_18197_length_1342_cov_286,93.475,1318,38,7,1,1293,48,1342,0,1914,1292,1294
56217,Nsylvestris_NODE_17591_length_1304_cov_157,Ntome_NODE_17615_length_1392_cov_61,94.768,1166,59,2,96,1260,214,1378,0,1814,1164,1164
56240,Nsylvestris_NODE_17601_length_1303_cov_93,Ntome_NODE_19434_length_1239_cov_163,92.617,1192,68,14,116,1300,1191,13,0,1696,1184,1178
56244,Nsylvestris_NODE_17603_length_1303_cov_29,Ntome_NODE_22040_length_1046_cov_2,95.92,1054,27,13,52,1100,1,1043,0,1694,1048,1042
56245,Nsylvestris_NODE_17604_length_1302_cov_206,Ntome_NODE_24441_length_896_cov_212,95.764,897,32,4,103,994,1,896,0,1441,891,895
56246,Nsylvestris_NODE_17606_length_1302_cov_185,Ntome_NODE_15018_length_1633_cov_196,93.497,1307,49,16,1,1302,316,1591,0,1910,1301,1275
56293,Nsylvestris_NODE_17624_length_1301_cov_11,Ntome_NODE_22403_length_1023_cov_7,95.956,989,37,2,24,1009,30,1018,0,1602,985,988
56329,Nsylvestris_NODE_17638_length_1299_cov_104,Ntome_NODE_20956_length_1119_cov_119,94.041,772,44,2,483,1253,1085,315,0,1170,770,770
56357,Nsylvestris_NODE_17648_length_1298_cov_197,Ntome_NODE_29281_length_657_cov_15,81.771,192,27,5,532,723,116,299,2.68E-36,154,191,183
56364,Nsylvestris_NODE_17652_length_1298_cov_106,Ntome_NODE_18243_length_1339_cov_117,91.99,1261,68,21,44,1292,1251,12,0,1738,1248,1239
56365,Nsylvestris_NODE_17653_length_1298_cov_81,Ntome_NODE_21025_length_1114_cov_24,90.877,1140,50,17,78,1189,1114,1,0,1480,1111,1113
56393,Nsylvestris_NODE_17666_length_1297_cov_92,Ntome_NODE_30835_length_595_cov_7,96.866,351,7,2,450,797,595,246,8.00E-166,584,347,349
56447,Nsylvestris_NODE_17687_length_1295_cov_107,Ntome_NODE_20522_length_1152_cov_115,94.32,1074,60,1,11,1083,8,1081,0,1644,1072,1073
56490,Nsylvestris_NODE_17703_length_1294_cov_59,Ntome_NODE_17467_length_1406_cov_172,93.937,1270,77,0,1,1270,105,1374,0,1919,1269,1269
56535,Nsylvestris_NODE_17721_length_1292_cov_206,Ntome_NODE_18089_length_1350_cov_255,95.628,892,35,1,1,888,86,977,0,1428,887,891
56539,Nsylvestris_NODE_17723_length_1292_cov_158,Ntome_NODE_18395_length_1326_cov_219,94.856,1283,50,6,10,1292,1289,23,0,1989,1282,1266
56549,Nsylvestris_NODE_17730_length_1292_cov_8,Ntome_NODE_35725_length_347_cov_4,94.509,346,19,0,695,1040,347,2,8.14E-151,534,345,345
56630,Nsylvestris_NODE_17763_length_1289_cov_15,Ntome_NODE_33709_length_434_cov_7,86.444,450,27,11,677,1108,434,1,3.89E-129,462,431,433
56751,Nsylvestris_NODE_17813_length_1285_cov_171,Ntome_NODE_18583_length_1309_cov_270,94.01,1202,61,7,89,1285,1257,62,0,1810,1196,1195
56779,Nsylvestris_NODE_17824_length_1284_cov_70,Ntome_NODE_18638_length_1305_cov_106,95.133,1089,41,5,7,1092,1129,50,0,1707,1085,1079
56824,Nsylvestris_NODE_17841_length_1282_cov_220,Ntome_NODE_15759_length_1562_cov_255,94.269,1204,49,11,51,1235,1289,87,0,1823,1184,1202
56856,Nsylvestris_NODE_17852_length_1281_cov_218,Ntome_NODE_18630_length_1305_cov_278,96.822,1227,31,6,45,1264,1234,9,0,2043,1219,1225
56865,Nsylvestris_NODE_17856_length_1281_cov_77,Ntome_NODE_22298_length_1028_cov_49,85.899,1007,84,19,289,1264,980,1,0,1020,975,979
56937,Nsylvestris_NODE_17889_length_1275_cov_226,Ntome_NODE_15676_length_1573_cov_263,98.129,1176,20,1,57,1232,1426,253,0,2049,1175,1173
56938,Nsylvestris_NODE_17890_length_1277_cov_218,Ntome_NODE_17781_length_1376_cov_231,96.653,1255,42,0,1,1255,90,1344,0,2085,1254,1254
56968,Nsylvestris_NODE_17903_length_1276_cov_186,Ntome_NODE_18771_length_1294_cov_231,92.054,1271,69,13,12,1276,1261,17,0,1759,1264,1244
56982,Nsylvestris_NODE_17910_length_1276_cov_62,Ntome_NODE_22092_length_1042_cov_16,93.103,638,41,3,480,1116,1,636,0,931,636,635
56986,Nsylvestris_NODE_17912_length_1276_cov_55,Ntome_NODE_33409_length_451_cov_4,91.814,452,35,2,574,1024,1,451,3.58E-179,628,450,450
57002,Nsylvestris_NODE_17918_length_1275_cov_85,Ntome_NODE_15841_length_1554_cov_190,92.747,1227,54,10,68,1275,1269,59,0,1740,1207,1210
57003,Nsylvestris_NODE_17919_length_1275_cov_69,Ntome_NODE_34421_length_399_cov_4,93.155,336,23,0,258,593,336,1,1.36E-138,494,335,335
57010,Nsylvestris_NODE_17922_length_1275_cov_39,Ntome_NODE_22569_length_1012_cov_1,86.537,1025,78,25,132,1131,1,990,0,1074,999,989
57011,Nsylvestris_NODE_17923_length_1275_cov_35,Ntome_NODE_17597_length_1394_cov_18,93.064,1211,77,5,35,1239,2,1211,0,1764,1204,1209
57057,Nsylvestris_NODE_17938_length_1273_cov_69,Ntome_NODE_16966_length_1451_cov_236,92.47,1235,68,13,47,1273,184,1401,0,1742,1226,1217
57107,Nsylvestris_NODE_17963_length_1271_cov_75,Ntome_NODE_16541_length_1493_cov_99,92.878,1011,53,5,81,1081,1368,367,0,1450,1000,1001
57118,Nsylvestris_NODE_17966_length_1271_cov_13,Ntome_NODE_18971_length_1279_cov_6,95.094,795,36,1,1,792,795,1,0,1249,791,794
57146,Nsylvestris_NODE_17981_length_1269_cov_209,Ntome_NODE_18014_length_1357_cov_287,95.336,1222,43,5,1,1222,1309,102,0,1929,1221,1207
57147,Nsylvestris_NODE_17982_length_1269_cov_195,Ntome_NODE_19559_length_1227_cov_287,94.486,1215,54,8,60,1269,1,1207,0,1860,1209,1206
57194,Nsylvestris_NODE_18001_length_1268_cov_191,Ntome_NODE_13845_length_1752_cov_77,94.434,1114,43,2,81,1193,249,1344,0,1696,1112,1095
57258,Nsylvestris_NODE_18025_length_1266_cov_21,Ntome_NODE_16202_length_1521_cov_39,94.239,1215,67,2,5,1219,1438,227,0,1853,1214,1211
57271,Nsylvestris_NODE_18030_length_1265_cov_212,Ntome_NODE_16852_length_1460_cov_249,96.598,1205,37,2,50,1253,147,1348,0,1995,1203,1201
57281,Nsylvestris_NODE_18035_length_1265_cov_66,Ntome_NODE_16098_length_1531_cov_258,95.78,1256,36,11,1,1253,1288,47,0,2010,1252,1241
57310,Nsylvestris_NODE_18047_length_1264_cov_189,Ntome_NODE_15046_length_1630_cov_240,93.486,1136,61,7,130,1255,1284,152,0,1676,1125,1132
57358,Nsylvestris_NODE_18069_length_1262_cov_103,Ntome_NODE_18939_length_1281_cov_209,96.548,956,29,2,263,1214,1147,192,0,1580,951,955
57414,Nsylvestris_NODE_18093_length_1260_cov_64,Ntome_NODE_32977_length_480_cov_4,95.082,488,15,1,718,1205,1,479,0,760,487,478
57499,Nsylvestris_NODE_18129_length_1256_cov_59,Ntome_NODE_17769_length_1377_cov_115,89.168,1274,59,28,4,1233,107,1345,0,1515,1229,1238
57525,Nsylvestris_NODE_18142_length_1255_cov_16,Ntome_NODE_14694_length_1667_cov_37,93.503,1216,45,9,7,1198,138,1343,0,1777,1191,1205
57530,Nsylvestris_NODE_18144_length_1255_cov_13,Ntome_NODE_18568_length_1311_cov_19,84.675,1292,119,28,1,1255,41,1290,0,1216,1254,1249
57531,Nsylvestris_NODE_18145_length_1255_cov_7,Ntome_NODE_33887_length_425_cov_5,91.206,398,32,3,385,782,10,404,6.11E-152,538,397,394
57537,Nsylvestris_NODE_18147_length_1254_cov_190,Ntome_NODE_18434_length_1322_cov_266,95.05,1212,45,10,36,1242,105,1306,0,1892,1206,1201
57605,Nsylvestris_NODE_18179_length_1252_cov_102,Ntome_NODE_24870_length_871_cov_5,95.519,848,31,4,105,950,846,4,0,1349,845,842
57606,Nsylvestris_NODE_18180_length_1252_cov_82,Ntome_NODE_21271_length_1097_cov_26,90.578,1072,76,11,121,1189,38,1087,0,1397,1068,1049
57623,Nsylvestris_NODE_18186_length_1251_cov_205,Ntome_NODE_17784_length_1376_cov_114,94.477,1195,54,6,16,1204,1241,53,0,1831,1188,1188
57650,Nsylvestris_NODE_18199_length_1250_cov_172,Ntome_NODE_14562_length_1679_cov_131,95.725,959,22,7,34,981,128,1078,0,1526,947,950
57691,Nsylvestris_NODE_18212_length_1249_cov_101,Ntome_NODE_21874_length_1045_cov_113,94.372,995,50,6,96,1086,2,994,0,1522,990,992
57727,Nsylvestris_NODE_18226_length_1248_cov_15,Ntome_NODE_27612_length_728_cov_5,95.524,715,22,4,12,724,707,1,0,1134,712,706
57750,Nsylvestris_NODE_18236_length_1247_cov_32,Ntome_NODE_1903_length_4234_cov_152,93.975,1029,60,2,155,1182,4234,3207,0,1555,1027,1027
57772,Nsylvestris_NODE_18248_length_1248_cov_6,Ntome_NODE_14925_length_1643_cov_41,92.693,1259,77,7,2,1248,89,1344,0,1801,1246,1255
57791,Nsylvestris_NODE_18253_length_1245_cov_205,Ntome_NODE_20950_length_1119_cov_224,93.184,1027,40,10,2,999,1102,77,0,1482,997,1025
57797,Nsylvestris_NODE_18256_length_1245_cov_130,Ntome_NODE_22601_length_1010_cov_25,93.794,999,50,7,176,1168,15,1007,0,1491,992,992
57801,Nsylvestris_NODE_18258_length_1245_cov_20,Ntome_NODE_20864_length_1127_cov_35,94.605,1001,47,3,123,1117,1086,87,0,1543,994,999
57876,Nsylvestris_NODE_18289_length_1242_cov_35,Ntome_NODE_17965_length_1361_cov_84,93.621,1160,35,11,2,1152,1350,221,0,1696,1150,1129
57974,Nsylvestris_NODE_18331_length_1238_cov_227,Ntome_NODE_16533_length_1493_cov_234,93.955,1158,46,15,49,1204,1156,21,0,1729,1155,1135
57981,Nsylvestris_NODE_18334_length_1238_cov_182,Ntome_NODE_18967_length_1279_cov_134,92.931,1061,48,6,3,1053,1262,219,0,1519,1050,1043
57982,Nsylvestris_NODE_18335_length_1238_cov_181,Ntome_NODE_18078_length_1351_cov_233,94.246,1147,52,9,56,1195,1323,184,0,1740,1139,1139
58082,Nsylvestris_NODE_18380_length_1232_cov_96,Ntome_NODE_29195_length_660_cov_44,84.153,183,25,4,470,650,455,635,1.95E-42,174,180,180
58086,Nsylvestris_NODE_18383_length_1234_cov_32,Ntome_NODE_12101_length_1944_cov_225,92.014,1127,52,14,111,1234,1806,715,0,1548,1123,1091
58282,Nsylvestris_NODE_18468_length_1227_cov_82,Ntome_NODE_28645_length_682_cov_30,93.182,44,2,1,376,418,560,517,4.38E-09,63.9,42,43
58388,Nsylvestris_NODE_18512_length_1223_cov_190,Ntome_NODE_15498_length_1584_cov_229,94.113,1223,52,8,2,1222,1567,363,0,1842,1220,1204
58428,Nsylvestris_NODE_18527_length_1222_cov_23,Ntome_NODE_19198_length_1260_cov_41,91.424,1201,40,14,1,1168,1171,1,0,1589,1167,1170
58458,Nsylvestris_NODE_18539_length_1221_cov_91,Ntome_NODE_20416_length_1160_cov_175,94.872,1053,51,2,172,1221,56,1108,0,1642,1049,1052
58474,Nsylvestris_NODE_18548_length_1220_cov_153,Ntome_NODE_22762_length_999_cov_16,93.089,955,46,6,201,1144,20,965,0,1380,943,945
58505,Nsylvestris_NODE_18560_length_1219_cov_173,Ntome_NODE_24726_length_878_cov_107,94.759,725,38,0,240,964,113,837,0,1129,724,724
58513,Nsylvestris_NODE_18564_length_1219_cov_53,Ntome_NODE_18398_length_1326_cov_21,93.437,1219,67,4,1,1219,23,1228,0,1796,1218,1205
58556,Nsylvestris_NODE_18581_length_1218_cov_170,Ntome_NODE_23559_length_951_cov_17,92.782,859,43,8,241,1087,100,951,0,1225,846,851
58598,Nsylvestris_NODE_18600_length_1217_cov_129,Ntome_NODE_21954_length_1052_cov_54,90.819,708,56,3,58,765,10,708,0,939,707,698
58602,Nsylvestris_NODE_18602_length_1217_cov_81,Ntome_NODE_23654_length_946_cov_15,92.209,783,33,11,323,1095,765,1,0,1083,772,764
58615,Nsylvestris_NODE_18609_length_1217_cov_7,Ntome_NODE_14889_length_1645_cov_92,85.494,324,30,7,60,382,871,1178,6.49E-87,322,322,307
58619,Nsylvestris_NODE_18611_length_1216_cov_197,Ntome_NODE_19293_length_1252_cov_242,95.207,1210,50,5,11,1213,3,1211,0,1906,1202,1208
58647,Nsylvestris_NODE_18623_length_1215_cov_118,Ntome_NODE_21375_length_1090_cov_41,95.281,1102,31,8,83,1183,7,1088,0,1727,1100,1081
58733,Nsylvestris_NODE_18656_length_1213_cov_70,Ntome_NODE_19217_length_1258_cov_258,93.48,1043,50,8,95,1129,87,1119,0,1533,1034,1032
58740,Nsylvestris_NODE_18659_length_1213_cov_31,Ntome_NODE_18405_length_1325_cov_43,92.938,1147,59,8,11,1150,1274,143,0,1650,1139,1131
58842,Nsylvestris_NODE_18699_length_1209_cov_151,Ntome_NODE_21039_length_1113_cov_50,94.408,1055,41,5,172,1209,1,1054,0,1605,1037,1053
58875,Nsylvestris_NODE_18714_length_1208_cov_95,Ntome_NODE_18773_length_1294_cov_101,91.852,1166,70,12,1,1159,1217,70,0,1604,1158,1147
58923,Nsylvestris_NODE_18732_length_1207_cov_72,Ntome_NODE_34167_length_411_cov_4,89.448,417,36,1,27,443,3,411,2.13E-146,520,416,408
58980,Nsylvestris_NODE_18758_length_1205_cov_187,Ntome_NODE_16355_length_1508_cov_229,96.231,902,30,3,266,1163,449,1350,0,1474,897,901
58985,Nsylvestris_NODE_18761_length_1205_cov_167,Ntome_NODE_18312_length_1332_cov_277,93.451,1191,66,6,8,1197,1332,153,0,1757,1189,1179
59022,Nsylvestris_NODE_18782_length_1203_cov_208,Ntome_NODE_19628_length_1223_cov_291,93.582,1044,55,3,117,1158,48,1081,0,1546,1041,1033
59031,Nsylvestris_NODE_18786_length_1203_cov_159,Ntome_NODE_18034_length_1355_cov_149,94.587,1016,52,2,43,1057,1022,9,0,1568,1014,1013
59032,Nsylvestris_NODE_18787_length_1203_cov_147,Ntome_NODE_18674_length_1302_cov_282,90.73,1165,50,19,51,1203,133,1251,0,1500,1152,1118
59045,Nsylvestris_NODE_18795_length_1202_cov_177,Ntome_NODE_16062_length_1534_cov_192,91.346,1144,47,9,50,1147,1302,165,0,1517,1097,1137
59102,Nsylvestris_NODE_18821_length_1200_cov_71,Ntome_NODE_19519_length_1233_cov_12,94.976,1035,49,1,169,1200,116,1150,0,1620,1031,1034
59147,Nsylvestris_NODE_18839_length_1198_cov_116,Ntome_NODE_19818_length_1208_cov_118,93.656,1198,54,11,9,1192,1,1190,0,1772,1183,1189
59182,Nsylvestris_NODE_18858_length_1196_cov_210,Ntome_NODE_19158_length_1262_cov_276,93.069,1111,57,12,55,1157,11,1109,0,1607,1102,1098
59187,Nsylvestris_NODE_18861_length_1196_cov_177,Ntome_NODE_22383_length_1024_cov_17,95.034,1027,35,5,58,1071,1024,1,0,1600,1013,1023
59208,Nsylvestris_NODE_18872_length_1195_cov_188,Ntome_NODE_20856_length_1126_cov_288,92.537,1139,48,9,4,1123,6,1126,0,1598,1119,1120
59264,Nsylvestris_NODE_18893_length_1193_cov_198,Ntome_NODE_21540_length_1078_cov_271,93.303,1090,40,13,26,1102,7,1076,0,1578,1076,1069
59272,Nsylvestris_NODE_18898_length_1193_cov_16,Ntome_NODE_11581_length_2005_cov_47,95.39,1193,46,1,1,1193,1809,626,0,1890,1192,1183
59275,Nsylvestris_NODE_18900_length_1192_cov_176,Ntome_NODE_22155_length_1037_cov_174,94.532,951,27,11,1,932,39,983,0,1445,931,944
59290,Nsylvestris_NODE_18907_length_1192_cov_43,Ntome_NODE_15318_length_1603_cov_72,96.86,860,24,1,105,964,1468,612,0,1435,859,856
59462,Nsylvestris_NODE_18982_length_1185_cov_181,Ntome_NODE_19790_length_1211_cov_156,85.493,1034,84,20,53,1049,149,1153,0,1018,996,1004
59508,Nsylvestris_NODE_19004_length_1183_cov_111,Ntome_NODE_23485_length_956_cov_6,95.329,942,42,2,133,1073,956,16,0,1495,940,940
59541,Nsylvestris_NODE_19018_length_1182_cov_168,Ntome_NODE_15571_length_1578_cov_181,94.806,1136,48,5,1,1126,427,1561,0,1760,1125,1134
59571,Nsylvestris_NODE_19037_length_1180_cov_226,Ntome_NODE_18645_length_1304_cov_265,95.782,1138,37,3,53,1180,27,1163,0,1825,1127,1136
59593,Nsylvestris_NODE_19048_length_1179_cov_194,Ntome_NODE_23732_length_940_cov_177,90.551,889,63,6,1,889,913,46,0,1157,888,867
59595,Nsylvestris_NODE_19050_length_1179_cov_182,Ntome_NODE_18436_length_1322_cov_162,88.259,1252,48,28,4,1177,1257,27,0,1406,1173,1230
59665,Nsylvestris_NODE_19077_length_1177_cov_112,Ntome_NODE_32951_length_481_cov_165,96.899,387,12,0,53,439,387,1,0,649,386,386
59666,Nsylvestris_NODE_19078_length_1177_cov_79,Ntome_NODE_18931_length_1282_cov_8,93.678,949,48,2,106,1051,1236,297,0,1410,945,939
59698,Nsylvestris_NODE_19091_length_1176_cov_167,Ntome_NODE_22567_length_1012_cov_22,94.244,1025,29,11,61,1068,1,1012,0,1539,1007,1011
59710,Nsylvestris_NODE_19097_length_1175_cov_50,Ntome_NODE_35881_length_342_cov_20,92.857,42,1,2,37,77,258,218,5.42E-08,60.2,40,40
59766,Nsylvestris_NODE_19122_length_1174_cov_45,Ntome_NODE_18977_length_1278_cov_200,94.332,1182,57,1,1,1172,1244,63,0,1803,1171,1181
59779,Nsylvestris_NODE_19128_length_1173_cov_191,Ntome_NODE_21134_length_1106_cov_240,93.275,922,57,5,201,1122,177,1093,0,1354,921,916
59796,Nsylvestris_NODE_19136_length_1172_cov_205,Ntome_NODE_21838_length_1058_cov_293,94.235,1006,43,6,58,1055,1,999,0,1522,997,998
59808,Nsylvestris_NODE_19141_length_1172_cov_164,Ntome_NODE_19229_length_1257_cov_185,91.976,1159,59,11,1,1146,103,1240,0,1594,1145,1137
59814,Nsylvestris_NODE_19145_length_1172_cov_56,Ntome_NODE_29746_length_638_cov_189,97.297,37,1,0,262,298,111,75,4.18E-09,63.9,36,36
59848,Nsylvestris_NODE_19165_length_1170_cov_179,Ntome_NODE_20114_length_1183_cov_254,92.445,1178,40,13,1,1133,1,1174,0,1637,1132,1173
59858,Nsylvestris_NODE_19169_length_1170_cov_66,Ntome_NODE_32101_length_542_cov_171,90.625,288,18,5,835,1117,107,390,1.70E-102,374,282,283
59869,Nsylvestris_NODE_19178_length_1169_cov_88,Ntome_NODE_20754_length_1134_cov_164,92.074,921,46,9,202,1120,237,1132,0,1271,918,895
59883,Nsylvestris_NODE_19184_length_1169_cov_9,Ntome_NODE_14927_length_1643_cov_21,88.679,53,3,3,843,895,1081,1130,1.50E-08,62.1,52,49
59933,Nsylvestris_NODE_19206_length_1167_cov_195,Ntome_NODE_18471_length_1319_cov_190,91.881,973,77,2,59,1030,1193,222,0,1358,971,971
59934,Nsylvestris_NODE_19207_length_1167_cov_104,Ntome_NODE_20670_length_1140_cov_41,93.116,1104,54,17,31,1132,1140,57,0,1598,1101,1083
59966,Nsylvestris_NODE_19221_length_1166_cov_78,Ntome_NODE_19138_length_1264_cov_203,87.903,1149,63,29,27,1114,93,1226,0,1282,1087,1133
59968,Nsylvestris_NODE_19223_length_1166_cov_63,Ntome_NODE_19035_length_1273_cov_194,86.043,652,59,20,200,844,38,664,0,671,644,626
60038,Nsylvestris_NODE_19249_length_1164_cov_22,Ntome_NODE_16718_length_1475_cov_38,86.402,831,83,13,301,1122,995,186,0,881,821,809
60073,Nsylvestris_NODE_19261_length_1163_cov_11,Ntome_NODE_21426_length_1087_cov_5,95.698,1046,45,0,17,1062,42,1087,0,1683,1045,1045
60103,Nsylvestris_NODE_19272_length_1162_cov_139,Ntome_NODE_20653_length_1141_cov_175,91.136,1083,63,21,48,1122,9,1066,0,1437,1074,1057
60135,Nsylvestris_NODE_19286_length_1161_cov_198,Ntome_NODE_21516_length_1080_cov_190,96.397,1027,30,3,142,1161,1028,2,0,1685,1019,1026
60148,Nsylvestris_NODE_19289_length_1161_cov_182,Ntome_NODE_21433_length_1086_cov_90,90.167,956,61,18,126,1054,106,1055,0,1214,928,949
60156,Nsylvestris_NODE_19292_length_1161_cov_122,Ntome_NODE_19986_length_1193_cov_74,89.5,1019,70,14,159,1141,1018,1,0,1254,982,1017
60190,Nsylvestris_NODE_19307_length_1160_cov_200,Ntome_NODE_20984_length_1117_cov_239,94.804,1020,46,4,82,1095,80,1098,0,1583,1013,1018
60195,Nsylvestris_NODE_19311_length_1160_cov_82,Ntome_NODE_19609_length_1225_cov_124,87.874,1171,63,33,1,1122,43,1183,0,1303,1121,1140
60247,Nsylvestris_NODE_19337_length_1157_cov_20,Ntome_NODE_5371_length_2993_cov_59,89.474,76,6,2,722,796,2986,2912,1.46E-18,95.3,74,74
60277,Nsylvestris_NODE_19348_length_1156_cov_8,Ntome_NODE_36764_length_317_cov_3,85.938,128,2,1,1,128,112,1,6.70E-27,122,127,111
60308,Nsylvestris_NODE_19362_length_1154_cov_204,Ntome_NODE_20081_length_1185_cov_278,95.018,1104,41,9,53,1154,93,1184,0,1722,1101,1091
60317,Nsylvestris_NODE_19365_length_1154_cov_190,Ntome_NODE_20649_length_1141_cov_251,94.703,944,47,3,146,1089,963,23,0,1463,943,940
60323,Nsylvestris_NODE_19368_length_1154_cov_177,Ntome_NODE_20899_length_1123_cov_273,96.429,1064,38,0,85,1148,1074,11,0,1755,1063,1063
60329,Nsylvestris_NODE_19372_length_1154_cov_92,Ntome_NODE_25340_length_841_cov_67,95.504,734,30,3,210,940,56,789,0,1170,730,733
60347,Nsylvestris_NODE_19380_length_1153_cov_174,Ntome_NODE_20043_length_1188_cov_217,91.503,1071,44,14,102,1134,1164,103,0,1430,1032,1061
60422,Nsylvestris_NODE_19414_length_1151_cov_14,Ntome_NODE_27534_length_731_cov_3,91.787,694,54,3,323,1014,3,695,0,963,691,692
60432,Nsylvestris_NODE_19420_length_1150_cov_213,Ntome_NODE_19316_length_1250_cov_251,94.306,1124,53,5,1,1113,82,1205,0,1711,1112,1123
60466,Nsylvestris_NODE_19435_length_1149_cov_192,Ntome_NODE_15893_length_1548_cov_231,97.196,856,24,0,247,1102,293,1148,0,1448,855,855
60467,Nsylvestris_NODE_19436_length_1149_cov_180,Ntome_NODE_17857_length_1370_cov_205,95.462,1146,44,5,1,1143,132,1272,0,1821,1142,1140
60479,Nsylvestris_NODE_19443_length_1148_cov_203,Ntome_NODE_20310_length_1168_cov_258,92.398,1026,70,5,70,1094,1029,11,0,1456,1024,1018
60480,Nsylvestris_NODE_19444_length_1148_cov_188,Ntome_NODE_20223_length_1175_cov_261,93.462,933,47,10,101,1021,50,980,0,1373,920,930
60501,Nsylvestris_NODE_19453_length_1148_cov_27,Ntome_NODE_4055_length_3333_cov_129,89.758,908,62,8,8,891,2312,3212,0,1133,883,900
60513,Nsylvestris_NODE_19458_length_1148_cov_7,Ntome_NODE_13312_length_1807_cov_56,93.49,1152,59,8,2,1148,1367,227,0,1698,1146,1140
60559,Nsylvestris_NODE_19477_length_1145_cov_194,Ntome_NODE_22431_length_1020_cov_248,96.95,787,21,2,289,1073,786,1,0,1317,784,785
60568,Nsylvestris_NODE_19482_length_1145_cov_30,Ntome_NODE_22648_length_1007_cov_19,96.142,1011,30,5,14,1019,1,1007,0,1642,1005,1006
60570,Nsylvestris_NODE_19484_length_1145_cov_11,Ntome_NODE_19450_length_1238_cov_23,95.494,1154,41,5,1,1145,1217,66,0,1832,1144,1151
60573,Nsylvestris_NODE_19486_length_1145_cov_9,Ntome_NODE_11245_length_2043_cov_209,93.103,1160,65,4,1,1145,758,1917,0,1685,1144,1159
60593,Nsylvestris_NODE_19495_length_1144_cov_25,Ntome_NODE_18744_length_1296_cov_210,94.159,1147,37,14,1,1144,1236,117,0,1720,1143,1119
60629,Nsylvestris_NODE_19509_length_1142_cov_202,Ntome_NODE_22560_length_1012_cov_225,94.515,948,49,2,136,1080,1,948,0,1459,944,947
60653,Nsylvestris_NODE_19519_length_1141_cov_213,Ntome_NODE_20737_length_1135_cov_280,94.99,978,38,5,144,1115,1022,50,0,1524,971,972
60737,Nsylvestris_NODE_19555_length_1139_cov_135,Ntome_NODE_30710_length_600_cov_4,97.487,557,14,0,187,743,557,1,0,952,556,556
60770,Nsylvestris_NODE_19569_length_1137_cov_149,Ntome_NODE_21136_length_1106_cov_204,96.108,925,35,1,1,925,142,1065,0,1507,924,923
60779,Nsylvestris_NODE_19572_length_1137_cov_47,Ntome_NODE_21096_length_1109_cov_19,93.939,1056,61,2,38,1093,1,1053,0,1592,1055,1052
60822,Nsylvestris_NODE_19587_length_1135_cov_215,Ntome_NODE_20622_length_1143_cov_234,92.929,1089,58,8,20,1103,27,1101,0,1567,1083,1074
60828,Nsylvestris_NODE_19590_length_1135_cov_203,Ntome_NODE_21499_length_1081_cov_245,96.135,1035,32,5,35,1066,1038,9,0,1683,1031,1029
60906,Nsylvestris_NODE_19623_length_1133_cov_200,Ntome_NODE_19254_length_1255_cov_159,94.218,1055,51,6,1,1048,75,1126,0,1602,1047,1051
60927,Nsylvestris_NODE_19632_length_1132_cov_219,Ntome_NODE_19162_length_1262_cov_235,90.771,1116,81,10,1,1109,1101,1,0,1471,1108,1100
60953,Nsylvestris_NODE_19643_length_1131_cov_203,Ntome_NODE_29524_length_647_cov_123,91.068,571,25,9,124,684,4,558,0,749,560,554
60977,Nsylvestris_NODE_19656_length_1130_cov_207,Ntome_NODE_17604_length_1393_cov_221,94.711,1021,51,2,51,1068,1263,243,0,1583,1017,1020
61007,Nsylvestris_NODE_19671_length_1129_cov_68,Ntome_NODE_22088_length_1042_cov_62,95.938,1034,36,3,15,1042,1034,1,0,1672,1027,1033
61034,Nsylvestris_NODE_19686_length_1128_cov_119,Ntome_NODE_16776_length_1468_cov_182,93.607,1048,56,6,38,1078,3,1046,0,1554,1040,1043
61071,Nsylvestris_NODE_19702_length_1127_cov_119,Ntome_NODE_23326_length_964_cov_19,88.599,921,59,23,44,954,20,904,0,1077,910,884
61089,Nsylvestris_NODE_19710_length_1126_cov_178,Ntome_NODE_21554_length_1077_cov_195,92.5,880,30,12,29,889,60,922,0,1227,860,862
61132,Nsylvestris_NODE_19731_length_1124_cov_181,Ntome_NODE_19193_length_1260_cov_193,91.949,1093,66,11,1,1080,1084,1,0,1511,1079,1083
61133,Nsylvestris_NODE_19732_length_1124_cov_142,Ntome_NODE_21809_length_1060_cov_144,95.393,955,36,6,9,960,54,1003,0,1513,951,949
61157,Nsylvestris_NODE_19744_length_1123_cov_200,Ntome_NODE_21258_length_1097_cov_237,92.857,630,42,3,466,1093,728,100,0,911,627,628
61173,Nsylvestris_NODE_19752_length_1122_cov_199,Ntome_NODE_19740_length_1215_cov_235,94.599,1111,42,8,7,1109,1108,8,0,1703,1102,1100
61184,Nsylvestris_NODE_19755_length_1122_cov_58,Ntome_NODE_25200_length_851_cov_48,97.503,801,20,0,231,1031,49,849,0,1369,800,800
61260,Nsylvestris_NODE_19787_length_1118_cov_220,Ntome_NODE_20197_length_1177_cov_107,92.222,1080,61,8,51,1118,1069,1,0,1507,1067,1068
61332,Nsylvestris_NODE_19818_length_1116_cov_27,Ntome_NODE_30310_length_616_cov_12,96.803,563,18,0,231,793,52,614,0,941,562,562
61400,Nsylvestris_NODE_19845_length_1114_cov_99,Ntome_NODE_24128_length_917_cov_15,96.037,858,34,0,215,1072,917,60,0,1397,857,857
61478,Nsylvestris_NODE_19874_length_1112_cov_44,Ntome_NODE_15678_length_1570_cov_232,96.201,1053,40,0,52,1104,197,1249,0,1724,1052,1052
61496,Nsylvestris_NODE_19881_length_1111_cov_211,Ntome_NODE_20803_length_1130_cov_271,93.025,1061,50,14,30,1087,1080,41,0,1528,1057,1039
61508,Nsylvestris_NODE_19887_length_1111_cov_74,Ntome_NODE_20417_length_1160_cov_164,92.968,967,60,6,14,974,1084,120,0,1402,960,964
61522,Nsylvestris_NODE_19895_length_1110_cov_133,Ntome_NODE_25517_length_832_cov_88,89.682,785,52,8,188,954,50,823,0,974,766,773
61556,Nsylvestris_NODE_19910_length_1109_cov_214,Ntome_NODE_18954_length_1280_cov_221,95.424,1027,39,5,36,1060,1240,220,0,1629,1024,1020
61558,Nsylvestris_NODE_19912_length_1109_cov_194,Ntome_NODE_20943_length_1120_cov_102,90.282,1029,70,22,90,1109,100,1107,0,1319,1019,1007
61559,Nsylvestris_NODE_19913_length_1109_cov_190,Ntome_NODE_11816_length_1979_cov_152,97.196,856,23,1,46,901,1979,1125,0,1447,855,854
61588,Nsylvestris_NODE_19926_length_1108_cov_173,Ntome_NODE_21265_length_1097_cov_59,91.648,910,59,6,158,1055,973,69,0,1243,897,904
61595,Nsylvestris_NODE_19929_length_1108_cov_63,Ntome_NODE_20341_length_1166_cov_84,93.569,1104,37,13,24,1108,1,1089,0,1615,1084,1088
61604,Nsylvestris_NODE_19935_length_1107_cov_184,Ntome_NODE_22454_length_1019_cov_253,95.289,1019,38,4,51,1061,1019,3,0,1607,1010,1016
61605,Nsylvestris_NODE_19936_length_1107_cov_160,Ntome_NODE_19758_length_1213_cov_242,94.713,1116,45,8,1,1107,71,1181,0,1722,1106,1110
61726,Nsylvestris_NODE_19983_length_1104_cov_13,Ntome_NODE_19171_length_1262_cov_27,95.29,1104,52,0,1,1104,159,1262,0,1751,1103,1103
61733,Nsylvestris_NODE_19987_length_1103_cov_198,Ntome_NODE_21578_length_1076_cov_126,94.489,998,44,4,92,1083,84,1076,0,1528,991,992
61751,Nsylvestris_NODE_19997_length_1103_cov_23,Ntome_NODE_22179_length_1036_cov_39,76.046,693,148,12,359,1039,843,157,1.25E-93,344,680,686
61762,Nsylvestris_NODE_20003_length_1102_cov_217,Ntome_NODE_38077_length_287_cov_1,94.656,262,14,0,357,618,1,262,1.57E-112,407,261,261
61834,Nsylvestris_NODE_20032_length_1099_cov_195,Ntome_NODE_20179_length_1178_cov_230,89.583,912,44,24,200,1099,236,1108,0,1110,899,872
61838,Nsylvestris_NODE_20035_length_1099_cov_151,Ntome_NODE_17579_length_1395_cov_210,92.115,1078,42,12,1,1044,1069,1,0,1480,1043,1068
61855,Nsylvestris_NODE_20043_length_1098_cov_214,Ntome_NODE_19399_length_1242_cov_276,92.439,1111,68,5,1,1096,15,1124,0,1572,1095,1109
61864,Nsylvestris_NODE_20048_length_1098_cov_98,Ntome_NODE_7722_length_2537_cov_221,92.844,1118,40,11,1,1098,1303,2400,0,1585,1097,1097
62002,Nsylvestris_NODE_20109_length_1093_cov_116,Ntome_NODE_17503_length_1403_cov_76,96.332,1036,34,2,13,1047,1,1033,0,1700,1034,1032
62013,Nsylvestris_NODE_20114_length_1093_cov_31,Ntome_NODE_24460_length_895_cov_124,94.013,618,21,8,1,617,33,635,0,922,616,602
62048,Nsylvestris_NODE_20130_length_1091_cov_210,Ntome_NODE_20123_length_1182_cov_279,91.937,1017,75,2,50,1059,1058,42,0,1417,1009,1016
62062,Nsylvestris_NODE_20138_length_1091_cov_36,Ntome_NODE_23011_length_983_cov_16,95.214,982,43,3,15,992,2,983,0,1550,977,981
62098,Nsylvestris_NODE_20155_length_1090_cov_40,Ntome_NODE_31416_length_574_cov_5,90.4,500,30,6,567,1060,545,58,0,641,493,487
62111,Nsylvestris_NODE_20160_length_1089_cov_200,Ntome_NODE_22747_length_1000_cov_269,96.674,872,29,0,53,924,948,77,0,1450,871,871
62112,Nsylvestris_NODE_20161_length_1089_cov_198,Ntome_NODE_19605_length_1225_cov_231,92.791,860,57,3,181,1037,50,907,0,1240,856,857
62149,Nsylvestris_NODE_20176_length_1088_cov_106,Ntome_NODE_21260_length_1097_cov_173,94.387,1069,43,9,24,1078,25,1090,0,1626,1054,1065
62150,Nsylvestris_NODE_20177_length_1088_cov_65,Ntome_NODE_22526_length_1014_cov_63,92.723,962,55,9,42,999,951,1,0,1375,957,950
62174,Nsylvestris_NODE_20189_length_1087_cov_176,Ntome_NODE_15631_length_1573_cov_204,89.871,1086,67,22,1,1051,231,1308,0,1356,1050,1077
62179,Nsylvestris_NODE_20193_length_1087_cov_46,Ntome_NODE_27280_length_744_cov_87,94.659,674,36,0,21,694,724,51,0,1046,673,673
62180,Nsylvestris_NODE_20196_length_1087_cov_32,Ntome_NODE_18354_length_1329_cov_272,91.805,903,58,12,175,1076,292,1179,0,1243,901,887
62186,Nsylvestris_NODE_20200_length_1087_cov_13,Ntome_NODE_21653_length_1071_cov_9,95.02,1024,51,0,7,1030,1027,4,0,1609,1023,1023
62231,Nsylvestris_NODE_20223_length_1084_cov_105,Ntome_NODE_19510_length_1233_cov_103,92.661,1090,64,12,2,1083,1233,152,0,1555,1081,1081
62249,Nsylvestris_NODE_20233_length_1083_cov_209,Ntome_NODE_22079_length_1042_cov_235,92.013,914,55,7,25,929,1,905,0,1267,904,904
62253,Nsylvestris_NODE_20235_length_1083_cov_197,Ntome_NODE_38257_length_284_cov_4,92.982,57,4,0,620,676,144,200,2.96E-15,84.2,56,56
62271,Nsylvestris_NODE_20242_length_1083_cov_62,Ntome_NODE_39457_length_259_cov_2,96.109,257,10,0,332,588,257,1,1.99E-116,420,256,256
62289,Nsylvestris_NODE_20249_length_1083_cov_7,Ntome_NODE_37605_length_297_cov_6,84.513,226,34,1,18,242,226,1,6.01E-57,222,224,225
62312,Nsylvestris_NODE_20258_length_1082_cov_67,Ntome_NODE_19764_length_1213_cov_65,94.1,1000,42,6,50,1032,1001,2,0,1504,982,999
62313,Nsylvestris_NODE_20260_length_1082_cov_34,Ntome_NODE_17589_length_1394_cov_133,95.481,1018,40,4,69,1082,1229,214,0,1620,1013,1015
62322,Nsylvestris_NODE_20264_length_1081_cov_193,Ntome_NODE_24729_length_878_cov_83,91.319,887,41,13,141,1001,878,2,0,1179,860,876
62341,Nsylvestris_NODE_20274_length_1080_cov_41,Ntome_NODE_22612_length_1009_cov_175,87.134,956,48,32,137,1080,47,939,0,1014,943,892
62355,Nsylvestris_NODE_20279_length_1079_cov_187,Ntome_NODE_24513_length_891_cov_194,96.203,790,26,2,35,820,839,50,0,1290,785,789
62395,Nsylvestris_NODE_20292_length_1078_cov_31,Ntome_NODE_33533_length_444_cov_8,94.595,444,24,0,163,606,1,444,0,688,443,443
62436,Nsylvestris_NODE_20316_length_1076_cov_201,Ntome_NODE_20020_length_1190_cov_199,92.516,1069,41,16,37,1075,1189,130,0,1495,1038,1059
62515,Nsylvestris_NODE_20354_length_1073_cov_157,Ntome_NODE_26534_length_780_cov_248,96.532,692,23,1,335,1026,35,725,0,1144,691,690
62568,Nsylvestris_NODE_20376_length_1073_cov_20,Ntome_NODE_33861_length_426_cov_6,92.471,425,22,6,93,507,2,426,2.35E-170,599,414,424
62622,Nsylvestris_NODE_20398_length_1071_cov_83,Ntome_NODE_20318_length_1168_cov_26,94.358,1028,49,5,1,1023,2,1025,0,1568,1022,1023
62625,Nsylvestris_NODE_20402_length_1071_cov_22,Ntome_NODE_21621_length_1073_cov_43,90.897,747,42,4,253,982,336,1073,0,979,729,737
62659,Nsylvestris_NODE_20419_length_1070_cov_84,Ntome_NODE_18797_length_1292_cov_12,93.908,952,33,12,71,1021,247,1174,0,1413,950,927
62663,Nsylvestris_NODE_20421_length_1070_cov_52,Ntome_NODE_38894_length_270_cov_2,98.864,88,1,0,280,367,163,76,1.70E-37,158,87,87
62665,Nsylvestris_NODE_20425_length_1070_cov_17,Ntome_NODE_20873_length_1126_cov_227,75.327,689,158,12,39,718,1110,425,2.05E-86,320,679,685
62702,Nsylvestris_NODE_20446_length_1068_cov_195,Ntome_NODE_22535_length_1013_cov_215,94.211,881,41,6,28,899,1013,134,0,1336,871,879
62718,Nsylvestris_NODE_20453_length_1068_cov_84,Ntome_NODE_33674_length_436_cov_3,93.721,430,15,5,216,636,436,10,0,634,420,426
62768,Nsylvestris_NODE_20476_length_1066_cov_184,Ntome_NODE_21854_length_1057_cov_71,94.223,1004,44,8,46,1047,1020,29,0,1520,1001,991
62769,Nsylvestris_NODE_20477_length_1066_cov_148,Ntome_NODE_17714_length_1382_cov_204,89.645,1043,72,12,57,1064,282,1323,0,1295,1007,1041
62809,Nsylvestris_NODE_20495_length_1065_cov_22,Ntome_NODE_35051_length_372_cov_7,97.659,299,7,0,767,1065,372,74,8.70E-145,514,298,298
62816,Nsylvestris_NODE_20498_length_1065_cov_8,Ntome_NODE_37141_length_308_cov_3,94.643,56,2,1,372,426,1,56,8.09E-16,86.1,54,55
62818,Nsylvestris_NODE_20500_length_1064_cov_258,Ntome_NODE_18318_length_1332_cov_126,86.918,451,51,7,3,450,520,965,2.43E-140,499,447,445
62821,Nsylvestris_NODE_20502_length_1064_cov_101,Ntome_NODE_29017_length_667_cov_179,96.6,500,15,2,389,886,615,116,0,828,497,499
62892,Nsylvestris_NODE_20536_length_1062_cov_110,Ntome_NODE_13456_length_1790_cov_147,92.52,869,62,1,1,866,52,920,0,1242,865,868
62896,Nsylvestris_NODE_20539_length_1062_cov_33,Ntome_NODE_16995_length_1449_cov_166,92.691,944,50,5,55,993,405,1334,0,1343,938,929
62940,Nsylvestris_NODE_20558_length_1060_cov_127,Ntome_NODE_31561_length_569_cov_8,87.029,239,26,5,246,479,1,239,9.63E-70,265,233,238
63058,Nsylvestris_NODE_20607_length_1057_cov_142,Ntome_NODE_23714_length_942_cov_235,90.176,682,56,9,107,783,814,139,0,878,676,675
63112,Nsylvestris_NODE_20637_length_1055_cov_179,Ntome_NODE_25965_length_807_cov_195,93.3,791,40,6,212,997,25,807,0,1155,785,782
63133,Nsylvestris_NODE_20649_length_1054_cov_149,Ntome_NODE_19137_length_1264_cov_215,87.454,813,82,8,55,867,1137,345,0,918,812,792
63141,Nsylvestris_NODE_20653_length_1054_cov_16,Ntome_NODE_30883_length_593_cov_9,81.319,91,15,2,260,349,436,525,6.23E-12,73.1,89,89
63156,Nsylvestris_NODE_20662_length_1053_cov_9,Ntome_NODE_20849_length_1128_cov_76,91.757,922,51,15,145,1053,155,1064,0,1258,908,909
63208,Nsylvestris_NODE_20685_length_1051_cov_34,Ntome_NODE_20512_length_1153_cov_28,89.512,1106,50,24,1,1051,1095,1,0,1339,1050,1094
63220,Nsylvestris_NODE_20691_length_1050_cov_159,Ntome_NODE_22798_length_996_cov_246,91.431,992,39,15,96,1049,984,1,0,1319,953,983
63221,Nsylvestris_NODE_20692_length_1050_cov_147,Ntome_NODE_21021_length_1114_cov_182,95.642,826,31,3,1,822,41,865,0,1321,821,824
63239,Nsylvestris_NODE_20700_length_1050_cov_10,Ntome_NODE_2696_length_3816_cov_44,86.719,1024,114,11,1,1022,1775,772,0,1118,1021,1003
63246,Nsylvestris_NODE_20705_length_1049_cov_109,Ntome_NODE_31563_length_569_cov_6,86.466,133,18,0,819,951,137,269,3.60E-34,147,132,132
63280,Nsylvestris_NODE_20720_length_1048_cov_118,Ntome_NODE_23009_length_983_cov_21,95.043,928,39,3,93,1020,926,6,0,1452,927,920
63295,Nsylvestris_NODE_20725_length_1048_cov_10,Ntome_NODE_28298_length_698_cov_6,91.717,664,47,6,357,1013,1,663,0,915,656,662
63303,Nsylvestris_NODE_20730_length_1047_cov_148,Ntome_NODE_22881_length_991_cov_101,91.034,948,77,6,86,1029,46,989,0,1273,943,943
63347,Nsylvestris_NODE_20749_length_1046_cov_185,Ntome_NODE_18724_length_1298_cov_127,93.361,964,42,11,28,983,38,987,0,1406,955,949
63374,Nsylvestris_NODE_20761_length_1045_cov_213,Ntome_NODE_25335_length_842_cov_274,98.207,725,12,1,19,743,63,786,0,1266,724,723
63403,Nsylvestris_NODE_20773_length_1045_cov_11,Ntome_NODE_35686_length_348_cov_5,94.224,277,16,0,767,1043,348,72,1.48E-117,424,276,276
63453,Nsylvestris_NODE_20795_length_1043_cov_210,Ntome_NODE_9386_length_2283_cov_171,88.901,919,61,19,5,906,2245,1351,0,1094,901,894
63467,Nsylvestris_NODE_20800_length_1042_cov_75,Ntome_NODE_35727_length_347_cov_3,86.93,329,18,7,143,468,345,39,3.29E-94,346,325,306
63575,Nsylvestris_NODE_20841_length_1039_cov_26,Ntome_NODE_19810_length_1209_cov_116,92.906,1029,35,14,1,1009,61,1071,0,1461,1008,1010
63619,Nsylvestris_NODE_20862_length_1038_cov_24,Ntome_NODE_39000_length_267_cov_5,89.256,121,11,2,457,576,206,87,2.75E-35,150,119,119
63637,Nsylvestris_NODE_20870_length_1037_cov_158,Ntome_NODE_21077_length_1110_cov_96,94.164,891,38,3,1,891,877,1,0,1345,890,876
63644,Nsylvestris_NODE_20873_length_1037_cov_43,Ntome_NODE_19648_length_1222_cov_61,92.322,1042,51,11,21,1037,117,1154,0,1454,1016,1037
63645,Nsylvestris_NODE_20874_length_1037_cov_31,Ntome_NODE_37182_length_307_cov_2,83.224,304,31,3,523,806,1,304,1.22E-68,261,283,303
63656,Nsylvestris_NODE_20880_length_1037_cov_8,Ntome_NODE_34434_length_398_cov_6,94.595,37,1,1,188,223,175,211,6.17E-07,56.5,35,36
63679,Nsylvestris_NODE_20888_length_1036_cov_86,Ntome_NODE_21581_length_1076_cov_91,93.825,1004,47,5,40,1036,1004,9,0,1496,996,995
63708,Nsylvestris_NODE_20906_length_1035_cov_6,Ntome_NODE_33753_length_432_cov_3,96.759,432,14,0,565,996,1,432,0,721,431,431
63760,Nsylvestris_NODE_20935_length_1033_cov_63,Ntome_NODE_18365_length_1329_cov_15,95.475,906,36,3,89,994,1280,380,0,1441,905,900
63780,Nsylvestris_NODE_20945_length_1032_cov_92,Ntome_NODE_22720_length_1002_cov_237,94.833,929,27,6,1,919,970,53,0,1430,918,917
63812,Nsylvestris_NODE_20959_length_1031_cov_30,Ntome_NODE_39774_length_253_cov_3,87.671,146,15,3,60,203,252,108,2.72E-40,167,143,144
63904,Nsylvestris_NODE_20997_length_1028_cov_32,Ntome_NODE_23319_length_964_cov_40,93.895,950,34,5,80,1028,8,934,0,1411,948,926
63936,Nsylvestris_NODE_21009_length_1027_cov_193,Ntome_NODE_22856_length_992_cov_266,89.883,939,58,17,1,922,956,38,0,1173,921,918
63943,Nsylvestris_NODE_21012_length_1027_cov_145,Ntome_NODE_23208_length_971_cov_22,93.482,537,34,1,17,553,971,436,0,797,536,535
63946,Nsylvestris_NODE_21015_length_1027_cov_73,Ntome_NODE_22659_length_1006_cov_27,92.807,862,54,3,17,872,996,137,0,1242,855,859
63947,Nsylvestris_NODE_21017_length_1027_cov_17,Ntome_NODE_23534_length_953_cov_13,89.497,914,25,20,34,890,1,900,0,1090,856,899
63948,Nsylvestris_NODE_21018_length_1027_cov_14,Ntome_NODE_38892_length_270_cov_3,95.911,269,11,0,108,376,270,2,1.87E-121,436,268,268
64069,Nsylvestris_NODE_21069_length_1024_cov_3,Ntome_NODE_22581_length_1011_cov_42,93.866,864,52,1,109,971,955,92,0,1303,862,863
64149,Nsylvestris_NODE_21111_length_1021_cov_23,Ntome_NODE_21280_length_1096_cov_201,88.015,267,17,5,188,440,568,303,7.06E-81,302,252,265
64169,Nsylvestris_NODE_21119_length_1020_cov_167,Ntome_NODE_26901_length_763_cov_263,92.105,760,23,10,2,745,25,763,0,1037,743,738
64172,Nsylvestris_NODE_21121_length_1020_cov_56,Ntome_NODE_27384_length_739_cov_9,81.818,132,21,2,1,132,261,389,1.65E-22,108,131,128
64174,Nsylvestris_NODE_21124_length_1020_cov_28,Ntome_NODE_28350_length_695_cov_8,95.54,695,30,1,100,793,1,695,0,1110,693,694
64238,Nsylvestris_NODE_21152_length_1018_cov_130,Ntome_NODE_33407_length_451_cov_4,90.343,466,25,4,275,735,1,451,1.04E-168,593,460,450
64246,Nsylvestris_NODE_21156_length_1018_cov_66,Ntome_NODE_21140_length_1106_cov_106,90.467,986,69,12,41,1012,83,1057,0,1277,971,974
64258,Nsylvestris_NODE_21163_length_1017_cov_201,Ntome_NODE_21402_length_1088_cov_264,98.14,968,15,2,42,1009,1022,58,0,1685,967,964
64397,Nsylvestris_NODE_21227_length_1012_cov_94,Ntome_NODE_22503_length_1016_cov_119,93.615,1018,50,6,4,1012,1012,1,0,1506,1008,1011
64463,Nsylvestris_NODE_21253_length_1010_cov_189,Ntome_NODE_21541_length_1078_cov_261,93.586,951,42,3,16,964,8,941,0,1400,948,933
64513,Nsylvestris_NODE_21275_length_1009_cov_5,Ntome_NODE_37963_length_289_cov_4,91.623,191,5,2,764,947,1,187,1.98E-66,254,183,186
64559,Nsylvestris_NODE_21297_length_1007_cov_12,Ntome_NODE_22378_length_1024_cov_38,94.863,915,40,4,93,1006,914,6,0,1423,913,908
64590,Nsylvestris_NODE_21313_length_1005_cov_56,Ntome_NODE_25642_length_825_cov_24,90.655,824,60,6,107,924,5,817,0,1079,817,812
64666,Nsylvestris_NODE_21348_length_1003_cov_117,Ntome_NODE_22185_length_1035_cov_222,94.905,1001,39,9,3,996,39,1034,0,1555,993,995
64694,Nsylvestris_NODE_21361_length_1004_cov_6,Ntome_NODE_38394_length_280_cov_4,80.695,259,37,9,606,853,263,7,5.64E-47,189,247,256
64786,Nsylvestris_NODE_21404_length_998_cov_197,Ntome_NODE_21083_length_1109_cov_238,93.564,808,43,5,104,908,195,996,0,1195,804,801
64812,Nsylvestris_NODE_21415_length_998_cov_22,Ntome_NODE_19346_length_1248_cov_20,93.918,1003,47,2,10,998,1033,31,0,1502,988,1002
64817,Nsylvestris_NODE_21418_length_997_cov_206,Ntome_NODE_21771_length_1063_cov_175,97.314,968,23,2,17,983,966,1,0,1640,966,965
65016,Nsylvestris_NODE_21472_length_993_cov_216,Ntome_NODE_21668_length_1069_cov_280,96.366,963,32,3,1,962,44,1004,0,1581,961,960
65018,Nsylvestris_NODE_21474_length_993_cov_174,Ntome_NODE_24740_length_877_cov_219,90.995,744,54,8,40,778,784,49,0,990,738,735
65079,Nsylvestris_NODE_21509_length_991_cov_169,Ntome_NODE_22172_length_1036_cov_264,92.688,930,47,11,6,922,5,926,0,1321,916,921
65088,Nsylvestris_NODE_21514_length_991_cov_39,Ntome_NODE_20852_length_1128_cov_22,95.037,947,41,4,5,946,1,946,0,1483,941,945
65147,Nsylvestris_NODE_21541_length_989_cov_16,Ntome_NODE_24107_length_918_cov_19,95.448,725,18,5,274,989,186,904,0,1142,715,718
65207,Nsylvestris_NODE_21566_length_987_cov_72,Ntome_NODE_24020_length_923_cov_139,86.761,846,42,20,33,844,1,810,0,878,811,809
65229,Nsylvestris_NODE_21578_length_986_cov_144,Ntome_NODE_22860_length_992_cov_166,90.033,903,53,16,115,984,908,10,0,1134,869,898
65323,Nsylvestris_NODE_21620_length_983_cov_75,Ntome_NODE_22724_length_1002_cov_124,90.65,1016,46,15,2,982,1002,1,0,1304,980,1001
65335,Nsylvestris_NODE_21625_length_983_cov_28,Ntome_NODE_24536_length_890_cov_8,94.111,849,49,1,1,849,883,36,0,1290,848,847
65336,Nsylvestris_NODE_21626_length_984_cov_26,Ntome_NODE_35465_length_356_cov_3,83.333,330,33,10,165,476,356,31,6.85E-76,285,311,325
65384,Nsylvestris_NODE_21647_length_981_cov_168,Ntome_NODE_23114_length_976_cov_60,87.056,958,64,27,55,981,975,47,0,1027,926,928
65502,Nsylvestris_NODE_21700_length_977_cov_203,Ntome_NODE_22433_length_1020_cov_196,95.615,821,35,1,109,929,820,1,0,1315,820,819
65525,Nsylvestris_NODE_21715_length_976_cov_70,Ntome_NODE_19012_length_1275_cov_75,94.365,976,42,7,2,976,54,1017,0,1485,974,963
65526,Nsylvestris_NODE_21716_length_976_cov_47,Ntome_NODE_22920_length_988_cov_161,94.126,698,35,4,61,755,49,743,0,1057,694,694
65539,Nsylvestris_NODE_21726_length_975_cov_178,Ntome_NODE_33651_length_437_cov_4,89.888,445,24,5,302,734,436,1,1.68E-156,553,432,435
65542,Nsylvestris_NODE_21728_length_975_cov_151,Ntome_NODE_21987_length_1050_cov_217,91.014,957,41,17,18,959,927,1,0,1249,941,926
65628,Nsylvestris_NODE_21762_length_973_cov_10,Ntome_NODE_21735_length_1066_cov_35,94.444,72,4,0,276,347,202,273,1.22E-23,111,71,71
65733,Nsylvestris_NODE_21812_length_968_cov_145,Ntome_NODE_26154_length_798_cov_174,88.933,750,55,11,44,775,762,23,0,900,731,739
65735,Nsylvestris_NODE_21814_length_968_cov_117,Ntome_NODE_19947_length_1196_cov_237,90.987,932,37,19,53,944,1156,232,0,1212,891,924
65753,Nsylvestris_NODE_21826_length_967_cov_217,Ntome_NODE_23589_length_949_cov_287,90.513,917,54,13,18,930,908,21,0,1181,912,887
65780,Nsylvestris_NODE_21840_length_966_cov_203,Ntome_NODE_21236_length_1099_cov_241,90.351,912,64,6,41,951,120,1008,0,1175,910,888
65881,Nsylvestris_NODE_21889_length_960_cov_206,Ntome_NODE_21115_length_1107_cov_274,94.607,853,35,9,62,911,979,135,0,1310,849,844
65931,Nsylvestris_NODE_21913_length_961_cov_26,Ntome_NODE_27837_length_718_cov_9,94.868,721,34,1,162,882,718,1,0,1123,720,717
65932,Nsylvestris_NODE_21914_length_961_cov_25,Ntome_NODE_23120_length_976_cov_20,89.801,804,64,7,12,806,976,182,0,1014,794,794
65967,Nsylvestris_NODE_21929_length_960_cov_31,Ntome_NODE_22674_length_1005_cov_30,91.273,974,54,10,17,959,975,2,0,1299,942,973
66016,Nsylvestris_NODE_21953_length_958_cov_188,Ntome_NODE_22767_length_998_cov_249,92.731,963,39,11,1,940,955,1,0,1362,939,954
66033,Nsylvestris_NODE_21959_length_958_cov_148,Ntome_NODE_28573_length_685_cov_50,93.023,645,31,6,221,860,636,1,0,929,639,635
66179,Nsylvestris_NODE_22025_length_954_cov_83,Ntome_NODE_31663_length_565_cov_56,93.822,518,25,2,139,649,518,1,0,773,510,517
66240,Nsylvestris_NODE_22055_length_952_cov_190,Ntome_NODE_23679_length_944_cov_225,93.985,798,32,4,129,911,821,25,0,1194,782,796
66257,Nsylvestris_NODE_22064_length_952_cov_8,Ntome_NODE_34521_length_394_cov_11,92.416,356,23,3,551,906,394,43,4.67E-142,505,355,351
66281,Nsylvestris_NODE_22075_length_951_cov_8,Ntome_NODE_31806_length_560_cov_6,84.122,296,42,4,66,357,264,558,8.56E-75,281,291,294
66366,Nsylvestris_NODE_22118_length_948_cov_15,Ntome_NODE_37293_length_304_cov_3,87.869,305,26,7,108,402,304,1,8.29E-95,348,294,303
66398,Nsylvestris_NODE_22136_length_946_cov_48,Ntome_NODE_30438_length_611_cov_9,89.1,578,33,7,220,792,553,1,0,691,572,552
66444,Nsylvestris_NODE_22152_length_945_cov_51,Ntome_NODE_15523_length_1582_cov_114,94.643,728,35,3,4,728,95,821,0,1125,724,726
66445,Nsylvestris_NODE_22153_length_945_cov_39,Ntome_NODE_13092_length_1832_cov_95,88,350,38,4,110,457,1029,682,1.04E-113,411,347,347
66455,Nsylvestris_NODE_22158_length_945_cov_17,Ntome_NODE_39303_length_262_cov_3,82.117,274,34,7,624,897,3,261,1.88E-56,220,273,258
66466,Nsylvestris_NODE_22164_length_944_cov_179,Ntome_NODE_24685_length_881_cov_222,95.626,823,21,6,43,851,825,4,0,1306,808,821
66474,Nsylvestris_NODE_22168_length_944_cov_16,Ntome_NODE_32721_length_497_cov_2,95.976,497,20,0,256,752,1,497,0,808,496,496
66495,Nsylvestris_NODE_22180_length_943_cov_39,Ntome_NODE_22645_length_1007_cov_164,89.879,494,25,6,447,935,701,228,2.65E-174,612,488,473
66499,Nsylvestris_NODE_22183_length_943_cov_12,Ntome_NODE_35339_length_360_cov_8,97.382,191,5,0,753,943,1,191,3.86E-88,326,190,190
66564,Nsylvestris_NODE_22213_length_941_cov_88,Ntome_NODE_14708_length_1665_cov_28,93.359,783,26,13,1,769,1371,601,0,1134,768,770
66569,Nsylvestris_NODE_22216_length_939_cov_46,Ntome_NODE_26045_length_804_cov_106,93.026,717,33,6,8,718,2,707,0,1031,710,705
66572,Nsylvestris_NODE_22218_length_941_cov_24,Ntome_NODE_23403_length_960_cov_56,92.841,866,49,11,52,909,73,933,0,1243,857,860
66601,Nsylvestris_NODE_22230_length_940_cov_84,Ntome_NODE_11086_length_2063_cov_72,88.95,181,18,2,553,732,886,1065,5.20E-57,222,179,179
66747,Nsylvestris_NODE_22302_length_935_cov_210,Ntome_NODE_23374_length_961_cov_261,91.746,630,14,12,125,754,1,592,0,841,629,591
66763,Nsylvestris_NODE_22314_length_935_cov_11,Ntome_NODE_23846_length_934_cov_31,89.546,947,74,16,1,935,1,934,0,1177,934,933
66767,Nsylvestris_NODE_22318_length_934_cov_49,Ntome_NODE_24940_length_867_cov_13,91.482,857,61,8,33,881,854,2,0,1168,848,852
66780,Nsylvestris_NODE_22324_length_933_cov_216,Ntome_NODE_13047_length_1836_cov_177,95.884,826,27,5,59,882,139,959,0,1330,823,820
66784,Nsylvestris_NODE_22326_length_933_cov_187,Ntome_NODE_22281_length_1029_cov_207,91.505,930,54,13,16,924,926,1,0,1256,908,925
66785,Nsylvestris_NODE_22327_length_933_cov_59,Ntome_NODE_26796_length_768_cov_6,93.447,763,41,1,172,925,1,763,0,1123,753,762
66789,Nsylvestris_NODE_22330_length_933_cov_36,Ntome_NODE_24024_length_923_cov_27,95.599,818,35,1,66,883,923,107,0,1310,817,816
66831,Nsylvestris_NODE_22350_length_932_cov_44,Ntome_NODE_21561_length_1077_cov_63,88.999,909,55,12,30,926,955,80,0,1083,896,875
66832,Nsylvestris_NODE_22351_length_932_cov_44,Ntome_NODE_36323_length_330_cov_2,96.732,306,9,1,256,561,330,26,3.53E-143,508,305,304
66850,Nsylvestris_NODE_22370_length_931_cov_72,Ntome_NODE_24038_length_922_cov_120,87.691,853,36,30,96,931,834,34,0,929,835,800
66871,Nsylvestris_NODE_22386_length_930_cov_137,Ntome_NODE_25993_length_806_cov_90,92.846,643,32,5,196,834,729,97,0,920,638,632
66888,Nsylvestris_NODE_22398_length_927_cov_143,Ntome_NODE_25350_length_841_cov_37,89.985,679,67,1,57,735,53,730,0,876,678,677
66910,Nsylvestris_NODE_22410_length_927_cov_204,Ntome_NODE_15360_length_1597_cov_170,93.431,822,25,7,1,821,19,812,0,1192,820,793
66969,Nsylvestris_NODE_22446_length_925_cov_80,Ntome_NODE_16076_length_1532_cov_40,81.882,287,42,8,375,656,670,951,2.36E-60,233,281,281
66991,Nsylvestris_NODE_22464_length_924_cov_188,Ntome_NODE_23458_length_957_cov_148,94.645,859,31,8,1,852,99,949,0,1317,851,850
67005,Nsylvestris_NODE_22471_length_924_cov_28,Ntome_NODE_19499_length_1234_cov_85,92.372,839,28,10,90,919,295,1106,0,1162,829,811
67019,Nsylvestris_NODE_22479_length_923_cov_207,Ntome_NODE_14652_length_1672_cov_197,87.311,662,62,15,252,912,662,22,0,737,660,640
67133,Nsylvestris_NODE_22542_length_919_cov_190,Ntome_NODE_23601_length_948_cov_249,95.838,913,36,2,8,919,1,912,0,1474,911,911
67140,Nsylvestris_NODE_22547_length_919_cov_42,Ntome_NODE_23360_length_962_cov_65,94.301,737,40,2,49,784,850,115,0,1127,735,735
67146,Nsylvestris_NODE_22552_length_919_cov_10,Ntome_NODE_20168_length_1179_cov_45,82.322,758,62,24,2,706,93,831,3.36E-168,592,704,738
67147,Nsylvestris_NODE_22554_length_918_cov_215,Ntome_NODE_22749_length_1000_cov_227,92.629,719,50,3,58,775,235,951,0,1031,717,716
67148,Nsylvestris_NODE_22555_length_918_cov_200,Ntome_NODE_25212_length_850_cov_248,92.946,808,35,7,60,848,46,850,0,1157,788,804
67161,Nsylvestris_NODE_22560_length_918_cov_111,Ntome_NODE_26648_length_775_cov_184,95.751,659,24,3,144,800,710,54,0,1059,656,656
67211,Nsylvestris_NODE_22580_length_917_cov_12,Ntome_NODE_35751_length_346_cov_9,92.197,346,26,1,293,637,1,346,4.52E-137,488,344,345
67229,Nsylvestris_NODE_22588_length_916_cov_159,Ntome_NODE_21552_length_1077_cov_270,91.977,885,46,13,1,878,55,921,0,1218,877,866
67230,Nsylvestris_NODE_22589_length_916_cov_134,Ntome_NODE_23926_length_929_cov_123,93.074,693,36,7,7,688,910,219,0,1003,681,691
67298,Nsylvestris_NODE_22621_length_914_cov_147,Ntome_NODE_32640_length_503_cov_117,84.466,515,34,15,266,753,503,8,2.11E-130,466,487,495
67326,Nsylvestris_NODE_22638_length_914_cov_5,Ntome_NODE_25162_length_854_cov_7,78.109,603,59,22,3,600,747,213,8.10E-85,315,597,534
67386,Nsylvestris_NODE_22666_length_911_cov_158,Ntome_NODE_23759_length_939_cov_146,94.248,904,37,4,16,907,920,20,0,1367,891,900
67388,Nsylvestris_NODE_22669_length_911_cov_72,Ntome_NODE_27491_length_733_cov_21,87.483,751,53,25,133,875,16,733,0,828,742,717
67398,Nsylvestris_NODE_22678_length_910_cov_174,Ntome_NODE_23904_length_930_cov_205,94.032,687,27,7,4,688,842,168,0,1029,684,674
67430,Nsylvestris_NODE_22698_length_909_cov_93,Ntome_NODE_22363_length_1025_cov_57,96.114,772,19,4,96,859,1018,250,0,1249,763,768
67472,Nsylvestris_NODE_22723_length_907_cov_46,Ntome_NODE_20723_length_1136_cov_213,85.859,594,36,14,1,581,1055,497,4.29E-167,588,580,558
67497,Nsylvestris_NODE_22735_length_906_cov_157,Ntome_NODE_21198_length_1102_cov_138,89.677,930,50,9,11,900,61,984,0,1144,889,923
67535,Nsylvestris_NODE_22754_length_905_cov_206,Ntome_NODE_23019_length_982_cov_212,95.357,883,30,5,1,876,879,1,0,1393,875,878
67600,Nsylvestris_NODE_22788_length_904_cov_5,Ntome_NODE_30316_length_616_cov_6,92.762,525,35,2,218,742,522,1,0,756,524,521
67626,Nsylvestris_NODE_22803_length_902_cov_193,Ntome_NODE_26088_length_802_cov_253,87.801,705,56,16,179,859,732,34,0,798,680,698
67633,Nsylvestris_NODE_22806_length_902_cov_148,Ntome_NODE_29043_length_666_cov_27,86.866,670,51,16,201,842,1,661,0,715,641,660
67636,Nsylvestris_NODE_22809_length_902_cov_124,Ntome_NODE_22950_length_986_cov_76,91.685,914,37,10,2,900,986,97,0,1230,898,889
67655,Nsylvestris_NODE_22821_length_901_cov_116,Ntome_NODE_24983_length_864_cov_200,91.218,706,28,9,46,729,171,864,0,929,683,693
67660,Nsylvestris_NODE_22824_length_901_cov_64,Ntome_NODE_25591_length_828_cov_23,92.019,827,48,10,74,894,14,828,0,1146,820,814
67675,Nsylvestris_NODE_22834_length_900_cov_189,Ntome_NODE_26072_length_803_cov_238,95.856,748,20,3,57,795,7,752,0,1199,738,745
67676,Nsylvestris_NODE_22835_length_900_cov_185,Ntome_NODE_22845_length_990_cov_249,96.411,836,20,5,39,868,880,49,0,1369,829,831
67690,Nsylvestris_NODE_22844_length_900_cov_121,Ntome_NODE_27135_length_751_cov_55,94.641,765,24,8,126,889,3,751,0,1170,763,748
67771,Nsylvestris_NODE_22878_length_898_cov_184,Ntome_NODE_23430_length_958_cov_261,92.279,816,39,14,60,856,95,905,0,1136,796,810
67787,Nsylvestris_NODE_22885_length_898_cov_41,Ntome_NODE_24174_length_914_cov_110,84.012,688,70,25,17,696,824,169,3.23E-178,625,679,655
67788,Nsylvestris_NODE_22887_length_898_cov_22,Ntome_NODE_32901_length_484_cov_3,83.431,513,46,18,295,799,482,1,1.26E-122,440,504,481
67806,Nsylvestris_NODE_22899_length_897_cov_115,Ntome_NODE_22482_length_1017_cov_244,84.799,921,85,20,23,897,971,60,0,874,874,911
67842,Nsylvestris_NODE_22917_length_896_cov_58,Ntome_NODE_22608_length_1009_cov_276,94.344,831,35,4,43,867,160,984,0,1264,824,824
67861,Nsylvestris_NODE_22930_length_895_cov_143,Ntome_NODE_34566_length_392_cov_191,98.05,359,6,1,1,359,358,1,1.16E-177,623,358,357
67923,Nsylvestris_NODE_22956_length_894_cov_119,Ntome_NODE_24880_length_870_cov_207,91.436,794,47,15,47,828,810,26,0,1070,781,784
68072,Nsylvestris_NODE_23017_length_890_cov_75,Ntome_NODE_24052_length_921_cov_241,91.946,894,53,14,4,890,887,6,0,1234,886,881
68073,Nsylvestris_NODE_23018_length_890_cov_58,Ntome_NODE_28968_length_669_cov_51,94.558,588,24,4,264,846,620,36,0,902,582,584
68078,Nsylvestris_NODE_23020_length_889_cov_48,Ntome_NODE_17549_length_1398_cov_110,86.722,851,44,24,55,877,891,82,0,881,822,809
68174,Nsylvestris_NODE_23068_length_887_cov_14,Ntome_NODE_38327_length_282_cov_3,91.429,280,24,0,434,713,3,282,5.90E-106,385,279,279
68198,Nsylvestris_NODE_23078_length_886_cov_60,Ntome_NODE_27568_length_729_cov_100,91.107,506,32,6,76,575,27,525,0,673,499,498
68210,Nsylvestris_NODE_23086_length_886_cov_13,Ntome_NODE_24165_length_915_cov_9,97.579,826,20,0,1,826,826,1,0,1415,825,825
68269,Nsylvestris_NODE_23116_length_883_cov_47,Ntome_NODE_25239_length_848_cov_98,89.61,154,15,1,174,327,15,167,1.06E-48,195,153,152
68305,Nsylvestris_NODE_23131_length_883_cov_56,Ntome_NODE_26462_length_784_cov_36,93.182,440,25,5,328,762,204,643,0,641,434,439
68334,Nsylvestris_NODE_23145_length_882_cov_174,Ntome_NODE_20141_length_1181_cov_252,91.627,836,30,14,1,807,18,842,0,1120,806,824
68358,Nsylvestris_NODE_23160_length_881_cov_170,Ntome_NODE_25276_length_845_cov_140,90.675,815,36,10,93,880,802,1,0,1048,787,801
68382,Nsylvestris_NODE_23171_length_880_cov_109,Ntome_NODE_29895_length_632_cov_22,90.769,650,34,4,190,839,1,624,0,845,649,623
68391,Nsylvestris_NODE_23176_length_880_cov_46,Ntome_NODE_24832_length_873_cov_8,93.443,854,42,5,41,880,1,854,0,1254,839,853
68425,Nsylvestris_NODE_23192_length_879_cov_133,Ntome_NODE_26786_length_768_cov_169,92.056,642,17,5,198,821,1,626,0,872,623,625
68452,Nsylvestris_NODE_23203_length_878_cov_42,Ntome_NODE_34951_length_376_cov_9,92.308,351,24,3,73,421,376,27,2.59E-139,496,348,349
68460,Nsylvestris_NODE_23208_length_878_cov_20,Ntome_NODE_23779_length_937_cov_134,92.781,748,39,4,7,751,142,877,0,1068,744,735
68493,Nsylvestris_NODE_23221_length_877_cov_100,Ntome_NODE_29666_length_641_cov_205,88.324,531,18,10,1,512,588,83,6.88E-170,597,511,505
68501,Nsylvestris_NODE_23226_length_877_cov_41,Ntome_NODE_20808_length_1131_cov_159,92.639,557,41,0,46,602,271,827,0,802,556,556
68505,Nsylvestris_NODE_23228_length_877_cov_26,Ntome_NODE_16257_length_1516_cov_98,92.281,881,44,6,1,877,233,1093,0,1229,876,860
68596,Nsylvestris_NODE_23273_length_874_cov_219,Ntome_NODE_20834_length_1129_cov_268,83.902,615,71,18,18,613,1117,512,2.50E-159,562,595,605
68646,Nsylvestris_NODE_23298_length_872_cov_172,Ntome_NODE_22750_length_1000_cov_174,96.256,828,24,4,48,872,157,980,0,1351,824,823
68729,Nsylvestris_NODE_23346_length_868_cov_208,Ntome_NODE_24914_length_868_cov_235,95.735,680,27,2,122,799,1,680,0,1094,677,679
68760,Nsylvestris_NODE_23361_length_869_cov_5,Ntome_NODE_32034_length_548_cov_5,96.907,291,9,0,1,291,258,548,4.28E-137,488,290,290
68766,Nsylvestris_NODE_23364_length_868_cov_154,Ntome_NODE_27317_length_742_cov_103,91.726,701,34,8,88,775,738,49,0,952,687,689
68767,Nsylvestris_NODE_23365_length_868_cov_148,Ntome_NODE_26322_length_791_cov_30,90.254,749,41,9,111,827,2,750,0,950,716,748
68814,Nsylvestris_NODE_23386_length_867_cov_29,Ntome_NODE_16461_length_1500_cov_76,94.499,818,39,3,5,819,230,1044,0,1256,814,814
68850,Nsylvestris_NODE_23404_length_866_cov_66,Ntome_NODE_21927_length_1053_cov_119,91.638,873,58,6,1,861,929,60,0,1194,860,869
68944,Nsylvestris_NODE_23453_length_863_cov_26,Ntome_NODE_32794_length_492_cov_27,83.516,182,28,2,396,576,289,469,6.29E-41,169,180,180
69022,Nsylvestris_NODE_23493_length_860_cov_54,Ntome_NODE_21173_length_1104_cov_33,95.167,807,25,5,12,812,9,807,0,1262,800,798
69028,Nsylvestris_NODE_23497_length_860_cov_10,Ntome_NODE_18689_length_1302_cov_20,96.035,807,32,0,1,807,809,3,0,1314,806,806
69098,Nsylvestris_NODE_23532_length_858_cov_5,Ntome_NODE_38457_length_279_cov_3,90.253,277,24,2,505,779,1,276,3.46E-98,359,274,275
69105,Nsylvestris_NODE_23536_length_857_cov_208,Ntome_NODE_26210_length_796_cov_276,94.645,691,34,3,114,802,53,742,0,1068,688,689
69152,Nsylvestris_NODE_23557_length_856_cov_39,Ntome_NODE_22591_length_1010_cov_206,87.769,883,53,24,9,856,51,913,0,981,847,862
69156,Nsylvestris_NODE_23560_length_856_cov_13,Ntome_NODE_28857_length_674_cov_8,85.985,685,66,14,7,677,674,6,0,706,670,668
69257,Nsylvestris_NODE_23616_length_853_cov_159,Ntome_NODE_26647_length_775_cov_227,94.35,761,22,10,28,783,31,775,0,1147,755,744
69274,Nsylvestris_NODE_23626_length_853_cov_8,Ntome_NODE_27034_length_757_cov_9,83.471,363,43,13,297,645,360,1,4.51E-87,322,348,359
69302,Nsylvestris_NODE_23641_length_852_cov_72,Ntome_NODE_22819_length_995_cov_157,95.921,858,26,7,3,852,131,987,0,1382,849,856
69334,Nsylvestris_NODE_23660_length_851_cov_18,Ntome_NODE_21040_length_1113_cov_26,87.3,874,61,26,1,851,147,993,0,953,850,846
69354,Nsylvestris_NODE_23673_length_850_cov_58,Ntome_NODE_37114_length_308_cov_6,93.399,303,17,1,328,627,305,3,2.55E-124,446,299,302
69357,Nsylvestris_NODE_23675_length_850_cov_39,Ntome_NODE_31231_length_580_cov_29,93.497,569,25,6,17,578,1,564,0,835,561,563
69366,Nsylvestris_NODE_23680_length_850_cov_6,Ntome_NODE_17221_length_1428_cov_97,83.242,364,48,7,337,699,1386,1035,4.49E-87,322,362,351
69374,Nsylvestris_NODE_23685_length_849_cov_190,Ntome_NODE_26692_length_773_cov_100,97.426,544,14,0,306,849,51,594,0,928,543,543
69382,Nsylvestris_NODE_23690_length_849_cov_35,Ntome_NODE_22708_length_999_cov_68,89.213,788,45,20,1,760,34,809,0,948,759,775
69389,Nsylvestris_NODE_23700_length_849_cov_9,Ntome_NODE_18554_length_1311_cov_189,93.27,847,51,6,4,849,980,139,0,1243,845,841
69430,Nsylvestris_NODE_23722_length_847_cov_49,Ntome_NODE_23194_length_972_cov_63,93.814,679,33,4,29,700,140,816,0,1013,671,676
69461,Nsylvestris_NODE_23736_length_846_cov_178,Ntome_NODE_24967_length_865_cov_170,93.162,819,40,12,32,846,15,821,0,1188,814,806
69462,Nsylvestris_NODE_23737_length_846_cov_172,Ntome_NODE_27446_length_735_cov_185,98.182,55,1,0,211,265,643,589,2.95E-19,97.1,54,54
69463,Nsylvestris_NODE_23738_length_846_cov_126,Ntome_NODE_31646_length_566_cov_7,96.481,540,19,0,263,802,562,23,0,893,539,539
69498,Nsylvestris_NODE_23754_length_845_cov_58,Ntome_NODE_25874_length_811_cov_120,93.944,677,39,1,102,778,137,811,0,1022,676,674
69593,Nsylvestris_NODE_23799_length_841_cov_74,Ntome_NODE_29126_length_663_cov_22,84.483,232,29,5,496,725,229,3,4.64E-57,222,229,226
69596,Nsylvestris_NODE_23805_length_843_cov_14,Ntome_NODE_23488_length_955_cov_175,92.475,598,33,7,254,843,320,913,0,845,589,593
69599,Nsylvestris_NODE_23808_length_843_cov_6,Ntome_NODE_29760_length_638_cov_8,84.95,598,70,8,3,598,580,1,3.98E-167,588,595,579
69611,Nsylvestris_NODE_23817_length_842_cov_91,Ntome_NODE_24853_length_871_cov_224,87.427,684,36,17,168,805,162,841,0,741,637,679
69612,Nsylvestris_NODE_23819_length_842_cov_65,Ntome_NODE_24396_length_899_cov_99,90.943,806,34,20,1,791,782,1,0,1048,790,781
69631,Nsylvestris_NODE_23827_length_842_cov_12,Ntome_NODE_18749_length_1296_cov_29,80.534,262,49,2,439,698,378,117,2.18E-50,200,259,261
69704,Nsylvestris_NODE_23858_length_840_cov_142,Ntome_NODE_27197_length_748_cov_188,94.331,688,24,8,138,815,687,5,0,1040,677,682
69720,Nsylvestris_NODE_23866_length_840_cov_13,Ntome_NODE_22203_length_1034_cov_18,91.965,809,47,4,50,840,195,1003,0,1118,790,808
69738,Nsylvestris_NODE_23880_length_839_cov_173,Ntome_NODE_26905_length_763_cov_167,96.828,725,22,1,72,795,753,29,0,1210,723,724
69744,Nsylvestris_NODE_23883_length_839_cov_98,Ntome_NODE_39228_length_263_cov_4,96.774,62,2,0,778,839,97,158,1.75E-21,104,61,61
69779,Nsylvestris_NODE_23900_length_837_cov_190,Ntome_NODE_25362_length_840_cov_259,91.716,845,46,12,1,833,840,8,0,1151,832,832
69794,Nsylvestris_NODE_23905_length_837_cov_60,Ntome_NODE_23377_length_961_cov_139,90.965,819,48,11,7,807,863,53,0,1079,800,810
69813,Nsylvestris_NODE_23916_length_837_cov_9,Ntome_NODE_34265_length_407_cov_3,96.337,273,9,1,451,723,1,272,7.00E-125,448,272,271
69820,Nsylvestris_NODE_23920_length_836_cov_198,Ntome_NODE_22593_length_1010_cov_187,95.954,791,27,3,7,797,197,982,0,1279,790,785
69849,Nsylvestris_NODE_23935_length_836_cov_15,Ntome_NODE_22073_length_1043_cov_21,96.287,835,27,2,6,836,886,52,0,1367,830,834
69861,Nsylvestris_NODE_23944_length_836_cov_4,Ntome_NODE_17600_length_1394_cov_7,96.292,836,31,0,1,836,1108,273,0,1373,835,835
69963,Nsylvestris_NODE_23997_length_832_cov_57,Ntome_NODE_28207_length_701_cov_11,96.724,702,21,2,86,786,1,701,0,1168,700,700
69974,Nsylvestris_NODE_24008_length_832_cov_7,Ntome_NODE_37905_length_290_cov_7,93.284,268,18,0,84,351,268,1,2.56E-109,396,267,267
70015,Nsylvestris_NODE_24030_length_830_cov_146,Ntome_NODE_32289_length_529_cov_141,93.045,532,31,2,20,548,1,529,0,773,528,528
70023,Nsylvestris_NODE_24034_length_830_cov_61,Ntome_NODE_17862_length_1370_cov_72,93.564,606,36,1,50,655,668,1270,0,900,605,602
70073,Nsylvestris_NODE_24061_length_828_cov_24,Ntome_NODE_25607_length_827_cov_34,92.09,708,38,12,63,762,795,98,0,981,699,697
70090,Nsylvestris_NODE_24069_length_827_cov_187,Ntome_NODE_24056_length_921_cov_114,91.603,786,43,14,44,827,841,77,0,1064,783,764
70091,Nsylvestris_NODE_24070_length_827_cov_183,Ntome_NODE_26274_length_793_cov_224,93.234,739,37,6,19,748,786,52,0,1075,729,734
70163,Nsylvestris_NODE_24109_length_825_cov_27,Ntome_NODE_30458_length_610_cov_12,91.005,567,33,2,138,686,1,567,0,749,548,566
70171,Nsylvestris_NODE_24114_length_824_cov_199,Ntome_NODE_21043_length_1112_cov_256,90.326,827,50,13,7,824,860,55,0,1057,817,805
70247,Nsylvestris_NODE_24159_length_822_cov_83,Ntome_NODE_22704_length_1003_cov_186,92.326,821,50,6,2,822,891,84,0,1155,820,807
70251,Nsylvestris_NODE_24162_length_822_cov_25,Ntome_NODE_34721_length_386_cov_4,90.769,390,19,10,40,416,386,1,4.02E-142,505,376,385
70268,Nsylvestris_NODE_24170_length_821_cov_219,Ntome_NODE_29764_length_638_cov_6,93.74,639,20,2,39,661,1,635,0,941,622,634
70278,Nsylvestris_NODE_24177_length_821_cov_16,Ntome_NODE_27603_length_728_cov_11,92.17,728,31,9,65,766,728,1,0,1005,701,727
70291,Nsylvestris_NODE_24184_length_820_cov_81,Ntome_NODE_34030_length_418_cov_6,89.806,412,18,2,173,572,2,401,1.12E-142,507,399,399
70332,Nsylvestris_NODE_24208_length_818_cov_152,Ntome_NODE_28620_length_683_cov_44,86.877,381,42,5,27,405,683,309,1.49E-116,420,378,374
70356,Nsylvestris_NODE_24225_length_817_cov_155,Ntome_NODE_21857_length_1057_cov_35,86.071,481,64,3,225,705,468,945,6.64E-145,514,480,477
70397,Nsylvestris_NODE_24248_length_815_cov_196,Ntome_NODE_25613_length_826_cov_256,91.905,803,51,4,6,800,797,1,0,1110,794,796
70430,Nsylvestris_NODE_24269_length_814_cov_37,Ntome_NODE_28454_length_690_cov_43,90.359,612,51,6,140,744,611,1,0,797,604,610
70496,Nsylvestris_NODE_24301_length_812_cov_62,Ntome_NODE_27004_length_758_cov_30,91.344,774,42,12,45,810,1,757,0,1035,765,756
70497,Nsylvestris_NODE_24302_length_812_cov_37,Ntome_NODE_33510_length_445_cov_17,92.511,454,17,4,70,515,445,1,0,634,445,444
70506,Nsylvestris_NODE_24310_length_812_cov_10,Ntome_NODE_14770_length_1659_cov_60,94.317,827,27,1,3,809,650,1476,0,1249,806,826
70519,Nsylvestris_NODE_24316_length_812_cov_5,Ntome_NODE_26494_length_783_cov_5,96.028,705,21,2,115,812,1,705,0,1140,697,704
70561,Nsylvestris_NODE_24318_length_811_cov_217,Ntome_NODE_23661_length_945_cov_239,95.412,741,27,6,27,764,127,863,0,1173,737,736
70623,Nsylvestris_NODE_24351_length_809_cov_189,Ntome_NODE_29148_length_662_cov_36,89.916,476,40,5,275,743,534,60,1.05E-172,606,468,474
70631,Nsylvestris_NODE_24354_length_809_cov_154,Ntome_NODE_28697_length_680_cov_210,92.748,524,24,5,153,674,595,84,0,745,521,511
70642,Nsylvestris_NODE_24363_length_809_cov_22,Ntome_NODE_27012_length_758_cov_3,95.994,724,29,0,85,808,746,23,0,1177,723,723
70671,Nsylvestris_NODE_24375_length_808_cov_176,Ntome_NODE_24322_length_904_cov_207,94.351,655,28,4,84,737,849,203,0,996,653,646
70672,Nsylvestris_NODE_24376_length_808_cov_123,Ntome_NODE_30008_length_627_cov_22,86.458,576,57,10,129,685,627,54,2.26E-174,612,556,573
70724,Nsylvestris_NODE_24411_length_806_cov_41,Ntome_NODE_36160_length_334_cov_5,90.882,340,16,3,350,680,334,1,3.13E-123,442,330,333
70737,Nsylvestris_NODE_24418_length_806_cov_10,Ntome_NODE_7695_length_2542_cov_13,88.235,544,60,4,1,542,1386,1927,0,647,541,541
70749,Nsylvestris_NODE_24425_length_805_cov_183,Ntome_NODE_25878_length_811_cov_53,89.429,700,47,14,52,748,136,811,0,857,696,675
70786,Nsylvestris_NODE_24448_length_804_cov_128,Ntome_NODE_23169_length_973_cov_58,92.257,762,38,5,2,757,973,227,0,1061,755,746
70788,Nsylvestris_NODE_24450_length_804_cov_17,Ntome_NODE_22240_length_1032_cov_177,90.123,810,56,3,7,804,970,173,0,1031,797,797
70823,Nsylvestris_NODE_24464_length_803_cov_137,Ntome_NODE_22592_length_1010_cov_201,86.69,849,38,23,1,789,8,841,0,872,788,833
70873,Nsylvestris_NODE_24487_length_801_cov_107,Ntome_NODE_33406_length_451_cov_5,95.362,345,14,2,273,615,17,361,6.41E-155,547,342,344
70993,Nsylvestris_NODE_24560_length_798_cov_11,Ntome_NODE_27560_length_730_cov_6,85.449,701,55,25,1,673,49,730,0,686,672,681
71036,Nsylvestris_NODE_24582_length_796_cov_181,Ntome_NODE_23604_length_948_cov_154,94.11,781,32,4,27,796,37,814,0,1175,769,777
71092,Nsylvestris_NODE_24621_length_793_cov_200,Ntome_NODE_25599_length_827_cov_279,88.86,781,53,9,36,787,46,821,0,929,751,775
71122,Nsylvestris_NODE_24636_length_792_cov_218,Ntome_NODE_25824_length_814_cov_146,94.965,576,27,2,125,699,49,623,0,902,574,574
71169,Nsylvestris_NODE_24659_length_791_cov_47,Ntome_NODE_30571_length_605_cov_34,92.487,559,31,5,74,625,556,2,0,789,551,554
71185,Nsylvestris_NODE_24672_length_790_cov_220,Ntome_NODE_25475_length_834_cov_263,93.974,780,35,8,3,777,777,5,0,1170,774,772
71187,Nsylvestris_NODE_24674_length_790_cov_71,Ntome_NODE_26986_length_759_cov_48,91.304,759,30,6,23,745,759,1,0,1003,722,758
71221,Nsylvestris_NODE_24696_length_789_cov_56,Ntome_NODE_28519_length_688_cov_17,93.353,692,31,7,58,739,1,687,0,1009,681,686
71252,Nsylvestris_NODE_24712_length_788_cov_62,Ntome_NODE_27346_length_741_cov_10,72.688,703,163,23,3,693,38,723,1.22E-52,207,690,685
71320,Nsylvestris_NODE_24752_length_786_cov_10,Ntome_NODE_36986_length_311_cov_4,91.011,89,6,1,483,569,223,311,5.84E-26,119,86,88
71349,Nsylvestris_NODE_24775_length_784_cov_136,Ntome_NODE_25896_length_810_cov_177,91.379,290,13,5,389,677,511,789,1.45E-106,387,288,278
71370,Nsylvestris_NODE_24788_length_784_cov_11,Ntome_NODE_38392_length_280_cov_5,88.776,294,16,6,447,739,280,3,8.83E-94,344,292,277
71374,Nsylvestris_NODE_24790_length_784_cov_7,Ntome_NODE_33224_length_462_cov_3,94.231,468,20,4,264,730,462,1,0,708,466,461
71377,Nsylvestris_NODE_24793_length_784_cov_4,Ntome_NODE_24268_length_908_cov_171,91.338,785,46,12,1,783,824,60,0,1053,782,764
71393,Nsylvestris_NODE_24800_length_783_cov_109,Ntome_NODE_24173_length_914_cov_141,94.057,774,44,2,10,783,782,11,0,1173,773,771
71429,Nsylvestris_NODE_24819_length_782_cov_51,Ntome_NODE_9966_length_2204_cov_50,100,36,0,0,22,57,2038,2003,2.14E-10,67.6,35,35
71489,Nsylvestris_NODE_24854_length_780_cov_159,Ntome_NODE_24575_length_887_cov_280,92.593,675,32,10,36,695,827,156,0,953,659,671
71506,Nsylvestris_NODE_24864_length_779_cov_189,Ntome_NODE_23964_length_927_cov_215,90.116,688,34,13,110,779,771,100,0,863,669,671
71519,Nsylvestris_NODE_24869_length_779_cov_21,Ntome_NODE_30772_length_597_cov_86,93.038,158,11,0,162,319,60,217,7.13E-60,231,157,157
71525,Nsylvestris_NODE_24873_length_779_cov_8,Ntome_NODE_21391_length_1089_cov_51,90.409,636,44,11,88,716,315,940,0,821,628,625
71626,Nsylvestris_NODE_24924_length_775_cov_85,Ntome_NODE_25663_length_823_cov_254,92.5,640,19,11,35,662,136,758,0,889,627,622
71668,Nsylvestris_NODE_24948_length_774_cov_33,Ntome_NODE_39812_length_252_cov_4,94.8,250,13,0,400,649,3,252,1.10E-107,390,249,249
71677,Nsylvestris_NODE_24952_length_774_cov_20,Ntome_NODE_6062_length_2837_cov_50,95.758,165,7,0,525,689,1460,1296,1.94E-70,267,164,164
71753,Nsylvestris_NODE_24999_length_771_cov_191,Ntome_NODE_32026_length_548_cov_21,95.463,551,20,3,19,569,548,3,0,874,550,545
71768,Nsylvestris_NODE_25006_length_771_cov_23,Ntome_NODE_33539_length_444_cov_3,92.747,455,17,11,31,480,444,1,0,643,449,443
71781,Nsylvestris_NODE_25013_length_771_cov_8,Ntome_NODE_17968_length_1361_cov_30,89.535,774,46,15,1,771,81,822,0,948,770,741
71807,Nsylvestris_NODE_25027_length_770_cov_9,Ntome_NODE_33567_length_442_cov_4,92.551,443,18,8,236,665,441,1,3.58E-177,621,429,440
71809,Nsylvestris_NODE_25029_length_770_cov_9,Ntome_NODE_15607_length_1575_cov_57,91.23,764,52,7,3,754,560,1320,0,1026,751,760
71831,Nsylvestris_NODE_25040_length_769_cov_144,Ntome_NODE_17017_length_1447_cov_89,96.715,274,5,3,218,491,875,606,1.38E-126,453,273,269
71904,Nsylvestris_NODE_25071_length_767_cov_105,Ntome_NODE_27262_length_745_cov_94,86.329,395,41,12,331,715,742,351,5.02E-116,418,384,391
71947,Nsylvestris_NODE_25096_length_766_cov_131,Ntome_NODE_28818_length_675_cov_68,87.561,619,39,16,98,683,671,58,0,682,585,613
71981,Nsylvestris_NODE_25114_length_765_cov_70,Ntome_NODE_34013_length_419_cov_2,93.478,230,15,0,51,280,230,1,3.10E-93,342,229,229
71982,Nsylvestris_NODE_25115_length_765_cov_69,Ntome_NODE_21824_length_1059_cov_255,97.175,708,20,0,9,716,4,711,0,1197,707,707
72026,Nsylvestris_NODE_25141_length_764_cov_8,Ntome_NODE_18244_length_1339_cov_60,82.906,351,60,0,414,764,418,768,1.88E-85,316,350,350
72062,Nsylvestris_NODE_25157_length_763_cov_9,Ntome_NODE_29994_length_628_cov_7,97.963,589,12,0,1,589,37,625,0,1022,588,588
72080,Nsylvestris_NODE_25164_length_762_cov_177,Ntome_NODE_27080_length_754_cov_224,91.867,750,47,7,27,762,752,3,0,1035,735,749
72081,Nsylvestris_NODE_25165_length_762_cov_165,Ntome_NODE_28671_length_681_cov_190,92.193,538,41,1,137,674,635,99,0,760,537,536
72154,Nsylvestris_NODE_25202_length_760_cov_57,Ntome_NODE_14982_length_1638_cov_78,91.553,367,17,3,359,711,600,234,8.03E-139,494,352,366
72159,Nsylvestris_NODE_25206_length_760_cov_19,Ntome_NODE_26969_length_760_cov_49,94.362,745,36,3,1,742,19,760,0,1138,741,741
72272,Nsylvestris_NODE_25269_length_756_cov_144,Ntome_NODE_29442_length_650_cov_64,90.476,462,29,6,239,690,457,1,2.13E-169,595,451,456
72303,Nsylvestris_NODE_25284_length_755_cov_100,Ntome_NODE_22768_length_998_cov_209,90.878,581,32,6,130,709,42,602,0,760,579,560
72317,Nsylvestris_NODE_25294_length_755_cov_16,Ntome_NODE_38389_length_280_cov_5,92.908,282,15,5,477,755,1,280,3.84E-112,405,278,279
72345,Nsylvestris_NODE_25309_length_754_cov_91,Ntome_NODE_27404_length_738_cov_5,89.009,646,43,13,47,684,65,690,0,774,637,625
72346,Nsylvestris_NODE_25310_length_754_cov_49,Ntome_NODE_38503_length_278_cov_3,97.143,280,5,1,130,409,277,1,1.34E-131,470,279,276
72384,Nsylvestris_NODE_25329_length_753_cov_33,Ntome_NODE_32232_length_533_cov_20,92.25,529,24,10,219,744,515,1,0,734,525,514
72491,Nsylvestris_NODE_25393_length_749_cov_27,Ntome_NODE_32595_length_506_cov_22,85.855,509,46,9,103,589,505,1,4.69E-146,518,486,504
72535,Nsylvestris_NODE_25414_length_748_cov_90,Ntome_NODE_28722_length_679_cov_58,92.251,684,30,4,34,717,14,674,0,948,683,660
72539,Nsylvestris_NODE_25418_length_747_cov_42,Ntome_NODE_22771_length_998_cov_99,89.826,688,46,13,11,691,721,51,0,861,680,670
72553,Nsylvestris_NODE_25424_length_748_cov_12,Ntome_NODE_23766_length_939_cov_36,82.823,751,77,29,23,748,724,1,2.68E-178,625,725,723
72682,Nsylvestris_NODE_25506_length_744_cov_6,Ntome_NODE_23764_length_939_cov_44,94.519,748,27,10,1,744,1,738,0,1142,743,737
72693,Nsylvestris_NODE_25511_length_743_cov_48,Ntome_NODE_27449_length_735_cov_56,91.213,569,25,8,80,643,706,158,0,750,563,548
72722,Nsylvestris_NODE_25533_length_742_cov_38,Ntome_NODE_21288_length_1095_cov_223,88.633,695,54,11,58,733,930,242,0,822,675,688
72726,Nsylvestris_NODE_25538_length_742_cov_15,Ntome_NODE_26928_length_762_cov_31,89.909,773,36,15,1,742,762,1,0,957,741,761
72741,Nsylvestris_NODE_25549_length_741_cov_105,Ntome_NODE_25839_length_813_cov_204,95,740,30,4,4,741,744,10,0,1155,737,734
72755,Nsylvestris_NODE_25555_length_741_cov_52,Ntome_NODE_22725_length_1002_cov_94,94.838,678,23,5,74,740,751,75,0,1048,666,676
72780,Nsylvestris_NODE_25565_length_741_cov_8,Ntome_NODE_37694_length_295_cov_3,90.268,298,22,5,382,675,1,295,1.77E-105,383,293,294
72820,Nsylvestris_NODE_25590_length_740_cov_4,Ntome_NODE_38322_length_282_cov_3,100,31,0,0,19,49,252,222,1.21E-07,58.4,30,30
72829,Nsylvestris_NODE_25595_length_739_cov_161,Ntome_NODE_24220_length_911_cov_223,90.449,691,42,8,28,697,4,691,0,889,669,687
72837,Nsylvestris_NODE_25602_length_739_cov_49,Ntome_NODE_32465_length_516_cov_256,80.061,326,21,15,378,682,362,60,5.29E-51,202,304,302
72854,Nsylvestris_NODE_25615_length_739_cov_7,Ntome_NODE_19835_length_1207_cov_15,97.429,739,19,0,1,739,1163,425,0,1260,738,738
72868,Nsylvestris_NODE_25628_length_738_cov_24,Ntome_NODE_27392_length_738_cov_64,94.436,683,37,1,1,682,683,1,0,1050,681,682
72877,Nsylvestris_NODE_25636_length_738_cov_8,Ntome_NODE_25061_length_860_cov_17,94.03,737,44,0,2,738,79,815,0,1118,736,736
72963,Nsylvestris_NODE_25687_length_735_cov_12,Ntome_NODE_30207_length_620_cov_10,96.075,535,21,0,201,735,1,535,0,872,534,534
72983,Nsylvestris_NODE_25702_length_734_cov_39,Ntome_NODE_32676_length_500_cov_6,95.8,500,21,0,193,692,1,500,0,808,499,499
73004,Nsylvestris_NODE_25715_length_733_cov_16,Ntome_NODE_18841_length_1288_cov_19,94.058,690,26,2,1,678,1059,373,0,1033,677,686
73005,Nsylvestris_NODE_25717_length_733_cov_11,Ntome_NODE_31165_length_583_cov_12,93.46,581,38,0,65,645,1,581,0,863,580,580
73009,Nsylvestris_NODE_25723_length_732_cov_151,Ntome_NODE_29527_length_647_cov_72,89.465,617,45,7,31,645,2,600,0,761,614,598
73014,Nsylvestris_NODE_25725_length_732_cov_87,Ntome_NODE_25553_length_830_cov_79,88.538,253,26,3,270,521,471,721,1.40E-81,303,251,250
73057,Nsylvestris_NODE_25746_length_731_cov_22,Ntome_NODE_19211_length_1259_cov_24,92.185,691,42,4,50,730,698,10,0,966,680,688
73080,Nsylvestris_NODE_25760_length_731_cov_4,Ntome_NODE_33502_length_446_cov_5,94.515,237,12,1,495,731,1,236,6.31E-100,364,236,235
73096,Nsylvestris_NODE_25771_length_730_cov_23,Ntome_NODE_28436_length_691_cov_25,92.89,661,34,5,1,655,30,683,0,948,654,653
73142,Nsylvestris_NODE_25799_length_728_cov_86,Ntome_NODE_32410_length_520_cov_19,92.471,518,31,3,56,565,520,3,0,734,509,517
73157,Nsylvestris_NODE_25806_length_728_cov_12,Ntome_NODE_26592_length_778_cov_4,88.01,417,29,9,109,525,765,370,1.00E-132,473,416,395
73169,Nsylvestris_NODE_25813_length_728_cov_7,Ntome_NODE_21484_length_1083_cov_20,95.742,728,31,0,1,728,134,861,0,1173,727,727
73175,Nsylvestris_NODE_25815_length_728_cov_4,Ntome_NODE_38470_length_278_cov_7,86.364,88,6,6,88,171,273,188,1.18E-17,91.6,83,85
73187,Nsylvestris_NODE_25820_length_727_cov_103,Ntome_NODE_37023_length_310_cov_6,89.198,324,21,2,264,587,310,1,2.88E-108,392,323,309
73259,Nsylvestris_NODE_25862_length_725_cov_125,Ntome_NODE_26626_length_776_cov_90,90.698,645,16,14,104,722,110,736,0,819,618,626
73268,Nsylvestris_NODE_25866_length_725_cov_45,Ntome_NODE_20709_length_1137_cov_134,91.803,610,25,6,116,721,420,1008,0,826,605,588
73279,Nsylvestris_NODE_25871_length_725_cov_12,Ntome_NODE_37699_length_295_cov_3,96.61,295,10,0,209,503,1,295,9.89E-138,490,294,294
73292,Nsylvestris_NODE_25878_length_725_cov_6,Ntome_NODE_30620_length_603_cov_12,86.433,457,27,22,278,725,603,173,4.63E-131,468,447,430
73306,Nsylvestris_NODE_25884_length_721_cov_105,Ntome_NODE_23854_length_933_cov_201,83.673,392,48,9,332,715,433,50,3.74E-97,355,383,383
73344,Nsylvestris_NODE_25906_length_723_cov_44,Ntome_NODE_27650_length_726_cov_27,89.45,673,46,8,25,689,664,9,0,826,664,655
73414,Nsylvestris_NODE_25946_length_721_cov_167,Ntome_NODE_31765_length_561_cov_227,90.98,510,35,4,1,507,11,512,0,676,506,501
73418,Nsylvestris_NODE_25948_length_721_cov_85,Ntome_NODE_30064_length_625_cov_23,93.849,634,22,8,28,657,621,1,0,939,629,620
73454,Nsylvestris_NODE_25971_length_720_cov_30,Ntome_NODE_12157_length_1939_cov_84,93.304,672,41,2,48,719,975,308,0,989,671,667
73520,Nsylvestris_NODE_26004_length_718_cov_217,Ntome_NODE_29489_length_648_cov_290,92.054,516,40,1,154,668,627,112,0,725,514,515
73576,Nsylvestris_NODE_26030_length_717_cov_33,Ntome_NODE_26417_length_786_cov_36,93.494,707,43,3,1,705,1,706,0,1048,704,705
73578,Nsylvestris_NODE_26036_length_717_cov_10,Ntome_NODE_25324_length_843_cov_91,87.934,605,58,11,38,636,728,133,0,699,598,595
73585,Nsylvestris_NODE_26041_length_717_cov_6,Ntome_NODE_34180_length_410_cov_12,92.464,345,23,3,247,590,1,343,9.78E-138,490,343,342
73726,Nsylvestris_NODE_26075_length_715_cov_39,Ntome_NODE_31292_length_578_cov_28,92.885,506,23,4,19,517,1,500,0,723,498,499
73743,Nsylvestris_NODE_26081_length_715_cov_13,Ntome_NODE_28168_length_703_cov_11,94.034,704,38,2,2,702,1,703,0,1064,700,702
73786,Nsylvestris_NODE_26107_length_714_cov_8,Ntome_NODE_15222_length_1612_cov_12,91.907,729,32,14,8,714,1510,787,0,994,706,723
73810,Nsylvestris_NODE_26123_length_713_cov_28,Ntome_NODE_24854_length_871_cov_188,94.052,538,30,2,13,549,130,666,0,815,536,536
73854,Nsylvestris_NODE_26148_length_712_cov_16,Ntome_NODE_27161_length_750_cov_18,94.608,612,32,1,100,711,86,696,0,946,611,610
73935,Nsylvestris_NODE_26198_length_710_cov_7,Ntome_NODE_27255_length_746_cov_8,94.722,701,35,1,2,700,704,4,0,1088,698,700
73968,Nsylvestris_NODE_26221_length_709_cov_10,Ntome_NODE_33863_length_426_cov_6,88.969,417,41,4,46,458,8,423,7.42E-144,510,412,415
73974,Nsylvestris_NODE_26225_length_709_cov_5,Ntome_NODE_4864_length_3120_cov_35,76.226,530,116,8,179,703,580,1104,3.81E-72,272,524,524
73993,Nsylvestris_NODE_26235_length_708_cov_27,Ntome_NODE_27744_length_722_cov_184,94.961,635,25,2,1,635,628,1,0,989,634,627
73994,Nsylvestris_NODE_26236_length_708_cov_27,Ntome_NODE_35787_length_345_cov_8,97.345,339,9,0,138,476,7,345,7.20E-164,577,338,338
74081,Nsylvestris_NODE_26286_length_706_cov_26,Ntome_NODE_32566_length_508_cov_9,82.749,342,44,12,373,703,168,505,1.05E-77,291,330,337
74105,Nsylvestris_NODE_26301_length_705_cov_44,Ntome_NODE_29215_length_659_cov_192,89.247,651,23,18,72,687,21,659,0,771,615,638
74127,Nsylvestris_NODE_26317_length_704_cov_34,Ntome_NODE_33534_length_444_cov_7,90.948,232,21,0,243,474,1,232,2.23E-84,313,231,231
74153,Nsylvestris_NODE_26335_length_703_cov_170,Ntome_NODE_34019_length_418_cov_261,94.753,324,16,1,81,403,49,372,1.23E-141,503,322,323
74318,Nsylvestris_NODE_26436_length_699_cov_11,Ntome_NODE_21560_length_1077_cov_63,94.965,715,20,1,1,699,68,782,0,1107,698,714
74333,Nsylvestris_NODE_26444_length_698_cov_173,Ntome_NODE_27644_length_726_cov_84,92.427,647,36,3,35,668,712,66,0,911,633,646
74334,Nsylvestris_NODE_26445_length_698_cov_170,Ntome_NODE_28533_length_687_cov_165,93.294,686,29,5,13,698,6,674,0,996,685,668
74337,Nsylvestris_NODE_26448_length_698_cov_84,Ntome_NODE_29375_length_653_cov_202,93.186,587,25,14,2,582,18,595,0,848,580,577
74346,Nsylvestris_NODE_26454_length_698_cov_33,Ntome_NODE_32370_length_523_cov_20,92.593,54,2,2,290,341,247,194,3.15E-13,76.8,51,53
74357,Nsylvestris_NODE_26463_length_697_cov_179,Ntome_NODE_31952_length_553_cov_86,91.147,497,21,8,24,513,553,73,0,652,489,480
74358,Nsylvestris_NODE_26464_length_697_cov_149,Ntome_NODE_27117_length_752_cov_76,97.951,244,4,1,408,651,386,628,3.51E-117,422,243,242
74402,Nsylvestris_NODE_26488_length_695_cov_185,Ntome_NODE_14729_length_1662_cov_136,96.075,637,20,3,59,695,677,46,0,1033,636,631
74467,Nsylvestris_NODE_26534_length_694_cov_168,Ntome_NODE_27098_length_753_cov_230,94.839,620,32,0,62,681,672,53,0,968,619,619
74525,Nsylvestris_NODE_26567_length_693_cov_18,Ntome_NODE_34834_length_381_cov_5,88.221,416,10,9,3,414,1,381,7.40E-129,460,411,380
74569,Nsylvestris_NODE_26586_length_692_cov_16,Ntome_NODE_28562_length_686_cov_7,88.235,357,37,3,109,464,294,646,3.49E-117,422,355,352
74714,Nsylvestris_NODE_26668_length_688_cov_46,Ntome_NODE_30978_length_590_cov_10,94.147,598,18,7,81,671,1,588,0,894,590,587
74720,Nsylvestris_NODE_26673_length_688_cov_19,Ntome_NODE_25465_length_835_cov_15,93.849,634,37,1,55,688,202,833,0,953,633,631
74732,Nsylvestris_NODE_26678_length_688_cov_11,Ntome_NODE_38347_length_281_cov_6,92,200,4,2,204,397,1,194,1.33E-71,270,193,193
74757,Nsylvestris_NODE_26691_length_687_cov_201,Ntome_NODE_37233_length_305_cov_9,91.883,308,13,2,270,568,1,305,1.24E-116,420,298,304
74771,Nsylvestris_NODE_26697_length_687_cov_106,Ntome_NODE_27318_length_742_cov_62,88.292,726,30,19,1,687,734,25,0,819,686,709
74798,Nsylvestris_NODE_26715_length_686_cov_167,Ntome_NODE_36070_length_336_cov_10,91.74,339,22,3,244,581,334,1,1.57E-130,466,337,333
74805,Nsylvestris_NODE_26722_length_686_cov_53,Ntome_NODE_32087_length_543_cov_15,86.755,302,28,9,89,383,525,229,2.79E-88,326,294,296
74815,Nsylvestris_NODE_26726_length_686_cov_18,Ntome_NODE_28004_length_710_cov_48,81.008,516,61,25,3,516,8,488,2.73E-103,375,513,480
74834,Nsylvestris_NODE_26738_length_686_cov_9,Ntome_NODE_13459_length_1790_cov_28,91.023,557,38,7,1,546,977,1532,0,741,545,555
74848,Nsylvestris_NODE_26750_length_685_cov_74,Ntome_NODE_22336_length_1026_cov_151,94.629,633,30,3,1,632,131,760,0,977,631,629
74876,Nsylvestris_NODE_26767_length_684_cov_215,Ntome_NODE_27260_length_745_cov_206,87.619,630,42,23,27,632,7,624,0,699,605,617
74910,Nsylvestris_NODE_26782_length_684_cov_10,Ntome_NODE_37260_length_305_cov_2,97.917,48,1,0,637,684,10,57,1.85E-15,84.2,47,47
74961,Nsylvestris_NODE_26810_length_683_cov_6,Ntome_NODE_28066_length_707_cov_13,90.909,649,32,11,19,649,655,16,0,846,630,639
75001,Nsylvestris_NODE_26818_length_682_cov_42,Ntome_NODE_24540_length_889_cov_161,90.625,448,30,8,197,636,865,422,4.14E-166,584,439,443
75007,Nsylvestris_NODE_26823_length_682_cov_9,Ntome_NODE_7325_length_2600_cov_62,92.371,603,30,2,84,682,95,685,0,845,598,590
75089,Nsylvestris_NODE_26871_length_679_cov_47,Ntome_NODE_30242_length_618_cov_219,88.376,628,25,21,22,611,1,618,0,712,589,617
75117,Nsylvestris_NODE_26887_length_678_cov_148,Ntome_NODE_25459_length_835_cov_84,90.653,567,33,15,72,632,786,234,0,736,560,552
75183,Nsylvestris_NODE_26922_length_677_cov_10,Ntome_NODE_23296_length_966_cov_6,91.266,687,27,8,20,677,966,284,0,905,657,682
75225,Nsylvestris_NODE_26945_length_676_cov_6,Ntome_NODE_39479_length_258_cov_5,96.774,248,8,0,1,248,248,1,5.69E-115,414,247,247
75264,Nsylvestris_NODE_26974_length_674_cov_79,Ntome_NODE_25615_length_826_cov_131,89.267,587,36,12,28,614,74,633,0,710,586,559
75333,Nsylvestris_NODE_27008_length_673_cov_22,Ntome_NODE_22652_length_1007_cov_9,87.568,185,17,6,473,653,195,13,2.87E-53,209,180,182
75346,Nsylvestris_NODE_27016_length_673_cov_6,Ntome_NODE_19246_length_1256_cov_31,94.145,649,34,4,27,673,926,280,0,985,646,646
75507,Nsylvestris_NODE_27103_length_669_cov_9,Ntome_NODE_11797_length_1981_cov_140,94.09,423,25,0,1,423,1513,1935,0,643,422,422
75557,Nsylvestris_NODE_27137_length_667_cov_177,Ntome_NODE_32047_length_546_cov_38,91.731,520,36,3,125,644,546,34,0,715,519,512
75560,Nsylvestris_NODE_27139_length_667_cov_171,Ntome_NODE_24702_length_880_cov_163,94.676,601,24,6,24,617,880,281,0,926,593,599
75632,Nsylvestris_NODE_27185_length_665_cov_217,Ntome_NODE_23060_length_979_cov_228,90.651,599,38,10,75,656,180,777,0,780,581,597
75638,Nsylvestris_NODE_27189_length_665_cov_101,Ntome_NODE_19618_length_1224_cov_59,96.97,33,1,0,563,595,175,207,3.91E-07,56.5,32,32
75660,Nsylvestris_NODE_27205_length_664_cov_39,Ntome_NODE_27202_length_748_cov_31,90.909,638,35,7,1,634,67,685,0,835,633,618
75701,Nsylvestris_NODE_27225_length_663_cov_60,Ntome_NODE_18741_length_1297_cov_46,91.084,415,23,5,49,450,524,937,1.47E-155,549,401,413
75718,Nsylvestris_NODE_27238_length_663_cov_5,Ntome_NODE_23442_length_958_cov_49,93.949,661,25,6,3,663,204,849,0,985,660,645
75789,Nsylvestris_NODE_27273_length_661_cov_69,Ntome_NODE_29299_length_656_cov_107,90.975,554,28,6,56,608,653,121,0,726,552,532
75830,Nsylvestris_NODE_27294_length_658_cov_54,Ntome_NODE_33678_length_434_cov_228,87.784,352,34,5,113,457,350,1,1.20E-111,403,344,349
75835,Nsylvestris_NODE_27297_length_660_cov_22,Ntome_NODE_22199_length_1034_cov_73,89.95,398,31,6,51,442,299,693,3.20E-142,505,391,394
75836,Nsylvestris_NODE_27298_length_660_cov_19,Ntome_NODE_29474_length_649_cov_19,91.239,662,41,8,2,660,2,649,0,885,658,647
75838,Nsylvestris_NODE_27302_length_660_cov_16,Ntome_NODE_22384_length_1024_cov_17,94.418,627,28,2,34,660,290,909,0,957,626,619
75870,Nsylvestris_NODE_27320_length_660_cov_189,Ntome_NODE_24764_length_876_cov_222,94.921,630,18,3,1,619,849,223,0,974,618,626
75889,Nsylvestris_NODE_27335_length_659_cov_7,Ntome_NODE_23744_length_941_cov_9,91.438,292,22,3,226,515,291,1,5.58E-110,398,289,290
75936,Nsylvestris_NODE_27365_length_657_cov_181,Ntome_NODE_32076_length_544_cov_12,93.153,555,21,5,44,592,1,544,0,798,548,543
75937,Nsylvestris_NODE_27366_length_657_cov_178,Ntome_NODE_20785_length_1132_cov_97,87.871,371,22,6,248,595,714,1084,5.53E-115,414,347,370
75940,Nsylvestris_NODE_27369_length_657_cov_91,Ntome_NODE_6734_length_2706_cov_86,90.533,338,23,5,58,394,2,331,3.28E-122,438,336,329
75951,Nsylvestris_NODE_27376_length_657_cov_17,Ntome_NODE_35858_length_343_cov_5,83.944,355,35,14,30,374,343,1,1.24E-86,320,344,342
76028,Nsylvestris_NODE_27423_length_655_cov_4,Ntome_NODE_28068_length_707_cov_11,87.915,422,26,12,242,653,524,118,8.96E-133,473,411,406
76040,Nsylvestris_NODE_27430_length_654_cov_98,Ntome_NODE_29701_length_640_cov_10,97.55,449,11,0,158,606,1,449,0,769,448,448
76062,Nsylvestris_NODE_27445_length_653_cov_211,Ntome_NODE_25253_length_847_cov_235,90.206,582,25,16,51,601,216,796,0,730,550,580
76106,Nsylvestris_NODE_27468_length_652_cov_61,Ntome_NODE_20860_length_1127_cov_184,95.134,596,29,0,45,640,482,1077,0,941,595,595
76223,Nsylvestris_NODE_27532_length_650_cov_5,Ntome_NODE_31201_length_582_cov_4,93.966,580,35,0,64,643,3,582,0,878,579,579
76245,Nsylvestris_NODE_27545_length_649_cov_19,Ntome_NODE_28131_length_704_cov_103,92.936,637,45,0,1,637,673,37,0,928,636,636
76262,Nsylvestris_NODE_27556_length_648_cov_212,Ntome_NODE_24424_length_897_cov_197,86.677,623,43,19,27,647,869,285,0,654,620,584
76353,Nsylvestris_NODE_27617_length_646_cov_17,Ntome_NODE_26436_length_785_cov_185,96.604,589,20,0,3,591,60,648,0,977,588,588
76366,Nsylvestris_NODE_27624_length_646_cov_5,Ntome_NODE_35693_length_348_cov_3,94.842,349,14,2,26,371,348,1,2.39E-153,542,345,347
76381,Nsylvestris_NODE_27637_length_645_cov_5,Ntome_NODE_38011_length_288_cov_4,96.596,235,8,0,1,235,7,241,9.14E-108,390,234,234
76443,Nsylvestris_NODE_27675_length_643_cov_11,Ntome_NODE_30021_length_627_cov_8,91.978,536,42,1,2,536,42,577,0,750,534,535
76477,Nsylvestris_NODE_27699_length_642_cov_5,Ntome_NODE_16097_length_1531_cov_265,92.835,656,29,6,1,642,765,114,0,935,641,651
76517,Nsylvestris_NODE_27722_length_641_cov_10,Ntome_NODE_25762_length_818_cov_10,90.465,430,35,5,6,431,30,457,1.82E-159,562,425,427
76526,Nsylvestris_NODE_27728_length_641_cov_6,Ntome_NODE_28034_length_709_cov_4,85.645,411,41,8,243,641,104,508,1.50E-115,416,398,404
76645,Nsylvestris_NODE_27811_length_637_cov_138,Ntome_NODE_34781_length_383_cov_8,93.6,375,23,1,249,623,374,1,2.34E-158,558,374,373
76646,Nsylvestris_NODE_27814_length_637_cov_53,Ntome_NODE_36337_length_329_cov_3,96.241,133,5,0,55,187,197,329,4.50E-56,219,132,132
76693,Nsylvestris_NODE_27843_length_636_cov_12,Ntome_NODE_17398_length_1412_cov_63,86.19,420,45,8,24,437,68,480,2.45E-123,442,413,412
76723,Nsylvestris_NODE_27859_length_635_cov_18,Ntome_NODE_33187_length_464_cov_7,88.352,352,38,1,47,395,408,57,1.15E-116,420,348,351
76735,Nsylvestris_NODE_27867_length_634_cov_203,Ntome_NODE_25195_length_851_cov_264,88.889,522,37,9,30,547,1,505,8.13E-178,623,517,504
76750,Nsylvestris_NODE_27875_length_634_cov_17,Ntome_NODE_30039_length_626_cov_18,92.308,221,12,3,36,252,626,407,2.59E-83,309,216,219
76803,Nsylvestris_NODE_27900_length_633_cov_7,Ntome_NODE_38221_length_284_cov_4,91.544,272,20,1,1,272,1,269,3.25E-102,372,271,268
76807,Nsylvestris_NODE_27907_length_633_cov_3,Ntome_NODE_37096_length_309_cov_2,89.796,245,24,1,379,622,309,65,2.00E-84,313,243,244
76850,Nsylvestris_NODE_27933_length_631_cov_160,Ntome_NODE_30659_length_593_cov_263,90.317,537,24,8,111,627,556,28,0,678,516,528
76942,Nsylvestris_NODE_27991_length_629_cov_40,Ntome_NODE_21371_length_1090_cov_199,91.424,653,29,15,1,629,168,817,0,870,628,649
76957,Nsylvestris_NODE_28000_length_629_cov_10,Ntome_NODE_24310_length_905_cov_30,89.418,567,31,7,90,629,821,257,0,688,539,564
76967,Nsylvestris_NODE_28009_length_629_cov_3,Ntome_NODE_36614_length_321_cov_2,90.909,275,16,4,127,395,321,50,6.98E-99,361,268,271
77047,Nsylvestris_NODE_28050_length_626_cov_35,Ntome_NODE_29218_length_659_cov_100,90.747,616,34,12,1,603,12,617,0,800,602,605
77112,Nsylvestris_NODE_28091_length_625_cov_3,Ntome_NODE_33450_length_449_cov_6,81.637,452,42,15,2,426,1,438,1.17E-91,337,424,437
77156,Nsylvestris_NODE_28112_length_624_cov_10,Ntome_NODE_37041_length_310_cov_3,93.772,289,16,1,313,601,310,24,1.45E-120,433,288,286
77164,Nsylvestris_NODE_28117_length_624_cov_6,Ntome_NODE_16404_length_1505_cov_10,96.491,627,19,1,1,624,454,1080,0,1033,623,626
77209,Nsylvestris_NODE_28140_length_623_cov_8,Ntome_NODE_33813_length_429_cov_3,93.316,374,25,0,249,622,1,374,1.06E-156,553,373,373
77346,Nsylvestris_NODE_28216_length_619_cov_176,Ntome_NODE_28360_length_694_cov_220,90.774,607,48,7,1,602,50,653,0,804,601,603
77371,Nsylvestris_NODE_28229_length_618_cov_145,Ntome_NODE_32727_length_496_cov_131,95.172,290,12,2,47,336,117,404,8.50E-128,457,289,287
77408,Nsylvestris_NODE_28259_length_617_cov_3,Ntome_NODE_31644_length_566_cov_11,93.82,534,30,3,84,617,5,535,0,800,533,530
77415,Nsylvestris_NODE_28263_length_616_cov_14,Ntome_NODE_32909_length_484_cov_15,87.931,522,19,12,80,595,484,1,2.24E-163,575,515,483
77427,Nsylvestris_NODE_28272_length_616_cov_3,Ntome_NODE_28876_length_673_cov_10,93.41,607,28,5,22,616,1,607,0,889,594,606
77497,Nsylvestris_NODE_28315_length_613_cov_190,Ntome_NODE_29415_length_651_cov_191,87.776,589,29,20,9,564,3,581,0,649,555,578
77498,Nsylvestris_NODE_28316_length_613_cov_110,Ntome_NODE_29194_length_660_cov_56,93.648,614,25,7,1,606,622,15,0,905,605,607
77548,Nsylvestris_NODE_28348_length_612_cov_13,Ntome_NODE_38304_length_282_cov_4,92.334,287,17,2,142,428,1,282,1.11E-111,403,286,281
77573,Nsylvestris_NODE_28366_length_611_cov_179,Ntome_NODE_6642_length_2722_cov_36,79.189,370,51,12,182,551,613,270,1.54E-60,233,369,343
77576,Nsylvestris_NODE_28368_length_611_cov_51,Ntome_NODE_29620_length_643_cov_104,91.829,514,25,5,1,511,102,601,0,701,510,499
77718,Nsylvestris_NODE_28454_length_608_cov_6,Ntome_NODE_35816_length_344_cov_7,95.361,194,8,1,74,266,1,194,8.90E-83,307,192,193
77719,Nsylvestris_NODE_28456_length_604_cov_5,Ntome_NODE_32944_length_482_cov_4,91.473,258,19,3,191,446,482,226,4.03E-96,351,255,256
77766,Nsylvestris_NODE_28484_length_606_cov_157,Ntome_NODE_30768_length_597_cov_163,90.926,551,22,9,56,579,1,550,0,715,523,549
77767,Nsylvestris_NODE_28486_length_606_cov_92,Ntome_NODE_33231_length_461_cov_88,91.589,214,14,3,1,210,209,422,2.48E-78,292,209,213
77778,Nsylvestris_NODE_28495_length_606_cov_19,Ntome_NODE_24891_length_870_cov_9,95.39,282,12,1,95,375,282,1,5.01E-125,448,280,281
77800,Nsylvestris_NODE_28511_length_606_cov_4,Ntome_NODE_39333_length_261_cov_4,87.879,264,19,7,268,521,1,261,5.34E-80,298,253,260
77887,Nsylvestris_NODE_28567_length_603_cov_6,Ntome_NODE_37371_length_302_cov_5,97.701,261,6,0,343,603,302,42,1.39E-125,449,260,260
78007,Nsylvestris_NODE_28646_length_600_cov_4,Ntome_NODE_30845_length_594_cov_138,86.957,253,29,3,1,249,276,528,5.32E-75,281,248,252
78053,Nsylvestris_NODE_28674_length_598_cov_223,Ntome_NODE_26919_length_762_cov_239,92.308,598,25,9,7,592,9,597,0,830,585,588
78063,Nsylvestris_NODE_28680_length_598_cov_43,Ntome_NODE_31526_length_570_cov_45,92.171,281,22,0,171,451,148,428,5.05E-110,398,280,280
78072,Nsylvestris_NODE_28687_length_598_cov_22,Ntome_NODE_28695_length_680_cov_247,95.265,528,22,2,73,598,635,109,0,833,525,526
78112,Nsylvestris_NODE_28713_length_596_cov_8,Ntome_NODE_5870_length_2879_cov_150,93.333,60,4,0,1,60,698,639,3.44E-17,89.8,59,59
78123,Nsylvestris_NODE_28720_length_596_cov_221,Ntome_NODE_26358_length_789_cov_60,86.149,592,27,16,50,596,203,784,2.78E-167,588,546,581
78146,Nsylvestris_NODE_28729_length_596_cov_85,Ntome_NODE_27544_length_730_cov_91,90.773,401,24,3,203,593,318,715,7.95E-148,523,390,397
78286,Nsylvestris_NODE_28814_length_592_cov_8,Ntome_NODE_39070_length_266_cov_3,98.12,266,5,0,134,399,266,1,4.86E-130,464,265,265
78288,Nsylvestris_NODE_28816_length_592_cov_8,Ntome_NODE_1171_length_4873_cov_148,79.897,388,64,9,3,389,2322,2696,3.16E-72,272,386,374
78351,Nsylvestris_NODE_28860_length_589_cov_179,Ntome_NODE_24422_length_897_cov_218,92.115,520,27,3,70,589,853,348,0,721,519,505
78360,Nsylvestris_NODE_28868_length_589_cov_22,Ntome_NODE_32077_length_544_cov_10,90.744,551,31,5,6,556,5,535,0,717,550,530
78388,Nsylvestris_NODE_28888_length_588_cov_85,Ntome_NODE_29056_length_665_cov_238,89.842,571,29,13,10,559,13,575,0,706,549,562
78423,Nsylvestris_NODE_28911_length_587_cov_164,Ntome_NODE_31122_length_584_cov_252,91.317,357,31,0,4,360,574,218,2.86E-137,488,356,356
78437,Nsylvestris_NODE_28921_length_587_cov_8,Ntome_NODE_35908_length_342_cov_3,93.805,113,7,0,475,587,49,161,1.17E-41,171,112,112
78616,Nsylvestris_NODE_29000_length_584_cov_7,Ntome_NODE_34809_length_382_cov_9,87.442,215,24,2,373,584,1,215,6.79E-64,244,211,214
78619,Nsylvestris_NODE_29004_length_584_cov_4,Ntome_NODE_37098_length_309_cov_1,93.226,310,20,1,189,498,309,1,2.88E-127,455,309,308
78652,Nsylvestris_NODE_29020_length_583_cov_11,Ntome_NODE_29727_length_639_cov_15,96.822,535,17,0,1,535,535,1,0,894,534,534
78677,Nsylvestris_NODE_29037_length_582_cov_13,Ntome_NODE_34502_length_395_cov_6,92.929,396,22,3,157,550,1,392,2.73E-162,571,393,391
78684,Nsylvestris_NODE_29043_length_582_cov_6,Ntome_NODE_35396_length_358_cov_5,97.5,240,6,0,1,240,255,16,6.30E-114,411,239,239
78794,Nsylvestris_NODE_29120_length_578_cov_49,Ntome_NODE_29841_length_634_cov_18,93.514,555,28,5,1,554,629,82,0,819,553,547
78836,Nsylvestris_NODE_29140_length_577_cov_29,Ntome_NODE_20993_length_1117_cov_43,87.206,383,35,4,67,438,60,439,8.02E-118,424,371,379
78844,Nsylvestris_NODE_29146_length_577_cov_11,Ntome_NODE_26578_length_778_cov_22,96.007,576,22,1,2,577,98,672,0,935,575,574
78893,Nsylvestris_NODE_29179_length_576_cov_6,Ntome_NODE_39068_length_266_cov_3,86.94,268,22,4,263,525,1,260,3.05E-77,289,262,259
78978,Nsylvestris_NODE_29231_length_574_cov_5,Ntome_NODE_23880_length_932_cov_30,95.333,450,21,0,1,450,502,53,0,715,449,449
79079,Nsylvestris_NODE_29300_length_571_cov_11,Ntome_NODE_28576_length_685_cov_21,80.993,584,76,16,11,571,49,620,4.74E-120,431,560,571
79118,Nsylvestris_NODE_29327_length_570_cov_8,Ntome_NODE_22929_length_988_cov_8,90.435,575,42,5,1,570,988,422,0,745,569,566
79133,Nsylvestris_NODE_29341_length_569_cov_37,Ntome_NODE_32280_length_530_cov_11,91.885,382,31,0,130,511,383,2,3.50E-151,534,381,381
79165,Nsylvestris_NODE_29366_length_568_cov_207,Ntome_NODE_21658_length_1070_cov_244,95.407,479,21,1,41,518,186,664,0,761,477,478
79190,Nsylvestris_NODE_29378_length_568_cov_11,Ntome_NODE_28014_length_710_cov_3,90.359,446,31,6,126,568,142,578,2.06E-163,575,442,436
79208,Nsylvestris_NODE_29391_length_567_cov_180,Ntome_NODE_28618_length_683_cov_55,90.353,539,37,9,8,543,131,657,0,693,535,526
79383,Nsylvestris_NODE_29479_length_564_cov_5,Ntome_NODE_12872_length_1854_cov_45,75.918,245,59,0,37,281,599,355,2.47E-28,126,244,244
79407,Nsylvestris_NODE_29498_length_563_cov_23,Ntome_NODE_29157_length_662_cov_11,88.408,578,11,18,1,563,126,662,0,645,562,536
79410,Nsylvestris_NODE_29502_length_563_cov_12,Ntome_NODE_5700_length_2918_cov_74,91.822,538,28,8,33,563,1544,1016,0,736,530,528
79466,Nsylvestris_NODE_29533_length_562_cov_9,Ntome_NODE_29237_length_659_cov_7,92.491,546,28,3,13,556,50,584,0,769,543,534
79496,Nsylvestris_NODE_29547_length_561_cov_52,Ntome_NODE_37702_length_295_cov_3,91.892,296,15,6,83,370,1,295,2.82E-112,405,287,294
79502,Nsylvestris_NODE_29553_length_561_cov_12,Ntome_NODE_17607_length_1393_cov_87,78.696,230,40,5,49,275,137,360,6.79E-34,145,226,223
79514,Nsylvestris_NODE_29561_length_561_cov_5,Ntome_NODE_23190_length_972_cov_167,94.939,573,16,5,2,561,660,88,0,885,559,572
79550,Nsylvestris_NODE_29594_length_559_cov_202,Ntome_NODE_24117_length_917_cov_214,95.043,464,20,1,48,508,509,46,0,726,460,463
79580,Nsylvestris_NODE_29612_length_559_cov_3,Ntome_NODE_17357_length_1416_cov_25,93.173,498,33,1,62,558,889,1386,0,730,496,497
79605,Nsylvestris_NODE_29625_length_558_cov_8,Ntome_NODE_28119_length_705_cov_7,93.482,537,19,5,24,558,685,163,0,784,534,522
79609,Nsylvestris_NODE_29628_length_558_cov_6,Ntome_NODE_28139_length_704_cov_21,91.971,548,29,4,1,548,169,701,0,754,547,532
79617,Nsylvestris_NODE_29634_length_557_cov_68,Ntome_NODE_31857_length_558_cov_13,99.82,556,0,1,3,557,1,556,0,1020,554,555
79633,Nsylvestris_NODE_29644_length_557_cov_6,Ntome_NODE_29111_length_664_cov_5,93.814,388,20,2,1,385,387,1,4.34E-165,580,384,386
79695,Nsylvestris_NODE_29681_length_555_cov_18,Ntome_NODE_33057_length_473_cov_19,87.719,171,20,1,233,403,172,3,5.08E-50,198,170,169
79722,Nsylvestris_NODE_29706_length_554_cov_3,Ntome_NODE_31702_length_564_cov_8,83.455,550,44,15,33,551,564,31,3.50E-131,468,518,533
79751,Nsylvestris_NODE_29727_length_552_cov_9,Ntome_NODE_15988_length_1540_cov_13,86.344,227,30,1,31,256,831,605,1.78E-64,246,225,226
79760,Nsylvestris_NODE_29737_length_551_cov_55,Ntome_NODE_31985_length_551_cov_30,90.647,556,40,9,2,550,1,551,0,728,548,550
79780,Nsylvestris_NODE_29752_length_549_cov_44,Ntome_NODE_25499_length_833_cov_64,89.091,330,28,3,193,522,326,5,9.92E-112,403,329,321
79790,Nsylvestris_NODE_29762_length_548_cov_146,Ntome_NODE_19116_length_1266_cov_213,95.775,497,18,1,1,497,887,394,0,798,496,493
79792,Nsylvestris_NODE_29765_length_548_cov_11,Ntome_NODE_32409_length_520_cov_25,91.154,520,28,10,22,528,515,1,0,689,506,514
79833,Nsylvestris_NODE_29797_length_545_cov_6,Ntome_NODE_32961_length_481_cov_4,88.337,463,26,14,93,544,28,473,4.33E-150,531,451,445
79846,Nsylvestris_NODE_29804_length_544_cov_20,Ntome_NODE_27469_length_734_cov_38,91.583,499,31,7,1,488,174,672,0,678,487,498
79847,Nsylvestris_NODE_29805_length_544_cov_9,Ntome_NODE_15389_length_1595_cov_81,92.094,468,33,2,77,541,922,1388,0,656,464,466
79862,Nsylvestris_NODE_29819_length_543_cov_7,Ntome_NODE_28600_length_684_cov_67,95.316,427,17,2,120,543,54,480,0,675,423,426
79865,Nsylvestris_NODE_29822_length_543_cov_6,Ntome_NODE_25593_length_828_cov_15,93.04,273,19,0,271,543,264,536,1.27E-110,399,272,272
79891,Nsylvestris_NODE_29840_length_542_cov_4,Ntome_NODE_36379_length_328_cov_3,95,180,8,1,1,179,180,1,4.79E-75,281,178,179
79927,Nsylvestris_NODE_29864_length_539_cov_24,Ntome_NODE_32994_length_478_cov_6,77.46,315,51,16,141,451,100,398,1.07E-41,171,310,298
79931,Nsylvestris_NODE_29868_length_539_cov_6,Ntome_NODE_23407_length_960_cov_18,94.991,539,27,0,1,539,324,862,0,846,538,538
79944,Nsylvestris_NODE_29880_length_538_cov_7,Ntome_NODE_38969_length_268_cov_4,98.039,204,4,0,335,538,268,65,2.76E-97,355,203,203
79959,Nsylvestris_NODE_29889_length_537_cov_11,Ntome_NODE_29119_length_663_cov_237,88.841,466,36,9,69,530,508,55,1.95E-158,558,461,453
79977,Nsylvestris_NODE_29906_length_535_cov_163,Ntome_NODE_32728_length_496_cov_62,91.515,495,29,12,25,511,491,2,0,669,486,489
80011,Nsylvestris_NODE_29940_length_533_cov_7,Ntome_NODE_36293_length_330_cov_25,85.816,141,13,5,41,176,192,330,2.31E-33,143,135,138
80034,Nsylvestris_NODE_29954_length_532_cov_6,Ntome_NODE_32732_length_496_cov_9,90.549,455,32,7,1,452,447,1,1.91E-168,592,451,446
80036,Nsylvestris_NODE_29957_length_532_cov_2,Ntome_NODE_37945_length_289_cov_9,91.63,227,13,3,310,532,289,65,2.15E-83,309,222,224
80070,Nsylvestris_NODE_29975_length_530_cov_7,Ntome_NODE_30962_length_590_cov_60,92.203,513,34,2,1,513,590,84,0,721,512,506
80082,Nsylvestris_NODE_29982_length_529_cov_108,Ntome_NODE_30057_length_625_cov_101,87.711,415,34,7,131,529,521,108,3.34E-131,468,398,413
80113,Nsylvestris_NODE_30013_length_526_cov_193,Ntome_NODE_31597_length_567_cov_215,94.297,526,26,3,1,525,45,567,0,802,524,522
80114,Nsylvestris_NODE_30014_length_526_cov_75,Ntome_NODE_33529_length_444_cov_11,94.432,449,20,2,26,474,1,444,0,686,448,443
80115,Nsylvestris_NODE_30015_length_526_cov_19,Ntome_NODE_27000_length_758_cov_182,86.111,540,35,14,1,524,655,140,1.49E-154,545,523,515
80126,Nsylvestris_NODE_30022_length_525_cov_247,Ntome_NODE_25731_length_819_cov_247,89.668,542,30,9,2,525,815,282,0,667,523,533
80135,Nsylvestris_NODE_30027_length_525_cov_82,Ntome_NODE_38339_length_281_cov_16,94.224,277,16,0,186,462,1,277,7.27E-118,424,276,276
80139,Nsylvestris_NODE_30030_length_525_cov_26,Ntome_NODE_37508_length_299_cov_4,93.617,282,6,1,93,374,28,297,5.66E-114,411,281,269
80152,Nsylvestris_NODE_30055_length_523_cov_8,Ntome_NODE_33074_length_472_cov_9,92.632,95,7,0,276,370,89,183,1.06E-31,137,94,94
80156,Nsylvestris_NODE_30059_length_523_cov_4,Ntome_NODE_34402_length_400_cov_5,96.988,166,5,0,1,166,166,1,1.66E-74,279,165,165
80166,Nsylvestris_NODE_30065_length_521_cov_10,Ntome_NODE_34528_length_394_cov_6,98.473,393,5,1,36,428,1,392,0,691,392,391
80201,Nsylvestris_NODE_30101_length_518_cov_10,Ntome_NODE_29007_length_668_cov_8,91.441,222,17,2,3,222,375,596,9.74E-82,303,219,221
80205,Nsylvestris_NODE_30105_length_518_cov_4,Ntome_NODE_29937_length_630_cov_154,95.858,169,7,0,1,169,71,239,7.64E-73,274,168,168
80213,Nsylvestris_NODE_30116_length_516_cov_9,Ntome_NODE_36006_length_338_cov_7,86.174,311,14,10,2,312,52,333,2.08E-83,309,310,281
80231,Nsylvestris_NODE_30137_length_514_cov_26,Ntome_NODE_33875_length_425_cov_23,89.441,322,27,4,40,354,73,394,1.20E-110,399,314,321
80232,Nsylvestris_NODE_30138_length_514_cov_24,Ntome_NODE_32536_length_510_cov_13,89.61,385,18,9,20,386,118,498,9.00E-132,470,366,380
80233,Nsylvestris_NODE_30140_length_514_cov_8,Ntome_NODE_34680_length_387_cov_7,94.1,339,20,0,176,514,387,49,1.14E-145,516,338,338
80246,Nsylvestris_NODE_30152_length_513_cov_5,Ntome_NODE_34881_length_379_cov_4,98.551,345,5,0,1,345,345,1,5.07E-174,610,344,344
80274,Nsylvestris_NODE_30187_length_511_cov_1,Ntome_NODE_12792_length_1864_cov_20,87.324,71,8,1,217,286,14,84,1.76E-14,80.5,69,70
80284,Nsylvestris_NODE_30198_length_510_cov_6,Ntome_NODE_32038_length_547_cov_12,88,425,25,16,2,419,424,19,1.48E-134,479,417,405
80304,Nsylvestris_NODE_30218_length_508_cov_6,Ntome_NODE_16929_length_1454_cov_69,94.892,509,20,2,6,508,815,1323,0,791,502,508
80305,Nsylvestris_NODE_30222_length_508_cov_5,Ntome_NODE_25397_length_839_cov_5,93.306,493,20,3,5,491,354,839,0,715,486,485
80308,Nsylvestris_NODE_30227_length_508_cov_2,Ntome_NODE_14821_length_1654_cov_20,98.425,508,8,0,1,508,27,534,0,894,507,507
80339,Nsylvestris_NODE_30248_length_506_cov_12,Ntome_NODE_30031_length_626_cov_131,95.069,507,16,4,3,506,106,606,0,789,503,500
80363,Nsylvestris_NODE_30261_length_505_cov_11,Ntome_NODE_24805_length_874_cov_68,90.303,165,16,0,341,505,332,168,1.27E-55,217,164,164
80376,Nsylvestris_NODE_30276_length_505_cov_8,Ntome_NODE_36351_length_328_cov_77,91.473,129,5,4,334,461,328,205,2.79E-42,172,127,123
80439,Nsylvestris_NODE_30334_length_499_cov_6,Ntome_NODE_21559_length_1077_cov_85,94.934,454,15,2,4,454,782,334,0,704,450,448
80442,Nsylvestris_NODE_30336_length_499_cov_6,Ntome_NODE_18775_length_1294_cov_65,91.617,501,17,5,1,499,190,667,0,669,498,477
80452,Nsylvestris_NODE_30348_length_498_cov_10,Ntome_NODE_33273_length_459_cov_5,95.842,457,18,1,10,465,3,459,0,737,455,456
80508,Nsylvestris_NODE_30389_length_495_cov_8,Ntome_NODE_13380_length_1800_cov_8,95.152,495,24,0,1,495,1584,1090,0,782,494,494
80533,Nsylvestris_NODE_30407_length_494_cov_5,Ntome_NODE_36313_length_330_cov_4,89.407,236,24,1,259,493,1,236,1.55E-79,296,234,235
80581,Nsylvestris_NODE_30444_length_491_cov_9,Ntome_NODE_36634_length_320_cov_4,90.78,282,19,3,175,451,41,320,8.95E-102,370,276,279
80606,Nsylvestris_NODE_30473_length_488_cov_8,Ntome_NODE_39494_length_258_cov_3,94.8,250,13,0,228,477,3,252,6.82E-108,390,249,249
80624,Nsylvestris_NODE_30491_length_487_cov_5,Ntome_NODE_34261_length_407_cov_3,97.472,356,6,1,1,353,52,407,2.23E-172,604,352,355
80646,Nsylvestris_NODE_30508_length_485_cov_78,Ntome_NODE_24628_length_884_cov_136,91.753,485,23,4,1,485,878,411,0,658,484,467
80647,Nsylvestris_NODE_30509_length_485_cov_18,Ntome_NODE_36086_length_336_cov_4,86.726,339,40,4,7,344,2,336,2.46E-102,372,337,334
80648,Nsylvestris_NODE_30510_length_485_cov_12,Ntome_NODE_36790_length_316_cov_4,82.734,139,23,1,348,485,51,189,2.73E-27,122,137,138
80659,Nsylvestris_NODE_30520_length_484_cov_10,Ntome_NODE_33064_length_473_cov_4,95.181,83,4,0,1,83,362,280,4.53E-30,132,82,82
80712,Nsylvestris_NODE_30566_length_481_cov_8,Ntome_NODE_32028_length_528_cov_10,85.171,263,37,2,219,480,50,311,3.29E-71,268,261,261
80733,Nsylvestris_NODE_30586_length_480_cov_3,Ntome_NODE_34962_length_376_cov_3,93.238,281,11,4,1,273,281,1,6.66E-113,407,272,280
80752,Nsylvestris_NODE_30595_length_479_cov_8,Ntome_NODE_37864_length_291_cov_8,93.559,295,14,4,186,479,1,291,3.05E-121,435,293,290
80753,Nsylvestris_NODE_30598_length_479_cov_5,Ntome_NODE_33944_length_422_cov_4,95.469,309,14,0,1,309,114,422,4.96E-139,494,308,308
80785,Nsylvestris_NODE_30620_length_477_cov_10,Ntome_NODE_32797_length_492_cov_12,93.96,447,22,4,33,477,484,41,0,671,444,443
80792,Nsylvestris_NODE_30631_length_476_cov_29,Ntome_NODE_19736_length_1216_cov_46,87.374,198,12,2,175,360,311,115,4.29E-55,215,185,196
80793,Nsylvestris_NODE_30632_length_476_cov_19,Ntome_NODE_26571_length_778_cov_257,89.955,448,38,6,32,476,596,153,2.21E-162,571,444,443
80845,Nsylvestris_NODE_30674_length_473_cov_4,Ntome_NODE_35190_length_366_cov_15,91.765,170,11,2,147,316,366,200,1.18E-60,233,169,166
80851,Nsylvestris_NODE_30680_length_472_cov_6,Ntome_NODE_27694_length_724_cov_19,95.339,472,16,4,3,472,510,43,0,745,469,467
80874,Nsylvestris_NODE_30699_length_471_cov_178,Ntome_NODE_29570_length_645_cov_218,93.651,315,20,0,50,364,362,48,2.28E-132,472,314,314
80876,Nsylvestris_NODE_30701_length_471_cov_7,Ntome_NODE_38555_length_277_cov_2,98.917,277,3,0,22,298,277,1,1.35E-139,496,276,276
80877,Nsylvestris_NODE_30704_length_471_cov_5,Ntome_NODE_39251_length_263_cov_3,93.633,267,11,4,153,417,263,1,5.08E-109,394,264,262
80885,Nsylvestris_NODE_30710_length_471_cov_2,Ntome_NODE_16742_length_1472_cov_20,90.726,496,16,9,1,471,860,1350,0,634,470,490
80909,Nsylvestris_NODE_30738_length_469_cov_11,Ntome_NODE_32074_length_544_cov_72,93.103,406,18,1,64,469,544,149,7.78E-167,586,405,395
80938,Nsylvestris_NODE_30767_length_467_cov_10,Ntome_NODE_39883_length_251_cov_3,95.652,161,7,0,307,467,1,161,1.92E-68,259,160,160
80948,Nsylvestris_NODE_30776_length_466_cov_14,Ntome_NODE_33267_length_459_cov_11,93.705,413,22,3,1,413,410,2,9.85E-176,616,412,408
80978,Nsylvestris_NODE_30815_length_463_cov_6,Ntome_NODE_35822_length_344_cov_5,96.552,319,11,0,9,327,319,1,1.31E-149,529,318,318
80981,Nsylvestris_NODE_30817_length_463_cov_4,Ntome_NODE_33089_length_471_cov_4,95.749,447,11,2,5,451,33,471,0,713,446,438
80982,Nsylvestris_NODE_30818_length_461_cov_4,Ntome_NODE_38839_length_270_cov_10,97.619,84,2,0,32,115,1,84,5.52E-34,145,83,83
81001,Nsylvestris_NODE_30834_length_462_cov_5,Ntome_NODE_27250_length_746_cov_13,82.292,192,21,5,195,374,713,523,9.20E-37,154,179,190
81018,Nsylvestris_NODE_30853_length_460_cov_8,Ntome_NODE_31958_length_553_cov_7,89.979,479,21,9,1,454,10,486,4.55E-169,593,453,476
81055,Nsylvestris_NODE_30890_length_458_cov_7,Ntome_NODE_17498_length_1404_cov_6,96.507,458,16,0,1,458,951,494,0,758,457,457
81056,Nsylvestris_NODE_30891_length_458_cov_7,Ntome_NODE_36544_length_323_cov_5,90.476,273,22,1,190,458,311,39,6.47E-98,357,268,272
81058,Nsylvestris_NODE_30894_length_458_cov_5,Ntome_NODE_30104_length_624_cov_5,96.061,457,18,0,1,457,581,125,0,745,456,456
81074,Nsylvestris_NODE_30908_length_457_cov_14,Ntome_NODE_34573_length_392_cov_7,96.507,229,8,0,162,390,326,98,1.38E-104,379,228,228
81092,Nsylvestris_NODE_30928_length_456_cov_4,Ntome_NODE_31945_length_554_cov_10,94.737,228,5,2,1,228,221,1,3.88E-95,348,227,220
81095,Nsylvestris_NODE_30930_length_456_cov_3,Ntome_NODE_32184_length_537_cov_10,90,400,21,9,1,381,401,2,1.01E-140,499,380,399
81112,Nsylvestris_NODE_30937_length_455_cov_28,Ntome_NODE_23719_length_942_cov_66,77.22,259,38,6,194,451,557,795,4.24E-30,132,257,238
81132,Nsylvestris_NODE_30957_length_454_cov_4,Ntome_NODE_31303_length_578_cov_10,86.75,400,30,9,66,452,436,47,6.23E-118,424,386,389
81135,Nsylvestris_NODE_30961_length_454_cov_3,Ntome_NODE_28741_length_679_cov_3,83.929,224,16,9,2,205,456,679,1.48E-49,196,203,223
81159,Nsylvestris_NODE_30981_length_453_cov_2,Ntome_NODE_1364_length_4663_cov_85,81.148,122,23,0,111,232,1333,1212,4.28E-20,99,121,121
81164,Nsylvestris_NODE_30984_length_452_cov_184,Ntome_NODE_24879_length_870_cov_208,92.641,462,20,6,1,449,186,646,0,652,448,460
81169,Nsylvestris_NODE_30991_length_452_cov_9,Ntome_NODE_38033_length_288_cov_2,87.762,286,35,0,8,293,1,286,2.99E-91,335,285,285
81172,Nsylvestris_NODE_30994_length_452_cov_5,Ntome_NODE_28409_length_692_cov_29,88.788,330,37,0,1,330,296,625,2.25E-112,405,329,329
81207,Nsylvestris_NODE_31024_length_449_cov_11,Ntome_NODE_28797_length_676_cov_37,88.862,413,38,6,27,433,60,470,2.77E-141,501,406,410
81226,Nsylvestris_NODE_31040_length_448_cov_31,Ntome_NODE_27513_length_731_cov_221,89.017,346,32,5,1,343,633,291,6.15E-118,424,342,342
81232,Nsylvestris_NODE_31047_length_448_cov_7,Ntome_NODE_36567_length_322_cov_5,95.062,324,13,3,3,325,1,322,5.93E-143,507,322,321
81237,Nsylvestris_NODE_31052_length_448_cov_5,Ntome_NODE_24619_length_885_cov_8,92.692,260,16,3,37,295,573,830,2.26E-102,372,258,257
81241,Nsylvestris_NODE_31054_length_448_cov_5,Ntome_NODE_18561_length_1311_cov_44,87.742,465,30,11,1,448,808,1262,2.74E-146,518,447,454
81280,Nsylvestris_NODE_31088_length_446_cov_4,Ntome_NODE_15798_length_1558_cov_226,87.359,443,56,0,4,446,724,282,1.64E-143,508,442,442
81310,Nsylvestris_NODE_31111_length_444_cov_80,Ntome_NODE_27983_length_711_cov_39,91.241,411,15,7,2,412,257,646,5.80E-153,540,410,389
81339,Nsylvestris_NODE_31132_length_443_cov_4,Ntome_NODE_24591_length_887_cov_5,95.937,443,18,0,1,443,539,97,0,719,442,442
81343,Nsylvestris_NODE_31137_length_443_cov_3,Ntome_NODE_28385_length_694_cov_3,89.316,234,21,3,19,251,231,1,6.43E-78,291,232,230
81360,Nsylvestris_NODE_31157_length_441_cov_5,Ntome_NODE_38942_length_268_cov_8,96.988,166,5,0,276,441,1,166,1.38E-74,279,165,165
81361,Nsylvestris_NODE_31159_length_441_cov_4,Ntome_NODE_33811_length_429_cov_4,96.382,387,14,0,55,441,1,387,0,638,386,386
81369,Nsylvestris_NODE_31170_length_440_cov_37,Ntome_NODE_38015_length_288_cov_4,95.918,196,5,2,245,440,283,91,3.79E-85,315,195,192
81378,Nsylvestris_NODE_31182_length_439_cov_10,Ntome_NODE_26502_length_782_cov_39,88.889,468,18,8,4,439,167,632,1.23E-154,545,435,465
81390,Nsylvestris_NODE_31196_length_438_cov_19,Ntome_NODE_14691_length_1667_cov_67,87.118,458,38,11,2,438,1657,1200,9.69E-141,499,436,457
81392,Nsylvestris_NODE_31200_length_438_cov_12,Ntome_NODE_35538_length_353_cov_4,94.571,350,16,1,69,415,1,350,2.05E-152,538,346,349
81395,Nsylvestris_NODE_31202_length_438_cov_8,Ntome_NODE_33628_length_438_cov_6,79.602,201,14,3,235,435,226,399,3.17E-26,119,200,173
81412,Nsylvestris_NODE_31222_length_437_cov_9,Ntome_NODE_35201_length_366_cov_5,97.701,261,6,0,1,261,261,1,9.88E-126,449,260,260
81414,Nsylvestris_NODE_31227_length_437_cov_5,Ntome_NODE_39649_length_255_cov_4,90.09,111,10,1,1,110,111,1,1.88E-33,143,109,110
81416,Nsylvestris_NODE_31230_length_437_cov_3,Ntome_NODE_21692_length_1068_cov_98,91.391,151,7,2,218,362,1,151,3.05E-51,202,144,150
81432,Nsylvestris_NODE_31247_length_436_cov_2,Ntome_NODE_27126_length_752_cov_11,93.111,450,15,10,2,436,190,638,0,645,434,448
81440,Nsylvestris_NODE_31251_length_435_cov_23,Ntome_NODE_28282_length_698_cov_23,90.492,305,27,2,132,435,306,3,2.79E-111,401,303,303
81480,Nsylvestris_NODE_31281_length_433_cov_6,Ntome_NODE_32441_length_518_cov_8,87.066,317,22,10,74,386,1,302,6.14E-93,340,312,301
81484,Nsylvestris_NODE_31289_length_433_cov_4,Ntome_NODE_24497_length_893_cov_8,84.365,307,37,7,134,431,579,883,6.27E-78,291,297,304
81493,Nsylvestris_NODE_31303_length_432_cov_4,Ntome_NODE_18793_length_1292_cov_90,98.039,51,1,0,382,432,152,102,2.45E-17,89.8,50,50
81496,Nsylvestris_NODE_31310_length_431_cov_7,Ntome_NODE_38678_length_274_cov_3,87.826,115,14,0,249,363,5,119,3.10E-31,135,114,114
81498,Nsylvestris_NODE_31313_length_431_cov_6,Ntome_NODE_11184_length_2051_cov_105,97.436,39,1,0,294,332,1548,1586,1.15E-10,67.6,38,38
81517,Nsylvestris_NODE_31339_length_430_cov_4,Ntome_NODE_32188_length_537_cov_5,97.297,37,1,0,1,37,37,1,1.48E-09,63.9,36,36
81523,Nsylvestris_NODE_31348_length_429_cov_8,Ntome_NODE_36719_length_318_cov_6,97.59,83,1,1,348,429,1,83,6.62E-33,141,81,82
81536,Nsylvestris_NODE_31366_length_428_cov_4,Ntome_NODE_39727_length_254_cov_2,90.65,246,17,4,186,428,1,243,2.20E-87,322,242,242
81567,Nsylvestris_NODE_31395_length_426_cov_2,Ntome_NODE_24949_length_866_cov_81,92,350,15,5,1,341,400,55,1.23E-134,479,340,345
81573,Nsylvestris_NODE_31398_length_425_cov_16,Ntome_NODE_39336_length_260_cov_4,95.094,265,6,4,10,274,3,260,4.53E-114,411,264,257
81577,Nsylvestris_NODE_31406_length_425_cov_5,Ntome_NODE_24161_length_915_cov_22,93.882,425,26,0,1,425,363,787,0,641,424,424
81584,Nsylvestris_NODE_31414_length_425_cov_3,Ntome_NODE_6356_length_2777_cov_19,96.682,422,14,0,1,422,752,1173,0,702,421,421
81592,Nsylvestris_NODE_31419_length_424_cov_9,Ntome_NODE_32361_length_524_cov_4,89.681,407,38,3,19,424,4,407,9.30E-146,516,405,403
81600,Nsylvestris_NODE_31428_length_424_cov_4,Ntome_NODE_28006_length_710_cov_28,92.235,425,32,1,1,424,556,132,2.50E-171,601,423,424
81618,Nsylvestris_NODE_31452_length_422_cov_7,Ntome_NODE_30801_length_596_cov_11,93.03,330,11,5,98,422,1,323,2.03E-132,472,324,322
81657,Nsylvestris_NODE_31494_length_420_cov_4,Ntome_NODE_31813_length_560_cov_4,92.695,397,29,0,1,397,397,1,5.39E-163,573,396,396
81658,Nsylvestris_NODE_31495_length_420_cov_4,Ntome_NODE_34376_length_401_cov_9,90.598,234,13,4,13,238,233,1,2.81E-81,302,225,232
81660,Nsylvestris_NODE_31500_length_420_cov_3,Ntome_NODE_13477_length_1789_cov_24,95.192,416,20,0,3,418,1485,1070,0,658,415,415
81669,Nsylvestris_NODE_31511_length_419_cov_6,Ntome_NODE_27461_length_735_cov_5,96.217,423,10,2,1,417,665,243,0,688,416,422
81700,Nsylvestris_NODE_31546_length_417_cov_3,Ntome_NODE_36541_length_323_cov_5,97.426,272,7,0,145,416,322,51,3.36E-130,464,271,271
81702,Nsylvestris_NODE_31548_length_417_cov_2,Ntome_NODE_34930_length_377_cov_9,90.852,317,27,2,1,315,317,1,5.70E-118,424,314,316
81731,Nsylvestris_NODE_31581_length_415_cov_6,Ntome_NODE_35720_length_347_cov_4,96.83,347,11,0,50,396,1,347,3.18E-165,580,346,346
81756,Nsylvestris_NODE_31609_length_414_cov_3,Ntome_NODE_18745_length_1296_cov_139,85.39,397,49,7,1,390,781,387,7.36E-112,403,389,394
81795,Nsylvestris_NODE_31657_length_411_cov_3,Ntome_NODE_16782_length_1468_cov_32,95.62,411,18,0,1,411,490,80,0,660,410,410
81813,Nsylvestris_NODE_31667_length_410_cov_6,Ntome_NODE_30400_length_612_cov_15,90.217,92,9,0,18,109,32,123,8.22E-27,121,91,91
81814,Nsylvestris_NODE_31672_length_410_cov_3,Ntome_NODE_33676_length_436_cov_2,94.468,235,13,0,1,235,235,1,1.24E-99,363,234,234
81830,Nsylvestris_NODE_31695_length_408_cov_5,Ntome_NODE_33577_length_441_cov_17,87.468,391,26,12,1,374,385,1,1.20E-119,429,373,384
81850,Nsylvestris_NODE_31723_length_407_cov_4,Ntome_NODE_37346_length_303_cov_2,95.05,303,15,0,9,311,1,303,4.20E-134,477,302,302
81854,Nsylvestris_NODE_31731_length_406_cov_17,Ntome_NODE_31766_length_561_cov_148,87.037,216,22,5,30,243,7,218,2.15E-62,239,213,211
81888,Nsylvestris_NODE_31768_length_405_cov_3,Ntome_NODE_36094_length_336_cov_3,95.431,197,6,2,209,405,336,143,4.49E-84,311,196,193
81903,Nsylvestris_NODE_31779_length_404_cov_21,Ntome_NODE_35099_length_370_cov_11,90.741,270,24,1,15,284,18,286,1.58E-98,359,269,268
81906,Nsylvestris_NODE_31784_length_404_cov_7,Ntome_NODE_34495_length_395_cov_9,96.571,175,4,1,232,404,1,175,2.10E-77,289,172,174
81909,Nsylvestris_NODE_31791_length_404_cov_4,Ntome_NODE_30601_length_604_cov_7,90.476,378,33,3,24,401,95,469,1.15E-139,496,377,374
81910,Nsylvestris_NODE_31792_length_404_cov_4,Ntome_NODE_30885_length_593_cov_8,93.151,219,11,3,1,215,219,1,2.67E-86,318,214,218
81923,Nsylvestris_NODE_31806_length_403_cov_5,Ntome_NODE_30017_length_627_cov_12,96.114,386,15,0,1,386,141,526,3.02E-180,630,385,385
81936,Nsylvestris_NODE_31822_length_402_cov_8,Ntome_NODE_34656_length_388_cov_13,91.239,331,28,1,72,402,349,20,9.04E-126,449,330,329
81945,Nsylvestris_NODE_31845_length_401_cov_15,Ntome_NODE_25185_length_852_cov_193,91.206,398,22,4,11,401,608,217,1.13E-149,529,390,391
81960,Nsylvestris_NODE_31867_length_400_cov_5,Ntome_NODE_37653_length_296_cov_4,89.562,297,14,2,88,368,1,296,4.33E-99,361,280,295
81961,Nsylvestris_NODE_31873_length_400_cov_3,Ntome_NODE_33962_length_421_cov_4,90.254,236,20,3,1,234,184,418,2.06E-82,305,233,234
81972,Nsylvestris_NODE_31889_length_399_cov_3,Ntome_NODE_39949_length_250_cov_3,92.035,113,6,1,3,115,110,1,2.19E-37,156,112,109
82002,Nsylvestris_NODE_31920_length_398_cov_2,Ntome_NODE_34559_length_393_cov_4,95.965,347,8,2,56,398,1,345,1.42E-158,558,342,344
82023,Nsylvestris_NODE_31945_length_396_cov_14,Ntome_NODE_34393_length_400_cov_41,94.474,380,20,1,17,396,400,22,2.34E-166,584,379,378
82035,Nsylvestris_NODE_31957_length_395_cov_11,Ntome_NODE_32731_length_496_cov_10,97.368,114,3,0,134,247,496,383,4.59E-49,195,113,113
82055,Nsylvestris_NODE_31983_length_395_cov_2,Ntome_NODE_32596_length_506_cov_18,85.175,371,28,12,1,369,33,378,1.99E-97,355,368,345
82061,Nsylvestris_NODE_31986_length_394_cov_20,Ntome_NODE_27362_length_740_cov_16,95.431,394,18,0,1,394,202,595,1.06E-179,628,393,393
82066,Nsylvestris_NODE_31997_length_394_cov_5,Ntome_NODE_38265_length_283_cov_3,93.902,246,14,1,21,265,246,1,7.09E-102,370,244,245
82072,Nsylvestris_NODE_32002_length_394_cov_4,Ntome_NODE_35323_length_361_cov_4,97.541,122,3,0,3,124,122,1,1.63E-53,209,121,121
82075,Nsylvestris_NODE_32005_length_394_cov_2,Ntome_NODE_33896_length_424_cov_43,87.831,378,35,10,6,382,57,424,8.91E-121,433,376,367
82102,Nsylvestris_NODE_32036_length_392_cov_6,Ntome_NODE_34164_length_411_cov_4,90.411,365,23,5,31,392,1,356,6.75E-132,470,361,355
82112,Nsylvestris_NODE_32051_length_392_cov_3,Ntome_NODE_38237_length_284_cov_3,87.814,279,11,11,32,293,12,284,2.02E-82,305,261,272
82114,Nsylvestris_NODE_32055_length_392_cov_2,Ntome_NODE_3286_length_3592_cov_55,87.143,70,7,2,100,168,2364,2296,4.78E-14,78.7,68,68
82137,Nsylvestris_NODE_32080_length_390_cov_165,Ntome_NODE_37917_length_290_cov_4,96.587,293,7,2,70,362,1,290,8.63E-136,483,292,289
82139,Nsylvestris_NODE_32082_length_390_cov_53,Ntome_NODE_25404_length_838_cov_220,84.881,377,22,14,1,377,428,769,3.28E-95,348,376,341
82164,Nsylvestris_NODE_32113_length_389_cov_5,Ntome_NODE_36388_length_328_cov_1,92.284,324,24,1,34,356,324,1,1.45E-128,459,322,323
82170,Nsylvestris_NODE_32125_length_388_cov_195,Ntome_NODE_6363_length_2775_cov_39,93.651,315,19,1,53,367,386,73,6.68E-132,470,314,313
82174,Nsylvestris_NODE_32139_length_388_cov_4,Ntome_NODE_36442_length_326_cov_4,88.889,189,20,1,1,188,134,322,3.43E-60,231,187,188
82212,Nsylvestris_NODE_32180_length_386_cov_6,Ntome_NODE_35956_length_340_cov_4,93.004,243,17,0,1,243,98,340,1.94E-97,355,242,242
82213,Nsylvestris_NODE_32182_length_386_cov_6,Ntome_NODE_28780_length_677_cov_19,85.823,395,17,14,1,386,512,148,8.90E-106,383,385,364
82216,Nsylvestris_NODE_32184_length_386_cov_4,Ntome_NODE_33360_length_454_cov_4,95.439,285,13,0,1,285,166,450,1.86E-127,455,284,284
82232,Nsylvestris_NODE_32199_length_385_cov_8,Ntome_NODE_28089_length_706_cov_53,95.584,385,17,0,1,385,467,83,2.24E-176,617,384,384
82233,Nsylvestris_NODE_32202_length_385_cov_5,Ntome_NODE_26345_length_790_cov_11,88.974,390,24,10,1,384,402,26,3.08E-130,464,383,376
82242,Nsylvestris_NODE_32216_length_385_cov_2,Ntome_NODE_35461_length_356_cov_3,96.901,355,11,0,27,381,2,356,1.05E-169,595,354,354
82243,Nsylvestris_NODE_32217_length_385_cov_2,Ntome_NODE_29209_length_660_cov_7,92.683,369,16,7,24,382,1,368,1.80E-147,521,358,367
82249,Nsylvestris_NODE_32229_length_384_cov_6,Ntome_NODE_39543_length_257_cov_4,92.692,260,16,1,111,370,257,1,1.92E-102,372,259,256
82273,Nsylvestris_NODE_32255_length_383_cov_6,Ntome_NODE_38298_length_282_cov_5,93.19,279,16,2,87,362,1,279,5.24E-113,407,275,278
82281,Nsylvestris_NODE_32264_length_383_cov_3,Ntome_NODE_35573_length_352_cov_5,95.846,337,12,2,1,335,337,1,3.83E-154,544,334,336
82295,Nsylvestris_NODE_32282_length_382_cov_4,Ntome_NODE_36953_length_312_cov_2,84.656,189,13,4,156,344,309,137,5.77E-43,174,188,172
82306,Nsylvestris_NODE_32294_length_382_cov_1,Ntome_NODE_25592_length_828_cov_18,83.577,274,38,4,103,370,522,794,9.32E-66,250,267,272
82321,Nsylvestris_NODE_32307_length_381_cov_5,Ntome_NODE_33377_length_453_cov_3,86.207,290,29,5,1,279,345,56,7.03E-82,303,278,289
82345,Nsylvestris_NODE_32341_length_379_cov_12,Ntome_NODE_34980_length_375_cov_8,90.377,239,17,3,144,379,1,236,1.50E-83,309,235,235
82349,Nsylvestris_NODE_32349_length_379_cov_3,Ntome_NODE_38002_length_288_cov_5,97.569,288,7,0,76,363,288,1,3.87E-139,494,287,287
82351,Nsylvestris_NODE_32352_length_379_cov_2,Ntome_NODE_26727_length_772_cov_5,93.298,373,19,1,5,377,560,194,1.05E-154,545,372,366
82355,Nsylvestris_NODE_32355_length_378_cov_12,Ntome_NODE_35338_length_360_cov_16,83.473,357,25,13,9,357,25,355,2.51E-81,302,348,330
82370,Nsylvestris_NODE_32369_length_378_cov_3,Ntome_NODE_38494_length_278_cov_4,82.969,229,38,1,151,378,276,48,2.02E-52,206,227,228
82399,Nsylvestris_NODE_32405_length_376_cov_7,Ntome_NODE_25110_length_857_cov_15,90.283,247,16,4,126,368,220,462,8.91E-86,316,242,242
82412,Nsylvestris_NODE_32435_length_375_cov_6,Ntome_NODE_33891_length_425_cov_4,87.719,399,21,18,1,375,3,397,5.05E-123,440,374,394
82444,Nsylvestris_NODE_32488_length_372_cov_16,Ntome_NODE_32023_length_548_cov_68,89.109,101,11,0,272,372,176,76,1.60E-28,126,100,100
82452,Nsylvestris_NODE_32499_length_372_cov_5,Ntome_NODE_15623_length_1574_cov_39,84.173,278,34,7,1,271,499,773,4.20E-69,261,270,274
82459,Nsylvestris_NODE_32508_length_372_cov_3,Ntome_NODE_35777_length_346_cov_2,95.376,346,16,0,12,357,346,1,2.22E-156,551,345,345
82483,Nsylvestris_NODE_32536_length_371_cov_4,Ntome_NODE_32050_length_546_cov_7,87.356,87,11,0,99,185,460,546,9.66E-21,100,86,86
82486,Nsylvestris_NODE_32540_length_371_cov_2,Ntome_NODE_36453_length_326_cov_1,95.392,217,6,3,1,214,216,1,1.45E-93,342,213,215
82550,Nsylvestris_NODE_32614_length_367_cov_5,Ntome_NODE_29051_length_666_cov_7,95.095,367,15,1,1,367,618,255,1.30E-163,575,366,363
82598,Nsylvestris_NODE_32669_length_365_cov_3,Ntome_NODE_25555_length_830_cov_52,85.323,402,22,9,1,365,175,576,3.03E-105,381,364,401
82601,Nsylvestris_NODE_32675_length_365_cov_1,Ntome_NODE_18195_length_1343_cov_26,90.489,368,32,3,1,365,270,637,8.07E-136,483,364,367
82606,Nsylvestris_NODE_32680_length_364_cov_13,Ntome_NODE_34753_length_384_cov_23,92,350,21,6,19,364,11,357,2.24E-136,484,345,346
82611,Nsylvestris_NODE_32688_length_364_cov_4,Ntome_NODE_24130_length_917_cov_11,94.231,364,20,1,1,364,66,428,1.68E-157,555,363,362
82625,Nsylvestris_NODE_32708_length_363_cov_51,Ntome_NODE_39858_length_251_cov_9,91.02,245,22,0,16,260,251,7,3.07E-90,331,244,244
82636,Nsylvestris_NODE_32722_length_363_cov_4,Ntome_NODE_23008_length_983_cov_27,95.556,360,16,0,4,363,778,419,3.58E-164,577,359,359
82642,Nsylvestris_NODE_32733_length_363_cov_3,Ntome_NODE_19443_length_1239_cov_12,90.04,251,10,3,33,268,26,276,4.00E-84,311,235,250
82651,Nsylvestris_NODE_32750_length_362_cov_2,Ntome_NODE_24638_length_885_cov_11,92.077,366,24,4,1,362,139,503,3.67E-144,510,361,364
82661,Nsylvestris_NODE_32762_length_361_cov_9,Ntome_NODE_31924_length_555_cov_178,83.862,378,32,12,1,354,31,403,8.50E-91,333,353,372
82662,Nsylvestris_NODE_32763_length_361_cov_8,Ntome_NODE_19364_length_1246_cov_17,95,180,9,0,1,180,1221,1042,8.68E-76,283,179,179
82663,Nsylvestris_NODE_32767_length_361_cov_7,Ntome_NODE_33235_length_461_cov_7,96.243,346,10,1,4,346,454,109,2.77E-160,564,342,345
82690,Nsylvestris_NODE_32802_length_360_cov_6,Ntome_NODE_33894_length_425_cov_3,92.973,185,12,1,78,261,199,15,2.42E-71,268,183,184
82725,Nsylvestris_NODE_32838_length_359_cov_3,Ntome_NODE_32883_length_486_cov_17,87.732,269,33,0,84,352,470,202,3.06E-85,315,268,268
82733,Nsylvestris_NODE_32847_length_358_cov_10,Ntome_NODE_18747_length_1296_cov_40,91.808,354,14,11,20,358,415,62,1.02E-134,479,338,353
82737,Nsylvestris_NODE_32855_length_358_cov_4,Ntome_NODE_35083_length_371_cov_4,92.5,360,21,6,3,358,1,358,3.62E-144,510,355,357
82788,Nsylvestris_NODE_32895_length_356_cov_51,Ntome_NODE_37941_length_289_cov_43,92.347,196,13,2,25,219,36,230,3.98E-74,278,194,194
82804,Nsylvestris_NODE_32912_length_356_cov_4,Ntome_NODE_37841_length_292_cov_4,92.466,292,15,1,18,302,1,292,3.76E-114,411,284,291
82808,Nsylvestris_NODE_32917_length_356_cov_3,Ntome_NODE_27804_length_720_cov_7,95.706,326,12,2,1,324,9,334,4.63E-148,523,323,325
82846,Nsylvestris_NODE_32973_length_354_cov_4,Ntome_NODE_31535_length_570_cov_8,88.601,193,22,0,1,193,134,326,2.41E-61,235,192,192
82860,Nsylvestris_NODE_32986_length_353_cov_11,Ntome_NODE_30373_length_613_cov_153,92.878,337,19,2,1,335,256,589,2.16E-136,484,334,333
82886,Nsylvestris_NODE_33025_length_352_cov_7,Ntome_NODE_36198_length_333_cov_4,96.988,332,10,0,20,351,332,1,1.25E-158,558,331,331
82888,Nsylvestris_NODE_33035_length_352_cov_3,Ntome_NODE_19960_length_1195_cov_119,94.362,337,16,2,4,340,451,118,2.75E-145,514,336,333
82902,Nsylvestris_NODE_33058_length_351_cov_4,Ntome_NODE_36551_length_323_cov_3,81.928,249,26,10,1,246,281,49,1.46E-48,193,245,232
82948,Nsylvestris_NODE_33122_length_348_cov_22,Ntome_NODE_38491_length_278_cov_4,95.683,278,12,0,13,290,1,278,2.80E-125,448,277,277
82955,Nsylvestris_NODE_33131_length_348_cov_4,Ntome_NODE_34442_length_398_cov_4,96.491,228,8,0,1,228,171,398,3.72E-104,377,227,227
82970,Nsylvestris_NODE_33156_length_347_cov_6,Ntome_NODE_33889_length_425_cov_4,85.801,331,17,12,23,341,425,113,4.90E-88,324,318,312
82971,Nsylvestris_NODE_33157_length_347_cov_6,Ntome_NODE_27109_length_753_cov_4,91.404,349,22,5,6,346,126,474,1.65E-132,472,340,348
82979,Nsylvestris_NODE_33163_length_347_cov_4,Ntome_NODE_36267_length_331_cov_5,86.25,80,5,1,268,341,331,252,3.26E-15,82.4,73,79
82984,Nsylvestris_NODE_33174_length_347_cov_3,Ntome_NODE_30132_length_623_cov_7,97.126,348,9,1,1,347,160,507,5.66E-167,586,346,347
83029,Nsylvestris_NODE_33232_length_345_cov_4,Ntome_NODE_34561_length_393_cov_3,97.273,110,3,0,54,163,284,393,6.67E-47,187,109,109
83045,Nsylvestris_NODE_33255_length_344_cov_5,Ntome_NODE_27738_length_723_cov_6,89.296,355,23,8,1,344,683,333,2.78E-120,431,343,350
83049,Nsylvestris_NODE_33259_length_344_cov_4,Ntome_NODE_26621_length_777_cov_5,94.783,345,17,1,1,344,614,270,5.73E-152,536,343,344
83059,Nsylvestris_NODE_33270_length_343_cov_61,Ntome_NODE_31633_length_566_cov_38,92.44,291,9,9,26,312,525,244,6.04E-112,403,286,281
83084,Nsylvestris_NODE_33297_length_343_cov_3,Ntome_NODE_39058_length_266_cov_4,93.962,265,15,1,61,324,1,265,7.82E-111,399,263,264
83104,Nsylvestris_NODE_33311_length_342_cov_8,Ntome_NODE_17401_length_1412_cov_24,92,325,21,2,19,342,1191,871,2.12E-126,451,323,320
83122,Nsylvestris_NODE_33333_length_341_cov_5,Ntome_NODE_38925_length_269_cov_3,96.911,259,7,1,40,297,268,10,7.66E-121,433,257,258
83131,Nsylvestris_NODE_33347_length_341_cov_3,Ntome_NODE_38623_length_275_cov_3,91.866,209,7,3,143,341,1,209,8.16E-76,283,198,208
83134,Nsylvestris_NODE_33354_length_341_cov_2,Ntome_NODE_29084_length_665_cov_4,90.058,342,33,1,1,341,266,607,1.27E-123,442,340,341
83197,Nsylvestris_NODE_33428_length_338_cov_10,Ntome_NODE_37834_length_292_cov_4,93.893,262,9,1,3,257,28,289,1.67E-107,388,254,261
83201,Nsylvestris_NODE_33437_length_338_cov_5,Ntome_NODE_31750_length_562_cov_13,94.118,306,18,0,33,338,506,201,7.48E-131,466,305,305
83204,Nsylvestris_NODE_33442_length_338_cov_4,Ntome_NODE_32121_length_541_cov_6,93.671,316,17,2,26,338,540,225,5.78E-132,470,312,315
83206,Nsylvestris_NODE_33453_length_338_cov_2,Ntome_NODE_25703_length_821_cov_8,89.489,333,17,10,5,333,606,288,1.65E-112,405,328,318
83227,Nsylvestris_NODE_33473_length_337_cov_6,Ntome_NODE_21955_length_1052_cov_46,91.045,335,13,3,4,337,934,616,5.85E-122,436,333,318
83234,Nsylvestris_NODE_33483_length_337_cov_4,Ntome_NODE_27780_length_721_cov_12,91.746,315,9,6,38,337,1,313,1.64E-117,422,299,312
83235,Nsylvestris_NODE_33484_length_337_cov_4,Ntome_NODE_27785_length_721_cov_7,90.728,302,20,5,38,337,712,417,9.92E-110,396,299,295
83260,Nsylvestris_NODE_33508_length_336_cov_6,Ntome_NODE_37647_length_296_cov_5,94.366,213,12,0,34,246,296,84,3.66E-89,327,212,212
83267,Nsylvestris_NODE_33516_length_336_cov_4,Ntome_NODE_32666_length_501_cov_4,90.355,197,18,1,1,196,203,7,4.87E-68,257,195,196
83273,Nsylvestris_NODE_33524_length_336_cov_3,Ntome_NODE_25648_length_825_cov_5,91.875,320,24,2,19,336,504,823,9.68E-125,446,317,319
83274,Nsylvestris_NODE_33525_length_336_cov_3,Ntome_NODE_35248_length_364_cov_4,83.792,327,39,11,15,336,361,44,2.87E-80,298,321,317
83302,Nsylvestris_NODE_33556_length_335_cov_5,Ntome_NODE_35836_length_344_cov_2,93.119,218,10,3,1,218,121,333,2.84E-85,315,217,212
83309,Nsylvestris_NODE_33576_length_334_cov_28,Ntome_NODE_38898_length_269_cov_78,93.939,231,11,1,100,330,2,229,1.00E-94,346,230,227
83314,Nsylvestris_NODE_33585_length_334_cov_5,Ntome_NODE_32710_length_497_cov_241,87.943,282,17,8,1,266,217,497,7.87E-86,316,265,280
83318,Nsylvestris_NODE_33596_length_334_cov_4,Ntome_NODE_18052_length_1354_cov_19,92.72,261,19,0,1,261,310,50,3.56E-104,377,260,260
83344,Nsylvestris_NODE_33621_length_333_cov_5,Ntome_NODE_32191_length_537_cov_4,86.545,275,32,5,63,333,409,136,2.84E-80,298,270,273
83380,Nsylvestris_NODE_33658_length_332_cov_4,Ntome_NODE_29456_length_650_cov_6,88.52,331,38,0,2,332,291,621,2.10E-111,401,330,330
83392,Nsylvestris_NODE_33671_length_332_cov_2,Ntome_NODE_30473_length_610_cov_5,94.828,232,11,1,1,231,232,1,3.56E-99,361,230,231
83426,Nsylvestris_NODE_33720_length_330_cov_3,Ntome_NODE_32399_length_521_cov_8,98.246,57,1,0,96,152,1,57,8.52E-21,100,56,56
83443,Nsylvestris_NODE_33741_length_329_cov_51,Ntome_NODE_24578_length_887_cov_204,97.403,231,6,0,44,274,306,76,3.48E-109,394,230,230
83444,Nsylvestris_NODE_33742_length_329_cov_36,Ntome_NODE_33331_length_455_cov_37,90.036,281,10,10,7,271,385,107,2.75E-95,348,264,278
83455,Nsylvestris_NODE_33751_length_329_cov_6,Ntome_NODE_33423_length_450_cov_7,95.324,278,13,0,1,278,352,75,1.22E-123,442,277,277
83461,Nsylvestris_NODE_33766_length_329_cov_3,Ntome_NODE_25429_length_837_cov_8,88.35,309,24,5,8,305,182,489,3.53E-99,361,297,307
83472,Nsylvestris_NODE_33785_length_328_cov_7,Ntome_NODE_35479_length_355_cov_8,77.593,241,41,13,89,323,18,251,8.34E-31,134,234,233
83483,Nsylvestris_NODE_33802_length_328_cov_3,Ntome_NODE_36636_length_320_cov_4,93.262,282,19,0,47,328,1,282,7.40E-116,416,281,281
83485,Nsylvestris_NODE_33807_length_328_cov_2,Ntome_NODE_17967_length_1361_cov_45,96.951,328,10,0,1,328,546,873,1.94E-156,551,327,327
83498,Nsylvestris_NODE_33823_length_327_cov_6,Ntome_NODE_21218_length_1101_cov_10,94.19,327,8,2,1,327,137,452,1.54E-137,488,326,315
83501,Nsylvestris_NODE_33832_length_327_cov_4,Ntome_NODE_28229_length_700_cov_4,89.439,303,22,8,1,294,409,108,4.50E-103,374,293,301
83518,Nsylvestris_NODE_33859_length_326_cov_5,Ntome_NODE_37038_length_310_cov_3,93.092,304,14,3,6,309,14,310,1.57E-122,438,303,296
83525,Nsylvestris_NODE_33879_length_326_cov_3,Ntome_NODE_16372_length_1507_cov_165,88.077,260,20,6,59,316,930,680,2.78E-80,298,257,250
83528,Nsylvestris_NODE_33882_length_326_cov_3,Ntome_NODE_20204_length_1177_cov_8,93.558,326,20,1,1,326,328,4,1.99E-136,484,325,324
83578,Nsylvestris_NODE_33929_length_324_cov_5,Ntome_NODE_29065_length_665_cov_31,77.389,314,43,12,15,324,111,400,3.78E-39,161,309,289
83582,Nsylvestris_NODE_33938_length_324_cov_3,Ntome_NODE_39566_length_257_cov_2,88.976,127,13,1,199,324,113,239,1.76E-37,156,125,126
83615,Nsylvestris_NODE_33992_length_322_cov_4,Ntome_NODE_38656_length_274_cov_6,93.81,210,13,0,5,214,211,2,7.57E-86,316,209,209
83636,Nsylvestris_NODE_34013_length_321_cov_7,Ntome_NODE_36676_length_319_cov_5,96.386,166,6,0,156,321,319,154,4.60E-73,274,165,165
83651,Nsylvestris_NODE_34034_length_322_cov_3,Ntome_NODE_28379_length_694_cov_9,77.551,245,39,11,69,301,359,599,8.18E-31,134,232,240
83657,Nsylvestris_NODE_34050_length_320_cov_215,Ntome_NODE_32498_length_513_cov_242,94.485,272,14,1,1,271,513,242,2.00E-116,418,270,271
83683,Nsylvestris_NODE_34094_length_319_cov_5,Ntome_NODE_14488_length_1687_cov_36,85.714,182,20,2,97,272,420,601,6.13E-47,187,175,181
83688,Nsylvestris_NODE_34106_length_319_cov_3,Ntome_NODE_23390_length_961_cov_9,94.953,317,13,3,4,319,848,534,3.22E-139,494,315,314
83701,Nsylvestris_NODE_34128_length_318_cov_4,Ntome_NODE_38922_length_269_cov_3,95.597,159,6,1,1,159,112,269,5.94E-67,254,158,157
83702,Nsylvestris_NODE_34129_length_318_cov_4,Ntome_NODE_23985_length_926_cov_8,95.016,321,13,2,1,318,828,508,1.92E-141,501,317,320
83763,Nsylvestris_NODE_34225_length_315_cov_8,Ntome_NODE_35607_length_351_cov_5,95.254,295,14,0,1,295,295,1,1.93E-131,468,294,294
83767,Nsylvestris_NODE_34231_length_315_cov_5,Ntome_NODE_26348_length_790_cov_8,93.514,185,12,0,94,278,1,185,1.25E-73,276,184,184
83791,Nsylvestris_NODE_34257_length_314_cov_11,Ntome_NODE_32528_length_511_cov_6,95.094,265,10,3,52,314,445,182,2.54E-115,414,262,263
83795,Nsylvestris_NODE_34266_length_314_cov_5,Ntome_NODE_26163_length_799_cov_17,94.983,299,14,1,13,310,19,317,1.92E-131,468,297,298
83808,Nsylvestris_NODE_34293_length_314_cov_2,Ntome_NODE_9626_length_2250_cov_11,90.123,324,18,11,1,313,645,325,1.18E-113,409,312,320
83831,Nsylvestris_NODE_34338_length_312_cov_5,Ntome_NODE_21143_length_1106_cov_43,88.596,114,13,0,1,114,117,4,1.70E-32,139,113,113
83897,Nsylvestris_NODE_34438_length_310_cov_2,Ntome_NODE_32363_length_524_cov_4,91.824,318,12,8,5,310,1,316,2.49E-120,431,305,315
83911,Nsylvestris_NODE_34451_length_309_cov_7,Ntome_NODE_36816_length_315_cov_15,96.117,309,11,1,1,309,1,308,5.17E-142,503,308,307
83921,Nsylvestris_NODE_34473_length_309_cov_3,Ntome_NODE_29447_length_650_cov_19,94.419,215,12,0,95,309,650,436,2.58E-90,331,214,214
83934,Nsylvestris_NODE_34482_length_308_cov_63,Ntome_NODE_34567_length_392_cov_154,84.32,338,22,11,1,308,52,388,2.02E-81,302,307,336
83942,Nsylvestris_NODE_34489_length_308_cov_4,Ntome_NODE_15112_length_1623_cov_15,92.164,268,9,1,1,268,1322,1577,1.96E-101,368,267,255
83943,Nsylvestris_NODE_34491_length_308_cov_4,Ntome_NODE_26378_length_788_cov_86,96.753,308,10,0,1,308,533,226,2.38E-145,514,307,307
83947,Nsylvestris_NODE_34504_length_308_cov_2,Ntome_NODE_39246_length_263_cov_3,98.361,122,2,0,1,122,122,1,2.71E-55,215,121,121
83958,Nsylvestris_NODE_34514_length_307_cov_7,Ntome_NODE_31885_length_557_cov_9,87.926,323,18,10,1,303,142,463,3.27E-99,361,302,321
83969,Nsylvestris_NODE_34524_length_307_cov_3,Ntome_NODE_1952_length_4208_cov_51,94.444,306,17,0,1,306,1097,792,1.45E-132,472,305,305
83971,Nsylvestris_NODE_34526_length_307_cov_3,Ntome_NODE_21928_length_1053_cov_89,97.527,283,7,0,1,283,571,289,1.86E-136,484,282,282
83972,Nsylvestris_NODE_34527_length_307_cov_3,Ntome_NODE_37301_length_304_cov_2,93.534,232,12,2,1,230,74,304,1.19E-93,342,229,230
84002,Nsylvestris_NODE_34562_length_306_cov_3,Ntome_NODE_19291_length_1253_cov_9,92.763,304,22,0,3,306,774,471,4.07E-123,440,303,303
84039,Nsylvestris_NODE_34610_length_305_cov_3,Ntome_NODE_33038_length_475_cov_9,96.226,53,2,0,1,53,55,3,6.09E-17,87.9,52,52
84043,Nsylvestris_NODE_34614_length_305_cov_3,Ntome_NODE_25247_length_848_cov_8,94.059,303,18,0,1,303,396,94,3.11E-129,460,302,302
84053,Nsylvestris_NODE_34625_length_304_cov_7,Ntome_NODE_25342_length_842_cov_52,94.079,304,18,0,1,304,238,541,8.63E-130,462,303,303
84054,Nsylvestris_NODE_34626_length_304_cov_7,Ntome_NODE_37976_length_289_cov_2,88.889,135,13,2,1,135,133,1,2.72E-40,165,134,132
84093,Nsylvestris_NODE_34674_length_303_cov_5,Ntome_NODE_26493_length_783_cov_6,92.739,303,21,1,1,303,309,610,5.21E-122,436,302,301
84097,Nsylvestris_NODE_34683_length_303_cov_4,Ntome_NODE_24938_length_867_cov_16,87.619,105,8,3,191,291,601,498,7.71E-26,117,100,103
84104,Nsylvestris_NODE_34699_length_303_cov_3,Ntome_NODE_9847_length_2219_cov_38,87.981,208,18,3,32,234,1190,985,1.58E-62,239,202,205
84151,Nsylvestris_NODE_34775_length_301_cov_2,Ntome_NODE_32169_length_538_cov_8,95.154,227,11,0,1,227,239,13,1.15E-98,359,226,226
84158,Nsylvestris_NODE_34781_length_300_cov_7,Ntome_NODE_36778_length_316_cov_8,96.656,299,6,3,1,296,298,1,3.02E-139,494,295,297
84162,Nsylvestris_NODE_34793_length_300_cov_4,Ntome_NODE_25327_length_843_cov_20,79.167,288,49,8,12,298,442,719,1.59E-47,189,286,277
84194,Nsylvestris_NODE_34823_length_299_cov_6,Ntome_NODE_34600_length_391_cov_4,95.638,298,13,0,2,299,387,90,8.41E-135,479,297,297
84197,Nsylvestris_NODE_34829_length_299_cov_4,Ntome_NODE_28145_length_704_cov_5,91.837,147,9,2,153,298,36,180,2.04E-51,202,145,144
84200,Nsylvestris_NODE_34846_length_299_cov_3,Ntome_NODE_31936_length_555_cov_5,92.683,41,3,0,1,41,113,73,1.30E-08,60.2,40,40
84218,Nsylvestris_NODE_34871_length_298_cov_6,Ntome_NODE_38760_length_272_cov_4,89.13,92,9,1,9,100,228,138,9.80E-25,113,91,90
84243,Nsylvestris_NODE_34910_length_297_cov_6,Ntome_NODE_27331_length_742_cov_6,96.599,294,10,0,4,297,499,206,1.39E-137,488,293,293
84273,Nsylvestris_NODE_34946_length_296_cov_19,Ntome_NODE_35293_length_362_cov_116,89.764,127,6,2,80,200,1,126,1.59E-37,156,120,125
84275,Nsylvestris_NODE_34952_length_296_cov_6,Ntome_NODE_35122_length_369_cov_7,83.399,253,14,10,44,296,44,268,1.21E-53,209,252,224
84281,Nsylvestris_NODE_34961_length_296_cov_4,Ntome_NODE_39111_length_265_cov_4,95.055,182,8,1,114,295,9,189,1.95E-76,285,181,180
84285,Nsylvestris_NODE_34978_length_296_cov_3,Ntome_NODE_12654_length_1880_cov_184,82.282,333,17,5,1,296,431,104,7.10E-66,250,295,327
84311,Nsylvestris_NODE_35021_length_295_cov_3,Ntome_NODE_17865_length_1370_cov_9,93.688,301,10,2,4,295,956,656,1.09E-123,442,291,300
84312,Nsylvestris_NODE_35022_length_295_cov_2,Ntome_NODE_29794_length_636_cov_54,96.271,295,11,0,1,295,461,167,1.78E-136,484,294,294
84332,Nsylvestris_NODE_35054_length_294_cov_3,Ntome_NODE_17199_length_1430_cov_74,94.898,294,15,0,1,294,1126,833,2.99E-129,460,293,293
84345,Nsylvestris_NODE_35073_length_293_cov_4,Ntome_NODE_39354_length_260_cov_3,91.463,164,13,1,131,293,260,97,4.26E-58,224,162,163
84351,Nsylvestris_NODE_35096_length_293_cov_2,Ntome_NODE_28118_length_705_cov_8,86.466,133,11,5,2,134,17,142,1.59E-32,139,132,125
84362,Nsylvestris_NODE_35111_length_292_cov_6,Ntome_NODE_39375_length_260_cov_6,90.909,143,11,2,62,203,118,259,4.30E-48,191,141,141
84405,Nsylvestris_NODE_35161_length_291_cov_9,Ntome_NODE_24010_length_924_cov_46,88.552,297,14,7,1,291,420,702,1.12E-93,342,290,282
84421,Nsylvestris_NODE_35192_length_291_cov_3,Ntome_NODE_30341_length_615_cov_9,93.836,292,9,7,4,290,51,338,2.32E-120,431,286,287
84479,Nsylvestris_NODE_35268_length_289_cov_3,Ntome_NODE_39595_length_256_cov_4,95.862,145,5,1,59,203,113,256,6.97E-61,233,144,143
84548,Nsylvestris_NODE_35363_length_287_cov_4,Ntome_NODE_12121_length_1943_cov_13,88.591,298,18,4,1,287,1032,1324,2.37E-95,348,286,292
84549,Nsylvestris_NODE_35365_length_287_cov_4,Ntome_NODE_7948_length_2498_cov_283,94.138,290,14,1,1,287,1667,1956,1.37E-122,438,286,289
84572,Nsylvestris_NODE_35398_length_286_cov_5,Ntome_NODE_38862_length_270_cov_4,89.655,232,18,5,54,285,260,35,4.03E-78,291,231,225
84603,Nsylvestris_NODE_35442_length_285_cov_5,Ntome_NODE_33938_length_422_cov_5,96.629,267,9,0,2,268,267,1,2.91E-124,444,266,266
84625,Nsylvestris_NODE_35483_length_284_cov_5,Ntome_NODE_23518_length_954_cov_44,95.07,284,14,0,1,284,283,566,2.24E-125,448,283,283
84641,Nsylvestris_NODE_35510_length_284_cov_3,Ntome_NODE_16747_length_1471_cov_104,92.281,285,20,2,1,284,922,639,4.93E-112,403,283,283
84677,Nsylvestris_NODE_35570_length_283_cov_1,Ntome_NODE_26100_length_802_cov_18,94.7,283,15,0,1,283,468,750,3.74E-123,440,282,282
84722,Nsylvestris_NODE_35640_length_281_cov_3,Ntome_NODE_26032_length_805_cov_8,93.594,281,18,0,1,281,488,208,4.83E-117,420,280,280
84749,Nsylvestris_NODE_35668_length_280_cov_4,Ntome_NODE_34457_length_397_cov_4,82.784,273,21,6,34,280,397,125,5.24E-57,220,246,272
84771,Nsylvestris_NODE_35712_length_279_cov_5,Ntome_NODE_37126_length_308_cov_5,92.578,256,10,5,30,279,1,253,1.06E-98,359,249,252
84781,Nsylvestris_NODE_35719_length_279_cov_4,Ntome_NODE_25799_length_816_cov_21,89.753,283,16,3,1,279,292,565,6.38E-96,350,278,273
84793,Nsylvestris_NODE_35730_length_279_cov_3,Ntome_NODE_38012_length_288_cov_4,97.512,201,5,0,71,271,1,201,2.97E-94,344,200,200
84806,Nsylvestris_NODE_35743_length_278_cov_12,Ntome_NODE_28276_length_698_cov_59,90.517,232,15,1,36,267,698,474,6.49E-81,300,231,224
84808,Nsylvestris_NODE_35752_length_278_cov_5,Ntome_NODE_6868_length_2682_cov_13,94.619,223,11,1,1,222,2460,2682,2.96E-94,344,221,222
84813,Nsylvestris_NODE_35758_length_278_cov_5,Ntome_NODE_35993_length_339_cov_2,95.21,167,6,1,112,278,339,175,8.52E-70,263,166,164
84820,Nsylvestris_NODE_35771_length_278_cov_4,Ntome_NODE_33880_length_425_cov_7,91.2,125,11,0,154,278,1,125,5.31E-42,171,124,124
84831,Nsylvestris_NODE_35787_length_278_cov_3,Ntome_NODE_31653_length_566_cov_5,94.245,278,16,0,1,278,57,334,1.03E-118,425,277,277
84841,Nsylvestris_NODE_35800_length_277_cov_7,Ntome_NODE_34724_length_386_cov_4,91.176,272,21,3,4,275,101,369,6.29E-101,366,271,268
84847,Nsylvestris_NODE_35805_length_277_cov_4,Ntome_NODE_19755_length_1214_cov_59,93.077,260,16,2,18,275,1084,825,8.08E-105,379,257,259
84893,Nsylvestris_NODE_35875_length_276_cov_3,Ntome_NODE_34131_length_409_cov_3,94.301,193,10,1,84,276,68,259,3.00E-79,294,192,191
84907,Nsylvestris_NODE_35894_length_275_cov_5,Ntome_NODE_13862_length_1750_cov_23,90.391,281,19,4,1,274,472,751,8.07E-100,363,273,279
84916,Nsylvestris_NODE_35911_length_275_cov_3,Ntome_NODE_38718_length_273_cov_4,97.209,215,6,0,1,215,215,1,2.24E-100,364,214,214
84919,Nsylvestris_NODE_35919_length_275_cov_3,Ntome_NODE_26548_length_780_cov_12,87.008,254,31,1,2,255,193,444,1.80E-76,285,253,251
84920,Nsylvestris_NODE_35923_length_275_cov_3,Ntome_NODE_32730_length_496_cov_14,94.928,276,10,4,1,275,478,206,7.85E-120,429,274,272
84949,Nsylvestris_NODE_35967_length_274_cov_2,Ntome_NODE_39872_length_251_cov_4,96.216,185,7,0,4,188,67,251,4.94E-82,303,184,184
84988,Nsylvestris_NODE_36025_length_272_cov_71,Ntome_NODE_13050_length_1836_cov_91,94.884,215,10,1,1,214,418,632,1.74E-91,335,213,214
84998,Nsylvestris_NODE_36047_length_272_cov_4,Ntome_NODE_25489_length_834_cov_14,91.078,269,18,6,7,272,1,266,1.03E-98,359,265,265
85013,Nsylvestris_NODE_36078_length_271_cov_23,Ntome_NODE_38838_length_270_cov_14,92.969,256,15,2,13,268,15,267,4.75E-102,370,255,252
85029,Nsylvestris_NODE_36103_length_271_cov_4,Ntome_NODE_14880_length_1646_cov_39,95.911,269,9,2,1,268,407,140,1.66E-121,435,267,267
85030,Nsylvestris_NODE_36104_length_271_cov_4,Ntome_NODE_39780_length_253_cov_2,96.444,225,8,0,1,225,27,251,1.32E-102,372,224,224
85074,Nsylvestris_NODE_36157_length_270_cov_2,Ntome_NODE_35139_length_367_cov_11,93.836,146,9,0,1,146,146,1,5.04E-57,220,145,145
85098,Nsylvestris_NODE_36186_length_269_cov_3,Ntome_NODE_1525_length_4517_cov_41,92.969,128,8,1,114,241,736,610,1.83E-46,185,127,126
85125,Nsylvestris_NODE_36223_length_268_cov_4,Ntome_NODE_23980_length_926_cov_30,93.657,268,15,1,1,268,306,41,5.98E-111,399,267,265
85160,Nsylvestris_NODE_36274_length_267_cov_4,Ntome_NODE_23229_length_970_cov_7,96.255,267,9,1,1,267,493,758,4.54E-122,436,266,265
85165,Nsylvestris_NODE_36283_length_267_cov_2,Ntome_NODE_26697_length_773_cov_34,95.506,267,12,0,1,267,555,289,2.73E-119,427,266,266
85191,Nsylvestris_NODE_36316_length_266_cov_4,Ntome_NODE_37172_length_307_cov_4,93.82,178,11,0,61,238,129,306,1.74E-71,268,177,177
85231,Nsylvestris_NODE_36368_length_265_cov_4,Ntome_NODE_34979_length_375_cov_10,88.312,154,13,4,5,157,3,152,8.38E-45,180,152,149
85232,Nsylvestris_NODE_36370_length_264_cov_4,Ntome_NODE_1150_length_4898_cov_30,83.571,280,30,4,1,264,139,418,2.25E-65,248,263,279
85256,Nsylvestris_NODE_36410_length_264_cov_3,Ntome_NODE_36217_length_333_cov_2,99.621,264,1,0,1,264,327,64,5.68E-136,483,263,263
85270,Nsylvestris_NODE_36444_length_263_cov_5,Ntome_NODE_36932_length_312_cov_5,95.42,262,9,3,3,263,1,260,2.09E-115,414,260,259
85279,Nsylvestris_NODE_36468_length_263_cov_3,Ntome_NODE_36917_length_313_cov_2,92.045,264,20,1,1,263,266,3,4.59E-102,370,262,263
85283,Nsylvestris_NODE_36474_length_263_cov_3,Ntome_NODE_38411_length_280_cov_3,90.21,143,13,1,120,262,277,136,1.79E-46,185,142,141
85284,Nsylvestris_NODE_36476_length_263_cov_2,Ntome_NODE_33901_length_424_cov_5,94.444,234,13,0,30,263,1,234,2.76E-99,361,233,233
85294,Nsylvestris_NODE_36488_length_262_cov_5,Ntome_NODE_34737_length_385_cov_15,84.685,222,13,6,1,222,185,385,1.77E-51,202,221,200
85308,Nsylvestris_NODE_36518_length_262_cov_3,Ntome_NODE_17860_length_1370_cov_114,96.109,257,10,0,6,262,646,902,4.48E-117,420,256,256
85309,Nsylvestris_NODE_36522_length_262_cov_2,Ntome_NODE_39923_length_250_cov_4,92.105,190,12,2,75,261,245,56,2.22E-70,265,186,189
85317,Nsylvestris_NODE_36530_length_261_cov_7,Ntome_NODE_34955_length_376_cov_5,95.618,251,3,4,11,260,40,283,7.51E-110,396,249,243
85327,Nsylvestris_NODE_36555_length_261_cov_4,Ntome_NODE_11651_length_1997_cov_23,95.769,260,11,0,1,260,1680,1939,4.46E-117,420,259,259
85340,Nsylvestris_NODE_36579_length_260_cov_6,Ntome_NODE_37724_length_294_cov_9,93.436,259,17,0,2,260,293,35,1.62E-106,385,258,258
85353,Nsylvestris_NODE_36596_length_260_cov_3,Ntome_NODE_33966_length_421_cov_3,96.154,260,10,0,1,260,162,421,9.54E-119,425,259,259
85358,Nsylvestris_NODE_36605_length_260_cov_2,Ntome_NODE_17678_length_1386_cov_14,89.231,260,27,1,1,259,867,608,3.58E-88,324,258,259
85376,Nsylvestris_NODE_36632_length_259_cov_4,Ntome_NODE_33570_length_442_cov_2,92.899,169,8,2,18,184,276,442,1.03E-63,243,166,166
85378,Nsylvestris_NODE_36635_length_259_cov_4,Ntome_NODE_39537_length_257_cov_4,97.98,198,2,1,64,259,257,60,9.84E-94,342,195,197
85402,Nsylvestris_NODE_36666_length_258_cov_25,Ntome_NODE_36964_length_311_cov_12,94.922,256,7,3,8,258,1,255,7.42E-110,396,250,254
85448,Nsylvestris_NODE_36735_length_257_cov_3,Ntome_NODE_37383_length_302_cov_3,96.241,133,5,0,124,256,302,170,1.72E-56,219,132,132
85478,Nsylvestris_NODE_36782_length_256_cov_3,Ntome_NODE_9892_length_2214_cov_126,97.976,247,5,0,1,247,1036,1282,7.25E-120,429,246,246
85513,Nsylvestris_NODE_36828_length_255_cov_4,Ntome_NODE_33490_length_447_cov_4,98.99,99,1,0,157,255,447,349,2.89E-44,178,98,98
85596,Nsylvestris_NODE_36945_length_253_cov_2,Ntome_NODE_35733_length_347_cov_3,80.952,147,25,3,107,252,145,1,8.19E-25,113,145,144
85674,Nsylvestris_NODE_37046_length_251_cov_3,Ntome_NODE_34499_length_395_cov_7,84.016,244,27,5,3,246,292,61,3.59E-58,224,243,231
85701,Nsylvestris_NODE_37086_length_250_cov_3,Ntome_NODE_19893_length_1202_cov_10,93.574,249,12,3,1,248,242,487,1.56E-101,368,247,245
85710,Nsylvestris_NODE_37098_length_250_cov_1,Ntome_NODE_17645_length_1389_cov_49,97.794,136,3,0,20,155,1008,1143,1.65E-61,235,135,135