,Query.seq.ID,Subject.seq.ID,X.ID,Alignment.length,X..mismatches,X..gap.openings,start.in.query,end.in.query,start.in.subject,end.in.subject,evalue,bitscore,match.length.query,match.length.subject
241,Ntome_NODE_41_length_10213_cov_186,Nsylvestris_NODE_31_length_10192_cov_149,97.736,10157,195,8,71,10213,40,10175,0,17450,10142,10135
702,Ntome_NODE_138_length_7978_cov_141,Nsylvestris_NODE_122_length_8122_cov_92,97.722,7989,141,13,1,7976,62,8022,0,13706,7975,7960
1591,Ntome_NODE_311_length_6659_cov_97,Nsylvestris_NODE_263_length_6934_cov_93,95.917,6612,208,18,55,6610,194,6799,0,10658,6555,6605
1761,Ntome_NODE_351_length_6498_cov_169,Nsylvestris_NODE_359_length_6446_cov_171,97.08,6405,159,12,36,6422,33,6427,0,10767,6386,6394
2224,Ntome_NODE_442_length_6185_cov_261,Nsylvestris_NODE_481_length_6006_cov_227,98.062,5986,83,9,88,6051,7,5981,0,10381,5963,5974
2274,Ntome_NODE_454_length_6143_cov_308,Nsylvestris_NODE_429_length_6174_cov_233,97.895,5892,103,7,3,5888,6120,244,0,10174,5885,5876
2837,Ntome_NODE_569_length_5831_cov_290,Nsylvestris_NODE_632_length_5617_cov_228,96.078,5635,161,27,169,5785,20,5612,0,9127,5616,5592
3432,Ntome_NODE_712_length_5539_cov_171,Nsylvestris_NODE_9641_length_2159_cov_203,95.06,2085,67,14,3422,5481,29,2102,0,3247,2059,2073
3783,Ntome_NODE_796_length_5390_cov_268,Nsylvestris_NODE_710_length_5408_cov_215,96.411,5377,135,16,43,5381,19,5375,0,8807,5338,5356
4067,Ntome_NODE_866_length_5276_cov_251,Nsylvestris_NODE_872_length_5122_cov_205,95.885,5128,155,27,29,5143,4,5088,0,8250,5114,5084
4105,Ntome_NODE_875_length_5260_cov_302,Nsylvestris_NODE_749_length_5353_cov_163,80,105,16,5,3211,3312,2784,2886,2.95E-11,73.1,101,102
4899,Ntome_NODE_1065_length_5003_cov_107,Nsylvestris_NODE_15414_length_1511_cov_145,86.493,422,54,3,4501,4920,449,29,5.13E-128,460,419,420
4915,Ntome_NODE_1071_length_4997_cov_170,Nsylvestris_NODE_5618_length_2835_cov_153,96.465,2433,77,6,154,2579,2823,393,0,4008,2425,2430
5012,Ntome_NODE_1099_length_4946_cov_245,Nsylvestris_NODE_1158_length_4748_cov_123,96.375,4662,149,7,81,4737,52,4698,0,7655,4656,4646
5144,Ntome_NODE_1132_length_4916_cov_30,Nsylvestris_NODE_925_length_5053_cov_43,96.469,4899,158,7,1,4885,4898,1,0,8074,4884,4897
5171,Ntome_NODE_1139_length_4908_cov_252,Nsylvestris_NODE_1191_length_4709_cov_224,97.342,4627,92,13,1,4599,4625,2,0,7834,4598,4623
5181,Ntome_NODE_1143_length_4904_cov_140,Nsylvestris_NODE_989_length_4970_cov_182,96.412,4905,120,27,8,4902,4967,109,0,8032,4894,4858
5225,Ntome_NODE_1150_length_4898_cov_30,Nsylvestris_NODE_36370_length_264_cov_4,83.571,280,30,4,139,418,1,264,4.26E-64,248,279,263
5309,Ntome_NODE_1171_length_4873_cov_148,Nsylvestris_NODE_28816_length_592_cov_8,79.897,388,64,9,2322,2696,3,389,2.52E-71,272,374,386
5352,Ntome_NODE_1183_length_4859_cov_78,Nsylvestris_NODE_1054_length_4875_cov_139,89.13,46,5,0,3861,3906,2716,2671,7.64E-07,58.4,45,45
5761,Ntome_NODE_1282_length_4750_cov_151,Nsylvestris_NODE_12558_length_1808_cov_220,96.014,1430,54,2,3249,4675,1597,168,0,2322,1426,1429
5970,Ntome_NODE_1332_length_4699_cov_92,Nsylvestris_NODE_2253_length_3913_cov_88,98.827,3581,42,0,3,3583,3853,273,0,6381,3580,3580
6087,Ntome_NODE_1364_length_4663_cov_85,Nsylvestris_NODE_30981_length_453_cov_2,80.8,125,24,0,1212,1336,232,108,4.32E-19,99,124,124
6313,Ntome_NODE_1417_length_4614_cov_68,Nsylvestris_NODE_1483_length_4412_cov_12,93.462,4451,233,14,147,4578,4412,1,0,6554,4431,4411
6743,Ntome_NODE_1525_length_4517_cov_41,Nsylvestris_NODE_36186_length_269_cov_3,93.6,125,7,1,613,736,238,114,3.12E-45,185,123,124
6861,Ntome_NODE_1555_length_4491_cov_264,Nsylvestris_NODE_1525_length_4376_cov_205,97.62,4328,89,10,137,4462,4376,61,0,7409,4325,4315
7001,Ntome_NODE_1593_length_4459_cov_160,Nsylvestris_NODE_3864_length_3280_cov_151,97.212,3192,82,3,1219,4410,3279,95,0,5395,3191,3184
7236,Ntome_NODE_1653_length_4420_cov_228,Nsylvestris_NODE_1853_length_4147_cov_145,97.283,4086,102,7,211,4294,4147,69,0,6922,4083,4078
7315,Ntome_NODE_1676_length_4407_cov_65,Nsylvestris_NODE_1496_length_4403_cov_97,95.602,4184,151,7,238,4407,52,4216,0,6676,4169,4164
7400,Ntome_NODE_1696_length_4385_cov_34,Nsylvestris_NODE_6173_length_2722_cov_72,91.137,1918,124,12,2491,4385,770,2664,0,2558,1894,1894
7653,Ntome_NODE_1752_length_4341_cov_22,Nsylvestris_NODE_1454_length_4445_cov_170,96.204,4347,140,13,4,4341,73,4403,0,7090,4337,4330
7936,Ntome_NODE_1819_length_4295_cov_49,Nsylvestris_NODE_2035_length_4032_cov_82,95.907,3982,118,7,18,3956,3,3982,0,6408,3938,3979
8271,Ntome_NODE_1900_length_4235_cov_126,Nsylvestris_NODE_1626_length_4313_cov_129,97.548,4241,83,7,1,4224,58,4294,0,7236,4223,4236
8280,Ntome_NODE_1903_length_4234_cov_152,Nsylvestris_NODE_18236_length_1247_cov_32,94.055,1026,59,2,3210,4234,1179,155,0,1555,1024,1024
8323,Ntome_NODE_1913_length_4227_cov_203,Nsylvestris_NODE_1988_length_4063_cov_181,95.864,4038,127,16,166,4184,1,4017,0,6495,4018,4016
8483,Ntome_NODE_1952_length_4208_cov_51,Nsylvestris_NODE_34524_length_307_cov_3,94.444,306,17,0,792,1097,306,1,1.99E-131,472,305,305
8922,Ntome_NODE_2060_length_4135_cov_74,Nsylvestris_NODE_1896_length_4120_cov_101,94.483,4133,149,45,38,4135,4120,32,0,6296,4097,4088
8960,Ntome_NODE_2072_length_4128_cov_235,Nsylvestris_NODE_1798_length_4179_cov_146,95.311,4073,131,28,42,4077,58,4107,0,6408,4035,4049
9001,Ntome_NODE_2085_length_4115_cov_260,Nsylvestris_NODE_2431_length_3825_cov_140,94.453,3714,119,31,128,3791,4,3680,0,5637,3663,3676
9063,Ntome_NODE_2102_length_4109_cov_77,Nsylvestris_NODE_2333_length_3881_cov_52,94.986,3829,187,3,237,4060,3881,53,0,6002,3823,3828
9136,Ntome_NODE_2121_length_4098_cov_51,Nsylvestris_NODE_1913_length_4104_cov_108,96.76,3920,120,4,134,4047,4013,95,0,6529,3913,3918
9629,Ntome_NODE_2253_length_4032_cov_53,Nsylvestris_NODE_2148_length_3965_cov_56,94.908,3947,191,5,95,4032,1,3946,0,6167,3937,3945
9757,Ntome_NODE_2286_length_4014_cov_121,Nsylvestris_NODE_1475_length_4421_cov_114,95.832,3959,122,12,42,3984,447,4378,0,6357,3942,3931
10294,Ntome_NODE_2425_length_3946_cov_63,Nsylvestris_NODE_2290_length_3898_cov_70,95.56,3671,136,6,5,3671,3898,251,0,5851,3666,3647
10414,Ntome_NODE_2457_length_3927_cov_57,Nsylvestris_NODE_2093_length_3999_cov_136,95.732,3889,122,19,59,3923,3869,1,0,6222,3864,3868
10453,Ntome_NODE_2469_length_3921_cov_71,Nsylvestris_NODE_2783_length_3671_cov_183,95.424,3584,150,6,341,3921,49,3621,0,5698,3580,3572
10633,Ntome_NODE_2522_length_3898_cov_200,Nsylvestris_NODE_124_length_8100_cov_69,86.614,127,16,1,571,696,70,196,2.13E-31,139,125,126
10634,Ntome_NODE_2523_length_3897_cov_215,Nsylvestris_NODE_1502_length_4395_cov_193,96.717,3868,91,14,45,3897,371,4217,0,6407,3852,3846
10721,Ntome_NODE_2543_length_3888_cov_80,Nsylvestris_NODE_2604_length_3744_cov_34,95.828,3691,136,5,77,3756,61,3744,0,5947,3679,3683
10747,Ntome_NODE_2550_length_3884_cov_245,Nsylvestris_NODE_2395_length_3842_cov_210,97.416,3792,82,7,56,3843,1,3780,0,6445,3787,3779
11008,Ntome_NODE_2615_length_3852_cov_263,Nsylvestris_NODE_1774_length_4193_cov_175,96.987,3585,94,3,94,3678,3,3573,0,6010,3584,3570
11101,Ntome_NODE_2640_length_3844_cov_44,Nsylvestris_NODE_3070_length_3555_cov_66,94.847,3474,155,5,90,3560,56,3508,0,5402,3470,3452
11266,Ntome_NODE_2688_length_3820_cov_60,Nsylvestris_NODE_2280_length_3902_cov_113,95.492,3394,111,23,58,3446,288,3644,0,5382,3388,3356
11472,Ntome_NODE_2737_length_3798_cov_115,Nsylvestris_NODE_2710_length_3700_cov_109,95.12,3627,136,14,78,3697,3616,24,0,5679,3619,3592
11618,Ntome_NODE_2778_length_3777_cov_226,Nsylvestris_NODE_845_length_5164_cov_145,95.896,3338,135,1,92,3427,106,3443,0,5404,3335,3337
11660,Ntome_NODE_2791_length_3774_cov_273,Nsylvestris_NODE_1536_length_4371_cov_182,94.692,3674,145,21,2,3664,4367,733,0,5659,3662,3634
11919,Ntome_NODE_2853_length_3755_cov_60,Nsylvestris_NODE_2708_length_3701_cov_37,96.643,3724,81,11,49,3751,3701,1,0,6144,3702,3700
11969,Ntome_NODE_2868_length_3750_cov_151,Nsylvestris_NODE_10882_length_2002_cov_215,95.014,1725,74,9,50,1764,1846,124,0,2699,1714,1722
11976,Ntome_NODE_2870_length_3749_cov_250,Nsylvestris_NODE_2526_length_3780_cov_208,95.389,3687,109,21,50,3700,109,3770,0,5810,3650,3661
12090,Ntome_NODE_2898_length_3737_cov_129,Nsylvestris_NODE_4083_length_3209_cov_107,94.073,3138,131,23,65,3160,3173,49,0,4713,3095,3124
12140,Ntome_NODE_2911_length_3732_cov_164,Nsylvestris_NODE_2673_length_3714_cov_138,90.727,3688,220,53,47,3670,77,3706,0,4804,3623,3629
12184,Ntome_NODE_2921_length_3728_cov_42,Nsylvestris_NODE_2424_length_3829_cov_166,95.975,3627,86,18,107,3728,49,3620,0,5834,3621,3571
12368,Ntome_NODE_2971_length_3711_cov_283,Nsylvestris_NODE_2845_length_3639_cov_205,96.415,3654,82,17,54,3691,19,3639,0,5976,3637,3620
12513,Ntome_NODE_3009_length_3696_cov_35,Nsylvestris_NODE_2688_length_3710_cov_68,96.145,3709,118,7,4,3695,1,3701,0,6034,3691,3700
12577,Ntome_NODE_3025_length_3689_cov_260,Nsylvestris_NODE_2460_length_3809_cov_226,96.499,3656,88,12,46,3687,159,3788,0,6006,3641,3629
12718,Ntome_NODE_3061_length_3674_cov_66,Nsylvestris_NODE_3409_length_3434_cov_42,92.982,3420,171,26,113,3499,3396,13,0,4922,3386,3383
12735,Ntome_NODE_3065_length_3672_cov_96,Nsylvestris_NODE_2999_length_3588_cov_69,98.161,3481,63,1,54,3533,3481,1,0,6072,3479,3480
12834,Ntome_NODE_3093_length_3660_cov_296,Nsylvestris_NODE_2654_length_3721_cov_230,97.765,3624,68,4,48,3660,3622,1,0,6231,3612,3621
12944,Ntome_NODE_3119_length_3650_cov_176,Nsylvestris_NODE_5060_length_2958_cov_70,95.914,2692,97,7,65,2747,5,2692,0,4349,2682,2687
13013,Ntome_NODE_3135_length_3645_cov_11,Nsylvestris_NODE_3169_length_3518_cov_171,96.346,3476,116,6,1,3466,24,3498,0,5705,3465,3474
13024,Ntome_NODE_3138_length_3643_cov_49,Nsylvestris_NODE_2329_length_3881_cov_160,95.409,3659,118,18,9,3643,3673,41,0,5781,3634,3632
13112,Ntome_NODE_3160_length_3634_cov_51,Nsylvestris_NODE_2929_length_3610_cov_54,95.116,3563,166,7,71,3632,3588,33,0,5609,3561,3555
13244,Ntome_NODE_3195_length_3623_cov_69,Nsylvestris_NODE_3258_length_3487_cov_43,95.931,3441,120,7,19,3445,4,3438,0,5561,3426,3434
13294,Ntome_NODE_3211_length_3618_cov_191,Nsylvestris_NODE_3081_length_3549_cov_195,96.492,3449,104,5,37,3481,3486,51,0,5683,3444,3435
13477,Ntome_NODE_3262_length_3601_cov_213,Nsylvestris_NODE_4199_length_3176_cov_199,97.603,3004,52,8,613,3599,3055,55,0,5131,2986,3000
13561,Ntome_NODE_3286_length_3592_cov_55,Nsylvestris_NODE_32055_length_392_cov_2,87.143,70,7,2,2296,2364,168,100,4.33E-13,78.7,68,68
13594,Ntome_NODE_3293_length_3590_cov_84,Nsylvestris_NODE_3280_length_3481_cov_185,97.466,3433,63,10,50,3466,3447,23,0,5836,3416,3424
13825,Ntome_NODE_3356_length_3566_cov_181,Nsylvestris_NODE_3545_length_3385_cov_168,97.408,3318,79,4,73,3385,1,3316,0,5644,3312,3315
13842,Ntome_NODE_3360_length_3566_cov_65,Nsylvestris_NODE_2718_length_3697_cov_88,97.51,3494,80,3,77,3566,3526,36,0,5963,3489,3490
14004,Ntome_NODE_3406_length_3545_cov_180,Nsylvestris_NODE_3033_length_3574_cov_154,97.603,3504,68,8,1,3499,3543,51,0,5991,3498,3492
14077,Ntome_NODE_3426_length_3539_cov_176,Nsylvestris_NODE_3670_length_3344_cov_147,97.428,3266,70,7,91,3356,3279,28,0,5553,3265,3251
14367,Ntome_NODE_3502_length_3516_cov_177,Nsylvestris_NODE_3111_length_3539_cov_191,96.365,3466,98,8,1,3466,6,3443,0,5677,3465,3437
14872,Ntome_NODE_3638_length_3471_cov_110,Nsylvestris_NODE_3752_length_3318_cov_153,97.088,3056,77,3,54,3104,3049,1,0,5140,3050,3048
14951,Ntome_NODE_3662_length_3466_cov_240,Nsylvestris_NODE_2790_length_3666_cov_158,97.349,3470,85,3,1,3466,3579,113,0,5891,3465,3466
14955,Ntome_NODE_3664_length_3466_cov_92,Nsylvestris_NODE_4947_length_2987_cov_37,89.48,2386,182,27,48,2392,4,2361,0,2952,2344,2357
15133,Ntome_NODE_3716_length_3445_cov_78,Nsylvestris_NODE_2651_length_3722_cov_83,97.667,3300,72,3,50,3346,236,3533,0,5662,3296,3297
15213,Ntome_NODE_3736_length_3439_cov_26,Nsylvestris_NODE_3480_length_3408_cov_17,95.602,3320,138,7,124,3437,90,3407,0,5315,3313,3317
15243,Ntome_NODE_3745_length_3436_cov_222,Nsylvestris_NODE_3423_length_3428_cov_231,97.816,3389,68,4,49,3432,40,3427,0,5843,3383,3387
15376,Ntome_NODE_3780_length_3427_cov_29,Nsylvestris_NODE_3565_length_3378_cov_116,94.321,3381,135,15,52,3423,3333,1,0,5127,3371,3332
15484,Ntome_NODE_3813_length_3415_cov_241,Nsylvestris_NODE_3498_length_3402_cov_221,96.505,3376,91,16,1,3363,39,3400,0,5555,3362,3361
15638,Ntome_NODE_3856_length_3402_cov_309,Nsylvestris_NODE_3616_length_3360_cov_171,94.778,3313,160,1,28,3340,25,3324,0,5147,3312,3299
15664,Ntome_NODE_3864_length_3400_cov_92,Nsylvestris_NODE_3536_length_3387_cov_181,94.847,3377,148,8,38,3396,1,3369,0,5249,3358,3368
15700,Ntome_NODE_3875_length_3395_cov_278,Nsylvestris_NODE_2190_length_3940_cov_200,96.163,3362,94,7,1,3351,71,3408,0,5461,3350,3337
15731,Ntome_NODE_3883_length_3393_cov_141,Nsylvestris_NODE_3936_length_3256_cov_141,96.838,3036,77,5,183,3203,3211,180,0,5057,3020,3031
15926,Ntome_NODE_3940_length_3375_cov_76,Nsylvestris_NODE_3129_length_3534_cov_114,94.92,3366,129,20,3,3352,3525,186,0,5230,3349,3339
15931,Ntome_NODE_3942_length_3375_cov_34,Nsylvestris_NODE_5980_length_2765_cov_72,95.838,2571,101,4,1,2567,2685,117,0,4150,2566,2568
16337,Ntome_NODE_4055_length_3333_cov_129,Nsylvestris_NODE_19453_length_1148_cov_27,89.758,908,62,8,2312,3212,8,891,0,1133,900,883
16361,Ntome_NODE_4061_length_3331_cov_262,Nsylvestris_NODE_4603_length_3072_cov_226,96.343,2707,80,7,64,2763,2850,156,0,4433,2699,2694
16712,Ntome_NODE_4160_length_3305_cov_210,Nsylvestris_NODE_3483_length_3406_cov_194,95.984,3237,115,13,54,3288,3261,38,0,5243,3234,3223
16788,Ntome_NODE_4181_length_3301_cov_161,Nsylvestris_NODE_4095_length_3204_cov_107,95.253,3202,118,17,115,3288,3196,1,0,5040,3173,3195
16808,Ntome_NODE_4186_length_3300_cov_252,Nsylvestris_NODE_3959_length_3246_cov_183,95.278,3198,137,7,35,3221,1,3195,0,5057,3186,3194
17068,Ntome_NODE_4260_length_3274_cov_215,Nsylvestris_NODE_3609_length_3361_cov_218,95.626,3269,131,6,7,3266,89,3354,0,5234,3259,3265
17070,Ntome_NODE_4262_length_3273_cov_206,Nsylvestris_NODE_4558_length_3083_cov_185,96.511,3038,76,12,52,3086,3011,1,0,4996,3034,3010
17093,Ntome_NODE_4268_length_3272_cov_34,Nsylvestris_NODE_12459_length_1821_cov_28,95.677,1573,68,0,463,2035,94,1666,0,2529,1572,1572
17195,Ntome_NODE_4300_length_3261_cov_38,Nsylvestris_NODE_4858_length_3006_cov_16,95.148,2906,128,12,364,3259,45,2947,0,4573,2895,2902
17264,Ntome_NODE_4317_length_3256_cov_116,Nsylvestris_NODE_6711_length_2620_cov_28,95.25,2463,107,2,743,3205,2620,168,0,3892,2462,2452
17265,Ntome_NODE_4318_length_3256_cov_87,Nsylvestris_NODE_3772_length_3312_cov_63,92.885,3289,165,15,1,3246,3265,3,0,4713,3245,3262
17266,Ntome_NODE_4319_length_3255_cov_289,Nsylvestris_NODE_4760_length_3031_cov_150,96.701,2971,79,3,33,3003,28,2979,0,4926,2970,2951
17365,Ntome_NODE_4346_length_3251_cov_16,Nsylvestris_NODE_2819_length_3654_cov_52,97.919,3219,65,2,35,3251,3267,49,0,5572,3216,3218
17536,Ntome_NODE_4399_length_3239_cov_104,Nsylvestris_NODE_4145_length_3190_cov_135,96.305,3004,99,6,56,3059,3046,55,0,4922,3003,2991
17581,Ntome_NODE_4414_length_3234_cov_164,Nsylvestris_NODE_4180_length_3181_cov_174,97.585,3106,66,7,132,3232,53,3154,0,5312,3100,3101
17582,Ntome_NODE_4415_length_3234_cov_105,Nsylvestris_NODE_3321_length_3468_cov_119,95.424,3147,132,12,58,3197,3174,33,0,5003,3139,3141
17636,Ntome_NODE_4430_length_3227_cov_156,Nsylvestris_NODE_4604_length_3072_cov_118,96.721,3019,95,3,160,3178,1,3015,0,5024,3018,3014
17999,Ntome_NODE_4531_length_3201_cov_292,Nsylvestris_NODE_4480_length_3103_cov_226,97.348,3054,56,15,152,3192,3044,3,0,5168,3040,3041
18010,Ntome_NODE_4534_length_3201_cov_155,Nsylvestris_NODE_4313_length_3146_cov_236,93.763,2966,135,21,49,2985,202,3146,0,4407,2936,2944
18136,Ntome_NODE_4573_length_3189_cov_33,Nsylvestris_NODE_5451_length_2873_cov_45,96.741,2792,90,1,381,3172,1,2791,0,4650,2791,2790
18174,Ntome_NODE_4587_length_3185_cov_86,Nsylvestris_NODE_3256_length_3487_cov_203,96.321,3044,101,4,47,3089,316,3349,0,4990,3042,3033
18243,Ntome_NODE_4606_length_3181_cov_254,Nsylvestris_NODE_6877_length_2588_cov_231,95.875,2570,76,10,498,3061,3,2548,0,4132,2563,2545
18257,Ntome_NODE_4611_length_3181_cov_76,Nsylvestris_NODE_3731_length_3326_cov_51,95.467,2934,124,9,43,2971,3326,397,0,4673,2928,2929
18471,Ntome_NODE_4678_length_3163_cov_294,Nsylvestris_NODE_4555_length_3084_cov_230,95.711,3031,77,14,39,3032,29,3043,0,4828,2993,3014
18564,Ntome_NODE_4706_length_3158_cov_238,Nsylvestris_NODE_5530_length_2855_cov_224,96.27,2842,94,8,2,2843,2830,1,0,4650,2841,2829
18596,Ntome_NODE_4715_length_3156_cov_204,Nsylvestris_NODE_4627_length_3066_cov_109,96.323,2801,61,7,282,3040,2901,101,0,4564,2758,2800
18651,Ntome_NODE_4733_length_3152_cov_178,Nsylvestris_NODE_8146_length_2381_cov_140,95.705,2375,89,4,575,2946,2381,17,0,3808,2371,2364
18866,Ntome_NODE_4796_length_3134_cov_87,Nsylvestris_NODE_4458_length_3108_cov_33,96.34,3060,101,7,8,3062,55,3108,0,5020,3054,3053
18873,Ntome_NODE_4799_length_3133_cov_210,Nsylvestris_NODE_5442_length_2875_cov_206,96.1,2692,77,13,148,2813,45,2734,0,4364,2665,2689
18990,Ntome_NODE_4832_length_3126_cov_18,Nsylvestris_NODE_2573_length_3759_cov_153,97.618,3148,51,4,1,3126,212,3357,0,5376,3125,3145
19013,Ntome_NODE_4840_length_3123_cov_285,Nsylvestris_NODE_5520_length_2858_cov_108,93.682,2833,135,25,47,2866,2857,56,0,4200,2819,2801
19094,Ntome_NODE_4864_length_3120_cov_35,Nsylvestris_NODE_26225_length_709_cov_5,76.226,530,116,8,580,1104,179,703,1.61E-71,272,524,524
19398,Ntome_NODE_4947_length_3098_cov_246,Nsylvestris_NODE_4374_length_3133_cov_196,96.3,2973,81,13,22,2972,3133,168,0,4854,2950,2965
19538,Ntome_NODE_4984_length_3087_cov_42,Nsylvestris_NODE_5377_length_2891_cov_64,94.06,2761,118,19,330,3064,119,2859,0,4148,2734,2740
19566,Ntome_NODE_4990_length_3085_cov_33,Nsylvestris_NODE_4188_length_3179_cov_43,96.036,3078,110,6,16,3085,60,3133,0,4998,3069,3073
19721,Ntome_NODE_5033_length_3068_cov_299,Nsylvestris_NODE_4796_length_3022_cov_225,94.254,2924,152,11,27,2938,3005,86,0,4455,2911,2919
19744,Ntome_NODE_5041_length_3067_cov_178,Nsylvestris_NODE_4620_length_3067_cov_197,95.4,3022,93,16,61,3064,1,2994,0,4769,3003,2993
19836,Ntome_NODE_5070_length_3061_cov_113,Nsylvestris_NODE_5687_length_2822_cov_26,93.748,2751,141,14,248,2995,53,2775,0,4098,2747,2722
19946,Ntome_NODE_5107_length_3053_cov_49,Nsylvestris_NODE_4327_length_3144_cov_158,95.437,3068,119,5,1,3053,37,3098,0,4870,3052,3061
20141,Ntome_NODE_5153_length_3043_cov_258,Nsylvestris_NODE_5911_length_2779_cov_210,96.933,2739,65,9,178,2908,46,2773,0,4575,2730,2727
20584,Ntome_NODE_5282_length_3011_cov_289,Nsylvestris_NODE_4482_length_3103_cov_205,94.276,3005,97,27,48,2998,3005,22,0,4527,2950,2983
20758,Ntome_NODE_5331_length_3000_cov_225,Nsylvestris_NODE_5595_length_2841_cov_151,96.112,2855,74,14,40,2871,1,2841,0,4623,2831,2840
20898,Ntome_NODE_5370_length_2993_cov_168,Nsylvestris_NODE_6025_length_2755_cov_179,96.938,2711,61,9,187,2879,5,2711,0,4527,2692,2706
20899,Ntome_NODE_5371_length_2993_cov_59,Nsylvestris_NODE_19337_length_1157_cov_20,90.411,73,5,2,2915,2986,793,722,3.58E-18,95.3,71,71
20996,Ntome_NODE_5398_length_2985_cov_273,Nsylvestris_NODE_1784_length_4187_cov_161,96.94,2680,60,8,101,2778,4062,1403,0,4475,2677,2659
21105,Ntome_NODE_5432_length_2978_cov_35,Nsylvestris_NODE_4084_length_3208_cov_128,95.505,2981,116,7,1,2978,3165,200,0,4747,2977,2965
21192,Ntome_NODE_5456_length_2972_cov_214,Nsylvestris_NODE_5061_length_2957_cov_226,94.692,2958,136,7,1,2939,2956,1,0,4573,2938,2955
21198,Ntome_NODE_5458_length_2972_cov_207,Nsylvestris_NODE_5066_length_2956_cov_176,97.431,2958,69,4,6,2958,2956,1,0,5035,2952,2955
21244,Ntome_NODE_5471_length_2970_cov_38,Nsylvestris_NODE_4994_length_2974_cov_114,94.597,2980,107,13,1,2969,2957,21,0,4562,2968,2936
21570,Ntome_NODE_5557_length_2948_cov_290,Nsylvestris_NODE_5542_length_2852_cov_228,94.423,2618,132,7,336,2948,2804,196,0,4013,2612,2608
21812,Ntome_NODE_5634_length_2931_cov_260,Nsylvestris_NODE_5708_length_2818_cov_224,96.503,2774,85,8,96,2860,48,2818,0,4575,2764,2770
21841,Ntome_NODE_5642_length_2929_cov_288,Nsylvestris_NODE_5330_length_2900_cov_172,96.113,2624,76,12,309,2929,104,2704,0,4257,2620,2600
21898,Ntome_NODE_5658_length_2925_cov_283,Nsylvestris_NODE_5677_length_2823_cov_29,95.993,2720,85,10,129,2833,2711,1,0,4397,2704,2710
21937,Ntome_NODE_5670_length_2923_cov_171,Nsylvestris_NODE_4689_length_3047_cov_190,94.39,2959,85,23,3,2922,4,2920,0,4470,2919,2916
22036,Ntome_NODE_5700_length_2918_cov_74,Nsylvestris_NODE_29502_length_563_cov_12,91.963,535,27,8,1019,1544,560,33,0,736,525,527
22116,Ntome_NODE_5725_length_2912_cov_227,Nsylvestris_NODE_5952_length_2769_cov_161,94.691,2769,138,3,47,2808,2767,1,0,4290,2761,2766
22153,Ntome_NODE_5736_length_2909_cov_151,Nsylvestris_NODE_11401_length_1942_cov_11,95.984,1942,78,0,860,2801,1,1942,0,3155,1941,1941
22250,Ntome_NODE_5767_length_2904_cov_226,Nsylvestris_NODE_4770_length_3029_cov_199,98.561,2502,34,2,36,2537,1,2500,0,4420,2501,2499
22363,Ntome_NODE_5801_length_2894_cov_95,Nsylvestris_NODE_5846_length_2793_cov_69,94.434,2767,102,24,68,2808,2792,52,0,4209,2740,2740
22777,Ntome_NODE_5916_length_2868_cov_112,Nsylvestris_NODE_6019_length_2757_cov_97,94.488,2413,130,3,404,2814,188,2599,0,3716,2410,2411
22841,Ntome_NODE_5934_length_2865_cov_140,Nsylvestris_NODE_4655_length_3055_cov_192,93.993,2697,119,11,72,2750,141,2812,0,4043,2678,2671
22882,Ntome_NODE_5948_length_2861_cov_275,Nsylvestris_NODE_4921_length_2991_cov_228,94.244,2797,132,20,47,2819,2842,51,0,4246,2772,2791
22916,Ntome_NODE_5957_length_2859_cov_229,Nsylvestris_NODE_7420_length_2501_cov_169,97.144,2451,47,3,83,2521,53,2492,0,4117,2438,2439
22929,Ntome_NODE_5962_length_2857_cov_24,Nsylvestris_NODE_5638_length_2831_cov_29,97.272,2273,49,3,90,2350,29,2300,0,3842,2260,2271
23070,Ntome_NODE_6004_length_2846_cov_261,Nsylvestris_NODE_5627_length_2832_cov_223,96.401,2806,72,7,1,2784,2812,14,0,4595,2783,2798
23128,Ntome_NODE_6021_length_2843_cov_285,Nsylvestris_NODE_6894_length_2586_cov_205,96.331,2589,91,3,244,2831,2586,1,0,4252,2587,2585
23270,Ntome_NODE_6062_length_2837_cov_50,Nsylvestris_NODE_24952_length_774_cov_20,95.758,165,7,0,1296,1460,689,525,6.79E-70,267,164,164
23278,Ntome_NODE_6065_length_2836_cov_222,Nsylvestris_NODE_6048_length_2750_cov_146,95.398,2716,115,4,44,2756,42,2750,0,4314,2712,2708
23419,Ntome_NODE_6104_length_2830_cov_50,Nsylvestris_NODE_14085_length_1641_cov_190,93.6,1500,64,11,1,1474,72,1565,0,2209,1473,1493
23651,Ntome_NODE_6173_length_2817_cov_242,Nsylvestris_NODE_4971_length_2980_cov_211,96.796,2778,52,12,47,2817,165,2912,0,4602,2770,2747
24124,Ntome_NODE_6295_length_2789_cov_59,Nsylvestris_NODE_5292_length_2907_cov_184,95.294,2805,84,19,4,2789,2859,84,0,4405,2785,2775
24356,Ntome_NODE_6356_length_2777_cov_19,Nsylvestris_NODE_31414_length_425_cov_3,96.682,422,14,0,752,1173,1,422,0,702,421,421
24377,Ntome_NODE_6363_length_2775_cov_39,Nsylvestris_NODE_32125_length_388_cov_195,93.651,315,19,1,73,386,367,53,4.71E-131,470,313,314
24431,Ntome_NODE_6383_length_2770_cov_221,Nsylvestris_NODE_4753_length_3033_cov_126,93.897,2507,145,5,216,2718,2544,42,0,3775,2502,2502
24455,Ntome_NODE_6392_length_2769_cov_86,Nsylvestris_NODE_6326_length_2693_cov_67,94.059,2693,134,9,8,2695,22,2693,0,4063,2687,2671
24511,Ntome_NODE_6411_length_2765_cov_113,Nsylvestris_NODE_7894_length_2422_cov_99,94.768,2389,66,10,1,2376,37,2379,0,3664,2375,2342
24546,Ntome_NODE_6424_length_2762_cov_236,Nsylvestris_NODE_8061_length_2393_cov_40,95.596,2384,89,10,241,2610,2382,1,0,3807,2369,2381
24552,Ntome_NODE_6426_length_2762_cov_71,Nsylvestris_NODE_7133_length_2549_cov_20,96.4,2500,86,2,159,2654,2545,46,0,4115,2495,2499
24717,Ntome_NODE_6481_length_2751_cov_246,Nsylvestris_NODE_7016_length_2567_cov_108,96.003,2527,77,14,83,2600,51,2562,0,4085,2517,2511
24946,Ntome_NODE_6543_length_2739_cov_285,Nsylvestris_NODE_5751_length_2810_cov_131,94.39,2674,118,9,46,2700,150,2810,0,4078,2654,2660
24974,Ntome_NODE_6553_length_2738_cov_13,Nsylvestris_NODE_2934_length_3609_cov_15,95.642,2685,113,4,1,2684,2985,304,0,4307,2683,2681
25152,Ntome_NODE_6605_length_2729_cov_185,Nsylvestris_NODE_7075_length_2558_cov_132,97.654,2558,55,2,42,2594,2558,1,0,4386,2552,2557
25168,Ntome_NODE_6611_length_2728_cov_200,Nsylvestris_NODE_6572_length_2648_cov_59,95.51,2695,58,24,40,2718,1,2648,0,4248,2678,2647
25191,Ntome_NODE_6619_length_2726_cov_40,Nsylvestris_NODE_6772_length_2609_cov_44,94.045,2351,128,9,328,2674,138,2480,0,3555,2346,2342
25216,Ntome_NODE_6627_length_2724_cov_267,Nsylvestris_NODE_6293_length_2698_cov_227,96.813,2667,59,14,9,2666,2655,6,0,4431,2657,2649
25217,Ntome_NODE_6628_length_2724_cov_251,Nsylvestris_NODE_6664_length_2631_cov_136,91.504,2554,134,35,41,2547,2566,49,0,3437,2506,2517
25256,Ntome_NODE_6642_length_2722_cov_36,Nsylvestris_NODE_28366_length_611_cov_179,79.396,364,49,12,276,613,545,182,6.60E-60,233,337,363
25382,Ntome_NODE_6680_length_2716_cov_133,Nsylvestris_NODE_5814_length_2798_cov_95,96.502,2659,84,4,1,2654,47,2701,0,4386,2653,2654
25481,Ntome_NODE_6705_length_2713_cov_131,Nsylvestris_NODE_8166_length_2376_cov_75,92.527,2355,129,14,276,2612,46,2371,0,3330,2336,2325
25504,Ntome_NODE_6711_length_2712_cov_143,Nsylvestris_NODE_15358_length_1516_cov_56,92.686,752,26,11,1468,2200,401,1142,0,1057,732,741
25578,Ntome_NODE_6732_length_2706_cov_250,Nsylvestris_NODE_6634_length_2636_cov_172,94.319,2658,101,29,55,2684,2636,1,0,4026,2629,2635
25586,Ntome_NODE_6734_length_2706_cov_86,Nsylvestris_NODE_27369_length_657_cov_91,90.533,338,23,5,2,331,58,394,1.30E-121,438,329,336
25653,Ntome_NODE_6755_length_2703_cov_38,Nsylvestris_NODE_6060_length_2747_cov_34,94.205,2709,132,8,8,2701,1,2699,0,4109,2693,2698
25685,Ntome_NODE_6768_length_2700_cov_53,Nsylvestris_NODE_11462_length_1935_cov_16,97.09,1821,51,2,221,2039,1,1821,0,3068,1818,1820
25721,Ntome_NODE_6778_length_2698_cov_63,Nsylvestris_NODE_6208_length_2715_cov_79,93.129,2707,166,7,1,2698,18,2713,0,3951,2697,2695
25879,Ntome_NODE_6821_length_2690_cov_145,Nsylvestris_NODE_5960_length_2768_cov_59,94.819,2683,110,15,1,2670,19,2685,0,4157,2669,2666
25934,Ntome_NODE_6836_length_2687_cov_206,Nsylvestris_NODE_9808_length_2139_cov_50,93.988,2129,94,15,43,2143,1,2123,0,3192,2100,2122
25961,Ntome_NODE_6844_length_2686_cov_194,Nsylvestris_NODE_5950_length_2769_cov_206,96.426,2686,70,13,1,2683,2732,70,0,4405,2682,2662
25978,Ntome_NODE_6849_length_2685_cov_119,Nsylvestris_NODE_6038_length_2753_cov_209,95.303,2661,111,3,2,2653,2734,79,0,4209,2651,2655
26035,Ntome_NODE_6868_length_2682_cov_13,Nsylvestris_NODE_35752_length_278_cov_5,94.619,223,11,1,2460,2682,1,222,2.88E-93,344,222,221
26070,Ntome_NODE_6879_length_2678_cov_254,Nsylvestris_NODE_6928_length_2580_cov_228,95.624,2582,84,11,6,2578,2562,1,0,4115,2572,2561
26120,Ntome_NODE_6895_length_2675_cov_282,Nsylvestris_NODE_6289_length_2699_cov_224,95.133,2630,121,5,1,2624,2668,40,0,4141,2623,2628
26315,Ntome_NODE_6956_length_2657_cov_203,Nsylvestris_NODE_5504_length_2861_cov_158,97.158,2604,64,6,2,2598,102,2702,0,4390,2596,2600
26316,Ntome_NODE_6957_length_2662_cov_108,Nsylvestris_NODE_6341_length_2690_cov_235,95.884,2648,68,17,15,2637,17,2648,0,4248,2622,2631
26420,Ntome_NODE_6989_length_2657_cov_91,Nsylvestris_NODE_15588_length_1492_cov_23,94.58,1439,32,15,35,1443,1491,69,0,2183,1408,1422
26425,Ntome_NODE_6991_length_2656_cov_173,Nsylvestris_NODE_6830_length_2598_cov_165,94.315,2533,116,10,1,2520,37,2554,0,3855,2519,2517
26528,Ntome_NODE_7022_length_2652_cov_36,Nsylvestris_NODE_5729_length_2816_cov_153,95.71,2611,110,2,4,2614,2612,4,0,4200,2610,2608
26554,Ntome_NODE_7031_length_2650_cov_79,Nsylvestris_NODE_8468_length_2330_cov_23,95.662,2236,88,4,1,2230,2278,46,0,3583,2229,2232
26654,Ntome_NODE_7062_length_2645_cov_35,Nsylvestris_NODE_10288_length_2077_cov_159,95.06,2004,82,7,350,2343,2039,43,0,3136,1993,1996
26662,Ntome_NODE_7064_length_2644_cov_287,Nsylvestris_NODE_6400_length_2680_cov_156,96.227,2465,93,0,54,2518,2471,7,0,4037,2464,2464
26694,Ntome_NODE_7076_length_2642_cov_288,Nsylvestris_NODE_8619_length_2306_cov_217,94.73,2258,112,3,34,2284,2305,48,0,3504,2250,2257
26721,Ntome_NODE_7084_length_2642_cov_14,Nsylvestris_NODE_4312_length_3147_cov_26,92.768,2641,188,3,5,2642,434,3074,0,3816,2637,2640
26722,Ntome_NODE_7085_length_2641_cov_248,Nsylvestris_NODE_7971_length_2409_cov_199,95.709,2307,81,11,283,2588,2326,37,0,3696,2305,2289
26935,Ntome_NODE_7154_length_2630_cov_20,Nsylvestris_NODE_5536_length_2855_cov_36,95.404,2633,117,3,1,2630,124,2755,0,4189,2629,2631
26971,Ntome_NODE_7168_length_2628_cov_84,Nsylvestris_NODE_7122_length_2550_cov_45,96.436,2553,79,3,3,2546,2550,1,0,4200,2543,2549
27006,Ntome_NODE_7180_length_2625_cov_161,Nsylvestris_NODE_5490_length_2864_cov_89,95.946,2590,84,8,1,2577,28,2609,0,4181,2576,2581
27079,Ntome_NODE_7200_length_2622_cov_120,Nsylvestris_NODE_7968_length_2410_cov_97,96.749,2399,67,8,203,2593,2396,1,0,3988,2390,2395
27196,Ntome_NODE_7234_length_2617_cov_189,Nsylvestris_NODE_6138_length_2728_cov_155,93.953,2580,126,20,13,2573,120,2688,0,3873,2560,2568
27291,Ntome_NODE_7262_length_2611_cov_228,Nsylvestris_NODE_6437_length_2671_cov_158,93.89,2553,127,15,60,2605,2534,4,0,3823,2545,2530
27393,Ntome_NODE_7293_length_2605_cov_292,Nsylvestris_NODE_7167_length_2540_cov_216,96.697,2452,42,10,1,2425,30,2469,0,4043,2424,2439
27509,Ntome_NODE_7325_length_2600_cov_62,Nsylvestris_NODE_26823_length_682_cov_9,92.371,603,30,2,95,685,84,682,0,845,590,598
27528,Ntome_NODE_7332_length_2598_cov_59,Nsylvestris_NODE_6950_length_2577_cov_58,94.941,2530,122,4,71,2598,2577,52,0,3958,2527,2525
27570,Ntome_NODE_7346_length_2595_cov_137,Nsylvestris_NODE_6085_length_2741_cov_95,94.636,2442,59,19,148,2580,2380,2,0,3718,2432,2378
27571,Ntome_NODE_7347_length_2595_cov_137,Nsylvestris_NODE_9780_length_2143_cov_111,93.372,2052,73,19,5,2013,2,2033,0,2977,2008,2031
27627,Ntome_NODE_7365_length_2592_cov_69,Nsylvestris_NODE_17237_length_1337_cov_135,91.736,1319,80,5,1159,2451,1337,22,0,1805,1292,1315
27732,Ntome_NODE_7400_length_2585_cov_99,Nsylvestris_NODE_6201_length_2717_cov_44,97.297,2368,55,2,215,2573,348,2715,0,4010,2358,2367
27765,Ntome_NODE_7407_length_2584_cov_243,Nsylvestris_NODE_7208_length_2532_cov_183,95.474,2541,58,25,6,2532,2508,11,0,4002,2526,2497
27874,Ntome_NODE_7446_length_2578_cov_247,Nsylvestris_NODE_7601_length_2470_cov_221,97.743,2348,41,6,6,2349,2449,110,0,4032,2343,2339
27938,Ntome_NODE_7466_length_2575_cov_189,Nsylvestris_NODE_5777_length_2805_cov_192,94.635,2535,112,12,1,2522,59,2582,0,3906,2521,2523
28091,Ntome_NODE_7509_length_2570_cov_45,Nsylvestris_NODE_5453_length_2873_cov_23,95.932,2286,92,1,81,2366,2870,586,0,3705,2285,2284
28133,Ntome_NODE_7520_length_2567_cov_157,Nsylvestris_NODE_6604_length_2641_cov_186,94.502,2401,100,18,86,2465,2459,70,0,3674,2379,2389
28174,Ntome_NODE_7536_length_2565_cov_33,Nsylvestris_NODE_4443_length_3111_cov_80,90.25,1159,94,13,1005,2154,1185,37,0,1496,1149,1148
28176,Ntome_NODE_7538_length_2564_cov_290,Nsylvestris_NODE_14496_length_1600_cov_212,97.878,1555,27,4,971,2521,45,1597,0,2684,1550,1552
28194,Ntome_NODE_7544_length_2564_cov_121,Nsylvestris_NODE_6633_length_2636_cov_207,93.93,2356,121,10,173,2520,113,2454,0,3539,2347,2341
28240,Ntome_NODE_7557_length_2562_cov_160,Nsylvestris_NODE_7661_length_2459_cov_170,94.53,2468,109,15,39,2502,14,2459,0,3786,2463,2445
28360,Ntome_NODE_7601_length_2553_cov_294,Nsylvestris_NODE_7213_length_2531_cov_226,96.862,2390,62,6,23,2409,105,2484,0,3986,2386,2379
28398,Ntome_NODE_7611_length_2552_cov_257,Nsylvestris_NODE_11637_length_1914_cov_193,96.918,1882,41,11,669,2541,1874,1,0,3138,1872,1873
28614,Ntome_NODE_7678_length_2544_cov_195,Nsylvestris_NODE_7616_length_2468_cov_210,94.652,2431,95,13,49,2467,3,2410,0,3736,2418,2407
28672,Ntome_NODE_7695_length_2542_cov_13,Nsylvestris_NODE_24418_length_806_cov_10,88.235,544,60,4,1386,1927,1,542,0,647,541,541
28703,Ntome_NODE_7707_length_2539_cov_45,Nsylvestris_NODE_7103_length_2553_cov_97,96.301,2460,74,9,7,2458,2499,49,0,4023,2451,2450
28743,Ntome_NODE_7722_length_2537_cov_221,Nsylvestris_NODE_20048_length_1098_cov_98,92.844,1118,40,11,1303,2400,1,1098,0,1585,1097,1097
28770,Ntome_NODE_7730_length_2536_cov_106,Nsylvestris_NODE_16587_length_1392_cov_166,95.426,962,41,1,97,1055,1342,381,0,1530,958,961
28807,Ntome_NODE_7743_length_2533_cov_286,Nsylvestris_NODE_7948_length_2412_cov_219,97.703,2394,49,4,120,2513,22,2409,0,4111,2393,2387
28821,Ntome_NODE_7749_length_2533_cov_71,Nsylvestris_NODE_7414_length_2502_cov_199,95.376,2422,89,11,1,2418,2439,37,0,3831,2417,2402
28836,Ntome_NODE_7753_length_2532_cov_79,Nsylvestris_NODE_6726_length_2617_cov_36,94.261,2457,94,23,66,2499,185,2617,0,3712,2433,2432
28911,Ntome_NODE_7777_length_2528_cov_63,Nsylvestris_NODE_17195_length_1341_cov_9,92.068,1185,94,0,1205,2389,1185,1,0,1668,1184,1184
28973,Ntome_NODE_7797_length_2525_cov_226,Nsylvestris_NODE_8128_length_2383_cov_172,94.256,2385,121,10,140,2512,3,2383,0,3631,2372,2380
28990,Ntome_NODE_7804_length_2524_cov_132,Nsylvestris_NODE_7856_length_2427_cov_74,91.069,2497,120,40,27,2493,2424,1,0,3280,2466,2423
29052,Ntome_NODE_7822_length_2520_cov_288,Nsylvestris_NODE_7307_length_2518_cov_222,93.783,2445,116,16,57,2474,2436,1,0,3640,2417,2435
29082,Ntome_NODE_7832_length_2518_cov_269,Nsylvestris_NODE_6854_length_2593_cov_232,94.047,2503,111,9,48,2518,88,2584,0,3762,2470,2496
29339,Ntome_NODE_7912_length_2504_cov_244,Nsylvestris_NODE_6607_length_2641_cov_154,94.208,2210,107,8,81,2284,2398,204,0,3352,2203,2194
29359,Ntome_NODE_7918_length_2504_cov_111,Nsylvestris_NODE_7826_length_2433_cov_75,95.74,2418,62,15,2,2417,2423,45,0,3856,2415,2378
29381,Ntome_NODE_7926_length_2502_cov_72,Nsylvestris_NODE_7227_length_2530_cov_64,97.889,2511,43,4,1,2502,2528,19,0,4335,2501,2509
29399,Ntome_NODE_7933_length_2500_cov_155,Nsylvestris_NODE_8194_length_2372_cov_193,94.996,2378,85,17,9,2363,2369,3,0,3701,2354,2366
29447,Ntome_NODE_7948_length_2498_cov_283,Nsylvestris_NODE_35365_length_287_cov_4,94.138,290,14,1,1667,1956,1,287,1.19E-121,438,289,286
29528,Ntome_NODE_7973_length_2494_cov_227,Nsylvestris_NODE_8344_length_2349_cov_195,94.792,2304,89,13,140,2424,2292,1,0,3561,2284,2291
29540,Ntome_NODE_7977_length_2494_cov_137,Nsylvestris_NODE_8878_length_2267_cov_80,95.418,2226,86,10,6,2227,4,2217,0,3531,2221,2213
29584,Ntome_NODE_7992_length_2491_cov_283,Nsylvestris_NODE_7494_length_2486_cov_172,95.52,2232,82,7,125,2353,1,2217,0,3552,2228,2216
29618,Ntome_NODE_8004_length_2490_cov_248,Nsylvestris_NODE_6789_length_2605_cov_142,94.335,2383,107,13,1,2381,2423,67,0,3627,2380,2356
29673,Ntome_NODE_8018_length_2488_cov_298,Nsylvestris_NODE_7911_length_2418_cov_228,94.826,2358,93,18,61,2413,2367,34,0,3651,2352,2333
29674,Ntome_NODE_8019_length_2488_cov_296,Nsylvestris_NODE_7252_length_2526_cov_201,95.452,2199,95,2,239,2437,132,2325,0,3502,2198,2193
29717,Ntome_NODE_8032_length_2486_cov_44,Nsylvestris_NODE_6921_length_2582_cov_16,93.224,2450,101,21,47,2462,2419,1,0,3544,2415,2418
29746,Ntome_NODE_8043_length_2484_cov_270,Nsylvestris_NODE_7763_length_2443_cov_162,95.041,2420,86,6,1,2386,2420,1,0,3773,2385,2419
29796,Ntome_NODE_8058_length_2482_cov_96,Nsylvestris_NODE_7287_length_2521_cov_103,95.395,2454,72,19,6,2431,2469,29,0,3868,2425,2440
29818,Ntome_NODE_8065_length_2481_cov_122,Nsylvestris_NODE_6267_length_2704_cov_103,97.437,2068,51,2,308,2374,2073,7,0,3524,2066,2066
29894,Ntome_NODE_8091_length_2476_cov_122,Nsylvestris_NODE_7327_length_2516_cov_59,97.217,2479,63,2,1,2473,2479,1,0,4191,2472,2478
29909,Ntome_NODE_8096_length_2475_cov_190,Nsylvestris_NODE_9330_length_2203_cov_185,94.224,2095,88,15,222,2297,2127,47,0,3168,2075,2080
30010,Ntome_NODE_8128_length_2471_cov_218,Nsylvestris_NODE_7527_length_2481_cov_184,94.403,2412,71,26,41,2421,32,2410,0,3648,2380,2378
30050,Ntome_NODE_8140_length_2469_cov_257,Nsylvestris_NODE_7556_length_2476_cov_198,96.907,2425,59,11,48,2469,2412,1,0,4048,2421,2411
30126,Ntome_NODE_8166_length_2465_cov_233,Nsylvestris_NODE_8175_length_2375_cov_65,95.435,2344,94,9,48,2382,2370,31,0,3723,2334,2339
30274,Ntome_NODE_8211_length_2458_cov_236,Nsylvestris_NODE_3900_length_3268_cov_175,96.574,2306,51,11,6,2287,255,2556,0,3795,2281,2301
30330,Ntome_NODE_8227_length_2454_cov_283,Nsylvestris_NODE_8170_length_2375_cov_201,96.119,2190,79,4,223,2408,2375,188,0,3568,2185,2187
30378,Ntome_NODE_8240_length_2453_cov_182,Nsylvestris_NODE_7914_length_2418_cov_82,97.358,1930,51,0,333,2262,2278,349,0,3282,1929,1929
30441,Ntome_NODE_8262_length_2447_cov_291,Nsylvestris_NODE_7308_length_2518_cov_219,95.562,2321,59,6,31,2332,40,2335,0,3675,2301,2295
30527,Ntome_NODE_8287_length_2443_cov_283,Nsylvestris_NODE_8155_length_2379_cov_208,95.354,2389,77,16,1,2369,2379,5,0,3766,2368,2374
30549,Ntome_NODE_8295_length_2442_cov_147,Nsylvestris_NODE_7772_length_2442_cov_115,96.352,2111,73,2,34,2140,3,2113,0,3469,2106,2110
30609,Ntome_NODE_8314_length_2440_cov_110,Nsylvestris_NODE_7991_length_2405_cov_125,96.077,2396,68,10,62,2440,2405,19,0,3880,2378,2386
30630,Ntome_NODE_8321_length_2439_cov_131,Nsylvestris_NODE_15759_length_1487_cov_94,90.39,1436,63,32,851,2278,3,1371,0,1818,1427,1368
30688,Ntome_NODE_8339_length_2437_cov_11,Nsylvestris_NODE_6273_length_2703_cov_54,97.542,2360,58,0,2,2361,2629,270,0,4037,2359,2359
30920,Ntome_NODE_8410_length_2425_cov_185,Nsylvestris_NODE_6621_length_2638_cov_188,96.089,2327,76,9,1,2319,2541,222,0,3779,2318,2319
31038,Ntome_NODE_8450_length_2420_cov_178,Nsylvestris_NODE_13501_length_1706_cov_83,93.363,226,15,0,77,302,1698,1473,1.56E-90,335,225,225
31044,Ntome_NODE_8452_length_2420_cov_27,Nsylvestris_NODE_5180_length_2930_cov_155,95.82,2416,88,5,9,2420,2910,504,0,3890,2411,2406
31072,Ntome_NODE_8466_length_2417_cov_269,Nsylvestris_NODE_7346_length_2513_cov_190,94.659,2378,76,23,32,2384,125,2476,0,3640,2352,2351
31244,Ntome_NODE_8513_length_2411_cov_236,Nsylvestris_NODE_6079_length_2742_cov_155,93.66,2161,108,13,84,2236,2677,538,0,3205,2152,2139
31323,Ntome_NODE_8542_length_2407_cov_26,Nsylvestris_NODE_6383_length_2682_cov_110,89.203,2019,193,10,312,2325,372,2370,0,2497,2013,1998
31353,Ntome_NODE_8553_length_2406_cov_53,Nsylvestris_NODE_8416_length_2337_cov_65,89.104,670,38,8,279,939,2144,1501,0,800,660,643
31580,Ntome_NODE_8633_length_2394_cov_126,Nsylvestris_NODE_8893_length_2265_cov_49,97.071,2219,63,2,76,2293,2218,1,0,3736,2217,2217
31976,Ntome_NODE_8756_length_2377_cov_97,Nsylvestris_NODE_8768_length_2285_cov_10,96.435,2188,77,1,123,2309,98,2285,0,3607,2186,2187
31977,Ntome_NODE_8757_length_2377_cov_65,Nsylvestris_NODE_7706_length_2452_cov_78,95.298,2382,107,4,1,2377,67,2448,0,3773,2376,2381
32017,Ntome_NODE_8772_length_2374_cov_104,Nsylvestris_NODE_7456_length_2494_cov_226,95.487,2393,78,12,6,2374,90,2476,0,3794,2368,2386
32036,Ntome_NODE_8778_length_2373_cov_184,Nsylvestris_NODE_8510_length_2323_cov_142,91.942,2358,131,31,28,2361,1,2323,0,3247,2333,2322
32411,Ntome_NODE_8902_length_2353_cov_289,Nsylvestris_NODE_7838_length_2430_cov_207,94.418,2096,108,6,200,2291,290,2380,0,3214,2091,2090
32465,Ntome_NODE_8921_length_2351_cov_30,Nsylvestris_NODE_7042_length_2563_cov_31,95.389,2342,88,8,22,2351,2468,135,0,3709,2329,2333
32476,Ntome_NODE_8926_length_2350_cov_61,Nsylvestris_NODE_16271_length_1422_cov_104,91.176,782,36,11,782,1559,245,997,0,1031,777,752
32510,Ntome_NODE_8938_length_2347_cov_281,Nsylvestris_NODE_9145_length_2230_cov_203,95.86,2198,62,14,95,2289,2182,11,0,3528,2194,2171
32513,Ntome_NODE_8940_length_2347_cov_195,Nsylvestris_NODE_12095_length_1858_cov_217,92.677,1707,74,16,15,1694,1747,65,0,2412,1679,1682
32514,Ntome_NODE_8941_length_2347_cov_142,Nsylvestris_NODE_8308_length_2354_cov_136,93.533,2304,96,24,80,2345,2291,3,0,3380,2265,2288
32578,Ntome_NODE_8963_length_2344_cov_12,Nsylvestris_NODE_6710_length_2620_cov_53,94.062,2223,115,8,60,2266,2319,98,0,3358,2206,2221
32661,Ntome_NODE_8990_length_2340_cov_170,Nsylvestris_NODE_9736_length_2149_cov_81,94.517,2152,101,6,188,2328,2149,4,0,3304,2140,2145
32675,Ntome_NODE_8997_length_2339_cov_263,Nsylvestris_NODE_7881_length_2423_cov_225,96.898,2353,47,8,4,2338,2423,79,0,3917,2334,2344
32781,Ntome_NODE_9038_length_2332_cov_217,Nsylvestris_NODE_9592_length_2165_cov_209,96.388,2104,68,5,2,2098,56,2158,0,3458,2096,2102
32800,Ntome_NODE_9044_length_2331_cov_289,Nsylvestris_NODE_8828_length_2275_cov_193,95.149,2247,105,3,38,2283,3,2246,0,3542,2245,2243
32946,Ntome_NODE_9089_length_2325_cov_32,Nsylvestris_NODE_8803_length_2279_cov_69,95.386,1734,69,5,101,1830,2277,551,0,2748,1729,1726
33144,Ntome_NODE_9150_length_2318_cov_71,Nsylvestris_NODE_7678_length_2457_cov_94,94.895,2057,75,14,222,2265,2086,47,0,3190,2043,2039
33287,Ntome_NODE_9198_length_2308_cov_253,Nsylvestris_NODE_8782_length_2282_cov_141,96.251,2214,74,3,1,2205,23,2236,0,3620,2204,2213
33426,Ntome_NODE_9242_length_2303_cov_119,Nsylvestris_NODE_8635_length_2304_cov_28,94.228,2183,84,14,63,2228,10,2167,0,3295,2165,2157
33520,Ntome_NODE_9273_length_2300_cov_31,Nsylvestris_NODE_8847_length_2273_cov_24,95.679,2268,85,5,10,2266,8,2273,0,3633,2256,2265
33679,Ntome_NODE_9330_length_2291_cov_295,Nsylvestris_NODE_9777_length_2143_cov_231,95.2,2146,78,15,1,2124,1,2143,0,3369,2123,2142
33699,Ntome_NODE_9338_length_2291_cov_49,Nsylvestris_NODE_8906_length_2263_cov_90,97.098,2240,64,1,1,2239,21,2260,0,3775,2238,2239
33771,Ntome_NODE_9359_length_2288_cov_107,Nsylvestris_NODE_12233_length_1844_cov_143,92.071,1526,105,8,728,2249,193,1706,0,2134,1521,1513
33809,Ntome_NODE_9370_length_2286_cov_292,Nsylvestris_NODE_8341_length_2349_cov_221,96.792,2213,54,8,24,2224,2348,141,0,3677,2200,2207
33849,Ntome_NODE_9385_length_2284_cov_66,Nsylvestris_NODE_6817_length_2601_cov_33,96.295,2159,65,6,122,2279,2599,455,0,3530,2157,2144
33850,Ntome_NODE_9386_length_2283_cov_171,Nsylvestris_NODE_20795_length_1043_cov_210,88.901,919,61,20,1351,2245,906,5,0,1094,894,901
34043,Ntome_NODE_9451_length_2274_cov_281,Nsylvestris_NODE_10089_length_2104_cov_175,95.684,2039,83,5,12,2049,70,2104,0,3273,2037,2034
34133,Ntome_NODE_9482_length_2272_cov_18,Nsylvestris_NODE_8372_length_2345_cov_18,92.391,1945,121,17,312,2246,374,2301,0,2747,1934,1927
34199,Ntome_NODE_9503_length_2269_cov_217,Nsylvestris_NODE_15325_length_1520_cov_21,97.237,1520,37,2,315,1830,1,1519,0,2569,1515,1518
34269,Ntome_NODE_9525_length_2266_cov_286,Nsylvestris_NODE_10237_length_2083_cov_212,94.61,1985,84,3,60,2040,118,2083,0,3051,1980,1965
34351,Ntome_NODE_9555_length_2260_cov_126,Nsylvestris_NODE_9815_length_2138_cov_173,95.015,1986,77,16,45,2021,120,2092,0,3099,1976,1972
34553,Ntome_NODE_9621_length_2250_cov_264,Nsylvestris_NODE_9338_length_2202_cov_177,93.753,2241,96,12,13,2250,2202,3,0,3323,2237,2199
34559,Ntome_NODE_9626_length_2250_cov_11,Nsylvestris_NODE_34293_length_314_cov_2,90.123,324,18,11,325,645,313,1,8.43E-113,409,320,312
34974,Ntome_NODE_9769_length_2229_cov_147,Nsylvestris_NODE_9906_length_2127_cov_24,95.841,2140,62,10,42,2173,2124,4,0,3434,2131,2120
35023,Ntome_NODE_9783_length_2228_cov_45,Nsylvestris_NODE_9038_length_2246_cov_129,95.418,2008,64,12,217,2219,127,2111,0,3173,2002,1984
35096,Ntome_NODE_9809_length_2224_cov_70,Nsylvestris_NODE_9992_length_2117_cov_78,97.505,2084,52,0,14,2097,1,2084,0,3561,2083,2083
35122,Ntome_NODE_9819_length_2222_cov_239,Nsylvestris_NODE_600_length_5707_cov_34,92.469,239,12,2,1381,1614,5273,5036,3.98E-91,337,233,237
35191,Ntome_NODE_9842_length_2220_cov_23,Nsylvestris_NODE_10591_length_2039_cov_47,94.023,1673,96,4,550,2220,1755,85,0,2532,1670,1670
35206,Ntome_NODE_9847_length_2219_cov_38,Nsylvestris_NODE_34699_length_303_cov_3,87.981,208,18,3,985,1190,234,32,1.15E-61,239,205,202
35217,Ntome_NODE_9851_length_2218_cov_244,Nsylvestris_NODE_10135_length_2098_cov_204,94.857,2061,89,14,118,2169,2053,1,0,3203,2051,2052
35283,Ntome_NODE_9874_length_2216_cov_81,Nsylvestris_NODE_7711_length_2451_cov_96,96.798,2186,51,4,32,2216,2231,64,0,3631,2184,2167
35297,Ntome_NODE_9878_length_2215_cov_258,Nsylvestris_NODE_10461_length_2055_cov_82,94.105,1934,68,12,95,2022,2,1895,0,2898,1927,1893
35320,Ntome_NODE_9885_length_2215_cov_87,Nsylvestris_NODE_8392_length_2342_cov_97,93.579,2087,129,3,53,2135,2187,102,0,3107,2082,2085
35334,Ntome_NODE_9892_length_2214_cov_126,Nsylvestris_NODE_36782_length_256_cov_3,97.976,247,5,0,1036,1282,1,247,6.36E-119,429,246,246
35392,Ntome_NODE_9912_length_2211_cov_266,Nsylvestris_NODE_9897_length_2128_cov_159,94.062,2105,98,11,97,2177,18,2119,0,3169,2080,2101
35514,Ntome_NODE_9949_length_2206_cov_6,Nsylvestris_NODE_7931_length_2415_cov_20,95.188,2203,102,2,1,2203,198,2396,0,3478,2202,2198
35564,Ntome_NODE_9966_length_2204_cov_50,Nsylvestris_NODE_24819_length_782_cov_51,100,36,0,0,2003,2038,57,22,5.72E-10,67.6,35,35
35571,Ntome_NODE_9969_length_2203_cov_293,Nsylvestris_NODE_9193_length_2224_cov_222,95.758,2169,74,7,36,2203,40,2191,0,3480,2167,2151
35714,Ntome_NODE_10019_length_2197_cov_195,Nsylvestris_NODE_10931_length_1996_cov_184,95.278,1906,78,7,103,2003,1947,49,0,3011,1900,1898
35759,Ntome_NODE_10036_length_2195_cov_133,Nsylvestris_NODE_9097_length_2237_cov_142,95.618,2191,73,13,11,2195,50,2223,0,3493,2184,2173
35807,Ntome_NODE_10052_length_2193_cov_229,Nsylvestris_NODE_9352_length_2200_cov_198,95.471,2208,62,13,2,2185,1,2194,0,3489,2183,2193
36012,Ntome_NODE_10121_length_2183_cov_45,Nsylvestris_NODE_9192_length_2225_cov_44,94.627,2066,81,10,9,2047,2212,150,0,3173,2038,2062
36031,Ntome_NODE_10130_length_2181_cov_268,Nsylvestris_NODE_10198_length_2088_cov_224,97.793,2084,42,3,2,2085,9,2088,0,3591,2083,2079
36085,Ntome_NODE_10152_length_2177_cov_200,Nsylvestris_NODE_11446_length_1936_cov_163,95.338,1952,70,7,229,2177,1936,3,0,3081,1948,1933
36144,Ntome_NODE_10173_length_2174_cov_284,Nsylvestris_NODE_7142_length_2546_cov_202,94.214,2022,75,21,106,2119,446,2433,0,3048,2013,1987
36324,Ntome_NODE_10230_length_2166_cov_32,Nsylvestris_NODE_8030_length_2398_cov_130,92.801,2167,137,8,1,2166,2270,122,0,3120,2165,2148
36328,Ntome_NODE_10232_length_2165_cov_309,Nsylvestris_NODE_8747_length_2288_cov_224,96.006,2103,80,2,1,2103,2288,190,0,3415,2102,2098
36467,Ntome_NODE_10283_length_2158_cov_191,Nsylvestris_NODE_7663_length_2459_cov_77,95.952,2100,67,6,52,2145,372,2459,0,3391,2093,2087
36471,Ntome_NODE_10285_length_2158_cov_99,Nsylvestris_NODE_10528_length_2047_cov_34,91.389,2044,147,17,101,2125,12,2045,0,2772,2024,2033
36670,Ntome_NODE_10354_length_2152_cov_19,Nsylvestris_NODE_9636_length_2160_cov_29,95.366,2050,70,6,94,2121,43,2089,0,3236,2027,2046
36742,Ntome_NODE_10380_length_2148_cov_187,Nsylvestris_NODE_13924_length_1659_cov_220,85.653,467,63,4,124,588,1542,1078,1.00E-136,488,464,464
36805,Ntome_NODE_10403_length_2145_cov_61,Nsylvestris_NODE_11823_length_1890_cov_30,95.031,1791,82,2,324,2107,100,1890,0,2808,1783,1790
36817,Ntome_NODE_10409_length_2144_cov_229,Nsylvestris_NODE_12121_length_1855_cov_213,93.923,1810,67,7,61,1837,7,1806,0,2693,1776,1799
36838,Ntome_NODE_10415_length_2144_cov_43,Nsylvestris_NODE_6147_length_2727_cov_26,79.208,909,152,31,642,1525,1814,918,1.60E-169,597,883,896
36842,Ntome_NODE_10418_length_2143_cov_231,Nsylvestris_NODE_9154_length_2229_cov_198,97.2,2107,44,4,50,2143,2145,41,0,3550,2093,2104
36850,Ntome_NODE_10422_length_2143_cov_67,Nsylvestris_NODE_10537_length_2046_cov_129,94.553,2038,57,23,11,2029,18,2020,0,3099,2018,2002
36966,Ntome_NODE_10457_length_2137_cov_295,Nsylvestris_NODE_8322_length_2352_cov_223,97.685,1944,36,1,203,2137,170,2113,0,3332,1934,1943
37030,Ntome_NODE_10480_length_2134_cov_226,Nsylvestris_NODE_9782_length_2142_cov_228,94.312,2145,84,18,9,2133,2142,16,0,3251,2124,2126
37125,Ntome_NODE_10512_length_2130_cov_287,Nsylvestris_NODE_10310_length_2074_cov_143,92.056,1863,90,35,83,1941,1895,87,0,2567,1858,1808
37139,Ntome_NODE_10517_length_2130_cov_196,Nsylvestris_NODE_2260_length_3910_cov_75,96.979,1920,56,2,1,1919,1908,3826,0,3223,1918,1918
37300,Ntome_NODE_10570_length_2124_cov_80,Nsylvestris_NODE_17159_length_1343_cov_171,93.702,1302,57,10,801,2086,1,1293,0,1927,1285,1292
37351,Ntome_NODE_10587_length_2122_cov_56,Nsylvestris_NODE_7879_length_2424_cov_112,95.724,2128,85,1,1,2122,2344,217,0,3421,2121,2127
37379,Ntome_NODE_10597_length_2121_cov_17,Nsylvestris_NODE_9751_length_2147_cov_17,96.463,2092,69,3,23,2109,2094,3,0,3448,2086,2091
37495,Ntome_NODE_10635_length_2114_cov_173,Nsylvestris_NODE_10426_length_2059_cov_166,97.701,2044,43,2,27,2070,1,2040,0,3511,2043,2039
37628,Ntome_NODE_10687_length_2108_cov_224,Nsylvestris_NODE_8669_length_2298_cov_125,94.464,2023,95,6,38,2059,2243,237,0,3099,2021,2006
37642,Ntome_NODE_10692_length_2108_cov_15,Nsylvestris_NODE_9314_length_2206_cov_77,95.553,2114,73,10,8,2103,2179,69,0,3363,2095,2110
37658,Ntome_NODE_10699_length_2106_cov_284,Nsylvestris_NODE_8514_length_2322_cov_196,92.449,2013,99,25,51,2038,171,2155,0,2826,1987,1984
37671,Ntome_NODE_10704_length_2106_cov_234,Nsylvestris_NODE_12256_length_1842_cov_42,95.185,1537,58,7,100,1630,20,1546,0,2414,1530,1526
37712,Ntome_NODE_10718_length_2105_cov_214,Nsylvestris_NODE_13177_length_1741_cov_104,94.158,1763,69,14,10,1760,1,1741,0,2654,1750,1740
37869,Ntome_NODE_10771_length_2099_cov_84,Nsylvestris_NODE_9791_length_2141_cov_209,95.394,2106,71,13,6,2099,7,2098,0,3328,2093,2091
37908,Ntome_NODE_10786_length_2098_cov_12,Nsylvestris_NODE_9315_length_2206_cov_39,93.379,2054,109,9,14,2058,2180,145,0,3014,2044,2035
37925,Ntome_NODE_10792_length_2097_cov_112,Nsylvestris_NODE_10233_length_2084_cov_105,97.382,1719,42,3,55,1772,2083,367,0,2922,1717,1716
37981,Ntome_NODE_10810_length_2094_cov_279,Nsylvestris_NODE_9680_length_2155_cov_191,92.906,2044,89,21,23,2041,106,2118,0,2920,2018,2012
37995,Ntome_NODE_10816_length_2094_cov_170,Nsylvestris_NODE_9926_length_2125_cov_139,94.089,2064,63,22,40,2066,52,2093,0,3081,2026,2041
38044,Ntome_NODE_10831_length_2092_cov_213,Nsylvestris_NODE_11470_length_1933_cov_208,92.352,1922,84,26,76,1981,7,1881,0,2676,1905,1874
38135,Ntome_NODE_10865_length_2089_cov_9,Nsylvestris_NODE_15115_length_1539_cov_150,76.199,1147,221,35,1,1121,341,1461,7.34E-158,558,1120,1120
38145,Ntome_NODE_10868_length_2088_cov_216,Nsylvestris_NODE_10428_length_2058_cov_162,94.058,2070,91,17,27,2088,2058,13,0,3112,2061,2045
38324,Ntome_NODE_10928_length_2082_cov_117,Nsylvestris_NODE_10753_length_2019_cov_62,95.028,1951,74,13,97,2032,2012,70,0,3044,1935,1942
38345,Ntome_NODE_10935_length_2082_cov_14,Nsylvestris_NODE_8532_length_2321_cov_28,95.926,2111,48,8,1,2082,2302,201,0,3387,2081,2101
38412,Ntome_NODE_10957_length_2079_cov_155,Nsylvestris_NODE_10055_length_2110_cov_115,95.033,1953,64,17,137,2063,1946,1,0,3038,1926,1945
38421,Ntome_NODE_10962_length_2078_cov_100,Nsylvestris_NODE_14273_length_1622_cov_181,91.187,1634,94,25,103,1707,1613,1,0,2174,1604,1612
38558,Ntome_NODE_11013_length_2071_cov_161,Nsylvestris_NODE_11044_length_1982_cov_185,95.944,1849,52,6,54,1882,93,1938,0,2977,1828,1845
38568,Ntome_NODE_11017_length_2070_cov_275,Nsylvestris_NODE_9832_length_2135_cov_217,94.45,2018,87,9,9,2002,119,2135,0,3083,1993,2016
38583,Ntome_NODE_11023_length_2070_cov_16,Nsylvestris_NODE_9016_length_2249_cov_145,94.879,2070,85,7,1,2069,2138,89,0,3216,2068,2049
38621,Ntome_NODE_11039_length_2067_cov_264,Nsylvestris_NODE_10509_length_2049_cov_198,95.311,2026,78,10,53,2066,2047,27,0,3199,2013,2020
38752,Ntome_NODE_11086_length_2063_cov_72,Nsylvestris_NODE_22230_length_940_cov_84,88.95,181,18,2,886,1065,553,732,1.08E-56,222,179,179
38884,Ntome_NODE_11131_length_2056_cov_243,Nsylvestris_NODE_12287_length_1838_cov_219,94.364,1792,85,9,82,1859,1,1790,0,2736,1777,1789
38902,Ntome_NODE_11138_length_2056_cov_81,Nsylvestris_NODE_12775_length_1789_cov_147,95.558,1756,53,15,73,1809,40,1789,0,2787,1736,1749
38938,Ntome_NODE_11154_length_2054_cov_216,Nsylvestris_NODE_8860_length_2273_cov_145,93.414,1822,110,7,23,1843,1979,167,0,2691,1820,1812
38993,Ntome_NODE_11169_length_2053_cov_31,Nsylvestris_NODE_9302_length_2207_cov_98,95.084,1973,85,5,51,2022,1994,33,0,3096,1971,1961
39008,Ntome_NODE_11175_length_2052_cov_167,Nsylvestris_NODE_10159_length_2094_cov_14,92.065,1903,123,19,46,1925,1898,1,0,2652,1879,1897
39025,Ntome_NODE_11182_length_2051_cov_132,Nsylvestris_NODE_12891_length_1776_cov_45,94.477,1684,74,5,276,1954,78,1747,0,2577,1678,1669
39032,Ntome_NODE_11184_length_2051_cov_105,Nsylvestris_NODE_31313_length_431_cov_6,97.436,39,1,0,1548,1586,294,332,5.33E-10,67.6,38,38
39047,Ntome_NODE_11191_length_2050_cov_246,Nsylvestris_NODE_11136_length_1971_cov_83,94.786,1918,96,1,136,2049,49,1966,0,2985,1913,1917
39048,Ntome_NODE_11192_length_2050_cov_230,Nsylvestris_NODE_11404_length_1941_cov_196,92.845,1747,95,19,197,1937,124,1846,0,2507,1740,1722
39178,Ntome_NODE_11236_length_2045_cov_236,Nsylvestris_NODE_11613_length_1917_cov_216,93.291,1908,90,13,99,1974,2,1903,0,2780,1875,1901
39193,Ntome_NODE_11244_length_2044_cov_210,Nsylvestris_NODE_9887_length_2129_cov_189,95.339,1974,74,10,1,1966,48,2011,0,3120,1965,1963
39194,Ntome_NODE_11245_length_2043_cov_209,Nsylvestris_NODE_19486_length_1145_cov_9,93.103,1160,65,4,758,1917,1,1145,0,1685,1159,1144
39305,Ntome_NODE_11287_length_2039_cov_148,Nsylvestris_NODE_10724_length_2023_cov_46,93.098,1927,100,15,77,1993,1909,6,0,2791,1916,1903
39368,Ntome_NODE_11312_length_2036_cov_55,Nsylvestris_NODE_10677_length_2029_cov_42,94.361,2004,55,16,19,1990,1978,1,0,3022,1971,1977
39566,Ntome_NODE_11377_length_2028_cov_105,Nsylvestris_NODE_6144_length_2727_cov_95,92.279,1865,77,20,114,1941,2672,838,0,2584,1827,1834
39567,Ntome_NODE_11378_length_2028_cov_70,Nsylvestris_NODE_10650_length_2031_cov_196,96.66,1976,60,5,50,2023,15,1986,0,3278,1973,1971
39605,Ntome_NODE_11390_length_2026_cov_277,Nsylvestris_NODE_10483_length_2052_cov_214,92.949,2014,70,35,17,2001,82,2052,0,2867,1984,1970
39618,Ntome_NODE_11395_length_2026_cov_80,Nsylvestris_NODE_9223_length_2220_cov_80,93.375,1932,84,19,1,1913,1911,5,0,2819,1912,1906
39646,Ntome_NODE_11404_length_2025_cov_228,Nsylvestris_NODE_11265_length_1955_cov_184,93.776,1912,85,15,107,2011,1894,10,0,2841,1904,1884
39771,Ntome_NODE_11446_length_2020_cov_35,Nsylvestris_NODE_14446_length_1606_cov_11,94.763,1394,73,0,279,1672,1394,1,0,2170,1393,1393
39810,Ntome_NODE_11459_length_2018_cov_217,Nsylvestris_NODE_10710_length_2024_cov_126,93.064,2033,73,26,2,2018,1,1981,0,2911,2016,1980
39821,Ntome_NODE_11462_length_2018_cov_200,Nsylvestris_NODE_13936_length_1658_cov_194,95.184,1225,58,1,749,1972,1530,306,0,1934,1223,1224
39898,Ntome_NODE_11489_length_2015_cov_286,Nsylvestris_NODE_11906_length_1879_cov_222,95.158,1838,75,6,115,1945,1831,1,0,2889,1830,1830
39941,Ntome_NODE_11503_length_2014_cov_90,Nsylvestris_NODE_10021_length_2113_cov_116,97.165,1975,56,0,10,1984,139,2113,0,3338,1974,1974
40054,Ntome_NODE_11543_length_2009_cov_113,Nsylvestris_NODE_11447_length_1936_cov_163,96.083,1838,48,7,120,1939,1932,101,0,2974,1819,1831
40103,Ntome_NODE_11562_length_2007_cov_28,Nsylvestris_NODE_8280_length_2358_cov_42,77.778,225,35,8,766,977,791,1013,3.05E-27,124,211,222
40145,Ntome_NODE_11581_length_2005_cov_47,Nsylvestris_NODE_18898_length_1193_cov_16,95.39,1193,46,1,626,1809,1193,1,0,1890,1183,1192
40219,Ntome_NODE_11605_length_2002_cov_273,Nsylvestris_NODE_10417_length_2060_cov_137,95.995,1648,62,1,168,1815,355,1998,0,2675,1647,1643
40236,Ntome_NODE_11611_length_2001_cov_225,Nsylvestris_NODE_9088_length_2239_cov_216,95.631,2014,60,11,1,2001,191,2189,0,3206,2000,1998
40278,Ntome_NODE_11624_length_2000_cov_211,Nsylvestris_NODE_8256_length_2362_cov_153,88.992,1944,109,46,116,2000,41,1938,0,2307,1884,1897
40364,Ntome_NODE_11651_length_1997_cov_23,Nsylvestris_NODE_36555_length_261_cov_4,95.769,260,11,0,1680,1939,1,260,3.45E-116,420,259,259
40400,Ntome_NODE_11665_length_1995_cov_209,Nsylvestris_NODE_15508_length_1501_cov_144,95.384,1473,61,4,468,1939,12,1478,0,2337,1471,1466
40501,Ntome_NODE_11699_length_1991_cov_239,Nsylvestris_NODE_12261_length_1841_cov_194,95.18,1805,61,13,161,1953,1791,1,0,2828,1792,1790
40502,Ntome_NODE_11700_length_1991_cov_220,Nsylvestris_NODE_12952_length_1768_cov_153,94.363,1437,62,10,555,1991,1467,50,0,2187,1436,1417
40604,Ntome_NODE_11734_length_1988_cov_178,Nsylvestris_NODE_12836_length_1782_cov_150,95.444,1690,52,9,82,1768,1668,1,0,2671,1686,1667
40610,Ntome_NODE_11738_length_1988_cov_107,Nsylvestris_NODE_12777_length_1789_cov_104,96.718,1676,52,2,296,1971,1708,36,0,2787,1675,1672
40765,Ntome_NODE_11797_length_1981_cov_140,Nsylvestris_NODE_27103_length_669_cov_9,94.09,423,25,0,1513,1935,1,423,0,643,422,422
40771,Ntome_NODE_11800_length_1981_cov_48,Nsylvestris_NODE_10840_length_2009_cov_19,94.319,1813,75,7,182,1968,199,2009,0,2752,1786,1810
40807,Ntome_NODE_11810_length_1980_cov_123,Nsylvestris_NODE_9584_length_2166_cov_66,97.445,1918,46,3,48,1963,249,2165,0,3267,1915,1916
40819,Ntome_NODE_11815_length_1979_cov_247,Nsylvestris_NODE_11396_length_1942_cov_148,95.838,1946,75,6,6,1949,1,1942,0,3140,1943,1941
40820,Ntome_NODE_11816_length_1979_cov_152,Nsylvestris_NODE_19913_length_1109_cov_190,97.196,856,23,1,1125,1979,901,46,0,1447,854,855
40902,Ntome_NODE_11843_length_1976_cov_138,Nsylvestris_NODE_11766_length_1897_cov_213,92.04,1784,83,27,109,1875,1748,7,0,2453,1766,1741
40976,Ntome_NODE_11866_length_1974_cov_128,Nsylvestris_NODE_9105_length_2236_cov_94,95.942,1651,61,2,257,1906,591,2236,0,2673,1649,1645
40995,Ntome_NODE_11872_length_1973_cov_267,Nsylvestris_NODE_11947_length_1875_cov_192,93.189,1571,84,16,171,1731,1577,20,0,2287,1560,1557
41021,Ntome_NODE_11882_length_1972_cov_219,Nsylvestris_NODE_10703_length_2025_cov_132,95.303,1831,85,1,141,1970,20,1850,0,2904,1829,1830
41052,Ntome_NODE_11897_length_1970_cov_158,Nsylvestris_NODE_13392_length_1718_cov_16,93.219,1696,106,5,218,1907,1695,3,0,2486,1689,1692
41102,Ntome_NODE_11913_length_1968_cov_235,Nsylvestris_NODE_11512_length_1929_cov_111,94.984,1854,90,3,72,1925,79,1929,0,2905,1853,1850
41228,Ntome_NODE_11954_length_1963_cov_67,Nsylvestris_NODE_10990_length_1989_cov_135,94.266,1866,67,19,114,1949,47,1902,0,2817,1835,1855
41247,Ntome_NODE_11962_length_1962_cov_97,Nsylvestris_NODE_14950_length_1555_cov_183,95.16,1529,73,1,210,1737,1539,11,0,2412,1527,1528
41271,Ntome_NODE_11972_length_1961_cov_180,Nsylvestris_NODE_8099_length_2387_cov_188,94.027,1825,82,9,55,1873,264,2067,0,2741,1818,1803
41426,Ntome_NODE_12028_length_1954_cov_178,Nsylvestris_NODE_11257_length_1956_cov_197,94.498,1854,83,6,1,1851,119,1956,0,2841,1850,1837
41427,Ntome_NODE_12029_length_1954_cov_122,Nsylvestris_NODE_10894_length_2001_cov_175,95.476,1901,43,14,52,1945,1920,56,0,2994,1893,1864
41505,Ntome_NODE_12056_length_1951_cov_9,Nsylvestris_NODE_10647_length_2032_cov_22,94.427,1866,99,3,46,1907,61,1925,0,2865,1861,1864
41517,Ntome_NODE_12061_length_1950_cov_56,Nsylvestris_NODE_11722_length_1902_cov_176,96.483,1905,64,1,2,1906,1,1902,0,3144,1904,1901
41637,Ntome_NODE_12101_length_1944_cov_225,Nsylvestris_NODE_18383_length_1234_cov_32,92.014,1127,52,14,715,1806,1234,111,0,1548,1091,1123
41674,Ntome_NODE_12112_length_1943_cov_178,Nsylvestris_NODE_7871_length_2425_cov_207,97.745,1951,33,4,1,1943,1961,14,0,3349,1942,1947
41695,Ntome_NODE_12121_length_1943_cov_13,Nsylvestris_NODE_35363_length_287_cov_4,88.591,298,18,4,1032,1324,1,287,1.61E-94,348,292,286
41744,Ntome_NODE_12140_length_1941_cov_142,Nsylvestris_NODE_10616_length_2035_cov_161,96.007,1753,53,4,114,1865,62,1798,0,2833,1751,1736
41752,Ntome_NODE_12145_length_1940_cov_273,Nsylvestris_NODE_11926_length_1877_cov_225,94.913,1848,81,7,95,1937,5,1844,0,2880,1842,1839
41780,Ntome_NODE_12157_length_1939_cov_84,Nsylvestris_NODE_25971_length_720_cov_30,93.304,672,41,2,308,975,719,48,0,989,667,671
41793,Ntome_NODE_12162_length_1938_cov_249,Nsylvestris_NODE_9773_length_2144_cov_182,97.076,1847,41,7,1,1843,99,1936,0,3099,1842,1837
41807,Ntome_NODE_12167_length_1938_cov_14,Nsylvestris_NODE_11875_length_1883_cov_7,95.749,1882,77,1,6,1887,1879,1,0,3029,1881,1878
41826,Ntome_NODE_12173_length_1937_cov_167,Nsylvestris_NODE_10459_length_2055_cov_159,91.501,1906,114,24,54,1937,1935,56,0,2579,1883,1879
41905,Ntome_NODE_12199_length_1931_cov_283,Nsylvestris_NODE_10700_length_2025_cov_216,95.922,1888,61,6,51,1924,120,2005,0,3046,1873,1885
41984,Ntome_NODE_12223_length_1930_cov_99,Nsylvestris_NODE_16497_length_1400_cov_39,93.397,1151,67,8,80,1222,1,1150,0,1696,1142,1149
42024,Ntome_NODE_12238_length_1929_cov_27,Nsylvestris_NODE_10395_length_2063_cov_14,90.328,1923,104,32,20,1879,2062,159,0,2446,1859,1903
42288,Ntome_NODE_12322_length_1918_cov_261,Nsylvestris_NODE_12340_length_1833_cov_214,97.787,1672,33,2,4,1671,161,1832,0,2880,1667,1671
42449,Ntome_NODE_12378_length_1911_cov_217,Nsylvestris_NODE_11640_length_1914_cov_143,94.188,1910,79,17,3,1896,21,1914,0,2883,1893,1893
42574,Ntome_NODE_12423_length_1906_cov_77,Nsylvestris_NODE_11440_length_1937_cov_68,88.822,1825,137,32,24,1833,1896,124,0,2178,1809,1772
42575,Ntome_NODE_12424_length_1906_cov_60,Nsylvestris_NODE_10783_length_2016_cov_31,92.9,1676,86,9,188,1856,2016,367,0,2405,1668,1649
42710,Ntome_NODE_12476_length_1900_cov_119,Nsylvestris_NODE_17521_length_1311_cov_61,93.548,1209,44,10,530,1736,1186,10,0,1770,1206,1176
42736,Ntome_NODE_12484_length_1899_cov_92,Nsylvestris_NODE_10802_length_2013_cov_184,98.162,1850,34,0,48,1897,1925,76,0,3229,1849,1849
42766,Ntome_NODE_12495_length_1897_cov_226,Nsylvestris_NODE_12925_length_1771_cov_219,94.975,1771,54,9,96,1838,1771,8,0,2745,1742,1763
42770,Ntome_NODE_12497_length_1897_cov_177,Nsylvestris_NODE_14394_length_1611_cov_11,96.201,1632,40,4,218,1849,1,1610,0,2651,1631,1609
42821,Ntome_NODE_12515_length_1896_cov_66,Nsylvestris_NODE_11989_length_1871_cov_46,94.74,1844,84,5,16,1851,33,1871,0,2856,1835,1838
42885,Ntome_NODE_12536_length_1894_cov_91,Nsylvestris_NODE_13914_length_1661_cov_177,96.545,1621,44,1,274,1894,1,1609,0,2673,1620,1608
42924,Ntome_NODE_12549_length_1892_cov_289,Nsylvestris_NODE_12182_length_1849_cov_212,93.607,1752,63,16,51,1789,1779,64,0,2569,1738,1715
42928,Ntome_NODE_12552_length_1892_cov_197,Nsylvestris_NODE_13896_length_1663_cov_125,95.59,1542,54,6,355,1892,1598,67,0,2459,1537,1531
42971,Ntome_NODE_12566_length_1883_cov_152,Nsylvestris_NODE_12242_length_1843_cov_36,93.136,1792,100,8,35,1809,1843,58,0,2606,1774,1785
42982,Ntome_NODE_12570_length_1891_cov_55,Nsylvestris_NODE_12495_length_1816_cov_30,92.923,1837,81,15,44,1864,1804,1,0,2627,1820,1803
43035,Ntome_NODE_12588_length_1889_cov_18,Nsylvestris_NODE_11452_length_1936_cov_84,97.799,1545,30,3,346,1889,1887,346,0,2662,1543,1541
43060,Ntome_NODE_12597_length_1887_cov_47,Nsylvestris_NODE_12434_length_1823_cov_209,90.417,1774,89,37,111,1845,42,1773,0,2259,1734,1731
43065,Ntome_NODE_12599_length_1887_cov_20,Nsylvestris_NODE_9047_length_2245_cov_74,95.977,1889,72,3,1,1887,2075,189,0,3064,1886,1886
43087,Ntome_NODE_12608_length_1886_cov_29,Nsylvestris_NODE_13265_length_1732_cov_19,94.223,1731,94,4,27,1753,1729,1,0,2638,1726,1728
43209,Ntome_NODE_12654_length_1880_cov_184,Nsylvestris_NODE_34978_length_296_cov_3,82.282,333,17,5,104,431,296,1,4.51E-65,250,327,295
43276,Ntome_NODE_12681_length_1877_cov_40,Nsylvestris_NODE_11999_length_1870_cov_137,95.213,1713,78,2,1,1713,113,1821,0,2706,1712,1708
43277,Ntome_NODE_12682_length_1877_cov_36,Nsylvestris_NODE_9691_length_2153_cov_124,94.544,1888,64,9,2,1870,1946,79,0,2880,1868,1867
43289,Ntome_NODE_12689_length_1875_cov_28,Nsylvestris_NODE_12694_length_1796_cov_79,94.752,1772,78,7,42,1805,19,1783,0,2743,1763,1764
43333,Ntome_NODE_12703_length_1873_cov_61,Nsylvestris_NODE_10343_length_2070_cov_45,96.107,1824,60,5,5,1823,36,1853,0,2964,1818,1817
43380,Ntome_NODE_12725_length_1870_cov_20,Nsylvestris_NODE_10959_length_1993_cov_86,97.385,1874,43,4,1,1870,1891,20,0,3184,1869,1871
43387,Ntome_NODE_12729_length_1869_cov_236,Nsylvestris_NODE_10780_length_2016_cov_104,93.778,1816,92,12,44,1846,1808,1,0,2708,1802,1807
43428,Ntome_NODE_12743_length_1868_cov_171,Nsylvestris_NODE_11566_length_1922_cov_202,94.872,1677,85,1,89,1765,50,1725,0,2619,1676,1675
43472,Ntome_NODE_12758_length_1867_cov_31,Nsylvestris_NODE_10879_length_2003_cov_111,96.356,1866,68,0,2,1867,1866,1,0,3070,1865,1865
43486,Ntome_NODE_12765_length_1866_cov_87,Nsylvestris_NODE_11093_length_1977_cov_102,94.499,1836,75,15,53,1866,47,1878,0,2808,1813,1831
43550,Ntome_NODE_12788_length_1864_cov_66,Nsylvestris_NODE_12124_length_1855_cov_42,93.784,1850,85,11,1,1845,28,1852,0,2752,1844,1824
43562,Ntome_NODE_12792_length_1864_cov_20,Nsylvestris_NODE_30187_length_511_cov_1,87.324,71,8,1,14,84,217,286,6.21E-14,80.5,70,69
43620,Ntome_NODE_12816_length_1859_cov_279,Nsylvestris_NODE_12691_length_1796_cov_225,94.167,1783,82,2,70,1833,3,1782,0,2697,1763,1779
43759,Ntome_NODE_12868_length_1854_cov_191,Nsylvestris_NODE_11865_length_1884_cov_184,96.438,1853,56,6,3,1853,36,1880,0,3048,1850,1844
43772,Ntome_NODE_12872_length_1854_cov_45,Nsylvestris_NODE_29479_length_564_cov_5,75.918,245,59,0,355,599,281,37,7.82E-28,126,244,244
43777,Ntome_NODE_12875_length_1854_cov_27,Nsylvestris_NODE_9409_length_2192_cov_85,94.176,1803,70,14,17,1795,2145,354,0,2715,1778,1791
43846,Ntome_NODE_12894_length_1852_cov_124,Nsylvestris_NODE_12670_length_1798_cov_231,95.623,1759,58,4,29,1778,20,1768,0,2804,1749,1748
43880,Ntome_NODE_12910_length_1851_cov_165,Nsylvestris_NODE_15790_length_1471_cov_26,93.165,1507,62,16,267,1768,1,1471,0,2174,1501,1470
43881,Ntome_NODE_12911_length_1851_cov_38,Nsylvestris_NODE_11450_length_1936_cov_113,94.351,1841,97,4,1,1835,1879,40,0,2817,1834,1839
43954,Ntome_NODE_12938_length_1848_cov_56,Nsylvestris_NODE_17182_length_1342_cov_16,91.818,1320,106,2,433,1750,1342,23,0,1838,1317,1319
44005,Ntome_NODE_12960_length_1845_cov_237,Nsylvestris_NODE_14890_length_1561_cov_210,93.652,1528,79,9,272,1798,51,1561,0,2268,1526,1510
44045,Ntome_NODE_12974_length_1845_cov_11,Nsylvestris_NODE_14468_length_1603_cov_216,94.363,1561,81,6,41,1600,1555,1,0,2388,1559,1554
44105,Ntome_NODE_12995_length_1843_cov_104,Nsylvestris_NODE_10418_length_2060_cov_114,94.89,1683,50,7,177,1841,323,1987,0,2599,1664,1664
44217,Ntome_NODE_13034_length_1838_cov_15,Nsylvestris_NODE_11086_length_1978_cov_77,97.594,1704,32,3,140,1837,113,1813,0,2911,1697,1700
44240,Ntome_NODE_13047_length_1836_cov_177,Nsylvestris_NODE_22324_length_933_cov_216,95.884,826,27,5,139,959,59,882,0,1330,820,823
44248,Ntome_NODE_13050_length_1836_cov_91,Nsylvestris_NODE_36025_length_272_cov_71,94.884,215,10,1,418,632,1,214,1.18E-90,335,214,213
44307,Ntome_NODE_13074_length_1834_cov_46,Nsylvestris_NODE_12840_length_1782_cov_57,89.878,1640,118,24,8,1640,1773,175,0,2065,1632,1598
44314,Ntome_NODE_13077_length_1834_cov_8,Nsylvestris_NODE_9928_length_2125_cov_41,97.219,1834,48,1,1,1834,2062,232,0,3101,1833,1830
44349,Ntome_NODE_13092_length_1832_cov_95,Nsylvestris_NODE_22153_length_945_cov_39,88,350,38,4,682,1029,457,110,1.91E-113,411,347,347
44357,Ntome_NODE_13095_length_1832_cov_63,Nsylvestris_NODE_9197_length_2224_cov_125,94.079,1807,67,15,2,1790,388,2172,0,2708,1788,1784
44360,Ntome_NODE_13097_length_1832_cov_13,Nsylvestris_NODE_16886_length_1366_cov_34,94.849,1262,63,2,519,1779,51,1311,0,1969,1260,1260
44382,Ntome_NODE_13106_length_1831_cov_25,Nsylvestris_NODE_4099_length_3203_cov_50,94.194,1843,86,3,1,1825,1934,95,0,2791,1824,1839
44417,Ntome_NODE_13123_length_1828_cov_275,Nsylvestris_NODE_14519_length_1598_cov_111,91.587,1569,78,24,7,1548,1,1542,0,2117,1541,1541
44418,Ntome_NODE_13124_length_1828_cov_238,Nsylvestris_NODE_10957_length_1993_cov_190,97.475,1822,36,2,1,1812,8,1829,0,3101,1811,1821
44424,Ntome_NODE_13126_length_1828_cov_233,Nsylvestris_NODE_13421_length_1715_cov_155,96.694,1724,42,11,19,1737,1714,1,0,2854,1718,1713
44446,Ntome_NODE_13135_length_1827_cov_175,Nsylvestris_NODE_12757_length_1791_cov_70,95.845,1733,60,8,56,1778,61,1791,0,2791,1722,1730
44478,Ntome_NODE_13146_length_1826_cov_21,Nsylvestris_NODE_12768_length_1790_cov_39,94.074,1603,70,2,246,1826,75,1674,0,2410,1580,1599
44523,Ntome_NODE_13165_length_1824_cov_17,Nsylvestris_NODE_2360_length_3867_cov_34,94.577,1807,86,4,1,1798,2023,3826,0,2784,1797,1803
44641,Ntome_NODE_13216_length_1818_cov_11,Nsylvestris_NODE_12593_length_1806_cov_10,94.553,1487,73,4,39,1523,56,1536,0,2290,1484,1480
44676,Ntome_NODE_13229_length_1816_cov_263,Nsylvestris_NODE_12263_length_1841_cov_152,95.507,1736,70,5,19,1754,1781,54,0,2767,1735,1727
44677,Ntome_NODE_13230_length_1816_cov_247,Nsylvestris_NODE_13982_length_1652_cov_147,93.397,1469,73,11,55,1514,1645,192,0,2154,1459,1453
44742,Ntome_NODE_13251_length_1814_cov_53,Nsylvestris_NODE_12637_length_1802_cov_65,91.881,1675,111,10,7,1657,2,1675,0,2316,1650,1673
44759,Ntome_NODE_13258_length_1813_cov_98,Nsylvestris_NODE_11449_length_1936_cov_127,95.238,1827,55,17,1,1813,127,1935,0,2863,1812,1808
44923,Ntome_NODE_13312_length_1807_cov_56,Nsylvestris_NODE_19458_length_1148_cov_7,93.49,1152,59,8,227,1367,1148,2,0,1698,1140,1146
44949,Ntome_NODE_13321_length_1806_cov_109,Nsylvestris_NODE_13031_length_1760_cov_84,94.959,1726,80,4,60,1785,1724,6,0,2699,1725,1718
44958,Ntome_NODE_13326_length_1805_cov_220,Nsylvestris_NODE_13597_length_1696_cov_198,92.924,1611,78,7,27,1627,1657,73,0,2311,1600,1584
45019,Ntome_NODE_13346_length_1803_cov_125,Nsylvestris_NODE_8003_length_2403_cov_123,94.814,1832,60,12,3,1803,2347,520,0,2824,1800,1827
45042,Ntome_NODE_13356_length_1801_cov_205,Nsylvestris_NODE_13343_length_1724_cov_189,94.718,1098,49,6,44,1136,1631,538,0,1698,1092,1093
45113,Ntome_NODE_13380_length_1800_cov_8,Nsylvestris_NODE_30389_length_495_cov_8,95.152,495,24,0,1090,1584,495,1,0,782,494,494
45122,Ntome_NODE_13383_length_1799_cov_248,Nsylvestris_NODE_14843_length_1565_cov_186,94.834,1510,64,5,244,1746,1507,5,0,2344,1502,1502
45162,Ntome_NODE_13396_length_1797_cov_266,Nsylvestris_NODE_12588_length_1806_cov_204,95.057,1740,67,12,58,1790,11,1738,0,2719,1732,1727
45194,Ntome_NODE_13407_length_1796_cov_68,Nsylvestris_NODE_16427_length_1407_cov_111,95.337,1351,41,12,2,1334,13,1359,0,2126,1332,1346
45222,Ntome_NODE_13418_length_1794_cov_174,Nsylvestris_NODE_16423_length_1400_cov_176,90.549,1111,62,26,687,1774,304,1394,0,1430,1087,1090
45331,Ntome_NODE_13456_length_1790_cov_147,Nsylvestris_NODE_20536_length_1062_cov_110,92.52,869,62,1,52,920,1,866,0,1242,868,865
45339,Ntome_NODE_13459_length_1790_cov_28,Nsylvestris_NODE_26738_length_686_cov_9,91.023,557,38,7,977,1532,1,546,0,741,555,545
45392,Ntome_NODE_13477_length_1789_cov_24,Nsylvestris_NODE_31500_length_420_cov_3,95.192,416,20,0,1070,1485,418,3,0,658,415,415
45397,Ntome_NODE_13480_length_1788_cov_224,Nsylvestris_NODE_12561_length_1808_cov_210,95.655,1749,63,7,36,1782,1808,71,0,2796,1746,1737
45423,Ntome_NODE_13489_length_1788_cov_23,Nsylvestris_NODE_12935_length_1771_cov_17,95.303,1767,73,7,1,1760,1769,6,0,2795,1759,1763
45437,Ntome_NODE_13493_length_1787_cov_157,Nsylvestris_NODE_12657_length_1800_cov_43,95.221,1632,64,1,28,1645,1,1632,0,2569,1617,1631
45466,Ntome_NODE_13503_length_1786_cov_31,Nsylvestris_NODE_11787_length_1895_cov_50,94.223,1679,80,5,114,1778,175,1850,0,2547,1664,1675
45523,Ntome_NODE_13526_length_1784_cov_3,Nsylvestris_NODE_7194_length_2536_cov_40,92.999,1814,92,23,1,1784,553,2361,0,2614,1783,1808
45547,Ntome_NODE_13535_length_1782_cov_267,Nsylvestris_NODE_13495_length_1706_cov_227,92.959,1676,93,19,21,1684,1702,40,0,2418,1663,1662
45550,Ntome_NODE_13537_length_1782_cov_220,Nsylvestris_NODE_13613_length_1694_cov_209,92.141,1565,87,13,203,1757,1539,1,0,2176,1554,1538
45585,Ntome_NODE_13551_length_1781_cov_136,Nsylvestris_NODE_16130_length_1437_cov_49,93.372,1388,84,6,33,1413,1,1387,0,2047,1380,1386
45597,Ntome_NODE_13556_length_1781_cov_31,Nsylvestris_NODE_12556_length_1809_cov_10,92.486,173,11,2,1234,1405,1809,1638,5.52E-64,246,171,171
45671,Ntome_NODE_13578_length_1779_cov_53,Nsylvestris_NODE_16335_length_1416_cov_30,96.229,1379,43,3,62,1440,1416,47,0,2250,1378,1369
45747,Ntome_NODE_13608_length_1776_cov_53,Nsylvestris_NODE_13471_length_1710_cov_31,93.658,1703,89,9,20,1718,11,1698,0,2529,1698,1687
45774,Ntome_NODE_13620_length_1774_cov_274,Nsylvestris_NODE_14107_length_1639_cov_228,93.871,1550,78,10,77,1620,101,1639,0,2320,1543,1538
45798,Ntome_NODE_13629_length_1774_cov_29,Nsylvestris_NODE_13425_length_1715_cov_56,95.263,1731,61,5,36,1761,1715,1,0,2723,1725,1714
45833,Ntome_NODE_13641_length_1773_cov_90,Nsylvestris_NODE_12169_length_1851_cov_94,92.915,1736,74,12,80,1773,70,1798,0,2479,1693,1728
45886,Ntome_NODE_13663_length_1771_cov_119,Nsylvestris_NODE_13260_length_1732_cov_56,93.038,1738,86,7,42,1750,1,1732,0,2507,1708,1731
45914,Ntome_NODE_13672_length_1770_cov_103,Nsylvestris_NODE_12185_length_1849_cov_148,92.133,1627,99,14,43,1651,180,1795,0,2268,1608,1615
45978,Ntome_NODE_13697_length_1768_cov_61,Nsylvestris_NODE_13168_length_1742_cov_81,94.043,1729,67,16,47,1767,1742,42,0,2590,1720,1700
45980,Ntome_NODE_13700_length_1768_cov_31,Nsylvestris_NODE_11936_length_1876_cov_219,92.988,1797,81,15,3,1764,66,1852,0,2579,1761,1786
46023,Ntome_NODE_13714_length_1766_cov_219,Nsylvestris_NODE_13194_length_1739_cov_200,94.975,1592,50,9,45,1632,51,1616,0,2470,1587,1565
46103,Ntome_NODE_13743_length_1763_cov_124,Nsylvestris_NODE_12285_length_1839_cov_136,93.938,1765,72,16,9,1755,92,1839,0,2634,1746,1747
46136,Ntome_NODE_13759_length_1761_cov_257,Nsylvestris_NODE_13695_length_1685_cov_201,93.709,1685,100,4,82,1761,1685,2,0,2519,1679,1683
46177,Ntome_NODE_13772_length_1760_cov_168,Nsylvestris_NODE_14618_length_1587_cov_104,94.168,1526,44,13,37,1528,1529,15,0,2283,1491,1514
46190,Ntome_NODE_13779_length_1759_cov_281,Nsylvestris_NODE_11790_length_1894_cov_170,95.202,1459,47,4,50,1489,1634,180,0,2285,1439,1454
46238,Ntome_NODE_13799_length_1758_cov_9,Nsylvestris_NODE_7691_length_2454_cov_166,96.016,1757,70,0,2,1758,496,2252,0,2857,1756,1756
46354,Ntome_NODE_13845_length_1752_cov_77,Nsylvestris_NODE_18001_length_1268_cov_191,94.434,1114,43,2,249,1344,81,1193,0,1696,1095,1112
46377,Ntome_NODE_13852_length_1751_cov_51,Nsylvestris_NODE_13828_length_1671_cov_19,93.04,1566,87,12,62,1627,1671,128,0,2268,1565,1543
46404,Ntome_NODE_13862_length_1750_cov_23,Nsylvestris_NODE_35894_length_275_cov_5,90.391,281,19,4,472,751,1,274,5.16E-99,363,279,273
46491,Ntome_NODE_13897_length_1746_cov_271,Nsylvestris_NODE_13866_length_1666_cov_215,94.981,1554,62,8,32,1575,1666,119,0,2423,1543,1547
46518,Ntome_NODE_13906_length_1746_cov_260,Nsylvestris_NODE_13288_length_1729_cov_210,95.828,1606,53,5,47,1650,1599,6,0,2582,1603,1593
46554,Ntome_NODE_13918_length_1745_cov_18,Nsylvestris_NODE_8772_length_2284_cov_101,95.528,1744,68,4,3,1745,2166,432,0,2780,1742,1734
46555,Ntome_NODE_13919_length_1744_cov_281,Nsylvestris_NODE_12672_length_1798_cov_224,95.033,1671,74,5,9,1678,9,1671,0,2617,1669,1662
46594,Ntome_NODE_13931_length_1744_cov_24,Nsylvestris_NODE_13852_length_1668_cov_131,96.072,1604,62,1,105,1708,1633,31,0,2612,1603,1602
46650,Ntome_NODE_13955_length_1741_cov_198,Nsylvestris_NODE_16454_length_1404_cov_199,95.552,1349,42,11,24,1363,59,1398,0,2143,1339,1339
46671,Ntome_NODE_13963_length_1741_cov_25,Nsylvestris_NODE_16485_length_1401_cov_58,96.53,1412,33,3,207,1618,6,1401,0,2322,1411,1395
46771,Ntome_NODE_14000_length_1738_cov_28,Nsylvestris_NODE_14152_length_1635_cov_101,93.491,1521,67,14,87,1596,1546,47,0,2231,1509,1499
46772,Ntome_NODE_14001_length_1738_cov_17,Nsylvestris_NODE_7993_length_2405_cov_45,97.296,1738,42,4,1,1735,296,2031,0,2944,1734,1735
46792,Ntome_NODE_14008_length_1737_cov_36,Nsylvestris_NODE_13071_length_1755_cov_71,94.256,1654,86,5,21,1666,51,1703,0,2519,1645,1652
46796,Ntome_NODE_14010_length_1737_cov_12,Nsylvestris_NODE_19906_length_1110_cov_14,89.655,290,20,5,1457,1737,985,697,1.84E-98,361,280,288
46864,Ntome_NODE_14042_length_1734_cov_9,Nsylvestris_NODE_8608_length_2308_cov_49,91.806,1672,132,3,4,1671,501,2171,0,2324,1667,1670
46937,Ntome_NODE_14069_length_1731_cov_27,Nsylvestris_NODE_3815_length_3296_cov_72,83.684,190,23,6,1087,1270,2136,1949,9.24E-42,172,183,187
46973,Ntome_NODE_14082_length_1729_cov_73,Nsylvestris_NODE_13824_length_1670_cov_81,94.669,1557,65,4,24,1564,1659,105,0,2399,1540,1554
47008,Ntome_NODE_14097_length_1731_cov_5,Nsylvestris_NODE_10091_length_2104_cov_71,95.168,1573,75,1,152,1724,2103,532,0,2483,1572,1571
47015,Ntome_NODE_14100_length_1727_cov_242,Nsylvestris_NODE_15669_length_1483_cov_174,95.455,1188,54,0,237,1424,219,1406,0,1895,1187,1187
47028,Ntome_NODE_14107_length_1726_cov_196,Nsylvestris_NODE_15068_length_1544_cov_223,94.367,1509,59,12,25,1519,1544,48,0,2292,1494,1496
47119,Ntome_NODE_14145_length_1722_cov_197,Nsylvestris_NODE_15439_length_1509_cov_46,95.19,1476,45,8,149,1606,1469,2,0,2309,1457,1467
47138,Ntome_NODE_14152_length_1721_cov_176,Nsylvestris_NODE_12821_length_1784_cov_128,93.382,1511,67,13,212,1715,1525,41,0,2206,1503,1484
47184,Ntome_NODE_14168_length_1720_cov_11,Nsylvestris_NODE_10360_length_2068_cov_73,95.644,1538,67,0,103,1640,1856,319,0,2470,1537,1537
47233,Ntome_NODE_14185_length_1716_cov_284,Nsylvestris_NODE_13878_length_1665_cov_213,93.548,1643,86,7,25,1652,28,1665,0,2429,1627,1637
47249,Ntome_NODE_14194_length_1716_cov_14,Nsylvestris_NODE_13412_length_1716_cov_23,94.391,1676,77,4,49,1707,8,1683,0,2558,1658,1675
47296,Ntome_NODE_14213_length_1714_cov_143,Nsylvestris_NODE_11270_length_1955_cov_54,94.128,1686,76,6,28,1713,89,1751,0,2543,1685,1662
47355,Ntome_NODE_14234_length_1711_cov_276,Nsylvestris_NODE_14524_length_1597_cov_224,95.551,1506,54,9,1,1494,21,1525,0,2398,1493,1504
47398,Ntome_NODE_14248_length_1710_cov_235,Nsylvestris_NODE_14521_length_1598_cov_93,95.215,1442,69,0,269,1710,50,1491,0,2281,1441,1441
47431,Ntome_NODE_14261_length_1709_cov_223,Nsylvestris_NODE_9015_length_2249_cov_160,92.641,1685,84,15,32,1709,125,1776,0,2388,1677,1651
47484,Ntome_NODE_14278_length_1708_cov_25,Nsylvestris_NODE_13760_length_1678_cov_48,96.344,1641,52,7,41,1679,1653,19,0,2691,1638,1634
47505,Ntome_NODE_14285_length_1707_cov_15,Nsylvestris_NODE_12539_length_1811_cov_25,94.799,1596,57,4,102,1681,1646,61,0,2464,1579,1585
47584,Ntome_NODE_14320_length_1703_cov_115,Nsylvestris_NODE_14286_length_1621_cov_213,94.627,1433,55,12,49,1461,1583,153,0,2200,1412,1430
47669,Ntome_NODE_14351_length_1700_cov_90,Nsylvestris_NODE_15042_length_1547_cov_28,95.346,1504,66,1,155,1658,1,1500,0,2386,1503,1499
47718,Ntome_NODE_14371_length_1698_cov_212,Nsylvestris_NODE_13247_length_1734_cov_195,97.55,1592,38,1,2,1592,107,1698,0,2723,1590,1591
47724,Ntome_NODE_14374_length_1698_cov_100,Nsylvestris_NODE_6761_length_2611_cov_169,94.745,1256,66,0,3,1258,2587,1332,0,1954,1255,1255
47746,Ntome_NODE_14382_length_1697_cov_158,Nsylvestris_NODE_15453_length_1507_cov_80,90.082,1472,93,33,59,1498,10,1460,0,1860,1439,1450
47747,Ntome_NODE_14383_length_1697_cov_133,Nsylvestris_NODE_13322_length_1726_cov_174,94.504,1692,62,18,1,1685,23,1690,0,2580,1684,1667
47864,Ntome_NODE_14423_length_1693_cov_170,Nsylvestris_NODE_15430_length_1510_cov_34,93.329,1514,85,10,183,1693,1,1501,0,2222,1510,1500
47879,Ntome_NODE_14431_length_1692_cov_258,Nsylvestris_NODE_15216_length_1530_cov_79,93.759,1362,68,10,71,1422,1528,174,0,2028,1351,1354
47921,Ntome_NODE_14445_length_1691_cov_213,Nsylvestris_NODE_12514_length_1813_cov_183,94.338,1678,47,20,20,1686,1730,90,0,2529,1666,1640
47928,Ntome_NODE_14449_length_1691_cov_13,Nsylvestris_NODE_12205_length_1848_cov_27,93.704,1636,75,12,61,1691,1688,76,0,2425,1630,1612
47955,Ntome_NODE_14458_length_1690_cov_41,Nsylvestris_NODE_12463_length_1820_cov_125,96.816,1476,38,1,78,1544,1668,193,0,2457,1466,1475
47973,Ntome_NODE_14466_length_1689_cov_205,Nsylvestris_NODE_14328_length_1618_cov_222,90.869,1599,96,22,51,1609,1597,9,0,2098,1558,1588
47996,Ntome_NODE_14475_length_1688_cov_25,Nsylvestris_NODE_10201_length_2088_cov_18,97.532,1661,41,0,1,1661,2069,409,0,2841,1660,1660
48016,Ntome_NODE_14483_length_1687_cov_178,Nsylvestris_NODE_13725_length_1682_cov_161,95.487,1551,49,8,93,1637,1640,105,0,2457,1544,1535
48028,Ntome_NODE_14488_length_1687_cov_36,Nsylvestris_NODE_34094_length_319_cov_5,85.714,182,20,2,420,601,97,272,3.21E-46,187,181,175
48079,Ntome_NODE_14506_length_1685_cov_92,Nsylvestris_NODE_15257_length_1526_cov_17,93.198,1529,75,11,90,1610,1526,19,0,2220,1520,1507
48146,Ntome_NODE_14535_length_1682_cov_58,Nsylvestris_NODE_15521_length_1500_cov_42,94.481,1504,76,3,66,1567,1,1499,0,2311,1501,1498
48172,Ntome_NODE_14546_length_1680_cov_238,Nsylvestris_NODE_13808_length_1672_cov_194,95.558,1621,56,9,22,1640,1672,66,0,2580,1618,1606
48196,Ntome_NODE_14557_length_1679_cov_236,Nsylvestris_NODE_13566_length_1699_cov_193,95.684,1622,58,6,48,1665,1623,10,0,2597,1617,1613
48206,Ntome_NODE_14561_length_1679_cov_132,Nsylvestris_NODE_13078_length_1753_cov_147,96.075,1325,45,6,340,1658,390,1713,0,2152,1318,1323
48207,Ntome_NODE_14562_length_1679_cov_131,Nsylvestris_NODE_18199_length_1250_cov_172,95.725,959,22,7,128,1078,34,981,0,1526,950,947
48226,Ntome_NODE_14573_length_1678_cov_129,Nsylvestris_NODE_14487_length_1601_cov_157,94.788,1439,44,8,52,1485,1447,35,0,2213,1433,1412
48234,Ntome_NODE_14577_length_1678_cov_32,Nsylvestris_NODE_10564_length_2042_cov_28,93.379,1601,79,18,46,1632,390,1977,0,2344,1586,1587
48257,Ntome_NODE_14586_length_1677_cov_114,Nsylvestris_NODE_14105_length_1640_cov_14,95.537,1053,40,3,225,1274,1147,99,0,1677,1049,1048
48262,Ntome_NODE_14588_length_1677_cov_47,Nsylvestris_NODE_14197_length_1630_cov_30,93.719,1608,94,6,69,1675,1628,27,0,2403,1606,1601
48270,Ntome_NODE_14592_length_1676_cov_260,Nsylvestris_NODE_13738_length_1680_cov_215,94.059,1515,85,3,162,1676,85,1594,0,2294,1514,1509
48306,Ntome_NODE_14605_length_1676_cov_50,Nsylvestris_NODE_12607_length_1804_cov_148,95.183,1557,64,6,11,1560,42,1594,0,2449,1549,1552
48363,Ntome_NODE_14626_length_1674_cov_79,Nsylvestris_NODE_14814_length_1568_cov_86,93.207,1428,71,10,167,1588,1408,1,0,2076,1421,1407
48395,Ntome_NODE_14642_length_1673_cov_93,Nsylvestris_NODE_10740_length_2021_cov_87,92.502,1467,85,14,125,1579,519,1972,0,2076,1454,1453
48412,Ntome_NODE_14652_length_1672_cov_197,Nsylvestris_NODE_22479_length_923_cov_207,87.405,659,61,15,25,662,909,252,0,737,637,657
48502,Ntome_NODE_14691_length_1667_cov_67,Nsylvestris_NODE_31196_length_438_cov_19,87.118,458,38,11,1200,1657,438,2,3.59E-140,499,457,436
48505,Ntome_NODE_14694_length_1667_cov_37,Nsylvestris_NODE_18142_length_1255_cov_16,93.503,1216,45,9,138,1343,7,1198,0,1777,1205,1191
48528,Ntome_NODE_14703_length_1665_cov_249,Nsylvestris_NODE_11964_length_1874_cov_179,97.038,1553,41,3,41,1589,1552,1,0,2608,1548,1551
48543,Ntome_NODE_14708_length_1665_cov_28,Nsylvestris_NODE_22213_length_941_cov_88,93.359,783,26,13,601,1371,769,1,0,1134,770,768
48544,Ntome_NODE_14709_length_1665_cov_21,Nsylvestris_NODE_11551_length_1924_cov_207,96.029,1662,57,1,13,1665,1765,104,0,2695,1652,1661
48553,Ntome_NODE_14714_length_1664_cov_257,Nsylvestris_NODE_15108_length_1540_cov_119,90.71,1550,86,27,138,1643,1,1536,0,2012,1505,1535
48573,Ntome_NODE_14720_length_1663_cov_275,Nsylvestris_NODE_15596_length_1491_cov_170,94.088,1370,68,10,241,1606,1362,2,0,2069,1365,1360
48582,Ntome_NODE_14725_length_1663_cov_9,Nsylvestris_NODE_9201_length_2223_cov_36,95.364,1661,76,1,1,1661,130,1789,0,2639,1660,1659
48592,Ntome_NODE_14729_length_1662_cov_136,Nsylvestris_NODE_26488_length_695_cov_185,95.938,640,21,3,46,680,695,56,0,1033,634,639
48647,Ntome_NODE_14746_length_1661_cov_53,Nsylvestris_NODE_14621_length_1587_cov_65,93.56,1615,52,16,63,1659,6,1586,0,2359,1596,1580
48667,Ntome_NODE_14751_length_1660_cov_225,Nsylvestris_NODE_14593_length_1589_cov_200,95.925,1546,47,6,112,1653,1535,2,0,2492,1541,1533
48705,Ntome_NODE_14765_length_1659_cov_181,Nsylvestris_NODE_14237_length_1625_cov_124,96.398,1610,54,2,1,1609,18,1624,0,2649,1608,1606
48714,Ntome_NODE_14770_length_1659_cov_60,Nsylvestris_NODE_24310_length_812_cov_10,94.317,827,27,1,650,1476,3,809,0,1249,826,806
48731,Ntome_NODE_14778_length_1658_cov_25,Nsylvestris_NODE_11858_length_1885_cov_53,95.221,1653,79,0,1,1653,163,1815,0,2615,1652,1652
48806,Ntome_NODE_14811_length_1655_cov_34,Nsylvestris_NODE_13681_length_1688_cov_38,94.667,1669,63,10,1,1655,1667,11,0,2566,1654,1656
48832,Ntome_NODE_14819_length_1654_cov_67,Nsylvestris_NODE_16869_length_1367_cov_48,91.81,1392,81,17,268,1651,1367,1,0,1908,1383,1366
48835,Ntome_NODE_14821_length_1654_cov_20,Nsylvestris_NODE_30227_length_508_cov_2,98.425,508,8,0,27,534,1,508,0,894,507,507
48900,Ntome_NODE_14843_length_1650_cov_241,Nsylvestris_NODE_14867_length_1563_cov_203,89.176,1589,80,34,66,1604,1,1547,0,1897,1538,1546
48906,Ntome_NODE_14846_length_1651_cov_78,Nsylvestris_NODE_12228_length_1845_cov_98,88.455,1126,113,5,209,1318,1174,50,0,1343,1109,1124
48963,Ntome_NODE_14866_length_1647_cov_277,Nsylvestris_NODE_8875_length_2267_cov_201,95.635,1535,53,10,97,1623,694,2222,0,2451,1526,1528
48986,Ntome_NODE_14877_length_1646_cov_276,Nsylvestris_NODE_15017_length_1548_cov_221,93.412,1533,94,6,88,1616,1,1530,0,2265,1528,1529
48991,Ntome_NODE_14880_length_1646_cov_39,Nsylvestris_NODE_36103_length_271_cov_4,95.911,269,9,2,140,407,268,1,1.01E-120,435,267,267
49013,Ntome_NODE_14889_length_1645_cov_92,Nsylvestris_NODE_18609_length_1217_cov_7,85.494,324,30,7,871,1178,60,382,8.23E-87,322,307,322
49014,Ntome_NODE_14890_length_1645_cov_70,Nsylvestris_NODE_16336_length_1416_cov_24,94.126,1379,77,3,231,1608,33,1408,0,2095,1377,1375
49015,Ntome_NODE_14891_length_1645_cov_27,Nsylvestris_NODE_12363_length_1831_cov_98,95.75,1553,66,0,93,1645,1759,207,0,2503,1552,1552
49031,Ntome_NODE_14897_length_1644_cov_245,Nsylvestris_NODE_12687_length_1797_cov_148,94.464,1391,65,6,263,1644,382,1769,0,2132,1381,1387
49050,Ntome_NODE_14904_length_1644_cov_102,Nsylvestris_NODE_13283_length_1730_cov_63,95.258,1645,68,5,1,1640,1640,1,0,2597,1639,1639
49068,Ntome_NODE_14912_length_1643_cov_259,Nsylvestris_NODE_13605_length_1695_cov_190,96.027,1636,47,7,20,1637,1695,60,0,2645,1617,1635
49108,Ntome_NODE_14925_length_1643_cov_41,Nsylvestris_NODE_18248_length_1248_cov_6,92.693,1259,77,7,89,1344,2,1248,0,1801,1255,1246
49109,Ntome_NODE_14927_length_1643_cov_21,Nsylvestris_NODE_19184_length_1169_cov_9,88.679,53,3,3,1081,1130,843,895,1.98E-08,62.1,49,52
49182,Ntome_NODE_14956_length_1640_cov_73,Nsylvestris_NODE_14823_length_1567_cov_153,93.571,1571,68,15,74,1637,1567,23,0,2311,1563,1544
49255,Ntome_NODE_14982_length_1638_cov_78,Nsylvestris_NODE_25202_length_760_cov_57,91.553,367,17,3,234,600,711,359,1.64E-138,494,366,352
49293,Ntome_NODE_14999_length_1635_cov_278,Nsylvestris_NODE_11275_length_1954_cov_161,96.194,1550,48,6,89,1635,1869,328,0,2525,1546,1541
49341,Ntome_NODE_15018_length_1633_cov_196,Nsylvestris_NODE_17606_length_1302_cov_185,93.497,1307,49,16,316,1591,1,1302,0,1910,1275,1301
49408,Ntome_NODE_15046_length_1630_cov_240,Nsylvestris_NODE_18047_length_1264_cov_189,94.654,1085,51,4,202,1284,1209,130,0,1676,1082,1079
49491,Ntome_NODE_15076_length_1627_cov_269,Nsylvestris_NODE_14889_length_1561_cov_212,96.164,1564,41,8,60,1607,1,1561,0,2538,1547,1560
49503,Ntome_NODE_15080_length_1627_cov_24,Nsylvestris_NODE_12784_length_1788_cov_148,94.954,1625,67,2,1,1625,166,1775,0,2532,1624,1609
49554,Ntome_NODE_15100_length_1624_cov_18,Nsylvestris_NODE_14893_length_1561_cov_58,96.502,1458,48,2,143,1600,1511,57,0,2407,1457,1454
49558,Ntome_NODE_15104_length_1623_cov_176,Nsylvestris_NODE_13554_length_1700_cov_178,92.116,1522,83,18,62,1578,82,1571,0,2111,1516,1489
49575,Ntome_NODE_15112_length_1623_cov_15,Nsylvestris_NODE_34489_length_308_cov_4,92.164,268,9,1,1322,1577,1,268,1.03E-100,368,255,267
49640,Ntome_NODE_15135_length_1620_cov_86,Nsylvestris_NODE_15904_length_1460_cov_47,93.858,1335,73,6,157,1487,1455,126,0,2002,1330,1329
49652,Ntome_NODE_15142_length_1619_cov_203,Nsylvestris_NODE_13974_length_1653_cov_114,93.867,1598,75,6,1,1582,1597,7,0,2386,1581,1590
49694,Ntome_NODE_15159_length_1617_cov_214,Nsylvestris_NODE_15476_length_1505_cov_147,95.792,1212,26,2,114,1303,1491,283,0,1932,1189,1208
49711,Ntome_NODE_15168_length_1616_cov_212,Nsylvestris_NODE_16712_length_1380_cov_180,91.47,973,52,5,227,1189,1380,429,0,1308,962,951
49719,Ntome_NODE_15172_length_1616_cov_118,Nsylvestris_NODE_15332_length_1519_cov_116,90.007,1361,89,19,167,1480,1361,1,0,1716,1313,1360
49745,Ntome_NODE_15181_length_1615_cov_243,Nsylvestris_NODE_14725_length_1577_cov_29,92.421,1491,46,17,156,1589,97,1577,0,2065,1433,1480
49770,Ntome_NODE_15195_length_1614_cov_244,Nsylvestris_NODE_12918_length_1772_cov_195,90.584,1593,95,28,55,1614,82,1652,0,2060,1559,1570
49774,Ntome_NODE_15198_length_1614_cov_154,Nsylvestris_NODE_14361_length_1614_cov_68,93.871,1550,69,20,1,1536,1548,11,0,2313,1535,1537
49786,Ntome_NODE_15202_length_1604_cov_302,Nsylvestris_NODE_13980_length_1652_cov_223,95.244,1535,64,5,35,1565,1566,37,0,2422,1530,1529
49800,Ntome_NODE_15210_length_1613_cov_115,Nsylvestris_NODE_13077_length_1753_cov_157,95.97,1588,60,3,1,1588,43,1626,0,2575,1587,1583
49824,Ntome_NODE_15219_length_1612_cov_97,Nsylvestris_NODE_14437_length_1606_cov_193,94.202,1604,68,9,1,1581,1603,2,0,2423,1580,1601
49830,Ntome_NODE_15222_length_1612_cov_12,Nsylvestris_NODE_26107_length_714_cov_8,91.907,729,32,14,787,1510,714,8,0,994,723,706
49869,Ntome_NODE_15236_length_1610_cov_203,Nsylvestris_NODE_13116_length_1749_cov_125,96.765,1484,48,0,125,1608,1720,237,0,2475,1483,1483
49916,Ntome_NODE_15255_length_1609_cov_41,Nsylvestris_NODE_12799_length_1786_cov_215,94.097,1440,59,11,4,1428,69,1497,0,2165,1424,1428
49948,Ntome_NODE_15269_length_1607_cov_280,Nsylvestris_NODE_15029_length_1547_cov_234,94.293,1542,65,9,3,1531,16,1547,0,2338,1528,1531
49976,Ntome_NODE_15279_length_1607_cov_53,Nsylvestris_NODE_11560_length_1923_cov_170,94.804,1559,72,6,1,1554,222,1776,0,2422,1553,1554
49992,Ntome_NODE_15285_length_1606_cov_87,Nsylvestris_NODE_15304_length_1521_cov_42,92.67,1296,72,5,274,1552,75,1364,0,1845,1278,1289
50012,Ntome_NODE_15294_length_1605_cov_273,Nsylvestris_NODE_14248_length_1624_cov_206,96.185,1494,32,10,130,1598,1563,70,0,2420,1468,1493
50031,Ntome_NODE_15302_length_1604_cov_289,Nsylvestris_NODE_14016_length_1647_cov_214,96.794,1591,44,6,16,1602,1645,58,0,2649,1586,1587
50075,Ntome_NODE_15318_length_1603_cov_72,Nsylvestris_NODE_18907_length_1192_cov_43,96.86,860,24,1,612,1468,964,105,0,1435,856,859
50095,Ntome_NODE_15327_length_1602_cov_15,Nsylvestris_NODE_10456_length_2056_cov_18,97.502,1601,40,0,1,1601,1935,335,0,2736,1600,1600
50122,Ntome_NODE_15340_length_1600_cov_226,Nsylvestris_NODE_14821_length_1567_cov_201,91.467,1547,67,23,56,1600,13,1496,0,2065,1544,1483
50135,Ntome_NODE_15345_length_1600_cov_27,Nsylvestris_NODE_14471_length_1603_cov_48,95.145,1586,71,2,16,1598,1,1583,0,2497,1582,1582
50149,Ntome_NODE_15350_length_1599_cov_246,Nsylvestris_NODE_12835_length_1782_cov_206,94.942,1542,63,8,2,1538,1726,195,0,2401,1536,1531
50157,Ntome_NODE_15353_length_1598_cov_242,Nsylvestris_NODE_12226_length_1845_cov_155,92.996,1599,69,26,19,1587,68,1653,0,2292,1568,1585
50176,Ntome_NODE_15360_length_1597_cov_170,Nsylvestris_NODE_22410_length_927_cov_204,93.431,822,25,7,19,812,1,821,0,1192,793,820
50239,Ntome_NODE_15383_length_1595_cov_261,Nsylvestris_NODE_15495_length_1503_cov_205,94.993,1358,59,3,47,1403,87,1436,0,2122,1356,1349
50252,Ntome_NODE_15389_length_1595_cov_81,Nsylvestris_NODE_29805_length_544_cov_9,92.094,468,33,2,922,1388,77,541,0,656,466,464
50301,Ntome_NODE_15409_length_1593_cov_111,Nsylvestris_NODE_14401_length_1610_cov_113,94.862,1265,48,6,4,1264,1601,350,0,1960,1260,1251
50370,Ntome_NODE_15435_length_1591_cov_23,Nsylvestris_NODE_9448_length_2186_cov_43,95.194,1623,43,14,1,1591,203,1822,0,2532,1590,1619
50418,Ntome_NODE_15453_length_1588_cov_217,Nsylvestris_NODE_15584_length_1492_cov_157,89.839,1427,108,17,97,1513,1481,82,0,1797,1416,1399
50498,Ntome_NODE_15484_length_1585_cov_197,Nsylvestris_NODE_15197_length_1531_cov_135,94.012,1503,66,10,40,1536,1530,46,0,2255,1496,1484
50521,Ntome_NODE_15492_length_1585_cov_67,Nsylvestris_NODE_15795_length_1470_cov_116,94.18,1512,46,5,63,1574,1,1470,0,2266,1511,1469
50536,Ntome_NODE_15498_length_1584_cov_229,Nsylvestris_NODE_18512_length_1223_cov_190,94.113,1223,52,8,363,1567,1222,2,0,1842,1204,1220
50574,Ntome_NODE_15516_length_1583_cov_25,Nsylvestris_NODE_13263_length_1732_cov_50,91.88,1601,88,19,1,1583,120,1696,0,2198,1582,1576
50593,Ntome_NODE_15523_length_1582_cov_114,Nsylvestris_NODE_22152_length_945_cov_51,94.643,728,35,3,95,821,4,728,0,1125,726,724
50613,Ntome_NODE_15532_length_1581_cov_98,Nsylvestris_NODE_16027_length_1447_cov_150,93.921,1464,51,14,1,1447,2,1444,0,2176,1446,1442
50623,Ntome_NODE_15537_length_1580_cov_282,Nsylvestris_NODE_12552_length_1809_cov_111,94.748,1447,45,10,102,1526,1799,362,0,2222,1424,1437
50652,Ntome_NODE_15552_length_1579_cov_249,Nsylvestris_NODE_16754_length_1376_cov_211,95.678,1342,42,6,44,1375,1336,1,0,2143,1331,1335
50677,Ntome_NODE_15560_length_1579_cov_113,Nsylvestris_NODE_14777_length_1572_cov_56,95.493,1531,61,4,1,1530,1542,19,0,2438,1529,1523
50686,Ntome_NODE_15564_length_1578_cov_287,Nsylvestris_NODE_12798_length_1784_cov_216,97.971,1331,25,2,248,1578,185,1513,0,2307,1330,1328
50703,Ntome_NODE_15571_length_1578_cov_181,Nsylvestris_NODE_19018_length_1182_cov_168,94.806,1136,48,5,427,1561,1,1126,0,1760,1134,1125
50704,Ntome_NODE_15572_length_1578_cov_120,Nsylvestris_NODE_16235_length_1426_cov_180,94.807,1425,66,7,2,1420,2,1424,0,2215,1418,1422
50728,Ntome_NODE_15583_length_1577_cov_251,Nsylvestris_NODE_14027_length_1646_cov_183,94.485,1505,65,9,81,1571,88,1588,0,2303,1490,1500
50733,Ntome_NODE_15586_length_1577_cov_245,Nsylvestris_NODE_15682_length_1481_cov_223,96.496,1427,37,6,56,1470,1,1426,0,2346,1414,1425
50778,Ntome_NODE_15607_length_1575_cov_57,Nsylvestris_NODE_25029_length_770_cov_9,91.23,764,52,7,560,1320,3,754,0,1026,760,751
50801,Ntome_NODE_15619_length_1574_cov_139,Nsylvestris_NODE_14699_length_1579_cov_172,90.689,1407,83,19,1,1393,1572,200,0,1829,1392,1372
50812,Ntome_NODE_15623_length_1574_cov_39,Nsylvestris_NODE_32499_length_372_cov_5,84.173,278,34,7,499,773,1,271,1.74E-68,261,274,270
50824,Ntome_NODE_15629_length_1573_cov_268,Nsylvestris_NODE_15449_length_1507_cov_164,94.952,1446,61,7,23,1467,1435,1,0,2255,1444,1434
50828,Ntome_NODE_15631_length_1573_cov_204,Nsylvestris_NODE_20189_length_1087_cov_176,89.871,1086,67,22,231,1308,1,1051,0,1356,1077,1050
50860,Ntome_NODE_15644_length_1572_cov_228,Nsylvestris_NODE_15021_length_1548_cov_131,91.194,1499,99,17,53,1532,1485,1,0,2006,1479,1484
50899,Ntome_NODE_15656_length_1571_cov_237,Nsylvestris_NODE_14035_length_1646_cov_46,92.73,1513,88,11,4,1510,1637,141,0,2165,1506,1496
50923,Ntome_NODE_15664_length_1571_cov_25,Nsylvestris_NODE_14175_length_1633_cov_22,95.647,1585,49,4,2,1571,33,1612,0,2527,1569,1579
50940,Ntome_NODE_15676_length_1573_cov_263,Nsylvestris_NODE_17889_length_1275_cov_226,98.129,1176,20,1,253,1426,1232,57,0,2049,1173,1175
50942,Ntome_NODE_15678_length_1570_cov_232,Nsylvestris_NODE_19874_length_1112_cov_44,96.201,1053,40,0,197,1249,52,1104,0,1724,1052,1052
50983,Ntome_NODE_15694_length_1568_cov_249,Nsylvestris_NODE_14698_length_1579_cov_200,95.016,1565,55,6,12,1564,1,1554,0,2436,1552,1553
50984,Ntome_NODE_15695_length_1568_cov_233,Nsylvestris_NODE_12231_length_1844_cov_182,95.245,1472,47,7,99,1568,1814,364,0,2309,1469,1450
51055,Ntome_NODE_15725_length_1566_cov_7,Nsylvestris_NODE_13311_length_1726_cov_32,93.45,1481,85,3,98,1566,61,1541,0,2187,1468,1480
51079,Ntome_NODE_15735_length_1565_cov_90,Nsylvestris_NODE_13182_length_1740_cov_211,95.131,1561,71,4,2,1557,101,1661,0,2457,1555,1560
51092,Ntome_NODE_15741_length_1564_cov_18,Nsylvestris_NODE_4494_length_3101_cov_145,94.426,1525,74,5,50,1563,1617,93,0,2335,1513,1524
51136,Ntome_NODE_15759_length_1562_cov_255,Nsylvestris_NODE_17841_length_1282_cov_220,94.269,1204,49,11,87,1289,1235,51,0,1823,1202,1184
51209,Ntome_NODE_15795_length_1558_cov_277,Nsylvestris_NODE_17023_length_1355_cov_201,91.753,1358,62,14,157,1495,2,1328,0,1842,1338,1326
51216,Ntome_NODE_15798_length_1558_cov_226,Nsylvestris_NODE_31088_length_446_cov_4,87.22,446,57,0,282,727,446,1,5.57E-143,508,445,445
51271,Ntome_NODE_15819_length_1556_cov_160,Nsylvestris_NODE_5996_length_2761_cov_139,95.401,1435,56,7,78,1505,1232,2663,0,2276,1427,1431
51331,Ntome_NODE_15841_length_1554_cov_190,Nsylvestris_NODE_17918_length_1275_cov_85,92.747,1227,54,10,59,1269,1275,68,0,1740,1210,1207
51428,Ntome_NODE_15881_length_1550_cov_45,Nsylvestris_NODE_13573_length_1699_cov_116,96.025,1459,34,8,105,1550,79,1526,0,2351,1445,1447
51462,Ntome_NODE_15893_length_1548_cov_231,Nsylvestris_NODE_19435_length_1149_cov_192,97.196,856,24,0,293,1148,247,1102,0,1448,855,855
51511,Ntome_NODE_15913_length_1546_cov_266,Nsylvestris_NODE_16516_length_1398_cov_201,94.565,1196,61,4,88,1281,1352,159,0,1845,1193,1193
51583,Ntome_NODE_15944_length_1543_cov_136,Nsylvestris_NODE_15754_length_1474_cov_190,93.038,1422,62,11,72,1487,1474,84,0,2043,1415,1390
51590,Ntome_NODE_15947_length_1543_cov_109,Nsylvestris_NODE_15903_length_1460_cov_59,93.675,1423,62,15,28,1439,4,1409,0,2104,1411,1405
51594,Ntome_NODE_15950_length_1543_cov_33,Nsylvestris_NODE_16484_length_1401_cov_82,94.375,1351,53,6,201,1529,1351,2,0,2052,1328,1349
51609,Ntome_NODE_15958_length_1542_cov_221,Nsylvestris_NODE_15261_length_1525_cov_167,92.333,1539,60,21,9,1523,21,1525,0,2135,1514,1504
51684,Ntome_NODE_15988_length_1540_cov_13,Nsylvestris_NODE_29727_length_552_cov_9,86.087,230,31,1,605,834,256,28,4.77E-64,246,229,228
51723,Ntome_NODE_16006_length_1538_cov_250,Nsylvestris_NODE_11078_length_1979_cov_121,95.646,1401,52,6,2,1394,1979,580,0,2241,1392,1399
51804,Ntome_NODE_16039_length_1536_cov_64,Nsylvestris_NODE_15270_length_1524_cov_211,91.26,1476,84,21,98,1536,1496,29,0,1969,1438,1467
51849,Ntome_NODE_16055_length_1535_cov_18,Nsylvestris_NODE_6101_length_2737_cov_164,95.652,1495,62,2,1,1492,537,2031,0,2398,1491,1494
51854,Ntome_NODE_16058_length_1534_cov_269,Nsylvestris_NODE_11559_length_1923_cov_179,94.049,1546,63,16,1,1534,233,1761,0,2318,1533,1528
51863,Ntome_NODE_16062_length_1534_cov_192,Nsylvestris_NODE_18795_length_1202_cov_177,91.346,1144,47,9,165,1302,1147,50,0,1517,1137,1097
51896,Ntome_NODE_16076_length_1532_cov_40,Nsylvestris_NODE_22446_length_925_cov_80,81.882,287,42,8,670,951,375,656,3.69E-60,233,281,281
51897,Ntome_NODE_16077_length_1533_cov_25,Nsylvestris_NODE_14410_length_1609_cov_127,92.524,1351,82,8,148,1484,39,1384,0,1917,1336,1345
51939,Ntome_NODE_16093_length_1532_cov_5,Nsylvestris_NODE_12189_length_1849_cov_44,95.35,1527,66,5,9,1532,1741,217,0,2422,1523,1524
51950,Ntome_NODE_16097_length_1531_cov_265,Nsylvestris_NODE_27699_length_642_cov_5,92.835,656,29,6,114,765,642,1,0,935,651,641
51951,Ntome_NODE_16098_length_1531_cov_258,Nsylvestris_NODE_18035_length_1265_cov_66,95.78,1256,36,11,47,1288,1253,1,0,2010,1241,1252
52042,Ntome_NODE_16137_length_1527_cov_261,Nsylvestris_NODE_16153_length_1434_cov_220,94.788,1439,57,10,87,1513,1433,1,0,2226,1426,1432
52072,Ntome_NODE_16150_length_1526_cov_193,Nsylvestris_NODE_14342_length_1615_cov_211,91.505,1542,97,18,1,1523,34,1560,0,2091,1522,1526
52171,Ntome_NODE_16193_length_1521_cov_265,Nsylvestris_NODE_15786_length_1471_cov_201,93.333,1425,60,9,4,1402,56,1471,0,2073,1398,1415
52172,Ntome_NODE_16194_length_1521_cov_238,Nsylvestris_NODE_16920_length_1363_cov_187,94.254,1340,50,13,118,1443,1327,1,0,2023,1325,1326
52191,Ntome_NODE_16202_length_1521_cov_39,Nsylvestris_NODE_18025_length_1266_cov_21,94.239,1215,67,2,227,1438,1219,5,0,1853,1211,1214
52257,Ntome_NODE_16228_length_1518_cov_243,Nsylvestris_NODE_16881_length_1366_cov_85,91.783,1363,68,22,57,1407,2,1332,0,1857,1350,1330
52328,Ntome_NODE_16257_length_1516_cov_98,Nsylvestris_NODE_23228_length_877_cov_26,92.281,881,44,6,233,1093,1,877,0,1229,860,876
52337,Ntome_NODE_16262_length_1515_cov_224,Nsylvestris_NODE_17272_length_1334_cov_218,91.673,1297,87,12,124,1415,54,1334,0,1777,1291,1280
52365,Ntome_NODE_16274_length_1514_cov_278,Nsylvestris_NODE_15541_length_1497_cov_205,92.516,1443,69,16,1,1440,1454,48,0,2030,1439,1406
52420,Ntome_NODE_16298_length_1512_cov_130,Nsylvestris_NODE_14383_length_1612_cov_25,91.906,1495,92,13,29,1512,1612,136,0,2063,1483,1476
52432,Ntome_NODE_16303_length_1512_cov_62,Nsylvestris_NODE_16691_length_1382_cov_28,93.463,1392,66,7,46,1436,1374,7,0,2043,1390,1367
52512,Ntome_NODE_16332_length_1510_cov_81,Nsylvestris_NODE_14857_length_1564_cov_186,94.806,1444,58,9,1,1436,128,1562,0,2235,1435,1434
52533,Ntome_NODE_16340_length_1509_cov_148,Nsylvestris_NODE_15854_length_1463_cov_196,94.354,1470,45,13,68,1506,1,1463,0,2220,1438,1462
52551,Ntome_NODE_16348_length_1509_cov_20,Nsylvestris_NODE_14393_length_1611_cov_35,93.305,1434,78,14,3,1428,1466,43,0,2100,1425,1423
52570,Ntome_NODE_16355_length_1508_cov_229,Nsylvestris_NODE_18758_length_1205_cov_187,96.231,902,30,3,449,1350,266,1163,0,1474,901,897
52622,Ntome_NODE_16372_length_1507_cov_165,Nsylvestris_NODE_33879_length_326_cov_3,88.327,257,19,6,683,930,313,59,1.27E-79,298,247,254
52656,Ntome_NODE_16385_length_1506_cov_230,Nsylvestris_NODE_17339_length_1328_cov_167,93.622,1270,50,6,214,1481,88,1328,0,1868,1267,1240
52700,Ntome_NODE_16404_length_1505_cov_10,Nsylvestris_NODE_28117_length_624_cov_6,96.491,627,19,1,454,1080,1,624,0,1033,626,623
52743,Ntome_NODE_16422_length_1503_cov_127,Nsylvestris_NODE_16944_length_1361_cov_67,93.5,1277,69,10,188,1452,7,1281,0,1886,1264,1274
52755,Ntome_NODE_16427_length_1503_cov_18,Nsylvestris_NODE_15700_length_1480_cov_79,94.01,1369,70,8,3,1364,68,1431,0,2063,1361,1363
52784,Ntome_NODE_16443_length_1501_cov_238,Nsylvestris_NODE_14272_length_1622_cov_192,94.97,1491,53,15,11,1493,136,1612,0,2318,1482,1476
52792,Ntome_NODE_16447_length_1501_cov_154,Nsylvestris_NODE_17118_length_1347_cov_42,91.205,1319,103,7,67,1385,42,1347,0,1781,1318,1305
52823,Ntome_NODE_16461_length_1500_cov_76,Nsylvestris_NODE_23386_length_867_cov_29,94.499,818,39,3,230,1044,5,819,0,1256,814,814
52870,Ntome_NODE_16476_length_1498_cov_227,Nsylvestris_NODE_15420_length_1510_cov_218,93.667,1500,67,16,8,1498,1508,28,0,2218,1490,1480
52882,Ntome_NODE_16481_length_1498_cov_98,Nsylvestris_NODE_16319_length_1417_cov_50,93.849,1203,51,7,45,1234,46,1238,0,1790,1189,1192
52891,Ntome_NODE_16484_length_1497_cov_300,Nsylvestris_NODE_14560_length_1593_cov_198,95.917,1445,42,6,10,1446,10,1445,0,2326,1436,1435
52892,Ntome_NODE_16485_length_1497_cov_271,Nsylvestris_NODE_13880_length_1665_cov_204,95.361,1509,44,10,1,1497,67,1561,0,2375,1496,1494
52942,Ntome_NODE_16503_length_1496_cov_162,Nsylvestris_NODE_15999_length_1449_cov_144,93.191,1454,79,14,53,1491,1,1449,0,2119,1438,1448
53015,Ntome_NODE_16532_length_1493_cov_265,Nsylvestris_NODE_15103_length_1540_cov_198,92.55,1396,68,18,70,1451,1376,3,0,1969,1381,1373
53016,Ntome_NODE_16533_length_1493_cov_234,Nsylvestris_NODE_18331_length_1238_cov_227,93.95,1157,48,13,21,1156,1204,49,0,1729,1135,1155
53031,Ntome_NODE_16537_length_1493_cov_210,Nsylvestris_NODE_15952_length_1454_cov_223,90.973,1285,101,6,160,1444,1407,138,0,1716,1284,1269
53038,Ntome_NODE_16541_length_1493_cov_99,Nsylvestris_NODE_17963_length_1271_cov_75,92.801,1014,54,5,367,1371,1081,78,0,1450,1004,1003
53057,Ntome_NODE_16551_length_1492_cov_10,Nsylvestris_NODE_14418_length_1609_cov_26,95.007,1402,56,6,1,1389,93,1493,0,2189,1388,1400
53182,Ntome_NODE_16610_length_1485_cov_264,Nsylvestris_NODE_14761_length_1573_cov_214,93.542,1471,51,17,22,1459,1525,66,0,2150,1437,1459
53190,Ntome_NODE_16613_length_1485_cov_142,Nsylvestris_NODE_15826_length_1466_cov_158,91.892,1369,73,14,114,1482,55,1385,0,1879,1368,1330
53245,Ntome_NODE_16637_length_1483_cov_14,Nsylvestris_NODE_7120_length_2550_cov_62,97.367,1481,39,0,3,1483,2169,689,0,2519,1480,1480
53328,Ntome_NODE_16666_length_1480_cov_71,Nsylvestris_NODE_15266_length_1525_cov_13,94.881,1387,65,3,51,1435,27,1409,0,2163,1384,1382
53333,Ntome_NODE_16669_length_1479_cov_172,Nsylvestris_NODE_16553_length_1395_cov_151,91.753,1358,49,19,1,1311,1395,54,0,1829,1310,1341
53359,Ntome_NODE_16681_length_1478_cov_49,Nsylvestris_NODE_16115_length_1439_cov_10,90.593,489,44,1,121,607,8,496,0,647,486,488
53425,Ntome_NODE_16718_length_1475_cov_38,Nsylvestris_NODE_19249_length_1164_cov_22,86.402,831,83,13,186,995,1122,301,0,881,809,821
53488,Ntome_NODE_16742_length_1472_cov_20,Nsylvestris_NODE_30710_length_471_cov_2,90.726,496,16,9,860,1350,1,471,0,634,490,470
53494,Ntome_NODE_16745_length_1471_cov_285,Nsylvestris_NODE_15887_length_1461_cov_206,97.222,1188,25,2,129,1311,1409,225,0,2004,1182,1184
53499,Ntome_NODE_16747_length_1471_cov_104,Nsylvestris_NODE_35510_length_284_cov_3,92.281,285,20,2,639,922,284,1,2.55E-111,403,283,283
53540,Ntome_NODE_16762_length_1469_cov_238,Nsylvestris_NODE_11887_length_1881_cov_123,96.361,1319,31,3,1,1303,47,1364,0,2154,1302,1317
53550,Ntome_NODE_16765_length_1469_cov_126,Nsylvestris_NODE_16057_length_1444_cov_96,96.157,1405,49,3,65,1466,3,1405,0,2290,1401,1402
53570,Ntome_NODE_16773_length_1468_cov_272,Nsylvestris_NODE_16119_length_1437_cov_213,95.507,1291,50,7,140,1426,140,1426,0,2056,1286,1286
53575,Ntome_NODE_16776_length_1468_cov_182,Nsylvestris_NODE_19686_length_1128_cov_119,93.607,1048,56,6,3,1046,38,1078,0,1554,1043,1040
53581,Ntome_NODE_16780_length_1468_cov_77,Nsylvestris_NODE_16091_length_1441_cov_149,95.672,1109,48,0,46,1154,1109,1,0,1783,1108,1108
53584,Ntome_NODE_16782_length_1468_cov_32,Nsylvestris_NODE_31657_length_411_cov_3,95.62,411,18,0,80,490,411,1,0,660,410,410
53610,Ntome_NODE_16791_length_1467_cov_149,Nsylvestris_NODE_14209_length_1628_cov_143,97.825,1471,28,2,1,1467,119,1589,0,2536,1466,1470
53641,Ntome_NODE_16803_length_1465_cov_263,Nsylvestris_NODE_17224_length_1338_cov_206,94.829,1315,38,5,152,1465,1297,12,0,2025,1313,1285
53680,Ntome_NODE_16816_length_1464_cov_189,Nsylvestris_NODE_15126_length_1537_cov_88,95.77,922,39,0,543,1464,1076,155,0,1487,921,921
53688,Ntome_NODE_16820_length_1464_cov_59,Nsylvestris_NODE_14497_length_1600_cov_208,91.565,1470,91,14,1,1450,22,1478,0,1997,1449,1456
53697,Ntome_NODE_16823_length_1463_cov_178,Nsylvestris_NODE_15423_length_1510_cov_198,94.777,1436,58,6,1,1426,7,1435,0,2220,1425,1428
53726,Ntome_NODE_16834_length_1462_cov_50,Nsylvestris_NODE_14580_length_1591_cov_63,96.514,1463,49,2,1,1462,108,1569,0,2418,1461,1461
53770,Ntome_NODE_16852_length_1460_cov_249,Nsylvestris_NODE_18030_length_1265_cov_212,96.598,1205,37,2,147,1348,50,1253,0,1995,1201,1203
53789,Ntome_NODE_16860_length_1460_cov_22,Nsylvestris_NODE_15591_length_1492_cov_7,94.136,1313,63,9,158,1460,15,1323,0,1986,1302,1308
53790,Ntome_NODE_16861_length_1461_cov_12,Nsylvestris_NODE_13511_length_1705_cov_54,96.177,1465,49,6,1,1461,86,1547,0,2388,1460,1461
53794,Ntome_NODE_16865_length_1459_cov_241,Nsylvestris_NODE_13398_length_1717_cov_148,94.721,1326,51,6,36,1351,1711,395,0,2043,1315,1316
53845,Ntome_NODE_16888_length_1457_cov_277,Nsylvestris_NODE_17512_length_1312_cov_136,91.692,1300,90,11,68,1357,1311,20,0,1786,1289,1291
53875,Ntome_NODE_16902_length_1456_cov_219,Nsylvestris_NODE_16790_length_1373_cov_182,90.523,1224,85,17,87,1300,1368,166,0,1589,1213,1202
53957,Ntome_NODE_16929_length_1454_cov_69,Nsylvestris_NODE_30218_length_508_cov_6,94.892,509,20,2,815,1323,6,508,0,791,508,502
53988,Ntome_NODE_16940_length_1453_cov_134,Nsylvestris_NODE_16383_length_1411_cov_142,95.18,1307,43,11,163,1450,106,1411,0,2047,1287,1305
54008,Ntome_NODE_16951_length_1452_cov_265,Nsylvestris_NODE_15805_length_1469_cov_169,92.515,1376,68,18,71,1421,85,1450,0,1938,1350,1365
54036,Ntome_NODE_16966_length_1451_cov_236,Nsylvestris_NODE_17938_length_1273_cov_69,92.47,1235,68,13,184,1401,47,1273,0,1742,1217,1226
54037,Ntome_NODE_16967_length_1451_cov_222,Nsylvestris_NODE_15855_length_1463_cov_192,94.508,1402,62,9,36,1426,1398,1,0,2148,1390,1397
54059,Ntome_NODE_16975_length_1451_cov_85,Nsylvestris_NODE_15630_length_1487_cov_112,89.706,1428,92,23,1,1400,73,1473,0,1772,1399,1400
54090,Ntome_NODE_16990_length_1450_cov_74,Nsylvestris_NODE_16590_length_1392_cov_44,95.795,1403,36,12,1,1398,8,1392,0,2242,1397,1384
54100,Ntome_NODE_16995_length_1449_cov_166,Nsylvestris_NODE_20539_length_1062_cov_33,92.691,944,50,5,405,1334,55,993,0,1343,929,938
54119,Ntome_NODE_17002_length_1448_cov_254,Nsylvestris_NODE_16550_length_1395_cov_186,95.399,1304,49,6,141,1441,1339,44,0,2065,1300,1295
54126,Ntome_NODE_17005_length_1448_cov_103,Nsylvestris_NODE_10580_length_2040_cov_131,97.056,951,27,1,388,1337,580,1530,0,1600,949,950
54162,Ntome_NODE_17017_length_1447_cov_89,Nsylvestris_NODE_25040_length_769_cov_144,96.715,274,5,3,606,875,491,218,2.46E-126,453,269,273
54176,Ntome_NODE_17023_length_1446_cov_265,Nsylvestris_NODE_15142_length_1535_cov_214,94.078,1334,41,16,135,1446,1335,18,0,1991,1311,1317
54180,Ntome_NODE_17026_length_1446_cov_186,Nsylvestris_NODE_14498_length_1600_cov_204,95.783,1399,56,2,47,1445,154,1549,0,2254,1398,1395
54249,Ntome_NODE_17056_length_1443_cov_88,Nsylvestris_NODE_15963_length_1453_cov_192,95.963,1288,39,6,147,1432,1407,131,0,2078,1285,1276
54254,Ntome_NODE_17058_length_1443_cov_25,Nsylvestris_NODE_14870_length_1563_cov_190,80.925,173,28,5,225,393,176,347,1.30E-29,132,168,171
54319,Ntome_NODE_17080_length_1441_cov_114,Nsylvestris_NODE_17526_length_1311_cov_23,91.37,1321,73,21,102,1391,1,1311,0,1770,1289,1310
54387,Ntome_NODE_17114_length_1438_cov_87,Nsylvestris_NODE_11333_length_1948_cov_114,87.532,1171,88,23,53,1191,1193,49,0,1301,1138,1144
54432,Ntome_NODE_17134_length_1437_cov_8,Nsylvestris_NODE_14773_length_1573_cov_25,95.49,1419,59,3,16,1433,2,1416,0,2261,1417,1414
54608,Ntome_NODE_17199_length_1430_cov_74,Nsylvestris_NODE_35054_length_294_cov_3,94.898,294,15,0,833,1126,294,1,1.45E-128,460,293,293
54660,Ntome_NODE_17221_length_1428_cov_97,Nsylvestris_NODE_23680_length_850_cov_6,83.106,367,49,7,1035,1389,699,334,7.13E-87,322,354,365
54786,Ntome_NODE_17275_length_1422_cov_253,Nsylvestris_NODE_16961_length_1360_cov_23,93.684,1045,66,0,298,1342,1095,51,0,1565,1044,1044
54818,Ntome_NODE_17290_length_1421_cov_102,Nsylvestris_NODE_16568_length_1394_cov_113,95.424,1180,39,5,7,1178,1,1173,0,1866,1171,1172
54832,Ntome_NODE_17297_length_1420_cov_240,Nsylvestris_NODE_16302_length_1418_cov_154,90.943,1082,55,12,64,1114,9,1078,0,1415,1050,1069
54833,Ntome_NODE_17298_length_1420_cov_228,Nsylvestris_NODE_16722_length_1379_cov_81,94.038,1258,63,10,173,1419,1337,81,0,1897,1246,1256
54837,Ntome_NODE_17301_length_1420_cov_160,Nsylvestris_NODE_15322_length_1520_cov_27,93.433,670,36,3,393,1061,802,1464,0,987,668,662
54953,Ntome_NODE_17357_length_1416_cov_25,Nsylvestris_NODE_29612_length_559_cov_3,93.173,498,33,1,889,1386,62,558,0,730,497,496
55042,Ntome_NODE_17398_length_1412_cov_63,Nsylvestris_NODE_27843_length_636_cov_12,86.19,420,45,8,68,480,24,437,5.18E-123,442,412,413
55049,Ntome_NODE_17401_length_1412_cov_24,Nsylvestris_NODE_33311_length_342_cov_8,91.768,328,22,2,871,1194,342,16,8.61E-126,451,323,326
55100,Ntome_NODE_17421_length_1411_cov_111,Nsylvestris_NODE_17041_length_1354_cov_24,95.174,1181,48,6,47,1221,1235,58,0,1857,1174,1177
55124,Ntome_NODE_17431_length_1409_cov_115,Nsylvestris_NODE_14679_length_1581_cov_147,94.264,1046,57,3,1,1045,55,1098,0,1596,1044,1043
55125,Ntome_NODE_17432_length_1409_cov_82,Nsylvestris_NODE_16595_length_1391_cov_211,96.04,1212,46,2,26,1237,1391,182,0,1971,1211,1209
55181,Ntome_NODE_17463_length_1406_cov_265,Nsylvestris_NODE_15212_length_1530_cov_195,93.38,1420,61,21,1,1406,52,1452,0,2071,1405,1400
55192,Ntome_NODE_17467_length_1406_cov_172,Nsylvestris_NODE_17703_length_1294_cov_59,93.937,1270,77,0,105,1374,1,1270,0,1919,1269,1269
55241,Ntome_NODE_17488_length_1404_cov_270,Nsylvestris_NODE_16630_length_1388_cov_190,94.349,1398,62,9,1,1391,1,1388,0,2128,1390,1387
55265,Ntome_NODE_17498_length_1404_cov_6,Nsylvestris_NODE_30890_length_458_cov_7,96.507,458,16,0,494,951,458,1,0,758,457,457
55278,Ntome_NODE_17503_length_1403_cov_76,Nsylvestris_NODE_20109_length_1093_cov_116,96.332,1036,34,2,1,1033,13,1047,0,1700,1032,1034
55365,Ntome_NODE_17535_length_1399_cov_259,Nsylvestris_NODE_14423_length_1608_cov_152,95.227,1299,48,8,64,1359,1397,110,0,2043,1295,1287
55404,Ntome_NODE_17549_length_1398_cov_110,Nsylvestris_NODE_23020_length_889_cov_48,86.722,851,44,24,82,891,877,55,0,881,809,822
55455,Ntome_NODE_17568_length_1396_cov_92,Nsylvestris_NODE_4393_length_3128_cov_96,84.483,116,14,3,1057,1170,1026,1139,1.64E-23,111,113,113
55457,Ntome_NODE_17570_length_1396_cov_33,Nsylvestris_NODE_16927_length_1363_cov_15,95.158,1363,60,3,1,1357,1363,1,0,2146,1356,1362
55466,Ntome_NODE_17575_length_1395_cov_288,Nsylvestris_NODE_15080_length_1543_cov_181,92.415,1292,61,16,2,1277,1517,247,0,1808,1275,1270
55475,Ntome_NODE_17579_length_1395_cov_210,Nsylvestris_NODE_20035_length_1099_cov_151,92.115,1078,42,12,1,1069,1044,1,0,1480,1068,1043
55501,Ntome_NODE_17589_length_1394_cov_133,Nsylvestris_NODE_20260_length_1082_cov_34,95.481,1018,40,4,214,1229,1082,69,0,1620,1015,1013
55522,Ntome_NODE_17597_length_1394_cov_18,Nsylvestris_NODE_17923_length_1275_cov_35,93.064,1211,77,5,2,1211,35,1239,0,1764,1209,1204
55526,Ntome_NODE_17600_length_1394_cov_7,Nsylvestris_NODE_23944_length_836_cov_4,96.292,836,31,0,273,1108,836,1,0,1373,835,835
55537,Ntome_NODE_17604_length_1393_cov_221,Nsylvestris_NODE_19656_length_1130_cov_207,94.711,1021,51,2,243,1263,1068,51,0,1583,1020,1017
55544,Ntome_NODE_17607_length_1393_cov_87,Nsylvestris_NODE_29553_length_561_cov_12,78.696,230,40,5,137,360,49,275,1.61E-33,145,223,226
55564,Ntome_NODE_17615_length_1392_cov_61,Nsylvestris_NODE_17591_length_1304_cov_157,94.768,1166,59,2,214,1378,96,1260,0,1814,1164,1164
55639,Ntome_NODE_17645_length_1389_cov_49,Nsylvestris_NODE_37098_length_250_cov_1,97.794,136,3,0,1008,1143,20,155,9.29E-61,235,135,135
55695,Ntome_NODE_17664_length_1387_cov_25,Nsylvestris_NODE_16705_length_1381_cov_22,95.977,1367,51,2,1,1367,1369,7,0,2217,1366,1362
55700,Ntome_NODE_17666_length_1387_cov_20,Nsylvestris_NODE_15166_length_1534_cov_47,94.317,1390,53,7,1,1384,1396,27,0,2106,1383,1369
55716,Ntome_NODE_17674_length_1386_cov_83,Nsylvestris_NODE_16739_length_1377_cov_208,93.285,1236,78,5,16,1249,89,1321,0,1818,1233,1232
55728,Ntome_NODE_17678_length_1386_cov_14,Nsylvestris_NODE_36605_length_260_cov_2,89.231,260,27,1,608,867,259,1,1.92E-87,324,259,258
55818,Ntome_NODE_17714_length_1382_cov_204,Nsylvestris_NODE_20477_length_1066_cov_148,89.645,1043,72,12,282,1323,57,1064,0,1295,1041,1007
55823,Ntome_NODE_17717_length_1382_cov_156,Nsylvestris_NODE_12426_length_1823_cov_138,93.21,1296,64,4,57,1333,195,1485,0,1884,1276,1290
55961,Ntome_NODE_17769_length_1377_cov_115,Nsylvestris_NODE_18129_length_1256_cov_59,89.168,1274,59,28,107,1345,4,1233,0,1515,1238,1229
55988,Ntome_NODE_17781_length_1376_cov_231,Nsylvestris_NODE_17890_length_1277_cov_218,96.653,1255,42,0,90,1344,1,1255,0,2085,1254,1254
55995,Ntome_NODE_17784_length_1376_cov_114,Nsylvestris_NODE_18186_length_1251_cov_205,94.477,1195,54,6,53,1241,1204,16,0,1831,1188,1188
56013,Ntome_NODE_17793_length_1375_cov_159,Nsylvestris_NODE_11782_length_1895_cov_172,94.809,1098,54,1,9,1103,423,1520,0,1709,1094,1097
56043,Ntome_NODE_17806_length_1374_cov_48,Nsylvestris_NODE_16510_length_1399_cov_27,91.089,1313,55,20,5,1274,79,1372,0,1720,1269,1293
56068,Ntome_NODE_17818_length_1373_cov_82,Nsylvestris_NODE_17353_length_1327_cov_79,91.762,1311,62,20,1,1290,1325,40,0,1781,1289,1285
56069,Ntome_NODE_17819_length_1373_cov_48,Nsylvestris_NODE_14507_length_1599_cov_136,96.8,1375,28,5,1,1373,71,1431,0,2281,1372,1360
56131,Ntome_NODE_17842_length_1371_cov_269,Nsylvestris_NODE_17451_length_1318_cov_181,91.25,1280,53,16,78,1338,27,1266,0,1688,1260,1239
56166,Ntome_NODE_17856_length_1370_cov_211,Nsylvestris_NODE_16108_length_1439_cov_106,96.88,1282,33,5,1,1276,1281,1,0,2139,1275,1280
56167,Ntome_NODE_17857_length_1370_cov_205,Nsylvestris_NODE_19436_length_1149_cov_180,95.462,1146,44,5,132,1272,1,1143,0,1821,1140,1142
56174,Ntome_NODE_17860_length_1370_cov_114,Nsylvestris_NODE_36518_length_262_cov_3,96.109,257,10,0,646,902,6,262,2.36E-116,420,256,256
56177,Ntome_NODE_17862_length_1370_cov_72,Nsylvestris_NODE_24034_length_830_cov_61,93.564,606,36,1,668,1270,50,655,0,900,602,605
56183,Ntome_NODE_17865_length_1370_cov_9,Nsylvestris_NODE_35021_length_295_cov_3,93.421,304,11,2,656,959,295,1,5.03E-123,442,303,294
56256,Ntome_NODE_17892_length_1367_cov_141,Nsylvestris_NODE_16931_length_1362_cov_172,92.188,1216,79,10,108,1318,1208,4,0,1705,1210,1204
56257,Ntome_NODE_17893_length_1367_cov_88,Nsylvestris_NODE_16609_length_1390_cov_209,92.53,1352,56,17,8,1318,1,1348,0,1895,1310,1347
56294,Ntome_NODE_17910_length_1365_cov_231,Nsylvestris_NODE_8123_length_2384_cov_47,96.524,633,22,0,363,995,2178,1546,0,1048,632,632
56331,Ntome_NODE_17926_length_1364_cov_228,Nsylvestris_NODE_16552_length_1395_cov_172,93.765,1267,66,10,102,1364,53,1310,0,1890,1262,1257
56388,Ntome_NODE_17950_length_1363_cov_23,Nsylvestris_NODE_16943_length_1355_cov_115,96.755,1325,43,0,1,1325,1345,21,0,2209,1324,1324
56417,Ntome_NODE_17965_length_1361_cov_84,Nsylvestris_NODE_18289_length_1242_cov_35,93.621,1160,35,11,221,1350,1152,2,0,1696,1129,1150
56422,Ntome_NODE_17967_length_1361_cov_45,Nsylvestris_NODE_33807_length_328_cov_2,96.951,328,10,0,546,873,1,328,7.95E-156,551,327,327
56423,Ntome_NODE_17968_length_1361_cov_30,Nsylvestris_NODE_25013_length_771_cov_8,89.535,774,46,15,81,822,1,771,0,948,741,770
56459,Ntome_NODE_17982_length_1360_cov_8,Nsylvestris_NODE_15078_length_1544_cov_30,92.962,952,54,7,392,1339,574,1516,0,1375,947,942
56471,Ntome_NODE_17988_length_1358_cov_246,Nsylvestris_NODE_9847_length_2134_cov_196,92.264,1047,59,13,11,1052,1045,2074,0,1465,1041,1029
56517,Ntome_NODE_18014_length_1357_cov_287,Nsylvestris_NODE_17981_length_1269_cov_209,95.336,1222,43,5,102,1309,1222,1,0,1929,1207,1221
56570,Ntome_NODE_18034_length_1355_cov_149,Nsylvestris_NODE_18786_length_1203_cov_159,94.587,1016,52,2,9,1022,1057,43,0,1568,1013,1014
56592,Ntome_NODE_18044_length_1354_cov_129,Nsylvestris_NODE_16756_length_1373_cov_144,95.715,1237,43,5,119,1346,38,1273,0,1982,1227,1235
56606,Ntome_NODE_18052_length_1354_cov_19,Nsylvestris_NODE_33596_length_334_cov_4,92.72,261,19,0,50,310,261,1,1.42E-103,377,260,260
56659,Ntome_NODE_18078_length_1351_cov_233,Nsylvestris_NODE_18335_length_1238_cov_181,94.528,1133,52,6,198,1323,1185,56,0,1740,1125,1129
56683,Ntome_NODE_18089_length_1350_cov_255,Nsylvestris_NODE_17721_length_1292_cov_206,95.628,892,35,1,86,977,1,888,0,1428,891,887
56736,Ntome_NODE_18113_length_1349_cov_149,Nsylvestris_NODE_6864_length_2592_cov_57,85.088,456,50,6,65,503,2069,1615,2.96E-125,449,438,454
56815,Ntome_NODE_18149_length_1347_cov_27,Nsylvestris_NODE_11975_length_1873_cov_168,96.151,1273,45,1,75,1347,1326,58,0,2076,1272,1268
56922,Ntome_NODE_18195_length_1343_cov_26,Nsylvestris_NODE_32675_length_365_cov_1,90.489,368,32,3,270,637,1,365,2.90E-135,483,367,364
56926,Ntome_NODE_18197_length_1342_cov_286,Nsylvestris_NODE_17590_length_1304_cov_159,93.475,1318,38,7,48,1342,1,1293,0,1914,1294,1292
56930,Ntome_NODE_18199_length_1342_cov_283,Nsylvestris_NODE_11327_length_1948_cov_224,95.309,1002,47,0,209,1210,1470,469,0,1591,1001,1001
57038,Ntome_NODE_18243_length_1339_cov_117,Nsylvestris_NODE_17652_length_1298_cov_106,91.93,1264,69,21,12,1254,1292,41,0,1738,1242,1251
57039,Ntome_NODE_18244_length_1339_cov_60,Nsylvestris_NODE_25141_length_764_cov_8,82.906,351,60,0,418,768,414,764,3.11E-85,316,350,350
57211,Ntome_NODE_18312_length_1332_cov_277,Nsylvestris_NODE_18761_length_1205_cov_167,93.451,1191,66,6,153,1332,1197,8,0,1757,1179,1189
57223,Ntome_NODE_18318_length_1332_cov_126,Nsylvestris_NODE_20500_length_1064_cov_258,86.889,450,53,6,520,965,3,450,2.86E-140,499,445,447
57261,Ntome_NODE_18335_length_1331_cov_236,Nsylvestris_NODE_17235_length_1337_cov_188,94.804,1251,59,3,42,1289,1,1248,0,1945,1247,1247
57298,Ntome_NODE_18354_length_1329_cov_272,Nsylvestris_NODE_20196_length_1087_cov_32,91.805,903,58,12,292,1179,175,1076,0,1243,887,901
57313,Ntome_NODE_18362_length_1329_cov_71,Nsylvestris_NODE_17274_length_1334_cov_201,94.406,1287,64,4,1,1283,15,1297,0,1971,1282,1282
57322,Ntome_NODE_18365_length_1329_cov_15,Nsylvestris_NODE_20935_length_1033_cov_63,95.475,906,36,3,380,1280,994,89,0,1441,900,905
57344,Ntome_NODE_18375_length_1328_cov_22,Nsylvestris_NODE_9099_length_2237_cov_96,96.758,987,32,0,298,1284,1361,375,0,1646,986,986
57384,Ntome_NODE_18395_length_1326_cov_219,Nsylvestris_NODE_17723_length_1292_cov_158,94.856,1283,50,6,23,1289,1292,10,0,1989,1266,1282
57389,Ntome_NODE_18398_length_1326_cov_21,Nsylvestris_NODE_18564_length_1219_cov_53,93.437,1219,67,4,23,1228,1,1219,0,1796,1205,1218
57404,Ntome_NODE_18405_length_1325_cov_43,Nsylvestris_NODE_18659_length_1213_cov_31,92.938,1147,59,8,143,1274,1150,11,0,1650,1131,1139
57451,Ntome_NODE_18426_length_1323_cov_229,Nsylvestris_NODE_14704_length_1579_cov_41,94.205,1277,47,13,61,1323,1491,228,0,1923,1262,1263
57454,Ntome_NODE_18428_length_1323_cov_111,Nsylvestris_NODE_16612_length_1390_cov_145,88.93,1355,71,13,1,1306,1330,6,0,1598,1305,1324
57465,Ntome_NODE_18434_length_1322_cov_266,Nsylvestris_NODE_18147_length_1254_cov_190,95.05,1212,45,10,105,1306,36,1242,0,1892,1201,1206
57469,Ntome_NODE_18436_length_1322_cov_162,Nsylvestris_NODE_19050_length_1179_cov_182,88.207,1255,49,28,27,1260,1177,1,0,1406,1233,1176
57557,Ntome_NODE_18471_length_1319_cov_190,Nsylvestris_NODE_19206_length_1167_cov_195,92.268,957,74,0,237,1193,1015,59,0,1358,956,956
57612,Ntome_NODE_18494_length_1317_cov_222,Nsylvestris_NODE_16519_length_1398_cov_122,95.37,1296,46,7,15,1298,1,1294,0,2049,1283,1293
57633,Ntome_NODE_18505_length_1316_cov_259,Nsylvestris_NODE_16857_length_1367_cov_194,93.286,1266,68,9,51,1316,1,1249,0,1851,1265,1248
57691,Ntome_NODE_18530_length_1314_cov_18,Nsylvestris_NODE_14435_length_1607_cov_45,96.071,1120,44,0,1,1120,1346,227,0,1825,1119,1119
57699,Ntome_NODE_18536_length_1313_cov_10,Nsylvestris_NODE_8070_length_2392_cov_29,92.639,1345,67,8,1,1313,1746,402,0,1906,1312,1344
57739,Ntome_NODE_18554_length_1311_cov_189,Nsylvestris_NODE_23700_length_849_cov_9,93.176,850,52,6,139,983,849,1,0,1243,844,848
57747,Ntome_NODE_18559_length_1311_cov_104,Nsylvestris_NODE_15288_length_1522_cov_118,92.268,1151,80,6,116,1264,1522,379,0,1624,1148,1143
57753,Ntome_NODE_18561_length_1311_cov_44,Nsylvestris_NODE_31054_length_448_cov_5,87.742,465,30,11,808,1262,1,448,7.76E-146,518,454,447
57767,Ntome_NODE_18568_length_1311_cov_19,Nsylvestris_NODE_18144_length_1255_cov_13,84.675,1292,119,28,41,1290,1,1255,0,1216,1249,1254
57798,Ntome_NODE_18583_length_1309_cov_270,Nsylvestris_NODE_17813_length_1285_cov_171,94.01,1202,61,7,62,1257,1285,89,0,1810,1195,1196
57799,Ntome_NODE_18584_length_1309_cov_267,Nsylvestris_NODE_15046_length_1546_cov_221,96.337,1092,37,2,214,1303,1099,9,0,1792,1089,1090
57830,Ntome_NODE_18601_length_1308_cov_202,Nsylvestris_NODE_17175_length_1342_cov_88,92.914,1129,54,14,131,1258,1160,57,0,1618,1127,1103
57859,Ntome_NODE_18611_length_1307_cov_265,Nsylvestris_NODE_9165_length_2228_cov_179,93.772,578,23,3,692,1259,1534,2108,0,856,567,574
57899,Ntome_NODE_18630_length_1305_cov_278,Nsylvestris_NODE_17852_length_1281_cov_218,96.822,1227,31,6,9,1234,1264,45,0,2043,1225,1219
57915,Ntome_NODE_18638_length_1305_cov_106,Nsylvestris_NODE_17824_length_1284_cov_70,95.133,1089,41,5,50,1129,1092,7,0,1707,1079,1085
57928,Ntome_NODE_18645_length_1304_cov_265,Nsylvestris_NODE_19037_length_1180_cov_226,95.782,1138,37,3,27,1163,53,1180,0,1825,1136,1127
57955,Ntome_NODE_18656_length_1304_cov_104,Nsylvestris_NODE_15360_length_1517_cov_41,93.394,1105,70,3,151,1254,249,1351,0,1633,1103,1102
57993,Ntome_NODE_18674_length_1302_cov_282,Nsylvestris_NODE_18787_length_1203_cov_147,90.73,1165,50,19,133,1251,51,1203,0,1500,1118,1152
58018,Ntome_NODE_18687_length_1302_cov_29,Nsylvestris_NODE_16897_length_1365_cov_87,90.625,1280,61,15,1,1252,1310,62,0,1644,1251,1248
58022,Ntome_NODE_18689_length_1302_cov_20,Nsylvestris_NODE_23497_length_860_cov_10,96.144,804,31,0,6,809,804,1,0,1314,803,803
58105,Ntome_NODE_18723_length_1298_cov_145,Nsylvestris_NODE_17028_length_1355_cov_75,92.112,1179,81,6,79,1253,1350,180,0,1652,1174,1170
58106,Ntome_NODE_18724_length_1298_cov_127,Nsylvestris_NODE_20749_length_1046_cov_185,93.361,964,42,11,38,987,28,983,0,1406,949,955
58137,Ntome_NODE_18741_length_1297_cov_46,Nsylvestris_NODE_27225_length_663_cov_60,91.084,415,23,5,524,937,49,450,2.72E-155,549,413,401
58143,Ntome_NODE_18744_length_1296_cov_210,Nsylvestris_NODE_19495_length_1144_cov_25,94.159,1147,37,14,117,1236,1144,1,0,1720,1119,1143
58144,Ntome_NODE_18745_length_1296_cov_139,Nsylvestris_NODE_31609_length_414_cov_3,85.39,397,49,7,387,781,390,1,2.24E-111,403,394,389
58145,Ntome_NODE_18746_length_1296_cov_113,Nsylvestris_NODE_14745_length_1575_cov_81,95.734,1172,28,11,54,1222,423,1575,0,1868,1168,1152
58146,Ntome_NODE_18747_length_1296_cov_40,Nsylvestris_NODE_32847_length_358_cov_10,91.808,354,14,11,62,415,358,20,3.62E-134,479,353,338
58147,Ntome_NODE_18749_length_1296_cov_29,Nsylvestris_NODE_23827_length_842_cov_12,80.534,262,49,2,117,378,698,439,3.16E-50,200,261,259
58172,Ntome_NODE_18760_length_1295_cov_56,Nsylvestris_NODE_12008_length_1869_cov_17,84.054,1041,158,6,53,1092,255,1288,0,996,1039,1033
58196,Ntome_NODE_18771_length_1294_cov_231,Nsylvestris_NODE_17903_length_1276_cov_186,92.054,1271,69,13,17,1261,1276,12,0,1759,1244,1264
58199,Ntome_NODE_18773_length_1294_cov_101,Nsylvestris_NODE_18714_length_1208_cov_95,91.852,1166,70,12,70,1217,1159,1,0,1604,1147,1158
58203,Ntome_NODE_18775_length_1294_cov_65,Nsylvestris_NODE_30336_length_499_cov_6,91.617,501,17,5,190,667,1,499,0,669,477,498
58263,Ntome_NODE_18797_length_1292_cov_12,Nsylvestris_NODE_20419_length_1070_cov_84,93.908,952,33,12,247,1174,71,1021,0,1413,927,950
58368,Ntome_NODE_18841_length_1288_cov_19,Nsylvestris_NODE_25715_length_733_cov_16,94.058,690,26,2,373,1059,678,1,0,1033,686,677
58419,Ntome_NODE_18861_length_1287_cov_8,Nsylvestris_NODE_14565_length_1593_cov_31,86.279,1188,97,21,3,1151,328,1488,0,1230,1148,1160
58498,Ntome_NODE_18892_length_1284_cov_200,Nsylvestris_NODE_15510_length_1501_cov_48,91.076,874,66,6,246,1111,81,950,0,1171,865,869
58555,Ntome_NODE_18920_length_1282_cov_136,Nsylvestris_NODE_16879_length_1366_cov_134,89.837,1289,69,23,1,1252,68,1331,0,1598,1251,1263
58584,Ntome_NODE_18931_length_1282_cov_8,Nsylvestris_NODE_19078_length_1177_cov_79,93.678,949,48,2,297,1236,1051,106,0,1410,939,945
58603,Ntome_NODE_18939_length_1281_cov_209,Nsylvestris_NODE_18069_length_1262_cov_103,96.548,956,29,2,192,1147,1214,263,0,1580,955,951
58651,Ntome_NODE_18952_length_1280_cov_250,Nsylvestris_NODE_17187_length_1341_cov_215,95.185,1163,52,2,47,1209,1221,63,0,1834,1162,1158
58655,Ntome_NODE_18954_length_1280_cov_221,Nsylvestris_NODE_19910_length_1109_cov_214,95.508,1024,38,5,223,1240,1057,36,0,1629,1017,1021
58680,Ntome_NODE_18967_length_1279_cov_134,Nsylvestris_NODE_18334_length_1238_cov_182,92.931,1061,48,6,219,1262,1053,3,0,1519,1043,1050
58687,Ntome_NODE_18971_length_1279_cov_6,Nsylvestris_NODE_17966_length_1271_cov_13,95.202,792,35,1,4,795,789,1,0,1249,791,788
58704,Ntome_NODE_18977_length_1278_cov_200,Nsylvestris_NODE_19122_length_1174_cov_45,94.332,1182,57,1,63,1244,1172,1,0,1803,1181,1171
58782,Ntome_NODE_19012_length_1275_cov_75,Nsylvestris_NODE_21715_length_976_cov_70,94.365,976,42,7,54,1017,2,976,0,1485,963,974
58829,Ntome_NODE_19034_length_1273_cov_202,Nsylvestris_NODE_16436_length_1406_cov_157,95.341,1159,47,5,47,1203,233,1386,0,1834,1156,1153
58830,Ntome_NODE_19035_length_1273_cov_194,Nsylvestris_NODE_19223_length_1166_cov_63,86.043,652,59,19,38,664,200,844,0,671,626,644
58841,Ntome_NODE_19039_length_1273_cov_97,Nsylvestris_NODE_16676_length_1383_cov_93,94.204,1225,54,5,56,1272,1330,115,0,1853,1216,1215
58983,Ntome_NODE_19106_length_1267_cov_29,Nsylvestris_NODE_14705_length_1579_cov_29,93.14,1239,55,12,1,1211,300,1536,0,1790,1210,1236
59006,Ntome_NODE_19116_length_1266_cov_213,Nsylvestris_NODE_29762_length_548_cov_146,95.775,497,18,1,394,887,497,1,0,798,493,496
59061,Ntome_NODE_19137_length_1264_cov_215,Nsylvestris_NODE_20649_length_1054_cov_149,87.226,822,85,8,345,1146,867,46,0,918,801,821
59062,Ntome_NODE_19138_length_1264_cov_203,Nsylvestris_NODE_19221_length_1166_cov_78,87.903,1149,63,29,93,1226,27,1114,0,1282,1133,1087
59110,Ntome_NODE_19158_length_1262_cov_276,Nsylvestris_NODE_18858_length_1196_cov_210,93.069,1111,57,12,11,1109,55,1157,0,1607,1098,1102
59119,Ntome_NODE_19162_length_1262_cov_235,Nsylvestris_NODE_19632_length_1132_cov_219,90.771,1116,81,10,1,1101,1109,1,0,1471,1100,1108
59140,Ntome_NODE_19171_length_1262_cov_27,Nsylvestris_NODE_19983_length_1104_cov_13,95.29,1104,52,0,159,1262,1,1104,0,1751,1103,1103
59194,Ntome_NODE_19193_length_1260_cov_193,Nsylvestris_NODE_19731_length_1124_cov_181,91.949,1093,66,11,1,1084,1080,1,0,1511,1083,1079
59206,Ntome_NODE_19198_length_1260_cov_41,Nsylvestris_NODE_18527_length_1222_cov_23,91.424,1201,40,14,1,1171,1168,1,0,1589,1170,1167
59233,Ntome_NODE_19211_length_1259_cov_24,Nsylvestris_NODE_25746_length_731_cov_22,92.075,694,43,4,10,701,730,47,0,966,691,683
59249,Ntome_NODE_19217_length_1258_cov_258,Nsylvestris_NODE_18656_length_1213_cov_70,93.48,1043,50,8,87,1119,95,1129,0,1533,1032,1034
59267,Ntome_NODE_19229_length_1257_cov_185,Nsylvestris_NODE_19141_length_1172_cov_164,91.976,1159,59,11,103,1240,1,1146,0,1594,1137,1145
59312,Ntome_NODE_19246_length_1256_cov_31,Nsylvestris_NODE_27016_length_673_cov_6,94.145,649,34,4,280,926,673,27,0,985,646,646
59332,Ntome_NODE_19254_length_1255_cov_159,Nsylvestris_NODE_19623_length_1133_cov_200,94.218,1055,51,6,75,1126,1,1048,0,1602,1051,1047
59422,Ntome_NODE_19291_length_1253_cov_9,Nsylvestris_NODE_34562_length_306_cov_3,92.763,304,22,0,471,774,306,3,1.65E-122,440,303,303
59424,Ntome_NODE_19293_length_1252_cov_242,Nsylvestris_NODE_18611_length_1216_cov_197,95.207,1210,50,5,3,1211,11,1213,0,1906,1208,1202
59474,Ntome_NODE_19316_length_1250_cov_251,Nsylvestris_NODE_19420_length_1150_cov_213,94.306,1124,53,5,82,1205,1,1113,0,1711,1123,1112
59475,Ntome_NODE_19317_length_1250_cov_251,Nsylvestris_NODE_7333_length_2515_cov_87,94.956,1031,47,1,64,1089,116,1146,0,1611,1025,1030
59560,Ntome_NODE_19346_length_1248_cov_20,Nsylvestris_NODE_21415_length_998_cov_22,93.918,1003,47,2,31,1033,998,10,0,1502,1002,988
59607,Ntome_NODE_19364_length_1246_cov_17,Nsylvestris_NODE_32763_length_361_cov_8,95.977,174,7,0,1048,1221,174,1,2.93E-75,283,173,173
59640,Ntome_NODE_19377_length_1245_cov_10,Nsylvestris_NODE_15071_length_1544_cov_195,93.902,1230,44,6,1,1227,1289,88,0,1827,1226,1201
59660,Ntome_NODE_19387_length_1243_cov_254,Nsylvestris_NODE_17197_length_1340_cov_198,95.423,874,31,4,379,1243,994,121,0,1384,864,873
59687,Ntome_NODE_19399_length_1242_cov_276,Nsylvestris_NODE_20043_length_1098_cov_214,92.439,1111,68,5,15,1124,1,1096,0,1572,1109,1095
59688,Ntome_NODE_19400_length_1242_cov_244,Nsylvestris_NODE_17449_length_1318_cov_212,91.771,1118,63,15,144,1233,1146,30,0,1528,1089,1116
59756,Ntome_NODE_19432_length_1239_cov_285,Nsylvestris_NODE_108_length_8357_cov_118,95.038,1169,56,2,73,1239,5093,6261,0,1836,1166,1168
59759,Ntome_NODE_19434_length_1239_cov_163,Nsylvestris_NODE_17601_length_1303_cov_93,92.624,1193,66,15,13,1191,1300,116,0,1696,1178,1184
59762,Ntome_NODE_19436_length_1239_cov_145,Nsylvestris_NODE_12330_length_1834_cov_88,92.444,675,29,7,105,762,1789,1120,0,944,657,669
59773,Ntome_NODE_19443_length_1239_cov_12,Nsylvestris_NODE_32733_length_363_cov_3,90.04,251,10,3,26,276,33,268,1.33E-83,311,250,235
59789,Ntome_NODE_19450_length_1238_cov_23,Nsylvestris_NODE_19484_length_1145_cov_11,95.494,1154,41,5,66,1217,1145,1,0,1832,1151,1144
59905,Ntome_NODE_19499_length_1234_cov_85,Nsylvestris_NODE_22471_length_924_cov_28,92.372,839,28,10,295,1106,90,919,0,1162,811,829
59934,Ntome_NODE_19510_length_1233_cov_103,Nsylvestris_NODE_20223_length_1084_cov_105,92.661,1090,64,12,152,1233,1083,2,0,1555,1081,1081
59939,Ntome_NODE_19513_length_1233_cov_55,Nsylvestris_NODE_14932_length_1557_cov_31,91.308,1254,70,11,10,1231,1311,65,0,1676,1221,1246
59955,Ntome_NODE_19519_length_1233_cov_12,Nsylvestris_NODE_18821_length_1200_cov_71,94.976,1035,49,1,116,1150,169,1200,0,1620,1034,1031
59999,Ntome_NODE_19540_length_1231_cov_42,Nsylvestris_NODE_14868_length_1563_cov_199,92.327,1225,94,0,7,1231,1511,287,0,1742,1224,1224
60019,Ntome_NODE_19549_length_1229_cov_289,Nsylvestris_NODE_17047_length_1353_cov_182,92.07,1198,65,9,1,1179,25,1211,0,1659,1178,1186
60023,Ntome_NODE_19551_length_1229_cov_105,Nsylvestris_NODE_16223_length_1427_cov_206,88.548,1205,95,14,12,1182,1275,80,0,1421,1170,1195
60036,Ntome_NODE_19555_length_1229_cov_10,Nsylvestris_NODE_17227_length_1338_cov_141,93.532,1175,41,8,59,1229,1263,120,0,1716,1170,1143
60040,Ntome_NODE_19559_length_1227_cov_287,Nsylvestris_NODE_17982_length_1269_cov_195,94.486,1215,54,8,1,1207,60,1269,0,1860,1206,1209
60144,Ntome_NODE_19605_length_1225_cov_231,Nsylvestris_NODE_20161_length_1089_cov_198,92.791,860,57,3,50,907,181,1037,0,1240,857,856
60150,Ntome_NODE_19609_length_1225_cov_124,Nsylvestris_NODE_19311_length_1160_cov_82,87.915,1175,55,31,43,1183,1,1122,0,1303,1140,1121
60176,Ntome_NODE_19618_length_1224_cov_59,Nsylvestris_NODE_27189_length_665_cov_101,96.97,33,1,0,175,207,563,595,6.82E-07,56.5,32,32
60197,Ntome_NODE_19628_length_1223_cov_291,Nsylvestris_NODE_18782_length_1203_cov_208,93.582,1044,55,3,48,1081,117,1158,0,1546,1033,1041
60246,Ntome_NODE_19648_length_1222_cov_61,Nsylvestris_NODE_20873_length_1037_cov_43,92.322,1042,51,11,117,1154,21,1037,0,1454,1037,1016
60363,Ntome_NODE_19691_length_1219_cov_21,Nsylvestris_NODE_13110_length_1750_cov_32,90.127,1185,99,11,1,1170,1567,386,0,1524,1169,1181
60476,Ntome_NODE_19736_length_1216_cov_46,Nsylvestris_NODE_30631_length_476_cov_29,87.374,198,12,2,115,311,360,175,1.06E-54,215,196,185
60485,Ntome_NODE_19740_length_1215_cov_235,Nsylvestris_NODE_19752_length_1122_cov_199,94.599,1111,42,8,8,1108,1109,7,0,1703,1100,1102
60514,Ntome_NODE_19754_length_1214_cov_140,Nsylvestris_NODE_16973_length_1359_cov_134,92.51,1215,47,18,16,1197,1359,156,0,1700,1181,1203
60515,Ntome_NODE_19755_length_1214_cov_59,Nsylvestris_NODE_35805_length_277_cov_4,93.385,257,15,2,828,1084,272,18,3.53E-104,379,256,254
60522,Ntome_NODE_19758_length_1213_cov_242,Nsylvestris_NODE_19936_length_1107_cov_160,94.713,1116,45,8,71,1181,1,1107,0,1722,1110,1106
60538,Ntome_NODE_19764_length_1213_cov_65,Nsylvestris_NODE_20258_length_1082_cov_67,94.1,1000,42,6,2,1001,1032,50,0,1504,999,982
60592,Ntome_NODE_19790_length_1211_cov_156,Nsylvestris_NODE_18982_length_1185_cov_181,85.493,1034,84,20,149,1153,53,1049,0,1018,1004,996
60644,Ntome_NODE_19809_length_1209_cov_141,Nsylvestris_NODE_7249_length_2527_cov_102,91.803,1159,63,14,50,1182,1367,2519,0,1585,1132,1152
60645,Ntome_NODE_19810_length_1209_cov_116,Nsylvestris_NODE_20841_length_1039_cov_26,92.906,1029,35,14,61,1071,1,1009,0,1461,1010,1008
60662,Ntome_NODE_19818_length_1208_cov_118,Nsylvestris_NODE_18839_length_1198_cov_116,93.656,1198,54,11,1,1190,9,1192,0,1772,1189,1183
60697,Ntome_NODE_19835_length_1207_cov_15,Nsylvestris_NODE_25615_length_739_cov_7,97.429,739,19,0,425,1163,739,1,0,1260,738,738
60765,Ntome_NODE_19868_length_1204_cov_10,Nsylvestris_NODE_16867_length_1367_cov_63,93.383,1209,54,13,4,1204,141,1331,0,1766,1200,1190
60824,Ntome_NODE_19893_length_1202_cov_10,Nsylvestris_NODE_37086_length_250_cov_3,93.574,249,12,3,242,487,1,248,7.57E-101,368,245,247
60965,Ntome_NODE_19947_length_1196_cov_237,Nsylvestris_NODE_21814_length_968_cov_117,90.987,932,37,19,232,1156,944,53,0,1212,924,891
60999,Ntome_NODE_19960_length_1195_cov_119,Nsylvestris_NODE_33035_length_352_cov_3,94.362,337,16,2,118,451,340,4,9.14E-145,514,333,336
61049,Ntome_NODE_19983_length_1193_cov_169,Nsylvestris_NODE_14791_length_1570_cov_117,91.736,1210,67,8,2,1193,233,1427,0,1650,1191,1194
61052,Ntome_NODE_19986_length_1193_cov_74,Nsylvestris_NODE_19292_length_1161_cov_122,89.5,1019,70,14,1,1018,1141,159,0,1254,1017,982
61120,Ntome_NODE_20020_length_1190_cov_199,Nsylvestris_NODE_20316_length_1076_cov_201,92.523,1070,39,16,130,1189,1075,37,0,1495,1059,1038
61178,Ntome_NODE_20043_length_1188_cov_217,Nsylvestris_NODE_19380_length_1153_cov_174,91.503,1071,44,14,103,1164,1134,102,0,1430,1061,1032
61250,Ntome_NODE_20072_length_1186_cov_172,Nsylvestris_NODE_16860_length_1367_cov_145,95.14,1111,51,2,1,1108,83,1193,0,1749,1107,1110
61268,Ntome_NODE_20081_length_1185_cov_278,Nsylvestris_NODE_19362_length_1154_cov_204,95.018,1104,41,9,93,1184,53,1154,0,1722,1091,1101
61340,Ntome_NODE_20114_length_1183_cov_254,Nsylvestris_NODE_19165_length_1170_cov_179,92.445,1178,40,13,1,1174,1,1133,0,1637,1173,1132
61363,Ntome_NODE_20123_length_1182_cov_279,Nsylvestris_NODE_20130_length_1091_cov_210,91.937,1017,75,2,42,1058,1059,50,0,1417,1016,1009
61379,Ntome_NODE_20130_length_1182_cov_101,Nsylvestris_NODE_15636_length_1486_cov_91,94.737,760,38,1,274,1033,1442,685,0,1181,759,757
61401,Ntome_NODE_20141_length_1181_cov_252,Nsylvestris_NODE_23145_length_882_cov_174,91.627,836,30,14,18,842,1,807,0,1120,824,806
61473,Ntome_NODE_20168_length_1179_cov_45,Nsylvestris_NODE_22552_length_919_cov_10,82.322,758,62,27,93,831,2,706,4.05E-168,592,738,704
61498,Ntome_NODE_20179_length_1178_cov_230,Nsylvestris_NODE_20032_length_1099_cov_195,89.572,911,46,21,236,1108,200,1099,0,1110,872,899
61532,Ntome_NODE_20194_length_1177_cov_134,Nsylvestris_NODE_7669_length_2458_cov_60,94.316,1038,52,2,52,1082,52,1089,0,1583,1030,1037
61538,Ntome_NODE_20197_length_1177_cov_107,Nsylvestris_NODE_19787_length_1118_cov_220,92.081,1086,63,8,1,1075,1118,45,0,1507,1074,1073
61547,Ntome_NODE_20204_length_1177_cov_8,Nsylvestris_NODE_33882_length_326_cov_3,93.558,326,20,1,4,328,326,1,7.05E-136,484,324,325
61592,Ntome_NODE_20223_length_1175_cov_261,Nsylvestris_NODE_19444_length_1148_cov_188,93.462,933,47,10,50,980,101,1021,0,1373,930,920
61624,Ntome_NODE_20241_length_1174_cov_153,Nsylvestris_NODE_14616_length_1587_cov_127,96.137,673,26,0,1,673,1437,765,0,1099,672,672
61645,Ntome_NODE_20251_length_1173_cov_293,Nsylvestris_NODE_17035_length_1354_cov_106,92.589,958,41,14,7,964,111,1038,0,1349,957,927
61656,Ntome_NODE_20256_length_1173_cov_177,Nsylvestris_NODE_15247_length_1526_cov_193,89.642,1033,62,16,133,1126,136,1162,0,1273,993,1026
61672,Ntome_NODE_20265_length_1172_cov_31,Nsylvestris_NODE_15230_length_1529_cov_45,95.116,1167,53,3,1,1167,1273,111,0,1836,1166,1162
61683,Ntome_NODE_20271_length_1171_cov_240,Nsylvestris_NODE_17278_length_1334_cov_173,96.233,1115,41,1,50,1163,1117,3,0,1825,1113,1114
61765,Ntome_NODE_20310_length_1168_cov_258,Nsylvestris_NODE_19443_length_1148_cov_203,92.542,1019,70,4,22,1035,1081,64,0,1456,1013,1017
61782,Ntome_NODE_20318_length_1168_cov_26,Nsylvestris_NODE_20398_length_1071_cov_83,94.358,1028,49,5,2,1025,1,1023,0,1568,1023,1022
61831,Ntome_NODE_20341_length_1166_cov_84,Nsylvestris_NODE_19929_length_1108_cov_63,93.569,1104,37,13,1,1089,24,1108,0,1615,1088,1084
61902,Ntome_NODE_20372_length_1163_cov_249,Nsylvestris_NODE_15446_length_1507_cov_214,95.19,1185,33,8,1,1163,232,1414,0,1851,1162,1182
61921,Ntome_NODE_20381_length_1163_cov_14,Nsylvestris_NODE_16992_length_1358_cov_170,95.193,1165,53,2,1,1163,54,1217,0,1838,1162,1163
61962,Ntome_NODE_20400_length_1161_cov_193,Nsylvestris_NODE_5243_length_2917_cov_91,92.271,841,27,8,72,877,2078,2915,0,1158,805,837
61997,Ntome_NODE_20416_length_1160_cov_175,Nsylvestris_NODE_18539_length_1221_cov_91,94.872,1053,51,2,56,1108,172,1221,0,1642,1052,1049
61998,Ntome_NODE_20417_length_1160_cov_164,Nsylvestris_NODE_19887_length_1111_cov_74,92.968,967,60,6,120,1084,974,14,0,1402,964,960
62082,Ntome_NODE_20455_length_1157_cov_178,Nsylvestris_NODE_15026_length_1548_cov_61,95.5,1089,40,7,45,1133,302,1381,0,1731,1088,1079
62155,Ntome_NODE_20482_length_1155_cov_16,Nsylvestris_NODE_17216_length_1339_cov_37,92.651,1075,58,8,88,1154,1081,20,0,1528,1066,1061
62226,Ntome_NODE_20512_length_1153_cov_28,Nsylvestris_NODE_20685_length_1051_cov_34,89.512,1106,50,24,1,1095,1051,1,0,1339,1094,1050
62247,Ntome_NODE_20522_length_1152_cov_115,Nsylvestris_NODE_17687_length_1295_cov_107,94.32,1074,60,1,8,1081,11,1083,0,1644,1073,1072
62474,Ntome_NODE_20622_length_1143_cov_234,Nsylvestris_NODE_19587_length_1135_cov_215,92.929,1089,58,8,27,1101,20,1103,0,1567,1074,1083
62520,Ntome_NODE_20649_length_1141_cov_251,Nsylvestris_NODE_19365_length_1154_cov_190,94.703,944,47,3,23,963,1089,146,0,1463,940,943
62527,Ntome_NODE_20653_length_1141_cov_175,Nsylvestris_NODE_19272_length_1162_cov_139,91.136,1083,63,21,9,1066,48,1122,0,1437,1057,1074
62528,Ntome_NODE_20654_length_1141_cov_162,Nsylvestris_NODE_17483_length_1315_cov_190,92.231,1107,61,10,2,1087,120,1222,0,1544,1085,1102
62563,Ntome_NODE_20670_length_1140_cov_41,Nsylvestris_NODE_19207_length_1167_cov_104,93.116,1104,54,17,57,1140,1132,31,0,1598,1083,1101
62595,Ntome_NODE_20683_length_1139_cov_209,Nsylvestris_NODE_17305_length_1331_cov_164,96.269,1099,38,3,43,1139,1331,234,0,1799,1096,1097
62618,Ntome_NODE_20691_length_1139_cov_4,Nsylvestris_NODE_15395_length_1513_cov_78,95.414,1112,51,0,1,1112,363,1474,0,1772,1111,1111
62647,Ntome_NODE_20705_length_1138_cov_8,Nsylvestris_NODE_12633_length_1802_cov_129,93.942,1139,55,4,1,1138,1531,406,0,1709,1137,1125
62658,Ntome_NODE_20709_length_1137_cov_134,Nsylvestris_NODE_25866_length_725_cov_45,91.803,610,25,6,420,1008,116,721,0,826,588,605
62683,Ntome_NODE_20723_length_1136_cov_213,Nsylvestris_NODE_22723_length_907_cov_46,85.859,594,36,14,497,1055,581,1,5.04E-167,588,558,580
62706,Ntome_NODE_20737_length_1135_cov_280,Nsylvestris_NODE_19519_length_1141_cov_213,94.99,978,38,5,50,1022,1115,144,0,1524,972,971
62742,Ntome_NODE_20754_length_1134_cov_164,Nsylvestris_NODE_19178_length_1169_cov_88,92.074,921,46,9,237,1132,202,1120,0,1271,895,918
62798,Ntome_NODE_20778_length_1133_cov_7,Nsylvestris_NODE_15605_length_1490_cov_63,94.278,1136,62,1,1,1133,1164,29,0,1735,1132,1135
62817,Ntome_NODE_20785_length_1132_cov_97,Nsylvestris_NODE_27366_length_657_cov_178,87.871,371,22,6,714,1084,248,595,9.02E-115,414,370,347
62851,Ntome_NODE_20803_length_1130_cov_271,Nsylvestris_NODE_19881_length_1111_cov_211,93.025,1061,50,14,41,1080,1087,30,0,1528,1039,1057
62860,Ntome_NODE_20808_length_1131_cov_159,Nsylvestris_NODE_23226_length_877_cov_41,92.639,557,41,0,271,827,46,602,0,802,556,556
62868,Ntome_NODE_20813_length_1131_cov_59,Nsylvestris_NODE_15262_length_1525_cov_100,95.848,1132,34,7,2,1131,44,1164,0,1818,1129,1120
62914,Ntome_NODE_20834_length_1129_cov_268,Nsylvestris_NODE_23273_length_874_cov_219,83.902,615,71,18,512,1117,613,18,3.04E-159,562,605,595
62920,Ntome_NODE_20838_length_1129_cov_30,Nsylvestris_NODE_15226_length_1529_cov_94,87.73,163,18,2,3,163,50,212,5.93E-47,189,160,162
62949,Ntome_NODE_20849_length_1128_cov_76,Nsylvestris_NODE_20662_length_1053_cov_9,91.757,922,51,15,155,1064,145,1053,0,1258,909,908
62958,Ntome_NODE_20852_length_1128_cov_22,Nsylvestris_NODE_21514_length_991_cov_39,95.037,947,41,4,1,946,5,946,0,1483,945,941
62965,Ntome_NODE_20856_length_1126_cov_288,Nsylvestris_NODE_18872_length_1195_cov_188,92.537,1139,48,9,6,1126,4,1123,0,1598,1120,1119
62973,Ntome_NODE_20860_length_1127_cov_184,Nsylvestris_NODE_27468_length_652_cov_61,95.134,596,29,0,482,1077,45,640,0,941,595,595
62981,Ntome_NODE_20864_length_1127_cov_35,Nsylvestris_NODE_18258_length_1245_cov_20,94.605,1001,47,3,87,1086,1117,123,0,1543,999,994
62982,Ntome_NODE_20866_length_1127_cov_23,Nsylvestris_NODE_16734_length_1378_cov_26,94.844,1125,57,1,3,1127,201,1324,0,1755,1124,1123
62999,Ntome_NODE_20873_length_1126_cov_227,Nsylvestris_NODE_20425_length_1070_cov_17,75.364,686,157,12,428,1110,715,39,2.01E-86,320,682,676
63056,Ntome_NODE_20899_length_1123_cov_273,Nsylvestris_NODE_19368_length_1154_cov_177,96.429,1064,38,0,11,1074,1148,85,0,1755,1063,1063
63157,Ntome_NODE_20943_length_1120_cov_102,Nsylvestris_NODE_19912_length_1109_cov_194,90.282,1029,70,22,100,1107,90,1109,0,1319,1007,1019
63176,Ntome_NODE_20950_length_1119_cov_224,Nsylvestris_NODE_18253_length_1245_cov_205,93.184,1027,40,10,77,1102,999,2,0,1482,1025,997
63191,Ntome_NODE_20956_length_1119_cov_119,Nsylvestris_NODE_17638_length_1299_cov_104,94.041,772,44,2,315,1085,1253,483,0,1170,770,770
63228,Ntome_NODE_20978_length_1118_cov_6,Nsylvestris_NODE_16613_length_1390_cov_133,91.682,1118,58,15,34,1118,1172,57,0,1517,1084,1115
63240,Ntome_NODE_20984_length_1117_cov_239,Nsylvestris_NODE_19307_length_1160_cov_200,94.804,1020,46,4,80,1098,82,1095,0,1583,1018,1013
63258,Ntome_NODE_20993_length_1117_cov_43,Nsylvestris_NODE_29140_length_577_cov_29,87.206,383,35,4,60,439,67,438,1.48E-117,424,379,371
63325,Ntome_NODE_21021_length_1114_cov_182,Nsylvestris_NODE_20692_length_1050_cov_147,95.642,826,31,3,41,865,1,822,0,1321,824,821
63330,Ntome_NODE_21025_length_1114_cov_24,Nsylvestris_NODE_17653_length_1298_cov_81,90.877,1140,50,17,1,1114,1189,78,0,1480,1113,1111
63360,Ntome_NODE_21039_length_1113_cov_50,Nsylvestris_NODE_18699_length_1209_cov_151,94.408,1055,41,5,1,1054,172,1209,0,1605,1053,1037
63361,Ntome_NODE_21040_length_1113_cov_26,Nsylvestris_NODE_23660_length_851_cov_18,87.3,874,61,26,147,993,1,851,0,953,846,850
63367,Ntome_NODE_21043_length_1112_cov_256,Nsylvestris_NODE_24114_length_824_cov_199,90.241,830,51,13,58,866,821,1,0,1057,808,820
63435,Ntome_NODE_21077_length_1110_cov_96,Nsylvestris_NODE_20870_length_1037_cov_158,94.164,891,38,3,1,877,891,1,0,1345,876,890
63450,Ntome_NODE_21083_length_1109_cov_238,Nsylvestris_NODE_21404_length_998_cov_197,93.564,808,43,5,195,996,104,908,0,1195,801,804
63469,Ntome_NODE_21093_length_1109_cov_29,Nsylvestris_NODE_16369_length_1413_cov_30,88.636,132,14,1,966,1096,394,263,4.57E-38,159,130,131
63478,Ntome_NODE_21096_length_1109_cov_19,Nsylvestris_NODE_19572_length_1137_cov_47,93.939,1056,61,2,1,1053,38,1093,0,1592,1052,1055
63506,Ntome_NODE_21115_length_1107_cov_274,Nsylvestris_NODE_21889_length_960_cov_206,94.607,853,35,9,135,979,911,62,0,1310,844,849
63550,Ntome_NODE_21134_length_1106_cov_240,Nsylvestris_NODE_19128_length_1173_cov_191,93.275,922,57,5,177,1093,201,1122,0,1354,916,921
63553,Ntome_NODE_21136_length_1106_cov_204,Nsylvestris_NODE_19569_length_1137_cov_149,96.108,925,35,1,142,1065,1,925,0,1507,923,924
63559,Ntome_NODE_21140_length_1106_cov_106,Nsylvestris_NODE_21156_length_1018_cov_66,90.467,986,69,12,83,1057,41,1012,0,1277,974,971
63566,Ntome_NODE_21143_length_1106_cov_43,Nsylvestris_NODE_34338_length_312_cov_5,88.596,114,13,0,4,117,114,1,5.94E-32,139,113,113
63629,Ntome_NODE_21173_length_1104_cov_33,Nsylvestris_NODE_23493_length_860_cov_54,95.167,807,25,5,9,807,12,812,0,1262,798,800
63662,Ntome_NODE_21187_length_1103_cov_115,Nsylvestris_NODE_16354_length_1414_cov_188,95.949,1012,30,5,1,1004,356,1364,0,1631,1003,1008
63678,Ntome_NODE_21198_length_1102_cov_138,Nsylvestris_NODE_22735_length_906_cov_157,89.677,930,50,9,61,984,11,900,0,1144,923,889
63831,Ntome_NODE_21218_length_1101_cov_10,Nsylvestris_NODE_33823_length_327_cov_6,94.19,327,8,2,137,452,1,327,5.09E-137,488,315,326
63865,Ntome_NODE_21236_length_1099_cov_241,Nsylvestris_NODE_21840_length_966_cov_203,90.351,912,64,6,120,1008,41,951,0,1175,888,910
63912,Ntome_NODE_21258_length_1097_cov_237,Nsylvestris_NODE_19744_length_1123_cov_200,92.61,636,44,3,100,734,1093,460,0,911,634,633
63917,Ntome_NODE_21260_length_1097_cov_173,Nsylvestris_NODE_20176_length_1088_cov_106,94.387,1069,43,9,25,1090,24,1078,0,1626,1065,1054
63926,Ntome_NODE_21265_length_1097_cov_59,Nsylvestris_NODE_19926_length_1108_cov_173,91.648,910,59,6,69,973,1055,158,0,1243,904,897
63938,Ntome_NODE_21271_length_1097_cov_26,Nsylvestris_NODE_18180_length_1252_cov_82,90.578,1072,76,11,38,1087,121,1189,0,1397,1049,1068
63951,Ntome_NODE_21280_length_1096_cov_201,Nsylvestris_NODE_21111_length_1021_cov_23,88.015,267,17,5,303,568,440,188,7.09E-81,302,265,252
63967,Ntome_NODE_21288_length_1095_cov_223,Nsylvestris_NODE_25533_length_742_cov_38,88.633,695,54,11,242,930,733,58,0,822,688,675
64103,Ntome_NODE_21345_length_1092_cov_46,Nsylvestris_NODE_15809_length_1469_cov_74,89.474,1007,55,11,82,1086,471,1428,0,1225,1004,957
64149,Ntome_NODE_21371_length_1090_cov_199,Nsylvestris_NODE_27991_length_629_cov_40,91.424,653,29,15,168,817,1,629,0,870,649,628
64156,Ntome_NODE_21375_length_1090_cov_41,Nsylvestris_NODE_18623_length_1215_cov_118,95.281,1102,31,8,7,1088,83,1183,0,1727,1081,1100
64196,Ntome_NODE_21391_length_1089_cov_51,Nsylvestris_NODE_24873_length_779_cov_8,90.379,634,48,8,315,940,88,716,0,821,625,628
64223,Ntome_NODE_21402_length_1088_cov_264,Nsylvestris_NODE_21163_length_1017_cov_201,98.14,968,15,2,58,1022,1009,42,0,1685,964,967
64279,Ntome_NODE_21426_length_1087_cov_5,Nsylvestris_NODE_19261_length_1163_cov_11,95.698,1046,45,0,42,1087,17,1062,0,1683,1045,1045
64293,Ntome_NODE_21433_length_1086_cov_90,Nsylvestris_NODE_19289_length_1161_cov_182,90.167,956,61,18,106,1055,126,1054,0,1214,949,928
64402,Ntome_NODE_21484_length_1083_cov_20,Nsylvestris_NODE_25813_length_728_cov_7,95.742,728,31,0,134,861,1,728,0,1173,727,727
64438,Ntome_NODE_21499_length_1081_cov_245,Nsylvestris_NODE_19590_length_1135_cov_203,96.135,1035,32,5,9,1038,1066,35,0,1683,1029,1031
64476,Ntome_NODE_21516_length_1080_cov_190,Nsylvestris_NODE_19286_length_1161_cov_198,96.311,1030,31,2,2,1031,1161,139,0,1685,1029,1022
64520,Ntome_NODE_21540_length_1078_cov_271,Nsylvestris_NODE_18893_length_1193_cov_198,93.303,1090,40,13,7,1076,26,1102,0,1578,1069,1076
64521,Ntome_NODE_21541_length_1078_cov_261,Nsylvestris_NODE_21253_length_1010_cov_189,93.586,951,42,3,8,941,16,964,0,1400,933,948
64548,Ntome_NODE_21552_length_1077_cov_270,Nsylvestris_NODE_22588_length_916_cov_159,91.977,885,46,13,55,921,1,878,0,1218,866,877
64552,Ntome_NODE_21554_length_1077_cov_195,Nsylvestris_NODE_19710_length_1126_cov_178,92.5,880,30,12,60,922,29,889,0,1227,862,860
64564,Ntome_NODE_21559_length_1077_cov_85,Nsylvestris_NODE_30334_length_499_cov_6,94.748,457,16,2,334,785,454,1,0,704,451,453
64565,Ntome_NODE_21560_length_1077_cov_63,Nsylvestris_NODE_26436_length_699_cov_11,94.965,715,20,1,68,782,1,699,0,1107,714,698
64566,Ntome_NODE_21561_length_1077_cov_63,Nsylvestris_NODE_22350_length_932_cov_44,88.999,909,55,12,80,955,926,30,0,1083,875,896
64601,Ntome_NODE_21578_length_1076_cov_126,Nsylvestris_NODE_19987_length_1103_cov_198,94.489,998,44,4,84,1076,92,1083,0,1528,992,991
64606,Ntome_NODE_21581_length_1076_cov_91,Nsylvestris_NODE_20888_length_1036_cov_86,93.825,1004,47,5,9,1004,1036,40,0,1496,995,996
64692,Ntome_NODE_21621_length_1073_cov_43,Nsylvestris_NODE_20402_length_1071_cov_22,90.897,747,42,4,336,1073,253,982,0,979,737,729
64696,Ntome_NODE_21624_length_1073_cov_18,Nsylvestris_NODE_17555_length_1308_cov_25,94.051,975,58,0,23,997,1289,315,0,1480,974,974
64737,Ntome_NODE_21644_length_1073_cov_4,Nsylvestris_NODE_15862_length_1463_cov_22,97.61,1046,25,0,25,1070,1,1046,0,1794,1045,1045
64745,Ntome_NODE_21648_length_1071_cov_35,Nsylvestris_NODE_15043_length_1547_cov_20,95.326,1027,47,1,3,1028,1485,459,0,1629,1025,1026
64756,Ntome_NODE_21653_length_1071_cov_9,Nsylvestris_NODE_20200_length_1087_cov_13,94.937,1027,52,0,7,1033,1027,1,0,1609,1026,1026
64759,Ntome_NODE_21658_length_1070_cov_244,Nsylvestris_NODE_29366_length_568_cov_207,95.407,479,21,1,186,664,41,518,0,761,478,477
64773,Ntome_NODE_21668_length_1069_cov_280,Nsylvestris_NODE_21472_length_993_cov_216,96.366,963,32,3,44,1004,1,962,0,1581,960,961
64827,Ntome_NODE_21692_length_1068_cov_98,Nsylvestris_NODE_31230_length_437_cov_3,91.391,151,7,2,1,151,218,362,7.20E-51,202,150,144
64928,Ntome_NODE_21735_length_1066_cov_35,Nsylvestris_NODE_21762_length_973_cov_10,94.444,72,4,0,202,273,276,347,1.25E-23,111,71,71
65009,Ntome_NODE_21770_length_1063_cov_244,Nsylvestris_NODE_16814_length_1371_cov_174,92.338,1018,65,9,55,1063,332,1345,0,1435,1008,1013
65010,Ntome_NODE_21771_length_1063_cov_175,Nsylvestris_NODE_21418_length_997_cov_206,97.314,968,23,2,1,966,983,17,0,1640,965,966
65082,Ntome_NODE_21809_length_1060_cov_144,Nsylvestris_NODE_19732_length_1124_cov_142,95.393,955,36,6,54,1003,9,960,0,1513,949,951
65110,Ntome_NODE_21824_length_1059_cov_255,Nsylvestris_NODE_25115_length_765_cov_69,97.175,708,20,0,4,711,9,716,0,1197,707,707
65140,Ntome_NODE_21838_length_1058_cov_293,Nsylvestris_NODE_19136_length_1172_cov_205,94.235,1006,43,6,1,999,58,1055,0,1522,998,997
65175,Ntome_NODE_21854_length_1057_cov_71,Nsylvestris_NODE_20476_length_1066_cov_184,94.223,1004,44,8,29,1020,1047,46,0,1520,991,1001
65181,Ntome_NODE_21857_length_1057_cov_35,Nsylvestris_NODE_24225_length_817_cov_155,86.071,481,64,3,468,945,225,705,8.06E-145,514,477,480
65192,Ntome_NODE_21865_length_1057_cov_14,Nsylvestris_NODE_17553_length_1308_cov_38,95.902,1025,41,1,1,1024,270,1294,0,1659,1023,1024
65207,Ntome_NODE_21872_length_1056_cov_204,Nsylvestris_NODE_13006_length_1763_cov_87,95.039,1028,40,5,25,1049,730,1749,0,1605,1024,1019
65209,Ntome_NODE_21874_length_1045_cov_113,Nsylvestris_NODE_18212_length_1249_cov_101,94.372,995,50,6,2,994,96,1086,0,1522,992,990
65315,Ntome_NODE_21927_length_1053_cov_119,Nsylvestris_NODE_23404_length_866_cov_66,91.657,875,54,9,60,929,861,1,0,1194,869,860
65316,Ntome_NODE_21928_length_1053_cov_89,Nsylvestris_NODE_34526_length_307_cov_3,97.527,283,7,0,289,571,283,1,6.29E-136,484,282,282
65336,Ntome_NODE_21937_length_1053_cov_17,Nsylvestris_NODE_16495_length_1400_cov_63,94.156,1061,30,12,6,1053,1396,355,0,1587,1047,1041
65371,Ntome_NODE_21954_length_1052_cov_54,Nsylvestris_NODE_18600_length_1217_cov_129,90.819,708,56,3,10,708,58,765,0,939,698,707
65372,Ntome_NODE_21955_length_1052_cov_46,Nsylvestris_NODE_33473_length_337_cov_6,91.265,332,12,3,619,934,334,4,1.79E-121,436,315,330
65389,Ntome_NODE_21967_length_1051_cov_270,Nsylvestris_NODE_15918_length_1458_cov_173,92.089,986,47,7,24,981,1207,225,0,1360,957,982
65419,Ntome_NODE_21987_length_1050_cov_217,Nsylvestris_NODE_21728_length_975_cov_151,91.014,957,41,17,1,927,959,18,0,1249,926,941
65538,Ntome_NODE_22040_length_1046_cov_2,Nsylvestris_NODE_17603_length_1303_cov_29,95.92,1054,27,13,1,1043,52,1100,0,1694,1042,1048
65621,Ntome_NODE_22073_length_1043_cov_21,Nsylvestris_NODE_23935_length_836_cov_15,96.287,835,27,2,52,886,836,6,0,1367,834,830
65633,Ntome_NODE_22079_length_1042_cov_235,Nsylvestris_NODE_20233_length_1083_cov_209,92.013,914,55,7,1,905,25,929,0,1267,904,904
65657,Ntome_NODE_22088_length_1042_cov_62,Nsylvestris_NODE_19671_length_1129_cov_68,95.938,1034,36,3,1,1034,1042,15,0,1672,1033,1027
65661,Ntome_NODE_22092_length_1042_cov_16,Nsylvestris_NODE_17910_length_1276_cov_62,93.103,638,41,3,1,636,480,1116,0,931,635,636
65796,Ntome_NODE_22155_length_1037_cov_174,Nsylvestris_NODE_18900_length_1192_cov_176,94.532,951,27,11,39,983,1,932,0,1445,944,931
65827,Ntome_NODE_22172_length_1036_cov_264,Nsylvestris_NODE_21509_length_991_cov_169,92.688,930,47,11,5,926,6,922,0,1321,921,916
65839,Ntome_NODE_22179_length_1036_cov_39,Nsylvestris_NODE_19997_length_1103_cov_23,76.046,693,148,12,157,843,1039,359,1.10E-93,344,686,680
65850,Ntome_NODE_22185_length_1035_cov_222,Nsylvestris_NODE_21348_length_1003_cov_117,94.905,1001,39,9,39,1034,3,996,0,1555,995,993
65879,Ntome_NODE_22199_length_1034_cov_73,Nsylvestris_NODE_27297_length_660_cov_22,89.95,398,31,6,299,693,51,442,4.74E-142,505,394,391
65889,Ntome_NODE_22203_length_1034_cov_18,Nsylvestris_NODE_23866_length_840_cov_13,91.965,809,47,4,195,1003,50,840,0,1118,808,790
65895,Ntome_NODE_22208_length_1034_cov_9,Nsylvestris_NODE_10853_length_2007_cov_19,93.907,1034,63,0,1,1034,763,1796,0,1561,1033,1033
65973,Ntome_NODE_22240_length_1032_cov_177,Nsylvestris_NODE_24450_length_804_cov_17,90.037,813,57,3,173,973,804,4,0,1031,800,800
66052,Ntome_NODE_22281_length_1029_cov_207,Nsylvestris_NODE_22326_length_933_cov_187,91.505,930,54,13,1,926,924,16,0,1256,925,908
66085,Ntome_NODE_22298_length_1028_cov_49,Nsylvestris_NODE_17856_length_1281_cov_77,85.899,1007,84,19,1,980,1264,289,0,1020,979,975
66161,Ntome_NODE_22336_length_1026_cov_151,Nsylvestris_NODE_26750_length_685_cov_74,94.629,633,30,3,131,760,1,632,0,977,629,631
66169,Ntome_NODE_22341_length_1026_cov_45,Nsylvestris_NODE_16005_length_1449_cov_48,90.26,770,42,8,57,817,795,50,0,976,760,745
66216,Ntome_NODE_22363_length_1025_cov_57,Nsylvestris_NODE_22698_length_909_cov_93,96.114,772,19,4,250,1018,859,96,0,1249,768,763
66246,Ntome_NODE_22378_length_1024_cov_38,Nsylvestris_NODE_21297_length_1007_cov_12,94.863,915,40,4,6,914,1006,93,0,1423,908,913
66259,Ntome_NODE_22383_length_1024_cov_17,Nsylvestris_NODE_18861_length_1196_cov_177,95.034,1027,35,5,1,1024,1071,58,0,1600,1023,1013
66260,Ntome_NODE_22384_length_1024_cov_17,Nsylvestris_NODE_27302_length_660_cov_16,94.427,628,26,4,291,909,33,660,0,957,618,627
66299,Ntome_NODE_22403_length_1023_cov_7,Nsylvestris_NODE_17624_length_1301_cov_11,95.956,989,37,2,30,1018,24,1009,0,1602,988,985
66364,Ntome_NODE_22431_length_1020_cov_248,Nsylvestris_NODE_19477_length_1145_cov_194,96.835,790,22,2,1,789,1073,286,0,1317,788,787
66369,Ntome_NODE_22433_length_1020_cov_196,Nsylvestris_NODE_21700_length_977_cov_203,95.51,824,36,1,1,823,929,106,0,1315,822,823
66396,Ntome_NODE_22454_length_1019_cov_253,Nsylvestris_NODE_19935_length_1107_cov_184,95.289,1019,38,4,3,1019,1061,51,0,1607,1016,1010
66451,Ntome_NODE_22482_length_1017_cov_244,Nsylvestris_NODE_22899_length_897_cov_115,84.799,921,85,20,60,971,897,23,0,874,911,874
66488,Ntome_NODE_22503_length_1016_cov_119,Nsylvestris_NODE_21227_length_1012_cov_94,93.536,1021,51,6,1,1015,1012,1,0,1506,1014,1011
66534,Ntome_NODE_22526_length_1014_cov_63,Nsylvestris_NODE_20177_length_1088_cov_65,92.642,965,56,9,1,954,999,39,0,1375,953,960
66548,Ntome_NODE_22535_length_1013_cov_215,Nsylvestris_NODE_20446_length_1068_cov_195,94.211,881,41,6,134,1013,899,28,0,1336,879,871
66599,Ntome_NODE_22560_length_1012_cov_225,Nsylvestris_NODE_19509_length_1142_cov_202,94.515,948,49,2,1,948,136,1080,0,1459,947,944
66615,Ntome_NODE_22567_length_1012_cov_22,Nsylvestris_NODE_19091_length_1176_cov_167,94.244,1025,29,11,1,1012,61,1068,0,1539,1011,1007
66617,Ntome_NODE_22569_length_1012_cov_1,Nsylvestris_NODE_17922_length_1275_cov_39,86.537,1025,78,25,1,990,132,1131,0,1074,989,999
66644,Ntome_NODE_22581_length_1011_cov_42,Nsylvestris_NODE_21069_length_1024_cov_3,93.866,864,52,1,92,955,971,109,0,1303,863,862
66668,Ntome_NODE_22591_length_1010_cov_206,Nsylvestris_NODE_23557_length_856_cov_39,87.769,883,53,24,51,913,9,856,0,981,862,847
66669,Ntome_NODE_22592_length_1010_cov_201,Nsylvestris_NODE_24464_length_803_cov_137,86.69,849,38,23,8,841,1,789,0,872,833,788
66670,Ntome_NODE_22593_length_1010_cov_187,Nsylvestris_NODE_23920_length_836_cov_198,95.954,791,27,3,197,982,7,797,0,1279,785,790
66685,Ntome_NODE_22601_length_1010_cov_25,Nsylvestris_NODE_18256_length_1245_cov_130,93.794,999,50,7,15,1007,176,1168,0,1491,992,992
66701,Ntome_NODE_22608_length_1009_cov_276,Nsylvestris_NODE_22917_length_896_cov_58,94.344,831,35,4,160,984,43,867,0,1264,824,824
66707,Ntome_NODE_22612_length_1009_cov_175,Nsylvestris_NODE_20274_length_1080_cov_41,87.12,955,50,31,47,939,137,1080,0,1014,892,943
66771,Ntome_NODE_22645_length_1007_cov_164,Nsylvestris_NODE_22180_length_943_cov_39,89.738,497,26,6,228,704,935,444,2.64E-174,612,476,491
66776,Ntome_NODE_22648_length_1007_cov_19,Nsylvestris_NODE_19482_length_1145_cov_30,96.142,1011,30,5,1,1007,14,1019,0,1642,1006,1005
66783,Ntome_NODE_22652_length_1007_cov_9,Nsylvestris_NODE_27008_length_673_cov_22,87.234,188,18,6,13,198,653,470,4.05E-53,209,185,183
66798,Ntome_NODE_22659_length_1006_cov_27,Nsylvestris_NODE_21015_length_1027_cov_73,92.807,862,54,3,137,996,872,17,0,1242,859,855
66833,Ntome_NODE_22674_length_1005_cov_30,Nsylvestris_NODE_21929_length_960_cov_31,91.273,974,54,10,2,975,959,17,0,1299,973,942
66898,Ntome_NODE_22704_length_1003_cov_186,Nsylvestris_NODE_24159_length_822_cov_83,92.326,821,50,7,84,891,822,2,0,1155,807,820
66905,Ntome_NODE_22708_length_999_cov_68,Nsylvestris_NODE_23690_length_849_cov_35,89.213,788,45,20,34,809,1,760,0,948,775,759
66935,Ntome_NODE_22720_length_1002_cov_237,Nsylvestris_NODE_20945_length_1032_cov_92,94.833,929,27,6,53,970,919,1,0,1430,917,918
66947,Ntome_NODE_22724_length_1002_cov_124,Nsylvestris_NODE_21620_length_983_cov_75,90.65,1016,46,15,1,1002,982,2,0,1304,1001,980
66948,Ntome_NODE_22725_length_1002_cov_94,Nsylvestris_NODE_25555_length_741_cov_52,94.838,678,23,5,75,751,740,74,0,1048,676,666
67000,Ntome_NODE_22747_length_1000_cov_269,Nsylvestris_NODE_20160_length_1089_cov_200,96.674,872,29,0,77,948,924,53,0,1450,871,871
67005,Ntome_NODE_22749_length_1000_cov_227,Nsylvestris_NODE_22554_length_918_cov_215,92.629,719,50,3,235,951,58,775,0,1031,716,717
67006,Ntome_NODE_22750_length_1000_cov_174,Nsylvestris_NODE_23298_length_872_cov_172,96.256,828,24,4,157,980,48,872,0,1351,823,824
67026,Ntome_NODE_22762_length_999_cov_16,Nsylvestris_NODE_18548_length_1220_cov_153,93.089,955,46,5,20,965,201,1144,0,1380,945,943
67032,Ntome_NODE_22767_length_998_cov_249,Nsylvestris_NODE_21953_length_958_cov_188,92.731,963,39,11,1,955,940,1,0,1362,954,939
67033,Ntome_NODE_22768_length_998_cov_209,Nsylvestris_NODE_25284_length_755_cov_100,90.878,581,32,6,42,602,130,709,0,760,560,579
67041,Ntome_NODE_22771_length_998_cov_99,Nsylvestris_NODE_25418_length_747_cov_42,89.826,688,46,13,51,721,691,11,0,861,670,680
67087,Ntome_NODE_22798_length_996_cov_246,Nsylvestris_NODE_20691_length_1050_cov_159,91.431,992,39,15,1,984,1049,96,0,1319,983,953
67138,Ntome_NODE_22819_length_995_cov_157,Nsylvestris_NODE_23641_length_852_cov_72,95.921,858,26,7,131,987,3,852,0,1382,856,849
67192,Ntome_NODE_22845_length_990_cov_249,Nsylvestris_NODE_22835_length_900_cov_185,96.837,822,20,4,63,880,858,39,0,1369,817,819
67209,Ntome_NODE_22856_length_992_cov_266,Nsylvestris_NODE_21009_length_1027_cov_193,89.883,939,58,17,38,956,922,1,0,1173,918,921
67213,Ntome_NODE_22860_length_992_cov_166,Nsylvestris_NODE_21578_length_986_cov_144,89.956,906,54,16,10,911,984,112,0,1134,901,872
67229,Ntome_NODE_22867_length_992_cov_42,Nsylvestris_NODE_10704_length_2025_cov_127,97.347,867,23,0,8,874,1986,1120,0,1474,866,866
67249,Ntome_NODE_22881_length_991_cov_101,Nsylvestris_NODE_20730_length_1047_cov_148,91.034,948,77,6,46,989,86,1029,0,1273,943,943
67325,Ntome_NODE_22920_length_988_cov_161,Nsylvestris_NODE_21716_length_976_cov_47,94.126,698,35,4,49,743,61,755,0,1057,694,694
67346,Ntome_NODE_22929_length_988_cov_8,Nsylvestris_NODE_29327_length_570_cov_8,90.435,575,42,5,422,988,570,1,0,745,566,569
67406,Ntome_NODE_22950_length_986_cov_76,Nsylvestris_NODE_22809_length_902_cov_124,91.685,914,37,10,97,986,900,2,0,1230,889,898
67448,Ntome_NODE_22970_length_985_cov_127,Nsylvestris_NODE_17173_length_1342_cov_93,94.688,979,35,7,4,981,994,32,0,1504,977,962
67528,Ntome_NODE_23008_length_983_cov_27,Nsylvestris_NODE_32722_length_363_cov_4,95.317,363,17,0,419,781,363,1,9.41E-164,577,362,362
67529,Ntome_NODE_23009_length_983_cov_21,Nsylvestris_NODE_20720_length_1048_cov_118,95.043,928,39,3,6,926,1020,93,0,1452,920,927
67530,Ntome_NODE_23011_length_983_cov_16,Nsylvestris_NODE_20138_length_1091_cov_36,95.214,982,43,3,2,983,15,992,0,1550,981,977
67547,Ntome_NODE_23019_length_982_cov_212,Nsylvestris_NODE_22754_length_905_cov_206,95.357,883,30,5,1,879,876,1,0,1393,878,875
67618,Ntome_NODE_23060_length_979_cov_228,Nsylvestris_NODE_27185_length_665_cov_217,90.651,599,38,10,180,777,75,656,0,780,597,581
67722,Ntome_NODE_23114_length_976_cov_60,Nsylvestris_NODE_21647_length_981_cov_168,87.056,958,64,27,47,975,981,55,0,1027,928,926
67734,Ntome_NODE_23120_length_976_cov_20,Nsylvestris_NODE_21914_length_961_cov_25,89.801,804,64,7,182,976,806,12,0,1014,794,794
67839,Ntome_NODE_23169_length_973_cov_58,Nsylvestris_NODE_24448_length_804_cov_128,92.257,762,38,5,227,973,757,2,0,1061,746,755
67878,Ntome_NODE_23190_length_972_cov_167,Nsylvestris_NODE_29561_length_561_cov_5,95.088,570,15,5,91,660,558,2,0,885,569,556
67888,Ntome_NODE_23194_length_972_cov_63,Nsylvestris_NODE_23722_length_847_cov_49,93.814,679,33,4,140,816,29,700,0,1013,676,671
67917,Ntome_NODE_23208_length_971_cov_22,Nsylvestris_NODE_21012_length_1027_cov_145,93.482,537,34,1,436,971,553,17,0,797,535,536
67934,Ntome_NODE_23215_length_970_cov_256,Nsylvestris_NODE_9284_length_2209_cov_95,94.944,890,35,8,1,885,39,923,0,1386,884,884
67963,Ntome_NODE_23229_length_970_cov_7,Nsylvestris_NODE_36274_length_267_cov_4,96.255,267,9,1,493,758,1,267,1.64E-121,436,265,266
68121,Ntome_NODE_23296_length_966_cov_6,Nsylvestris_NODE_26922_length_677_cov_10,91.266,687,27,8,284,966,677,20,0,905,682,657
68138,Ntome_NODE_23304_length_965_cov_71,Nsylvestris_NODE_10761_length_2018_cov_99,92.808,584,18,3,406,965,1015,432,0,824,559,583
68164,Ntome_NODE_23319_length_964_cov_40,Nsylvestris_NODE_20997_length_1028_cov_32,93.895,950,34,5,8,934,80,1028,0,1411,926,948
68180,Ntome_NODE_23326_length_964_cov_19,Nsylvestris_NODE_19702_length_1127_cov_119,88.599,921,59,23,20,904,44,954,0,1077,884,910
68235,Ntome_NODE_23360_length_962_cov_65,Nsylvestris_NODE_22547_length_919_cov_42,94.521,730,40,0,121,850,778,49,0,1127,729,729
68258,Ntome_NODE_23374_length_961_cov_261,Nsylvestris_NODE_22302_length_935_cov_210,91.746,630,14,12,1,592,125,754,0,841,591,629
68264,Ntome_NODE_23377_length_961_cov_139,Nsylvestris_NODE_23905_length_837_cov_60,90.876,822,49,11,53,866,807,4,0,1079,813,803
68265,Ntome_NODE_23378_length_961_cov_102,Nsylvestris_NODE_12427_length_1824_cov_109,94.366,781,30,3,192,961,1550,773,0,1186,769,777
68277,Ntome_NODE_23389_length_961_cov_10,Nsylvestris_NODE_16298_length_1420_cov_22,92.029,966,60,4,2,961,232,1186,0,1341,959,954
68278,Ntome_NODE_23390_length_961_cov_9,Nsylvestris_NODE_34106_length_319_cov_3,94.688,320,14,3,534,851,319,1,9.52E-139,494,317,318
68311,Ntome_NODE_23403_length_960_cov_56,Nsylvestris_NODE_22218_length_941_cov_24,92.841,866,49,11,73,933,52,909,0,1243,860,857
68318,Ntome_NODE_23407_length_960_cov_18,Nsylvestris_NODE_29868_length_539_cov_6,94.991,539,27,0,324,862,1,539,0,846,538,538
68366,Ntome_NODE_23430_length_958_cov_261,Nsylvestris_NODE_22878_length_898_cov_184,92.279,816,39,14,95,905,60,856,0,1136,810,796
68388,Ntome_NODE_23442_length_958_cov_49,Nsylvestris_NODE_27238_length_663_cov_5,93.949,661,25,6,204,849,3,663,0,985,645,660
68423,Ntome_NODE_23458_length_957_cov_148,Nsylvestris_NODE_22464_length_924_cov_188,94.645,859,31,8,99,949,1,852,0,1317,850,851
68481,Ntome_NODE_23485_length_956_cov_6,Nsylvestris_NODE_19004_length_1183_cov_111,95.329,942,42,2,16,956,1073,133,0,1495,940,940
68488,Ntome_NODE_23488_length_955_cov_175,Nsylvestris_NODE_23805_length_843_cov_14,92.475,598,33,7,320,913,254,843,0,845,593,589
68545,Ntome_NODE_23515_length_954_cov_114,Nsylvestris_NODE_16066_length_1443_cov_121,95.013,742,29,2,50,791,744,11,0,1158,741,733
68555,Ntome_NODE_23518_length_954_cov_44,Nsylvestris_NODE_35483_length_284_cov_5,95.07,284,14,0,283,566,1,284,7.46E-125,448,283,283
68577,Ntome_NODE_23531_length_953_cov_21,Nsylvestris_NODE_14192_length_1631_cov_33,94.671,957,35,3,3,947,679,1631,0,1471,944,952
68582,Ntome_NODE_23534_length_953_cov_13,Nsylvestris_NODE_21017_length_1027_cov_17,89.497,914,25,20,1,900,34,890,0,1090,899,856
68634,Ntome_NODE_23559_length_951_cov_17,Nsylvestris_NODE_18581_length_1218_cov_170,92.782,859,43,8,100,951,241,1087,0,1225,851,846
68687,Ntome_NODE_23589_length_949_cov_287,Nsylvestris_NODE_21826_length_967_cov_217,90.226,931,54,15,21,922,930,8,0,1181,901,922
68688,Ntome_NODE_23590_length_949_cov_229,Nsylvestris_NODE_16252_length_1424_cov_118,87.205,891,72,13,53,942,97,946,0,976,889,849
68714,Ntome_NODE_23601_length_948_cov_249,Nsylvestris_NODE_22542_length_919_cov_190,95.838,913,36,2,1,912,8,919,0,1474,911,911
68721,Ntome_NODE_23604_length_948_cov_154,Nsylvestris_NODE_24582_length_796_cov_181,94.11,781,32,4,37,814,27,796,0,1175,777,769
68805,Ntome_NODE_23649_length_946_cov_89,Nsylvestris_NODE_14364_length_1615_cov_25,93.885,278,10,6,581,852,1615,1339,2.70E-114,412,271,276
68813,Ntome_NODE_23654_length_946_cov_15,Nsylvestris_NODE_18602_length_1217_cov_81,92.209,783,33,11,1,765,1095,323,0,1083,764,772
68827,Ntome_NODE_23661_length_945_cov_239,Nsylvestris_NODE_24318_length_811_cov_217,95.412,741,27,6,127,863,27,764,0,1173,736,737
68864,Ntome_NODE_23679_length_944_cov_225,Nsylvestris_NODE_22055_length_952_cov_190,93.985,798,32,4,25,821,911,129,0,1194,796,782
68945,Ntome_NODE_23714_length_942_cov_235,Nsylvestris_NODE_20607_length_1057_cov_142,90.176,682,56,9,139,814,783,107,0,878,675,676
68957,Ntome_NODE_23719_length_942_cov_66,Nsylvestris_NODE_30937_length_455_cov_28,77.22,259,38,6,557,795,194,451,8.42E-30,132,238,257
68978,Ntome_NODE_23732_length_940_cov_177,Nsylvestris_NODE_19048_length_1179_cov_194,90.795,880,60,6,55,913,880,1,0,1157,858,879
69003,Ntome_NODE_23744_length_941_cov_9,Nsylvestris_NODE_27335_length_659_cov_7,91.438,292,22,3,1,291,515,226,7.51E-110,398,290,289
69036,Ntome_NODE_23759_length_939_cov_146,Nsylvestris_NODE_22666_length_911_cov_158,94.248,904,37,4,20,920,907,16,0,1367,900,891
69043,Ntome_NODE_23764_length_939_cov_44,Nsylvestris_NODE_25506_length_744_cov_6,94.519,748,27,10,1,738,1,744,0,1142,737,743
69045,Ntome_NODE_23766_length_939_cov_36,Nsylvestris_NODE_25424_length_748_cov_12,82.823,751,77,29,1,724,748,23,3.16E-178,625,723,725
69076,Ntome_NODE_23779_length_937_cov_134,Nsylvestris_NODE_23208_length_878_cov_20,92.781,748,39,4,142,877,7,751,0,1068,735,744
69175,Ntome_NODE_23827_length_935_cov_238,Nsylvestris_NODE_15477_length_1505_cov_86,88.338,686,48,8,195,880,1352,699,0,795,685,653
69203,Ntome_NODE_23846_length_934_cov_31,Nsylvestris_NODE_22314_length_935_cov_11,89.546,947,74,16,1,934,1,935,0,1177,933,934
69218,Ntome_NODE_23854_length_933_cov_201,Nsylvestris_NODE_25884_length_721_cov_105,83.673,392,48,9,50,433,715,332,4.55E-97,355,383,383
69289,Ntome_NODE_23880_length_932_cov_30,Nsylvestris_NODE_29231_length_574_cov_5,95.333,450,21,0,53,502,450,1,0,715,449,449
69344,Ntome_NODE_23904_length_930_cov_205,Nsylvestris_NODE_22678_length_910_cov_174,94.032,687,27,7,171,845,685,1,0,1029,674,684
69391,Ntome_NODE_23926_length_929_cov_123,Nsylvestris_NODE_22589_length_916_cov_134,93.074,693,36,7,219,910,688,7,0,1003,691,681
69477,Ntome_NODE_23964_length_927_cov_215,Nsylvestris_NODE_24864_length_779_cov_189,90.116,688,34,13,100,771,779,110,0,863,671,669
69501,Ntome_NODE_23980_length_926_cov_30,Nsylvestris_NODE_36223_length_268_cov_4,93.657,268,15,1,41,306,268,1,2.05E-110,399,265,267
69507,Ntome_NODE_23985_length_926_cov_8,Nsylvestris_NODE_34129_length_318_cov_4,95.016,321,13,2,508,828,318,1,5.48E-141,501,320,317
69531,Ntome_NODE_24001_length_925_cov_7,Nsylvestris_NODE_16457_length_1404_cov_29,95.264,929,40,2,1,925,1001,73,0,1469,924,928
69544,Ntome_NODE_24010_length_924_cov_46,Nsylvestris_NODE_35161_length_291_cov_9,88.552,297,14,7,420,702,1,291,3.50E-93,342,282,290
69563,Ntome_NODE_24020_length_923_cov_139,Nsylvestris_NODE_21566_length_987_cov_72,86.761,846,42,20,1,810,33,844,0,878,809,811
69565,Ntome_NODE_24024_length_923_cov_27,Nsylvestris_NODE_22330_length_933_cov_36,95.599,818,35,1,107,923,883,66,0,1310,816,817
69592,Ntome_NODE_24038_length_922_cov_120,Nsylvestris_NODE_22370_length_931_cov_72,87.691,853,36,30,34,834,931,96,0,929,800,835
69627,Ntome_NODE_24052_length_921_cov_241,Nsylvestris_NODE_23017_length_890_cov_75,91.862,897,54,14,6,890,890,1,0,1234,884,889
69634,Ntome_NODE_24056_length_921_cov_114,Nsylvestris_NODE_24069_length_827_cov_187,91.795,780,41,14,83,841,821,44,0,1064,758,777
69680,Ntome_NODE_24080_length_919_cov_263,Nsylvestris_NODE_17262_length_1335_cov_172,95.517,870,23,3,18,872,922,54,0,1376,854,868
69700,Ntome_NODE_24088_length_919_cov_78,Nsylvestris_NODE_17265_length_1335_cov_104,90.642,919,47,16,10,919,416,1304,0,1184,909,888
69735,Ntome_NODE_24107_length_918_cov_19,Nsylvestris_NODE_21541_length_989_cov_16,95.448,725,18,5,186,904,274,989,0,1142,718,715
69748,Ntome_NODE_24117_length_917_cov_214,Nsylvestris_NODE_29594_length_559_cov_202,95.043,464,20,1,46,509,508,48,0,726,463,460
69768,Ntome_NODE_24128_length_917_cov_15,Nsylvestris_NODE_19845_length_1114_cov_99,96.14,855,33,0,63,917,1069,215,0,1397,854,854
69771,Ntome_NODE_24130_length_917_cov_11,Nsylvestris_NODE_32688_length_364_cov_4,94.231,364,20,1,66,428,1,364,4.10E-157,555,362,363
69829,Ntome_NODE_24161_length_915_cov_22,Nsylvestris_NODE_31406_length_425_cov_5,93.882,425,26,0,363,787,1,425,0,641,424,424
69839,Ntome_NODE_24165_length_915_cov_9,Nsylvestris_NODE_23086_length_886_cov_13,97.579,826,20,0,1,826,826,1,0,1415,825,825
69858,Ntome_NODE_24173_length_914_cov_141,Nsylvestris_NODE_24800_length_783_cov_109,93.951,777,45,2,11,785,783,7,0,1173,774,776
69859,Ntome_NODE_24174_length_914_cov_110,Nsylvestris_NODE_22885_length_898_cov_41,84.012,688,70,24,169,824,696,17,3.07E-178,625,655,679
69951,Ntome_NODE_24220_length_911_cov_223,Nsylvestris_NODE_25595_length_739_cov_161,90.449,691,42,8,4,691,28,697,0,889,687,669
70043,Ntome_NODE_24268_length_908_cov_171,Nsylvestris_NODE_24793_length_784_cov_4,91.338,785,46,12,60,824,783,1,0,1053,764,782
70135,Ntome_NODE_24310_length_905_cov_30,Nsylvestris_NODE_28000_length_629_cov_10,89.418,567,31,7,257,821,629,90,0,688,564,539
70156,Ntome_NODE_24322_length_904_cov_207,Nsylvestris_NODE_24375_length_808_cov_176,94.351,655,28,4,203,849,737,84,0,996,646,653
70283,Ntome_NODE_24396_length_899_cov_99,Nsylvestris_NODE_23819_length_842_cov_65,90.943,806,34,19,1,782,791,1,0,1048,781,790
70326,Ntome_NODE_24422_length_897_cov_218,Nsylvestris_NODE_28860_length_589_cov_179,92.115,520,27,3,348,853,589,70,0,721,505,519
70330,Ntome_NODE_24424_length_897_cov_197,Nsylvestris_NODE_27556_length_648_cov_212,86.774,620,42,19,288,869,644,27,0,654,581,617
70361,Ntome_NODE_24441_length_896_cov_212,Nsylvestris_NODE_17604_length_1302_cov_206,95.764,897,32,4,1,896,103,994,0,1441,895,891
70393,Ntome_NODE_24460_length_895_cov_124,Nsylvestris_NODE_20114_length_1093_cov_31,94.013,618,21,8,33,635,1,617,0,922,602,616
70473,Ntome_NODE_24497_length_893_cov_8,Nsylvestris_NODE_31289_length_433_cov_4,84.365,307,37,7,579,883,134,431,1.25E-77,291,304,297
70501,Ntome_NODE_24513_length_891_cov_194,Nsylvestris_NODE_20279_length_1079_cov_187,96.203,790,26,2,50,839,820,35,0,1290,789,785
70552,Ntome_NODE_24536_length_890_cov_8,Nsylvestris_NODE_21625_length_983_cov_28,94.111,849,49,1,36,883,849,1,0,1290,847,848
70560,Ntome_NODE_24540_length_889_cov_161,Nsylvestris_NODE_26818_length_682_cov_42,90.625,448,30,8,422,865,636,197,5.08E-166,584,443,439
70629,Ntome_NODE_24575_length_887_cov_280,Nsylvestris_NODE_24854_length_780_cov_159,92.478,678,33,10,156,830,695,33,0,953,674,662
70634,Ntome_NODE_24578_length_887_cov_204,Nsylvestris_NODE_33741_length_329_cov_51,97.403,231,6,0,76,306,274,44,9.16E-109,394,230,230
70662,Ntome_NODE_24591_length_887_cov_5,Nsylvestris_NODE_31132_length_443_cov_4,95.937,443,18,0,97,539,443,1,0,719,442,442
70711,Ntome_NODE_24619_length_885_cov_8,Nsylvestris_NODE_31052_length_448_cov_5,92.692,260,16,3,573,830,37,295,4.28E-102,372,257,258
70730,Ntome_NODE_24628_length_884_cov_136,Nsylvestris_NODE_30508_length_485_cov_78,91.753,485,23,4,411,878,485,1,0,658,467,484
70739,Ntome_NODE_24638_length_885_cov_11,Nsylvestris_NODE_32750_length_362_cov_2,92.077,366,24,4,139,503,1,362,8.70E-144,510,364,361
70835,Ntome_NODE_24685_length_881_cov_222,Nsylvestris_NODE_22164_length_944_cov_179,95.626,823,21,6,4,825,851,43,0,1306,821,808
70868,Ntome_NODE_24702_length_880_cov_163,Nsylvestris_NODE_27139_length_667_cov_171,94.676,601,24,6,281,880,617,24,0,926,599,593
70913,Ntome_NODE_24726_length_878_cov_107,Nsylvestris_NODE_18560_length_1219_cov_173,94.759,725,38,0,113,837,240,964,0,1129,724,724
70918,Ntome_NODE_24729_length_878_cov_83,Nsylvestris_NODE_20264_length_1081_cov_193,91.319,887,41,13,2,878,1001,141,0,1179,876,860
70942,Ntome_NODE_24740_length_877_cov_219,Nsylvestris_NODE_21474_length_993_cov_174,90.995,744,54,8,49,784,778,40,0,990,735,738
70997,Ntome_NODE_24764_length_876_cov_222,Nsylvestris_NODE_27320_length_660_cov_189,94.921,630,18,3,223,849,619,1,0,974,626,618
70999,Ntome_NODE_24767_length_876_cov_152,Nsylvestris_NODE_8117_length_2385_cov_86,96.257,668,24,1,1,667,2300,1633,0,1094,666,667
71079,Ntome_NODE_24805_length_874_cov_68,Nsylvestris_NODE_30261_length_505_cov_11,90.303,165,16,0,168,332,505,341,2.10E-55,217,164,164
71130,Ntome_NODE_24832_length_873_cov_8,Nsylvestris_NODE_23176_length_880_cov_46,93.443,854,42,5,1,854,41,880,0,1254,853,839
71164,Ntome_NODE_24853_length_871_cov_224,Nsylvestris_NODE_23817_length_842_cov_91,87.427,684,36,17,162,841,168,805,0,741,679,637
71165,Ntome_NODE_24854_length_871_cov_188,Nsylvestris_NODE_26123_length_713_cov_28,94.052,538,30,2,130,666,13,549,0,815,536,536
71199,Ntome_NODE_24870_length_871_cov_5,Nsylvestris_NODE_18179_length_1252_cov_102,95.519,848,31,4,4,846,950,105,0,1349,842,845
71216,Ntome_NODE_24879_length_870_cov_208,Nsylvestris_NODE_30984_length_452_cov_184,92.641,462,20,6,186,646,1,449,0,652,460,448
71217,Ntome_NODE_24880_length_870_cov_207,Nsylvestris_NODE_22956_length_894_cov_119,91.436,794,47,15,26,810,828,47,0,1070,784,781
71236,Ntome_NODE_24891_length_870_cov_9,Nsylvestris_NODE_28495_length_606_cov_19,95.39,282,12,1,1,282,375,95,6.80E-125,448,281,280
71290,Ntome_NODE_24914_length_868_cov_235,Nsylvestris_NODE_23346_length_868_cov_208,95.735,680,27,2,1,680,122,799,0,1094,679,677
71339,Ntome_NODE_24938_length_867_cov_16,Nsylvestris_NODE_34683_length_303_cov_4,88.235,102,7,3,501,601,288,191,2.17E-25,117,100,97
71343,Ntome_NODE_24940_length_867_cov_13,Nsylvestris_NODE_22318_length_934_cov_49,91.482,857,61,8,2,854,881,33,0,1168,852,848
71360,Ntome_NODE_24949_length_866_cov_81,Nsylvestris_NODE_31395_length_426_cov_2,92,350,15,5,55,400,341,1,2.40E-134,479,345,340
71394,Ntome_NODE_24967_length_865_cov_170,Nsylvestris_NODE_23736_length_846_cov_178,93.162,819,40,12,15,821,32,846,0,1188,806,814
71424,Ntome_NODE_24983_length_864_cov_200,Nsylvestris_NODE_22821_length_901_cov_116,91.218,706,28,9,171,864,46,729,0,929,693,683
71503,Ntome_NODE_25023_length_862_cov_32,Nsylvestris_NODE_17131_length_1346_cov_105,94.016,869,27,8,1,862,476,1326,0,1293,861,850
71568,Ntome_NODE_25061_length_860_cov_17,Nsylvestris_NODE_25636_length_738_cov_8,94.03,737,44,0,79,815,2,738,0,1118,736,736
71633,Ntome_NODE_25096_length_858_cov_10,Nsylvestris_NODE_12166_length_1851_cov_184,100,55,0,0,804,858,1275,1221,6.01E-21,102,54,54
71661,Ntome_NODE_25110_length_857_cov_15,Nsylvestris_NODE_32405_length_376_cov_7,90.283,247,16,4,220,462,126,368,1.97E-85,316,242,242
71764,Ntome_NODE_25162_length_854_cov_7,Nsylvestris_NODE_22638_length_914_cov_5,78.167,600,58,22,216,747,597,3,7.06E-85,315,531,594
71802,Ntome_NODE_25185_length_852_cov_193,Nsylvestris_NODE_31845_length_401_cov_15,91.206,398,22,4,217,608,401,11,2.31E-149,529,391,390
71824,Ntome_NODE_25195_length_851_cov_264,Nsylvestris_NODE_27867_length_634_cov_203,88.889,522,37,9,1,505,30,547,1.03E-177,623,504,517
71837,Ntome_NODE_25200_length_851_cov_48,Nsylvestris_NODE_19755_length_1122_cov_58,97.503,801,20,0,49,849,231,1031,0,1369,800,800
71854,Ntome_NODE_25212_length_850_cov_248,Nsylvestris_NODE_22555_length_918_cov_200,92.946,808,35,7,46,850,60,848,0,1157,804,788
71906,Ntome_NODE_25239_length_848_cov_98,Nsylvestris_NODE_23116_length_883_cov_47,89.61,154,15,1,15,167,174,327,9.52E-49,195,152,153
71918,Ntome_NODE_25247_length_848_cov_8,Nsylvestris_NODE_34614_length_305_cov_3,94.059,303,18,0,94,396,303,1,8.50E-129,460,302,302
71922,Ntome_NODE_25253_length_847_cov_235,Nsylvestris_NODE_27445_length_653_cov_211,90.206,582,25,16,216,796,51,601,0,730,580,550
71968,Ntome_NODE_25276_length_845_cov_140,Nsylvestris_NODE_23160_length_881_cov_170,90.499,821,38,10,1,808,880,87,0,1048,807,793
72061,Ntome_NODE_25324_length_843_cov_91,Nsylvestris_NODE_26036_length_717_cov_10,88.04,602,57,11,136,728,633,38,0,699,592,595
72064,Ntome_NODE_25327_length_843_cov_20,Nsylvestris_NODE_34793_length_300_cov_4,79.167,288,49,8,442,719,12,298,4.40E-47,189,277,286
72075,Ntome_NODE_25335_length_842_cov_274,Nsylvestris_NODE_20761_length_1045_cov_213,98.207,725,12,1,63,786,19,743,0,1266,723,724
72084,Ntome_NODE_25340_length_841_cov_67,Nsylvestris_NODE_19372_length_1154_cov_92,95.504,734,30,3,56,789,210,940,0,1170,733,730
72086,Ntome_NODE_25342_length_842_cov_52,Nsylvestris_NODE_34625_length_304_cov_7,94.079,304,18,0,238,541,1,304,2.35E-129,462,303,303
72103,Ntome_NODE_25350_length_841_cov_37,Nsylvestris_NODE_22398_length_927_cov_143,89.985,679,67,1,53,730,57,735,0,876,677,678
72127,Ntome_NODE_25362_length_840_cov_259,Nsylvestris_NODE_23900_length_837_cov_190,91.716,845,46,12,8,840,833,1,0,1151,832,832
72182,Ntome_NODE_25397_length_839_cov_5,Nsylvestris_NODE_30222_length_508_cov_5,93.306,493,20,3,354,839,5,491,0,715,485,486
72198,Ntome_NODE_25404_length_838_cov_220,Nsylvestris_NODE_32082_length_390_cov_53,84.881,377,22,14,428,769,1,377,6.82E-95,348,341,376
72247,Ntome_NODE_25429_length_837_cov_8,Nsylvestris_NODE_33766_length_329_cov_3,88.35,309,24,5,182,489,8,305,8.75E-99,361,307,297
72302,Ntome_NODE_25459_length_835_cov_84,Nsylvestris_NODE_26887_length_678_cov_148,90.653,567,33,15,234,786,632,72,0,736,552,560
72315,Ntome_NODE_25465_length_835_cov_15,Nsylvestris_NODE_26673_length_688_cov_19,93.849,634,37,1,202,833,55,688,0,953,631,633
72328,Ntome_NODE_25475_length_834_cov_263,Nsylvestris_NODE_24672_length_790_cov_220,93.974,780,35,8,5,777,777,3,0,1170,772,774
72356,Ntome_NODE_25489_length_834_cov_14,Nsylvestris_NODE_36047_length_272_cov_4,91.078,269,18,6,1,266,7,272,3.14E-98,359,265,265
72369,Ntome_NODE_25499_length_833_cov_64,Nsylvestris_NODE_29752_length_549_cov_44,89.091,330,28,3,5,326,522,193,1.43E-111,403,321,329
72402,Ntome_NODE_25517_length_832_cov_88,Nsylvestris_NODE_19895_length_1110_cov_133,89.682,785,52,8,50,823,188,954,0,974,773,766
72480,Ntome_NODE_25553_length_830_cov_79,Nsylvestris_NODE_25725_length_732_cov_87,88.538,253,26,3,471,721,270,521,1.48E-81,303,250,251
72484,Ntome_NODE_25555_length_830_cov_52,Nsylvestris_NODE_32669_length_365_cov_3,85.323,402,22,9,175,576,1,365,6.66E-105,381,401,364
72555,Ntome_NODE_25591_length_828_cov_23,Nsylvestris_NODE_22824_length_901_cov_64,92.019,827,48,10,14,828,74,894,0,1146,814,820
72556,Ntome_NODE_25592_length_828_cov_18,Nsylvestris_NODE_32294_length_382_cov_1,83.577,274,38,4,522,794,103,370,1.96E-65,250,272,267
72557,Ntome_NODE_25593_length_828_cov_15,Nsylvestris_NODE_29822_length_543_cov_6,93.04,273,19,0,264,536,271,543,1.83E-110,399,272,272
72564,Ntome_NODE_25599_length_827_cov_279,Nsylvestris_NODE_24621_length_793_cov_200,88.86,781,53,9,46,821,36,787,0,929,775,751
72582,Ntome_NODE_25607_length_827_cov_34,Nsylvestris_NODE_24061_length_828_cov_24,92.09,708,38,12,98,795,762,63,0,981,697,699
72587,Ntome_NODE_25613_length_826_cov_256,Nsylvestris_NODE_24248_length_815_cov_196,91.905,803,51,4,1,797,800,6,0,1110,796,794
72591,Ntome_NODE_25615_length_826_cov_131,Nsylvestris_NODE_26974_length_674_cov_79,89.267,587,36,12,74,633,28,614,0,710,559,586
72635,Ntome_NODE_25642_length_825_cov_24,Nsylvestris_NODE_21313_length_1005_cov_56,90.655,824,60,6,5,817,107,924,0,1079,812,817
72644,Ntome_NODE_25648_length_825_cov_5,Nsylvestris_NODE_33524_length_336_cov_3,91.875,320,24,2,504,823,19,336,2.31E-124,446,319,317
72673,Ntome_NODE_25663_length_823_cov_254,Nsylvestris_NODE_24924_length_775_cov_85,92.5,640,19,11,136,758,35,662,0,889,622,627
72743,Ntome_NODE_25703_length_821_cov_8,Nsylvestris_NODE_33453_length_338_cov_2,89.489,333,17,9,288,606,333,5,3.91E-112,405,318,328
72798,Ntome_NODE_25731_length_819_cov_247,Nsylvestris_NODE_30022_length_525_cov_247,89.668,542,30,9,282,815,525,2,0,667,533,523
72840,Ntome_NODE_25762_length_818_cov_10,Nsylvestris_NODE_27722_length_641_cov_10,90.465,430,35,5,30,457,6,431,2.18E-159,562,427,425
72913,Ntome_NODE_25799_length_816_cov_21,Nsylvestris_NODE_35719_length_279_cov_4,89.753,283,16,3,292,565,1,279,1.85E-95,350,273,278
72950,Ntome_NODE_25824_length_814_cov_146,Nsylvestris_NODE_24636_length_792_cov_218,94.965,576,27,2,49,623,125,699,0,902,574,574
72981,Ntome_NODE_25839_length_813_cov_204,Nsylvestris_NODE_25549_length_741_cov_105,95,740,30,4,10,744,741,4,0,1155,734,737
73039,Ntome_NODE_25874_length_811_cov_120,Nsylvestris_NODE_23754_length_845_cov_58,93.944,677,39,1,137,811,102,778,0,1022,674,676
73045,Ntome_NODE_25878_length_811_cov_53,Nsylvestris_NODE_24425_length_805_cov_183,89.429,700,47,14,136,811,52,748,0,857,675,696
73098,Ntome_NODE_25896_length_810_cov_177,Nsylvestris_NODE_24775_length_784_cov_136,91.379,290,13,5,511,789,389,677,1.40E-106,387,278,288
73228,Ntome_NODE_25964_length_807_cov_205,Nsylvestris_NODE_5367_length_2893_cov_70,87.034,725,39,20,51,759,2831,2146,0,767,708,685
73229,Ntome_NODE_25965_length_807_cov_195,Nsylvestris_NODE_20637_length_1055_cov_179,93.3,791,40,6,25,807,212,997,0,1155,782,785
73276,Ntome_NODE_25993_length_806_cov_90,Nsylvestris_NODE_22386_length_930_cov_137,92.724,646,33,5,97,732,834,193,0,920,635,641
73324,Ntome_NODE_26032_length_805_cov_8,Nsylvestris_NODE_35640_length_281_cov_3,93.594,281,18,0,208,488,281,1,1.37E-116,420,280,280
73344,Ntome_NODE_26045_length_804_cov_106,Nsylvestris_NODE_22216_length_939_cov_46,93.026,717,33,6,2,707,8,718,0,1031,705,710
73398,Ntome_NODE_26072_length_803_cov_238,Nsylvestris_NODE_22834_length_900_cov_189,95.856,748,20,3,7,752,57,795,0,1199,745,738
73426,Ntome_NODE_26088_length_802_cov_253,Nsylvestris_NODE_22803_length_902_cov_193,88.075,696,53,12,48,735,849,176,0,798,687,673
73451,Ntome_NODE_26100_length_802_cov_18,Nsylvestris_NODE_35570_length_283_cov_1,94.7,283,15,0,468,750,1,283,1.05E-122,440,282,282
73558,Ntome_NODE_26154_length_798_cov_174,Nsylvestris_NODE_21812_length_968_cov_145,88.933,750,55,11,23,762,775,44,0,900,739,731
73574,Ntome_NODE_26163_length_799_cov_17,Nsylvestris_NODE_34266_length_314_cov_5,94.983,299,14,1,19,317,13,310,4.78E-131,468,298,297
73671,Ntome_NODE_26210_length_796_cov_276,Nsylvestris_NODE_23536_length_857_cov_208,94.645,691,34,3,53,742,114,802,0,1068,689,688
73788,Ntome_NODE_26274_length_793_cov_224,Nsylvestris_NODE_24070_length_827_cov_183,93.234,739,37,6,52,786,748,19,0,1075,734,729
73872,Ntome_NODE_26322_length_791_cov_30,Nsylvestris_NODE_23365_length_868_cov_148,90.254,749,41,9,2,750,111,827,0,950,748,716
73901,Ntome_NODE_26345_length_790_cov_11,Nsylvestris_NODE_32202_length_385_cov_5,88.974,390,24,10,26,402,384,1,6.11E-130,464,376,383
73902,Ntome_NODE_26348_length_790_cov_8,Nsylvestris_NODE_34231_length_315_cov_5,93.514,185,12,0,1,185,94,278,3.07E-73,276,184,184
73919,Ntome_NODE_26358_length_789_cov_60,Nsylvestris_NODE_28720_length_596_cov_221,86.149,592,27,16,203,784,50,596,3.47E-167,588,581,546
73947,Ntome_NODE_26373_length_788_cov_235,Nsylvestris_NODE_5923_length_2776_cov_136,95.779,616,23,3,3,618,1,613,0,990,615,612
73952,Ntome_NODE_26378_length_788_cov_86,Nsylvestris_NODE_34491_length_308_cov_4,96.753,308,10,0,226,533,308,1,5.97E-145,514,307,307
74019,Ntome_NODE_26417_length_786_cov_36,Nsylvestris_NODE_26030_length_717_cov_33,93.494,707,43,3,1,706,1,705,0,1048,705,704
74052,Ntome_NODE_26436_length_785_cov_185,Nsylvestris_NODE_27617_length_646_cov_17,96.604,589,20,0,60,648,3,591,0,977,588,588
74093,Ntome_NODE_26462_length_784_cov_36,Nsylvestris_NODE_23131_length_883_cov_56,93.182,440,25,5,204,643,328,762,0,641,439,434
74147,Ntome_NODE_26493_length_783_cov_6,Nsylvestris_NODE_34674_length_303_cov_5,92.739,303,21,1,309,610,1,303,1.32E-121,436,301,302
74148,Ntome_NODE_26494_length_783_cov_5,Nsylvestris_NODE_24316_length_812_cov_5,96.028,705,21,2,1,705,115,812,0,1140,704,697
74163,Ntome_NODE_26502_length_782_cov_39,Nsylvestris_NODE_31182_length_439_cov_10,88.889,468,18,8,167,632,4,439,2.10E-154,545,465,435
74231,Ntome_NODE_26534_length_780_cov_248,Nsylvestris_NODE_20354_length_1073_cov_157,96.532,692,23,1,35,725,335,1026,0,1144,690,691
74253,Ntome_NODE_26548_length_780_cov_12,Nsylvestris_NODE_35919_length_275_cov_3,87.008,254,31,1,193,444,2,255,5.04E-76,285,251,253
74280,Ntome_NODE_26571_length_778_cov_257,Nsylvestris_NODE_30632_length_476_cov_19,89.955,448,38,6,153,596,476,32,3.45E-162,571,443,444
74288,Ntome_NODE_26578_length_778_cov_22,Nsylvestris_NODE_29146_length_577_cov_11,96.007,576,22,1,98,672,2,577,0,935,574,575
74302,Ntome_NODE_26592_length_778_cov_4,Nsylvestris_NODE_25806_length_728_cov_12,88.01,417,29,9,370,765,525,109,9.99E-133,473,395,416
74333,Ntome_NODE_26613_length_777_cov_15,Nsylvestris_NODE_14939_length_1556_cov_107,92.636,679,48,1,71,749,273,949,0,976,678,676
74342,Ntome_NODE_26621_length_777_cov_5,Nsylvestris_NODE_33259_length_344_cov_4,94.783,345,17,1,270,614,344,1,1.26E-151,536,344,343
74349,Ntome_NODE_26626_length_776_cov_90,Nsylvestris_NODE_25862_length_725_cov_125,90.698,645,16,14,110,736,104,722,0,819,626,618
74383,Ntome_NODE_26647_length_775_cov_227,Nsylvestris_NODE_23616_length_853_cov_159,94.35,761,22,10,31,775,28,783,0,1147,744,755
74384,Ntome_NODE_26648_length_775_cov_184,Nsylvestris_NODE_22560_length_918_cov_111,95.751,659,24,3,54,710,800,144,0,1059,656,656
74463,Ntome_NODE_26692_length_773_cov_100,Nsylvestris_NODE_23685_length_849_cov_190,97.426,544,14,0,51,594,306,849,0,928,543,543
74474,Ntome_NODE_26697_length_773_cov_34,Nsylvestris_NODE_36283_length_267_cov_2,95.506,267,12,0,289,555,267,1,7.84E-119,427,266,266
74522,Ntome_NODE_26727_length_772_cov_5,Nsylvestris_NODE_32352_length_379_cov_2,93.298,373,19,1,194,560,377,5,2.07E-154,545,366,372
74624,Ntome_NODE_26772_length_769_cov_27,Nsylvestris_NODE_14190_length_1631_cov_85,79.016,386,55,12,299,681,860,1222,1.09E-62,241,382,362
74648,Ntome_NODE_26786_length_768_cov_169,Nsylvestris_NODE_23192_length_879_cov_133,92.056,642,17,5,1,626,198,821,0,872,625,623
74662,Ntome_NODE_26796_length_768_cov_6,Nsylvestris_NODE_22327_length_933_cov_59,93.447,763,41,1,1,763,172,925,0,1123,762,753
74837,Ntome_NODE_26901_length_763_cov_263,Nsylvestris_NODE_21119_length_1020_cov_167,92.105,760,23,10,25,763,2,745,0,1037,738,743
74844,Ntome_NODE_26905_length_763_cov_167,Nsylvestris_NODE_23880_length_839_cov_173,96.828,725,22,1,29,753,795,72,0,1210,724,723
74870,Ntome_NODE_26919_length_762_cov_239,Nsylvestris_NODE_28674_length_598_cov_223,92.308,598,25,9,9,597,7,592,0,830,588,585
74887,Ntome_NODE_26928_length_762_cov_31,Nsylvestris_NODE_25538_length_742_cov_15,89.909,773,36,15,1,762,742,1,0,957,761,741
74964,Ntome_NODE_26969_length_760_cov_49,Nsylvestris_NODE_25206_length_760_cov_19,94.362,745,36,3,19,760,1,742,0,1138,741,741
74997,Ntome_NODE_26986_length_759_cov_48,Nsylvestris_NODE_24674_length_790_cov_71,91.304,759,30,6,1,759,745,23,0,1003,758,722
75009,Ntome_NODE_27000_length_758_cov_182,Nsylvestris_NODE_30015_length_526_cov_19,86.111,540,35,14,140,655,524,1,2.03E-154,545,515,523
75012,Ntome_NODE_27004_length_758_cov_30,Nsylvestris_NODE_24301_length_812_cov_62,91.344,774,42,12,1,757,45,810,0,1035,756,765
75023,Ntome_NODE_27012_length_758_cov_3,Nsylvestris_NODE_24363_length_809_cov_22,95.994,724,29,0,23,746,808,85,0,1177,723,723
75062,Ntome_NODE_27034_length_757_cov_9,Nsylvestris_NODE_23626_length_853_cov_8,83.198,369,45,13,1,366,645,291,3.72E-87,322,365,354
75132,Ntome_NODE_27080_length_754_cov_224,Nsylvestris_NODE_25164_length_762_cov_177,92.173,741,44,7,12,752,753,27,0,1035,740,726
75166,Ntome_NODE_27098_length_753_cov_230,Nsylvestris_NODE_26534_length_694_cov_168,94.703,623,33,0,53,675,681,59,0,968,622,622
75179,Ntome_NODE_27109_length_753_cov_4,Nsylvestris_NODE_33157_length_347_cov_6,91.404,349,22,5,126,474,6,346,3.48E-132,472,348,340
75194,Ntome_NODE_27117_length_752_cov_76,Nsylvestris_NODE_26464_length_697_cov_149,97.951,244,4,1,386,628,408,651,3.54E-117,422,242,243
75214,Ntome_NODE_27126_length_752_cov_11,Nsylvestris_NODE_31247_length_436_cov_2,93.111,450,15,10,190,638,2,436,0,645,448,434
75231,Ntome_NODE_27135_length_751_cov_55,Nsylvestris_NODE_22844_length_900_cov_121,94.641,765,24,8,3,751,126,889,0,1170,748,763
75282,Ntome_NODE_27161_length_750_cov_18,Nsylvestris_NODE_26148_length_712_cov_16,94.608,612,32,1,86,696,100,711,0,946,610,611
75340,Ntome_NODE_27197_length_748_cov_188,Nsylvestris_NODE_23858_length_840_cov_142,94.331,688,24,8,5,687,815,138,0,1040,682,677
75345,Ntome_NODE_27202_length_748_cov_31,Nsylvestris_NODE_27205_length_664_cov_39,90.909,638,35,7,67,685,1,634,0,835,618,633
75441,Ntome_NODE_27250_length_746_cov_13,Nsylvestris_NODE_30834_length_462_cov_5,82.292,192,21,5,523,713,374,195,1.42E-36,154,190,179
75452,Ntome_NODE_27255_length_746_cov_8,Nsylvestris_NODE_26198_length_710_cov_7,94.842,698,34,1,7,704,697,2,0,1088,697,695
75453,Ntome_NODE_27256_length_746_cov_8,Nsylvestris_NODE_16901_length_1365_cov_64,95.935,738,30,0,9,746,1306,569,0,1197,737,737
75462,Ntome_NODE_27260_length_745_cov_206,Nsylvestris_NODE_26767_length_684_cov_215,87.599,629,44,22,7,624,27,632,0,699,617,605
75463,Ntome_NODE_27262_length_745_cov_94,Nsylvestris_NODE_25071_length_767_cov_105,86.329,395,41,12,351,742,715,331,4.54E-116,418,391,384
75499,Ntome_NODE_27280_length_744_cov_87,Nsylvestris_NODE_20193_length_1087_cov_46,94.659,674,36,0,51,724,694,21,0,1046,673,673
75530,Ntome_NODE_27296_length_744_cov_2,Nsylvestris_NODE_17014_length_1356_cov_162,95.289,743,29,4,1,739,534,1274,0,1173,738,740
75561,Ntome_NODE_27317_length_742_cov_103,Nsylvestris_NODE_23364_length_868_cov_154,91.726,701,34,8,49,738,775,88,0,952,689,687
75562,Ntome_NODE_27318_length_742_cov_62,Nsylvestris_NODE_26697_length_687_cov_106,88.292,726,30,19,25,734,687,1,0,819,709,686
75585,Ntome_NODE_27331_length_742_cov_6,Nsylvestris_NODE_34910_length_297_cov_6,96.296,297,11,0,206,502,297,1,3.40E-137,488,296,296
75613,Ntome_NODE_27346_length_741_cov_10,Nsylvestris_NODE_24712_length_788_cov_62,72.688,703,163,23,38,723,3,693,1.06E-52,207,685,690
75639,Ntome_NODE_27362_length_740_cov_16,Nsylvestris_NODE_31986_length_394_cov_20,95.431,394,18,0,202,595,1,394,1.91E-179,628,393,393
75671,Ntome_NODE_27384_length_739_cov_9,Nsylvestris_NODE_21121_length_1020_cov_56,81.818,132,21,2,261,389,1,132,1.11E-22,108,128,131
75685,Ntome_NODE_27392_length_738_cov_64,Nsylvestris_NODE_25628_length_738_cov_24,94.436,683,37,1,1,683,682,1,0,1050,682,681
75686,Ntome_NODE_27393_length_738_cov_55,Nsylvestris_NODE_11607_length_1918_cov_211,100,55,0,0,1,55,312,258,5.14E-21,102,54,54
75701,Ntome_NODE_27404_length_738_cov_5,Nsylvestris_NODE_25309_length_754_cov_91,89.009,646,43,13,65,690,47,684,0,774,625,637
75778,Ntome_NODE_27446_length_735_cov_185,Nsylvestris_NODE_23737_length_846_cov_172,98.182,55,1,0,589,643,265,211,2.38E-19,97.1,54,54
75781,Ntome_NODE_27449_length_735_cov_56,Nsylvestris_NODE_25511_length_743_cov_48,91.213,569,25,8,158,706,643,80,0,750,548,563
75805,Ntome_NODE_27461_length_735_cov_5,Nsylvestris_NODE_31511_length_419_cov_6,96.217,423,10,2,243,665,417,1,0,688,422,416
75815,Ntome_NODE_27469_length_734_cov_38,Nsylvestris_NODE_29804_length_544_cov_20,91.583,499,31,7,174,672,1,488,0,678,498,487
75843,Ntome_NODE_27491_length_733_cov_21,Nsylvestris_NODE_22669_length_911_cov_72,87.483,751,53,25,16,733,133,875,0,828,717,742
75887,Ntome_NODE_27513_length_731_cov_221,Nsylvestris_NODE_31040_length_448_cov_31,89.017,346,32,5,291,633,343,1,9.57E-118,424,342,342
75911,Ntome_NODE_27534_length_731_cov_3,Nsylvestris_NODE_19414_length_1151_cov_14,91.787,694,54,3,3,695,323,1014,0,963,692,691
75930,Ntome_NODE_27544_length_730_cov_91,Nsylvestris_NODE_28729_length_596_cov_85,90.773,401,24,3,318,715,203,593,9.16E-148,523,397,390
75948,Ntome_NODE_27556_length_730_cov_10,Nsylvestris_NODE_14183_length_1632_cov_56,85.915,568,46,18,145,695,600,50,2.49E-163,575,550,550
75955,Ntome_NODE_27560_length_730_cov_6,Nsylvestris_NODE_24560_length_798_cov_11,85.449,701,55,25,49,730,1,673,0,686,681,672
75968,Ntome_NODE_27568_length_729_cov_100,Nsylvestris_NODE_23078_length_886_cov_60,91.107,506,32,6,27,525,76,575,0,673,498,499
76005,Ntome_NODE_27591_length_728_cov_143,Nsylvestris_NODE_17356_length_1327_cov_16,89.032,310,30,4,1,308,631,938,5.82E-105,381,307,307
76024,Ntome_NODE_27603_length_728_cov_11,Nsylvestris_NODE_24177_length_821_cov_16,92.17,728,31,9,1,728,766,65,0,1005,727,701
76032,Ntome_NODE_27612_length_728_cov_5,Nsylvestris_NODE_18226_length_1248_cov_15,95.166,724,25,4,1,716,724,3,0,1134,715,721
76094,Ntome_NODE_27644_length_726_cov_84,Nsylvestris_NODE_26444_length_698_cov_173,92.427,647,36,3,66,712,668,35,0,911,646,633
76099,Ntome_NODE_27650_length_726_cov_27,Nsylvestris_NODE_25906_length_723_cov_44,89.45,673,46,8,9,664,689,25,0,826,655,664
76180,Ntome_NODE_27694_length_724_cov_19,Nsylvestris_NODE_30680_length_472_cov_6,95.339,472,16,4,43,510,472,3,0,745,467,469
76269,Ntome_NODE_27738_length_723_cov_6,Nsylvestris_NODE_33255_length_344_cov_5,89.489,352,22,8,336,683,341,1,5.66E-120,431,347,340
76280,Ntome_NODE_27744_length_722_cov_184,Nsylvestris_NODE_26235_length_708_cov_27,94.961,635,25,2,1,628,635,1,0,989,627,634
76340,Ntome_NODE_27780_length_721_cov_12,Nsylvestris_NODE_33483_length_337_cov_4,91.746,315,9,6,1,313,38,337,3.39E-117,422,312,299
76345,Ntome_NODE_27785_length_721_cov_7,Nsylvestris_NODE_33484_length_337_cov_4,90.728,302,20,5,417,712,337,38,2.06E-109,396,295,299
76376,Ntome_NODE_27804_length_720_cov_7,Nsylvestris_NODE_32917_length_356_cov_3,95.706,326,12,2,9,334,1,324,9.03E-148,523,325,323
76432,Ntome_NODE_27837_length_718_cov_9,Nsylvestris_NODE_21913_length_961_cov_26,94.868,721,34,1,1,718,882,162,0,1123,717,720
76528,Ntome_NODE_27902_length_715_cov_2,Nsylvestris_NODE_14127_length_1638_cov_36,97.331,712,19,0,4,715,1323,612,0,1210,711,711
76661,Ntome_NODE_27983_length_711_cov_39,Nsylvestris_NODE_31111_length_444_cov_80,91.241,411,15,7,257,646,2,412,8.85E-153,540,389,410
76695,Ntome_NODE_28004_length_710_cov_48,Nsylvestris_NODE_26726_length_686_cov_18,81.008,516,61,25,8,488,3,516,2.64E-103,375,480,513
76697,Ntome_NODE_28006_length_710_cov_28,Nsylvestris_NODE_31428_length_424_cov_4,92.235,425,32,1,132,556,424,1,4.00E-171,601,424,423
76713,Ntome_NODE_28014_length_710_cov_3,Nsylvestris_NODE_29378_length_568_cov_11,90.359,446,31,6,142,578,126,568,2.42E-163,575,436,442
76735,Ntome_NODE_28034_length_709_cov_4,Nsylvestris_NODE_27728_length_641_cov_6,85.645,411,41,8,104,508,243,641,1.55E-115,416,404,398
76785,Ntome_NODE_28066_length_707_cov_13,Nsylvestris_NODE_26810_length_683_cov_6,90.909,649,32,11,16,655,649,19,0,846,639,630
76787,Ntome_NODE_28068_length_707_cov_11,Nsylvestris_NODE_27423_length_655_cov_4,87.915,422,26,12,118,524,653,242,9.05E-133,473,406,411
76816,Ntome_NODE_28089_length_706_cov_53,Nsylvestris_NODE_32199_length_385_cov_8,95.584,385,17,0,83,467,385,1,3.95E-176,617,384,384
76863,Ntome_NODE_28118_length_705_cov_8,Nsylvestris_NODE_35096_length_293_cov_2,86.466,133,11,5,17,142,2,134,3.74E-32,139,125,132
76864,Ntome_NODE_28119_length_705_cov_7,Nsylvestris_NODE_29625_length_558_cov_8,93.482,537,19,5,163,685,558,24,0,784,522,534
76889,Ntome_NODE_28131_length_704_cov_103,Nsylvestris_NODE_27545_length_649_cov_19,92.936,637,45,0,37,673,637,1,0,928,636,636
76904,Ntome_NODE_28139_length_704_cov_21,Nsylvestris_NODE_29628_length_558_cov_6,91.971,548,29,4,169,701,1,548,0,754,532,547
76917,Ntome_NODE_28145_length_704_cov_5,Nsylvestris_NODE_34829_length_299_cov_4,91.837,147,9,2,36,180,153,298,4.70E-51,202,144,145
76965,Ntome_NODE_28168_length_703_cov_11,Nsylvestris_NODE_26081_length_715_cov_13,94.034,704,38,2,1,703,2,702,0,1064,702,700
77032,Ntome_NODE_28207_length_701_cov_11,Nsylvestris_NODE_23997_length_832_cov_57,96.724,702,21,2,1,701,86,786,0,1168,700,700
77072,Ntome_NODE_28229_length_700_cov_4,Nsylvestris_NODE_33832_length_327_cov_4,89.439,303,22,8,108,409,294,1,9.35E-103,374,301,293
77169,Ntome_NODE_28276_length_698_cov_59,Nsylvestris_NODE_35743_length_278_cov_12,90.517,232,15,1,474,698,267,36,1.60E-80,300,224,231
77180,Ntome_NODE_28282_length_698_cov_23,Nsylvestris_NODE_31251_length_435_cov_23,90.492,305,27,2,3,306,435,132,4.28E-111,401,303,303
77208,Ntome_NODE_28298_length_698_cov_6,Nsylvestris_NODE_20725_length_1048_cov_10,91.717,664,47,6,1,663,357,1013,0,915,662,656
77234,Ntome_NODE_28309_length_697_cov_15,Nsylvestris_NODE_16032_length_1447_cov_17,86.325,468,41,10,121,572,1312,852,3.19E-137,488,451,460
77289,Ntome_NODE_28350_length_695_cov_8,Nsylvestris_NODE_21124_length_1020_cov_28,95.54,695,30,1,1,695,100,793,0,1110,694,693
77297,Ntome_NODE_28356_length_695_cov_3,Nsylvestris_NODE_15851_length_1464_cov_7,89.937,636,56,6,1,633,828,1458,0,813,632,630
77305,Ntome_NODE_28360_length_694_cov_220,Nsylvestris_NODE_28216_length_619_cov_176,90.774,607,48,7,50,653,1,602,0,804,603,601
77341,Ntome_NODE_28379_length_694_cov_9,Nsylvestris_NODE_34034_length_322_cov_3,77.551,245,39,11,359,599,69,301,1.71E-30,134,240,232
77347,Ntome_NODE_28385_length_694_cov_3,Nsylvestris_NODE_31137_length_443_cov_3,89.316,234,21,3,1,231,251,19,9.60E-78,291,230,232
77377,Ntome_NODE_28409_length_692_cov_29,Nsylvestris_NODE_30994_length_452_cov_5,88.788,330,37,0,296,625,1,330,3.28E-112,405,329,329
77415,Ntome_NODE_28436_length_691_cov_25,Nsylvestris_NODE_25771_length_730_cov_23,92.89,661,34,5,30,683,1,655,0,948,653,654
77429,Ntome_NODE_28454_length_690_cov_43,Nsylvestris_NODE_24269_length_814_cov_37,90.359,612,51,6,1,611,744,140,0,797,610,604
77561,Ntome_NODE_28519_length_688_cov_17,Nsylvestris_NODE_24696_length_789_cov_56,93.353,692,31,7,1,687,58,739,0,1009,686,681
77590,Ntome_NODE_28533_length_687_cov_165,Nsylvestris_NODE_26445_length_698_cov_170,93.294,686,29,5,6,674,13,698,0,996,668,685
77635,Ntome_NODE_28562_length_686_cov_7,Nsylvestris_NODE_26586_length_692_cov_16,88.235,357,37,3,294,646,109,464,3.22E-117,422,352,355
77658,Ntome_NODE_28573_length_685_cov_50,Nsylvestris_NODE_21959_length_958_cov_148,92.901,648,32,6,1,639,860,218,0,929,638,642
77665,Ntome_NODE_28576_length_685_cov_21,Nsylvestris_NODE_29300_length_571_cov_11,80.993,584,76,16,49,620,11,571,5.35E-120,431,571,560
77709,Ntome_NODE_28600_length_684_cov_67,Nsylvestris_NODE_29819_length_543_cov_7,95.316,427,17,2,54,480,120,543,0,675,426,423
77732,Ntome_NODE_28618_length_683_cov_55,Nsylvestris_NODE_29391_length_567_cov_180,90.353,539,37,8,131,657,8,543,0,693,526,535
77735,Ntome_NODE_28620_length_683_cov_44,Nsylvestris_NODE_24208_length_818_cov_152,86.877,381,42,5,309,683,405,27,1.15E-116,420,374,378
77785,Ntome_NODE_28645_length_682_cov_30,Nsylvestris_NODE_18468_length_1227_cov_82,93.182,44,2,1,517,560,418,376,2.24E-09,63.9,43,42
77825,Ntome_NODE_28671_length_681_cov_190,Nsylvestris_NODE_25165_length_762_cov_165,92.193,538,41,1,99,635,674,137,0,760,536,537
77857,Ntome_NODE_28695_length_680_cov_247,Nsylvestris_NODE_28687_length_598_cov_22,95.265,528,22,2,109,635,598,73,0,833,526,525
77861,Ntome_NODE_28697_length_680_cov_210,Nsylvestris_NODE_24354_length_809_cov_154,92.748,524,24,5,84,595,674,153,0,745,511,521
77896,Ntome_NODE_28722_length_679_cov_58,Nsylvestris_NODE_25414_length_748_cov_90,92.251,684,30,4,14,674,34,717,0,948,660,683
77926,Ntome_NODE_28741_length_679_cov_3,Nsylvestris_NODE_30961_length_454_cov_3,83.929,224,16,9,456,679,2,205,2.10E-49,196,223,203
77984,Ntome_NODE_28780_length_677_cov_19,Nsylvestris_NODE_32182_length_386_cov_6,85.823,395,17,14,148,512,386,1,1.50E-105,383,364,385
78012,Ntome_NODE_28797_length_676_cov_37,Nsylvestris_NODE_31024_length_449_cov_11,88.862,413,38,6,60,470,27,433,3.96E-141,501,410,406
78043,Ntome_NODE_28818_length_675_cov_68,Nsylvestris_NODE_25096_length_766_cov_131,87.561,619,39,16,58,671,683,98,0,682,613,585
78098,Ntome_NODE_28857_length_674_cov_8,Nsylvestris_NODE_23560_length_856_cov_13,85.985,685,66,15,6,674,677,7,0,706,668,670
78124,Ntome_NODE_28876_length_673_cov_10,Nsylvestris_NODE_28272_length_616_cov_3,93.41,607,28,5,1,607,22,616,0,889,606,594
78265,Ntome_NODE_28968_length_669_cov_51,Nsylvestris_NODE_23018_length_890_cov_58,94.558,588,24,4,36,620,846,264,0,902,584,582
78342,Ntome_NODE_29007_length_668_cov_8,Nsylvestris_NODE_30101_length_518_cov_10,91.441,222,17,2,375,596,3,222,1.18E-81,303,221,219
78355,Ntome_NODE_29017_length_667_cov_179,Nsylvestris_NODE_20502_length_1064_cov_101,96.6,500,15,2,116,615,886,389,0,828,499,497
78400,Ntome_NODE_29043_length_666_cov_27,Nsylvestris_NODE_22806_length_902_cov_148,86.866,670,51,16,1,661,201,842,0,715,660,641
78413,Ntome_NODE_29051_length_666_cov_7,Nsylvestris_NODE_32614_length_367_cov_5,95.095,367,15,1,255,618,367,1,2.27E-163,575,363,366
78419,Ntome_NODE_29056_length_665_cov_238,Nsylvestris_NODE_28888_length_588_cov_85,89.807,569,33,13,13,575,10,559,0,706,562,549
78430,Ntome_NODE_29065_length_665_cov_31,Nsylvestris_NODE_33929_length_324_cov_5,77.389,314,43,12,111,400,15,324,7.51E-39,161,289,309
78464,Ntome_NODE_29084_length_665_cov_4,Nsylvestris_NODE_33354_length_341_cov_2,90.058,342,33,1,266,607,1,341,2.40E-123,442,341,340
78517,Ntome_NODE_29107_length_664_cov_10,Nsylvestris_NODE_15148_length_1535_cov_98,87.5,96,11,1,403,497,516,421,2.76E-23,110,94,95
78523,Ntome_NODE_29111_length_664_cov_5,Nsylvestris_NODE_29644_length_557_cov_6,93.814,388,20,2,1,387,385,1,4.86E-165,580,386,384
78539,Ntome_NODE_29119_length_663_cov_237,Nsylvestris_NODE_29889_length_537_cov_11,88.699,469,37,9,55,511,530,66,2.27E-158,558,456,464
78550,Ntome_NODE_29126_length_663_cov_22,Nsylvestris_NODE_23799_length_841_cov_74,84.716,229,28,5,6,229,722,496,3.39E-57,222,223,226
78579,Ntome_NODE_29148_length_662_cov_36,Nsylvestris_NODE_24351_length_809_cov_189,89.388,490,40,7,60,545,743,262,7.99E-173,606,485,481
78589,Ntome_NODE_29157_length_662_cov_11,Nsylvestris_NODE_29498_length_563_cov_23,88.408,578,11,18,126,662,1,563,0,645,536,562
78650,Ntome_NODE_29194_length_660_cov_56,Nsylvestris_NODE_28316_length_613_cov_110,93.648,614,25,7,15,622,606,1,0,905,607,605
78651,Ntome_NODE_29195_length_660_cov_44,Nsylvestris_NODE_18380_length_1232_cov_96,84.153,183,25,4,455,635,470,650,9.57E-43,174,180,180
78677,Ntome_NODE_29209_length_660_cov_7,Nsylvestris_NODE_32217_length_385_cov_2,92.683,369,16,7,1,368,24,382,2.97E-147,521,367,358
78688,Ntome_NODE_29215_length_659_cov_192,Nsylvestris_NODE_26301_length_705_cov_44,89.247,651,23,18,21,659,72,687,0,771,638,615
78695,Ntome_NODE_29218_length_659_cov_100,Nsylvestris_NODE_28050_length_626_cov_35,90.747,616,34,12,12,617,1,603,0,800,605,602
78723,Ntome_NODE_29237_length_659_cov_7,Nsylvestris_NODE_29533_length_562_cov_9,92.491,546,28,3,50,584,13,556,0,769,534,543
78794,Ntome_NODE_29281_length_657_cov_15,Nsylvestris_NODE_17648_length_1298_cov_197,81.771,192,27,5,116,299,532,723,1.24E-36,154,183,191
78803,Ntome_NODE_29299_length_656_cov_107,Nsylvestris_NODE_27273_length_661_cov_69,90.844,557,29,6,121,656,608,53,0,726,535,555
78821,Ntome_NODE_29308_length_656_cov_24,Nsylvestris_NODE_5661_length_2825_cov_50,84.286,210,23,5,438,639,2601,2808,2.03E-49,196,201,207
78927,Ntome_NODE_29375_length_653_cov_202,Nsylvestris_NODE_26448_length_698_cov_84,93.186,587,25,14,18,595,2,582,0,848,577,580
78995,Ntome_NODE_29415_length_651_cov_191,Nsylvestris_NODE_28315_length_613_cov_190,87.776,589,29,20,3,581,9,564,0,649,578,555
79047,Ntome_NODE_29442_length_650_cov_64,Nsylvestris_NODE_25269_length_756_cov_144,90.476,462,29,6,1,457,690,239,1.70E-169,595,456,451
79053,Ntome_NODE_29447_length_650_cov_19,Nsylvestris_NODE_34473_length_309_cov_3,94.419,215,12,0,436,650,309,95,5.28E-90,331,214,214
79064,Ntome_NODE_29456_length_650_cov_6,Nsylvestris_NODE_33658_length_332_cov_4,88.52,331,38,0,291,621,2,332,3.97E-111,401,330,330
79098,Ntome_NODE_29474_length_649_cov_19,Nsylvestris_NODE_27298_length_660_cov_19,91.239,662,41,8,2,649,2,660,0,885,647,658
79120,Ntome_NODE_29487_length_649_cov_4,Nsylvestris_NODE_11019_length_1985_cov_42,93.178,557,30,4,97,648,1406,1959,0,811,551,553
79126,Ntome_NODE_29489_length_648_cov_290,Nsylvestris_NODE_26004_length_718_cov_217,92.054,516,40,1,112,627,668,154,0,725,515,514
79174,Ntome_NODE_29524_length_647_cov_123,Nsylvestris_NODE_19643_length_1131_cov_203,91.068,571,25,9,4,558,124,684,0,749,554,560
79179,Ntome_NODE_29527_length_647_cov_72,Nsylvestris_NODE_25723_length_732_cov_151,89.465,617,45,7,2,600,31,645,0,761,598,614
79255,Ntome_NODE_29570_length_645_cov_218,Nsylvestris_NODE_30699_length_471_cov_178,93.651,315,20,0,48,362,364,50,2.96E-132,472,314,314
79333,Ntome_NODE_29620_length_643_cov_104,Nsylvestris_NODE_28368_length_611_cov_51,91.829,514,25,5,102,601,1,511,0,701,499,510
79414,Ntome_NODE_29666_length_641_cov_205,Nsylvestris_NODE_23221_length_877_cov_100,88.324,531,18,10,83,588,512,1,4.65E-170,597,505,511
79468,Ntome_NODE_29701_length_640_cov_10,Nsylvestris_NODE_27430_length_654_cov_98,97.55,449,11,0,1,449,158,606,0,769,448,448
79501,Ntome_NODE_29727_length_639_cov_15,Nsylvestris_NODE_29020_length_583_cov_11,96.822,535,17,0,1,535,535,1,0,894,534,534
79514,Ntome_NODE_29746_length_638_cov_189,Nsylvestris_NODE_19145_length_1172_cov_56,93.182,44,1,2,75,117,298,256,2.09E-09,63.9,42,42
79532,Ntome_NODE_29760_length_638_cov_8,Nsylvestris_NODE_23808_length_843_cov_6,84.95,598,70,11,1,580,598,3,2.78E-167,588,579,595
79537,Ntome_NODE_29764_length_638_cov_6,Nsylvestris_NODE_24170_length_821_cov_219,93.74,639,20,2,1,635,39,661,0,941,634,622
79600,Ntome_NODE_29794_length_636_cov_54,Nsylvestris_NODE_35022_length_295_cov_2,96.271,295,11,0,167,461,295,1,3.75E-136,484,294,294
79679,Ntome_NODE_29841_length_634_cov_18,Nsylvestris_NODE_29120_length_578_cov_49,93.514,555,28,5,82,629,554,1,0,819,547,553
79787,Ntome_NODE_29895_length_632_cov_22,Nsylvestris_NODE_23171_length_880_cov_109,90.769,650,34,4,1,624,190,839,0,845,623,649
79862,Ntome_NODE_29937_length_630_cov_154,Nsylvestris_NODE_30105_length_518_cov_4,95.858,169,7,0,71,239,1,169,8.74E-73,274,168,168
79961,Ntome_NODE_29994_length_628_cov_7,Nsylvestris_NODE_25157_length_763_cov_9,97.963,589,12,0,37,625,1,589,0,1022,588,588
79978,Ntome_NODE_30008_length_627_cov_22,Nsylvestris_NODE_24376_length_808_cov_123,86.458,576,57,10,54,627,685,129,1.62E-174,612,573,556
79993,Ntome_NODE_30017_length_627_cov_12,Nsylvestris_NODE_31806_length_403_cov_5,96.114,386,15,0,141,526,1,386,4.48E-180,630,385,385
79997,Ntome_NODE_30021_length_627_cov_8,Nsylvestris_NODE_27675_length_643_cov_11,91.978,536,42,1,42,577,2,536,0,750,535,534
80009,Ntome_NODE_30031_length_626_cov_131,Nsylvestris_NODE_30248_length_506_cov_12,95.069,507,16,4,106,606,3,506,0,789,500,503
80022,Ntome_NODE_30039_length_626_cov_18,Nsylvestris_NODE_27875_length_634_cov_17,92.308,221,12,3,407,626,252,36,2.38E-83,309,219,216
80055,Ntome_NODE_30057_length_625_cov_101,Nsylvestris_NODE_29982_length_529_cov_108,87.711,415,34,7,108,521,529,131,3.71E-131,468,413,398
80065,Ntome_NODE_30064_length_625_cov_23,Nsylvestris_NODE_25948_length_721_cov_85,93.849,634,22,8,1,621,657,28,0,939,620,629
80102,Ntome_NODE_30083_length_624_cov_135,Nsylvestris_NODE_17532_length_1310_cov_52,80,370,59,5,1,368,900,544,2.42E-68,259,367,356
80136,Ntome_NODE_30104_length_624_cov_5,Nsylvestris_NODE_30894_length_458_cov_5,96.061,457,18,0,125,581,457,1,0,745,456,456
80139,Ntome_NODE_30106_length_623_cov_226,Nsylvestris_NODE_15511_length_1501_cov_37,93.814,291,16,2,56,344,1342,1052,1.04E-121,436,288,290
80176,Ntome_NODE_30132_length_623_cov_7,Nsylvestris_NODE_33174_length_347_cov_3,97.126,348,9,1,160,507,1,347,9.77E-167,586,347,346
80293,Ntome_NODE_30207_length_620_cov_10,Nsylvestris_NODE_25687_length_735_cov_12,96.075,535,21,0,1,535,201,735,0,872,534,534
80347,Ntome_NODE_30242_length_618_cov_219,Nsylvestris_NODE_26871_length_679_cov_47,88.376,628,25,21,1,618,22,611,0,712,617,589
80454,Ntome_NODE_30310_length_616_cov_12,Nsylvestris_NODE_19818_length_1116_cov_27,96.803,563,18,0,52,614,231,793,0,941,562,562
80467,Ntome_NODE_30316_length_616_cov_6,Nsylvestris_NODE_22788_length_904_cov_5,92.762,525,35,2,1,522,742,218,0,756,521,524
80519,Ntome_NODE_30341_length_615_cov_9,Nsylvestris_NODE_35192_length_291_cov_3,93.836,292,9,7,51,338,4,290,4.78E-120,431,287,286
80524,Ntome_NODE_30346_length_615_cov_5,Nsylvestris_NODE_11096_length_1977_cov_11,96.585,615,21,0,1,615,1549,935,0,1020,614,614
80525,Ntome_NODE_30347_length_615_cov_3,Nsylvestris_NODE_4794_length_3023_cov_155,90.076,524,37,8,3,514,2437,2957,0,665,511,520
80571,Ntome_NODE_30373_length_613_cov_153,Nsylvestris_NODE_32986_length_353_cov_11,92.878,337,19,2,256,589,1,335,3.61E-136,484,333,334
80615,Ntome_NODE_30400_length_612_cov_15,Nsylvestris_NODE_31667_length_410_cov_6,90.217,92,9,0,32,123,18,109,1.17E-26,121,91,91
80671,Ntome_NODE_30438_length_611_cov_9,Nsylvestris_NODE_22136_length_946_cov_48,89.217,575,32,7,4,553,789,220,0,691,549,569
80697,Ntome_NODE_30458_length_610_cov_12,Nsylvestris_NODE_24109_length_825_cov_27,91.005,567,33,2,1,567,138,686,0,749,566,548
80722,Ntome_NODE_30473_length_610_cov_5,Nsylvestris_NODE_33671_length_332_cov_2,94.828,232,11,1,1,232,231,1,6.31E-99,361,231,230
80745,Ntome_NODE_30487_length_609_cov_35,Nsylvestris_NODE_16733_length_1378_cov_48,89.176,619,34,8,1,592,664,52,0,741,591,612
80870,Ntome_NODE_30571_length_605_cov_34,Nsylvestris_NODE_24659_length_791_cov_47,92.626,556,30,5,5,556,622,74,0,789,551,548
80921,Ntome_NODE_30601_length_604_cov_7,Nsylvestris_NODE_31791_length_404_cov_4,90.476,378,33,3,95,469,24,401,1.64E-139,496,374,377
80949,Ntome_NODE_30620_length_603_cov_12,Nsylvestris_NODE_25878_length_725_cov_6,86.433,457,27,22,173,603,725,278,3.57E-131,468,430,447
81008,Ntome_NODE_30659_length_593_cov_263,Nsylvestris_NODE_27933_length_631_cov_160,90.317,537,24,8,28,556,627,111,0,678,528,516
81084,Ntome_NODE_30710_length_600_cov_4,Nsylvestris_NODE_19555_length_1139_cov_135,97.487,557,14,0,1,557,743,187,0,952,556,556
81175,Ntome_NODE_30768_length_597_cov_163,Nsylvestris_NODE_28484_length_606_cov_157,90.926,551,22,9,1,550,56,579,0,715,549,523
81181,Ntome_NODE_30772_length_597_cov_86,Nsylvestris_NODE_24869_length_779_cov_21,93.038,158,11,0,60,217,162,319,5.04E-60,231,157,157
81235,Ntome_NODE_30801_length_596_cov_11,Nsylvestris_NODE_31452_length_422_cov_7,93.03,330,11,5,1,323,98,422,2.73E-132,472,322,324
81284,Ntome_NODE_30835_length_595_cov_7,Nsylvestris_NODE_17666_length_1297_cov_92,96.866,351,7,2,246,595,797,450,3.35E-166,584,349,347
81301,Ntome_NODE_30845_length_594_cov_138,Nsylvestris_NODE_28646_length_600_cov_4,86.957,253,29,3,276,528,1,249,4.91E-75,281,252,248
81358,Ntome_NODE_30883_length_593_cov_9,Nsylvestris_NODE_20653_length_1054_cov_16,81.319,91,15,2,436,525,260,349,3.21E-12,73.1,89,89
81361,Ntome_NODE_30885_length_593_cov_8,Nsylvestris_NODE_31792_length_404_cov_4,93.519,216,10,3,4,219,212,1,3.74E-86,318,215,211
81482,Ntome_NODE_30962_length_590_cov_60,Nsylvestris_NODE_29975_length_530_cov_7,92.203,513,34,2,84,590,513,1,0,721,506,512
81513,Ntome_NODE_30978_length_590_cov_10,Nsylvestris_NODE_26668_length_688_cov_46,94.147,598,18,7,1,588,81,671,0,894,587,590
81754,Ntome_NODE_31122_length_584_cov_252,Nsylvestris_NODE_28911_length_587_cov_164,91.317,357,31,0,218,574,360,4,2.65E-137,488,356,356
81824,Ntome_NODE_31165_length_583_cov_12,Nsylvestris_NODE_25717_length_733_cov_11,93.46,581,38,0,1,581,65,645,0,863,580,580
81883,Ntome_NODE_31201_length_582_cov_4,Nsylvestris_NODE_27532_length_650_cov_5,93.966,580,35,0,3,582,64,643,0,878,579,579
81927,Ntome_NODE_31224_length_581_cov_5,Nsylvestris_NODE_12572_length_1808_cov_57,96.902,581,18,0,1,581,1582,1002,0,974,580,580
81933,Ntome_NODE_31231_length_580_cov_29,Nsylvestris_NODE_23675_length_850_cov_39,93.497,569,25,6,1,564,17,578,0,835,563,561
82023,Ntome_NODE_31292_length_578_cov_28,Nsylvestris_NODE_26075_length_715_cov_39,92.885,506,23,4,1,500,19,517,0,723,499,498
82033,Ntome_NODE_31303_length_578_cov_10,Nsylvestris_NODE_30957_length_454_cov_4,87.056,394,28,9,53,436,446,66,7.50E-118,424,383,380
82205,Ntome_NODE_31416_length_574_cov_5,Nsylvestris_NODE_20155_length_1090_cov_40,89.225,529,35,8,58,574,1060,542,0,641,516,518
82424,Ntome_NODE_31526_length_570_cov_45,Nsylvestris_NODE_28680_length_598_cov_43,92.171,281,22,0,148,428,171,451,4.48E-110,398,280,280
82435,Ntome_NODE_31535_length_570_cov_8,Nsylvestris_NODE_32973_length_354_cov_4,88.601,193,22,0,134,326,1,193,3.72E-61,235,192,192
82474,Ntome_NODE_31561_length_569_cov_8,Nsylvestris_NODE_20558_length_1060_cov_127,87.029,239,26,5,1,239,246,479,4.73E-70,265,238,233
82475,Ntome_NODE_31563_length_569_cov_6,Nsylvestris_NODE_20705_length_1049_cov_109,86.466,133,18,0,137,269,819,951,1.79E-34,147,132,132
82520,Ntome_NODE_31597_length_567_cov_215,Nsylvestris_NODE_30013_length_526_cov_193,94.297,526,26,3,45,567,1,525,0,802,522,524
82567,Ntome_NODE_31633_length_566_cov_38,Nsylvestris_NODE_33270_length_343_cov_61,92.44,291,9,9,244,525,312,26,9.56E-112,403,281,286
82588,Ntome_NODE_31644_length_566_cov_11,Nsylvestris_NODE_28259_length_617_cov_3,93.82,534,30,3,5,535,84,617,0,800,530,533
82593,Ntome_NODE_31646_length_566_cov_7,Nsylvestris_NODE_23738_length_846_cov_126,96.481,540,19,0,23,562,802,263,0,893,539,539
82603,Ntome_NODE_31653_length_566_cov_5,Nsylvestris_NODE_35787_length_278_cov_3,94.245,278,16,0,57,334,1,278,2.04E-118,425,277,277
82620,Ntome_NODE_31663_length_565_cov_56,Nsylvestris_NODE_22025_length_954_cov_83,93.822,518,25,2,1,518,649,139,0,773,517,510
82692,Ntome_NODE_31702_length_564_cov_8,Nsylvestris_NODE_29706_length_554_cov_3,83.455,550,44,15,31,564,551,33,3.33E-131,468,533,518
82770,Ntome_NODE_31750_length_562_cov_13,Nsylvestris_NODE_33437_length_338_cov_5,94.118,306,18,0,201,506,338,33,1.19E-130,466,305,305
82794,Ntome_NODE_31765_length_561_cov_227,Nsylvestris_NODE_25946_length_721_cov_167,90.98,510,35,4,11,512,1,507,0,676,501,506
82795,Ntome_NODE_31766_length_561_cov_148,Nsylvestris_NODE_31731_length_406_cov_17,87.037,216,22,5,7,218,30,243,2.83E-62,239,211,213
82852,Ntome_NODE_31806_length_560_cov_6,Nsylvestris_NODE_22075_length_951_cov_8,84.122,296,42,4,264,558,66,357,4.62E-75,281,294,291
82861,Ntome_NODE_31813_length_560_cov_4,Nsylvestris_NODE_31494_length_420_cov_4,92.695,397,29,0,1,397,397,1,6.81E-163,573,396,396
82900,Ntome_NODE_31844_length_559_cov_5,Nsylvestris_NODE_17068_length_1351_cov_69,92.308,559,22,7,1,559,291,828,0,774,558,537
82918,Ntome_NODE_31857_length_558_cov_13,Nsylvestris_NODE_29634_length_557_cov_68,99.82,556,0,1,1,556,3,557,0,1020,555,554
82954,Ntome_NODE_31885_length_557_cov_9,Nsylvestris_NODE_34514_length_307_cov_7,87.926,323,18,10,142,463,1,303,5.74E-99,361,321,302
82998,Ntome_NODE_31924_length_555_cov_178,Nsylvestris_NODE_32762_length_361_cov_9,83.862,378,32,12,31,403,1,354,1.25E-90,333,372,353
83007,Ntome_NODE_31936_length_555_cov_5,Nsylvestris_NODE_34846_length_299_cov_3,92.683,41,3,0,73,113,41,1,2.33E-08,60.2,40,40
83015,Ntome_NODE_31945_length_554_cov_10,Nsylvestris_NODE_30928_length_456_cov_4,94.737,228,5,2,1,221,228,1,4.44E-95,348,220,227
83019,Ntome_NODE_31952_length_553_cov_86,Nsylvestris_NODE_26463_length_697_cov_179,91.446,491,19,8,79,553,507,24,0,652,474,483
83025,Ntome_NODE_31958_length_553_cov_7,Nsylvestris_NODE_30853_length_460_cov_8,89.979,479,21,9,10,486,1,454,5.16E-169,593,476,453
83028,Ntome_NODE_31960_length_553_cov_6,Nsylvestris_NODE_2097_length_3995_cov_89,94.595,37,1,1,139,174,749,713,3.01E-07,56.5,35,36
83034,Ntome_NODE_31971_length_552_cov_23,Nsylvestris_NODE_17206_length_1341_cov_15,86.364,352,43,3,188,537,467,815,1.57E-104,379,349,348
83047,Ntome_NODE_31985_length_551_cov_30,Nsylvestris_NODE_29737_length_551_cov_55,90.647,556,40,9,1,551,2,550,0,728,550,548
83076,Ntome_NODE_32023_length_548_cov_68,Nsylvestris_NODE_32488_length_372_cov_16,89.109,101,11,0,76,176,372,272,2.24E-28,126,100,100
83077,Ntome_NODE_32026_length_548_cov_21,Nsylvestris_NODE_24999_length_771_cov_191,95.463,551,20,3,3,548,569,19,0,874,545,550
83078,Ntome_NODE_32028_length_528_cov_10,Nsylvestris_NODE_30566_length_481_cov_8,85.171,263,37,2,50,311,219,480,3.38E-71,268,261,261
83080,Ntome_NODE_32034_length_548_cov_5,Nsylvestris_NODE_23361_length_869_cov_5,96.907,291,9,0,258,548,1,291,2.48E-137,488,290,290
83081,Ntome_NODE_32038_length_547_cov_12,Nsylvestris_NODE_30198_length_510_cov_6,88,425,25,16,19,424,419,2,1.49E-134,479,405,417
83093,Ntome_NODE_32047_length_546_cov_38,Nsylvestris_NODE_27137_length_667_cov_177,91.731,520,36,3,34,546,644,125,0,715,512,519
83095,Ntome_NODE_32050_length_546_cov_7,Nsylvestris_NODE_32536_length_371_cov_4,87.356,87,11,0,460,546,99,185,1.35E-20,100,86,86
83118,Ntome_NODE_32074_length_544_cov_72,Nsylvestris_NODE_30738_length_469_cov_11,95.148,371,18,0,174,544,434,64,8.48E-167,586,370,370
83119,Ntome_NODE_32076_length_544_cov_12,Nsylvestris_NODE_27365_length_657_cov_181,93.153,555,21,5,1,544,44,592,0,798,543,548
83120,Ntome_NODE_32077_length_544_cov_10,Nsylvestris_NODE_28868_length_589_cov_22,90.744,551,31,5,5,535,6,556,0,717,530,550
83129,Ntome_NODE_32087_length_543_cov_15,Nsylvestris_NODE_26722_length_686_cov_53,86.755,302,28,9,229,525,383,89,2.04E-88,326,296,294
83144,Ntome_NODE_32101_length_542_cov_171,Nsylvestris_NODE_19169_length_1170_cov_66,90.625,288,18,5,107,390,835,1117,7.16E-103,374,283,282
83166,Ntome_NODE_32121_length_541_cov_6,Nsylvestris_NODE_33442_length_338_cov_4,93.671,316,17,2,225,540,338,26,8.86E-132,470,315,312
83229,Ntome_NODE_32169_length_538_cov_8,Nsylvestris_NODE_34775_length_301_cov_2,95.154,227,11,0,13,239,227,1,1.99E-98,359,226,226
83243,Ntome_NODE_32184_length_537_cov_10,Nsylvestris_NODE_30930_length_456_cov_3,90,400,21,9,2,401,381,1,1.12E-140,499,399,380
83244,Ntome_NODE_32188_length_537_cov_5,Nsylvestris_NODE_31339_length_430_cov_4,97.297,37,1,0,1,37,37,1,1.74E-09,63.9,36,36
83245,Ntome_NODE_32191_length_537_cov_4,Nsylvestris_NODE_33621_length_333_cov_5,86.331,278,33,5,136,412,333,60,4.39E-80,298,276,273
83287,Ntome_NODE_32232_length_533_cov_20,Nsylvestris_NODE_25329_length_753_cov_33,92.25,529,24,10,1,515,744,219,0,734,514,525
83338,Ntome_NODE_32280_length_530_cov_11,Nsylvestris_NODE_29341_length_569_cov_37,91.885,382,31,0,2,383,511,130,3.03E-151,534,381,381
83343,Ntome_NODE_32289_length_529_cov_141,Nsylvestris_NODE_24030_length_830_cov_146,93.045,532,31,2,1,529,20,548,0,773,528,528
83433,Ntome_NODE_32361_length_524_cov_4,Nsylvestris_NODE_31419_length_424_cov_9,89.681,407,38,3,4,407,19,424,1.09E-145,516,403,405
83434,Ntome_NODE_32363_length_524_cov_4,Nsylvestris_NODE_34438_length_310_cov_2,91.824,318,12,8,1,316,5,310,4.04E-120,431,315,305
83446,Ntome_NODE_32370_length_523_cov_20,Nsylvestris_NODE_26454_length_698_cov_33,92.593,54,2,2,194,247,341,290,2.18E-13,76.8,53,51
83478,Ntome_NODE_32399_length_521_cov_8,Nsylvestris_NODE_33720_length_330_cov_3,98.246,57,1,0,1,57,96,152,1.29E-20,100,56,56
83487,Ntome_NODE_32409_length_520_cov_25,Nsylvestris_NODE_29765_length_548_cov_11,91.154,520,28,10,1,515,528,22,0,689,514,506
83488,Ntome_NODE_32410_length_520_cov_19,Nsylvestris_NODE_25799_length_728_cov_86,92.471,518,31,3,3,520,565,56,0,734,517,509
83513,Ntome_NODE_32441_length_518_cov_8,Nsylvestris_NODE_31281_length_433_cov_6,87.066,317,22,10,1,302,74,386,6.92E-93,340,301,312
83530,Ntome_NODE_32465_length_516_cov_256,Nsylvestris_NODE_25602_length_739_cov_49,80.061,326,21,15,60,362,682,378,3.40E-51,202,302,304
83556,Ntome_NODE_32498_length_513_cov_242,Nsylvestris_NODE_34050_length_320_cov_215,94.485,272,14,1,242,513,271,1,3.08E-116,418,271,270
83580,Ntome_NODE_32528_length_511_cov_6,Nsylvestris_NODE_34257_length_314_cov_11,95.094,265,10,3,182,445,314,52,3.97E-115,414,263,262
83589,Ntome_NODE_32536_length_510_cov_13,Nsylvestris_NODE_30138_length_514_cov_24,89.61,385,18,9,118,498,20,386,8.33E-132,470,380,366
83627,Ntome_NODE_32566_length_508_cov_9,Nsylvestris_NODE_26286_length_706_cov_26,82.749,342,44,12,168,505,373,703,6.93E-78,291,337,330
83660,Ntome_NODE_32595_length_506_cov_22,Nsylvestris_NODE_25393_length_749_cov_27,85.855,509,46,9,1,505,589,103,2.91E-146,518,504,486
83661,Ntome_NODE_32596_length_506_cov_18,Nsylvestris_NODE_31983_length_395_cov_2,85.175,371,28,12,33,378,1,369,2.41E-97,355,345,368
83662,Ntome_NODE_32598_length_506_cov_8,Nsylvestris_NODE_16839_length_1369_cov_19,90.323,93,8,1,132,223,1364,1272,9.58E-27,121,91,92
83730,Ntome_NODE_32640_length_503_cov_117,Nsylvestris_NODE_22621_length_914_cov_147,84.466,515,34,15,8,503,753,266,1.06E-130,466,495,487
83752,Ntome_NODE_32666_length_501_cov_4,Nsylvestris_NODE_33516_length_336_cov_4,90.355,197,18,1,7,203,196,1,6.93E-68,257,196,195
83764,Ntome_NODE_32676_length_500_cov_6,Nsylvestris_NODE_25702_length_734_cov_39,95.8,500,21,0,1,500,193,692,0,808,499,499
83813,Ntome_NODE_32710_length_497_cov_241,Nsylvestris_NODE_33585_length_334_cov_5,87.9,281,19,8,217,497,1,266,1.12E-85,316,280,265
83821,Ntome_NODE_32721_length_497_cov_2,Nsylvestris_NODE_22168_length_944_cov_16,95.976,497,20,0,1,497,256,752,0,808,496,496
83834,Ntome_NODE_32727_length_496_cov_131,Nsylvestris_NODE_28229_length_618_cov_145,95.172,290,12,2,117,404,47,336,6.30E-128,457,287,289
83835,Ntome_NODE_32728_length_496_cov_62,Nsylvestris_NODE_29906_length_535_cov_163,91.515,495,29,12,2,491,511,25,0,669,489,486
83838,Ntome_NODE_32730_length_496_cov_14,Nsylvestris_NODE_35923_length_275_cov_3,96.538,260,7,2,220,478,259,1,1.37E-119,429,258,258
83839,Ntome_NODE_32731_length_496_cov_10,Nsylvestris_NODE_31957_length_395_cov_11,97.368,114,3,0,383,496,247,134,5.45E-49,195,113,113
83840,Ntome_NODE_32732_length_496_cov_9,Nsylvestris_NODE_29954_length_532_cov_6,90.549,455,32,7,1,447,452,1,1.65E-168,592,446,451
83910,Ntome_NODE_32794_length_492_cov_27,Nsylvestris_NODE_23453_length_863_cov_26,83.516,182,28,2,289,469,396,576,3.28E-41,169,180,180
83911,Ntome_NODE_32797_length_492_cov_12,Nsylvestris_NODE_30620_length_477_cov_10,93.96,447,22,4,41,484,477,33,0,671,443,444
83931,Ntome_NODE_32814_length_491_cov_5,Nsylvestris_NODE_15547_length_1497_cov_13,88.889,72,5,2,299,367,153,82,3.39E-16,86.1,68,71
83976,Ntome_NODE_32858_length_488_cov_4,Nsylvestris_NODE_1624_length_4314_cov_47,87.309,457,50,8,36,488,4271,3819,1.01E-145,516,452,452
83994,Ntome_NODE_32883_length_486_cov_17,Nsylvestris_NODE_32838_length_359_cov_3,87.97,266,32,0,205,470,349,84,3.92E-85,315,265,265
84008,Ntome_NODE_32901_length_484_cov_3,Nsylvestris_NODE_22887_length_898_cov_22,83.431,513,46,18,1,482,799,295,6.18E-123,440,481,504
84023,Ntome_NODE_32909_length_484_cov_15,Nsylvestris_NODE_28263_length_616_cov_14,87.931,522,19,12,1,484,595,80,1.62E-163,575,483,515
84048,Ntome_NODE_32930_length_483_cov_5,Nsylvestris_NODE_12677_length_1798_cov_102,91.429,490,34,3,1,483,1195,1683,0,665,482,488
84052,Ntome_NODE_32933_length_483_cov_4,Nsylvestris_NODE_4713_length_3042_cov_55,95.807,477,17,1,6,482,2034,1561,0,767,476,473
84061,Ntome_NODE_32944_length_482_cov_4,Nsylvestris_NODE_28456_length_604_cov_5,91.765,255,18,3,229,482,443,191,2.97E-96,351,253,252
84067,Ntome_NODE_32951_length_481_cov_165,Nsylvestris_NODE_19077_length_1177_cov_112,96.899,387,12,0,1,387,439,53,0,649,386,386
84076,Ntome_NODE_32961_length_481_cov_4,Nsylvestris_NODE_29797_length_545_cov_6,88.337,463,26,14,28,473,93,544,3.54E-150,531,445,451
84096,Ntome_NODE_32977_length_480_cov_4,Nsylvestris_NODE_18093_length_1260_cov_64,95.082,488,15,1,1,479,718,1205,0,760,478,487
84108,Ntome_NODE_32994_length_478_cov_6,Nsylvestris_NODE_29864_length_539_cov_24,77.46,315,51,16,100,398,141,451,8.83E-42,171,298,310
84154,Ntome_NODE_33038_length_475_cov_9,Nsylvestris_NODE_34610_length_305_cov_3,96.226,53,2,0,3,55,53,1,9.09E-17,87.9,52,52
84170,Ntome_NODE_33057_length_473_cov_19,Nsylvestris_NODE_29681_length_555_cov_18,87.719,171,20,1,3,172,403,233,4.01E-50,198,169,170
84179,Ntome_NODE_33064_length_473_cov_4,Nsylvestris_NODE_30520_length_484_cov_10,95.181,83,4,0,280,362,83,1,4.12E-30,132,82,82
84186,Ntome_NODE_33074_length_472_cov_9,Nsylvestris_NODE_30055_length_523_cov_8,92.632,95,7,0,89,183,276,370,8.84E-32,137,94,94
84194,Ntome_NODE_33089_length_471_cov_4,Nsylvestris_NODE_30817_length_463_cov_4,95.749,447,11,2,33,471,5,451,0,713,438,446
84291,Ntome_NODE_33187_length_464_cov_7,Nsylvestris_NODE_27859_length_635_cov_18,88.352,352,38,1,57,408,395,47,7.70E-117,420,351,348
84330,Ntome_NODE_33224_length_462_cov_3,Nsylvestris_NODE_24790_length_784_cov_7,94.231,468,20,4,1,462,730,264,0,708,461,466
84342,Ntome_NODE_33231_length_461_cov_88,Nsylvestris_NODE_28486_length_606_cov_92,91.589,214,14,3,209,422,1,210,1.74E-78,292,213,209
84345,Ntome_NODE_33235_length_461_cov_7,Nsylvestris_NODE_32767_length_361_cov_7,95.989,349,11,1,109,457,346,1,3.34E-160,564,348,345
84383,Ntome_NODE_33267_length_459_cov_11,Nsylvestris_NODE_30776_length_466_cov_14,93.705,413,22,3,2,410,413,1,9.04E-176,616,408,412
84387,Ntome_NODE_33273_length_459_cov_5,Nsylvestris_NODE_30348_length_498_cov_10,95.842,457,18,1,3,459,10,465,0,737,456,455
84442,Ntome_NODE_33331_length_455_cov_37,Nsylvestris_NODE_33742_length_329_cov_36,90.036,281,10,10,107,385,271,7,3.61E-95,348,278,264
84470,Ntome_NODE_33358_length_454_cov_4,Nsylvestris_NODE_2625_length_3730_cov_103,96.744,430,14,0,1,430,813,1242,0,717,429,429
84472,Ntome_NODE_33360_length_454_cov_4,Nsylvestris_NODE_32184_length_386_cov_4,95.439,285,13,0,166,450,1,285,2.06E-127,455,284,284
84490,Ntome_NODE_33377_length_453_cov_3,Nsylvestris_NODE_32307_length_381_cov_5,86.207,290,29,5,56,345,279,1,7.89E-82,303,289,278
84523,Ntome_NODE_33406_length_451_cov_5,Nsylvestris_NODE_24487_length_801_cov_107,95.362,345,14,2,17,361,273,615,3.28E-155,547,344,342
84524,Ntome_NODE_33407_length_451_cov_4,Nsylvestris_NODE_21152_length_1018_cov_130,90.343,466,25,4,1,451,275,735,4.16E-169,593,450,460
84525,Ntome_NODE_33409_length_451_cov_4,Nsylvestris_NODE_17912_length_1276_cov_55,91.814,452,35,2,1,451,574,1024,1.14E-179,628,450,450
84536,Ntome_NODE_33423_length_450_cov_7,Nsylvestris_NODE_33751_length_329_cov_6,95.636,275,12,0,78,352,275,1,1.59E-123,442,274,274
84539,Ntome_NODE_33429_length_450_cov_4,Nsylvestris_NODE_8854_length_2272_cov_17,93.612,454,18,3,6,450,270,721,0,667,444,451
84569,Ntome_NODE_33450_length_449_cov_6,Nsylvestris_NODE_28091_length_625_cov_3,81.637,452,42,15,1,438,2,426,7.70E-92,337,437,424
84570,Ntome_NODE_33453_length_449_cov_4,Nsylvestris_NODE_8193_length_2372_cov_193,99.777,449,1,0,1,449,966,1414,0,824,448,448
84576,Ntome_NODE_33460_length_448_cov_13,Nsylvestris_NODE_16889_length_1366_cov_5,94.152,171,10,0,37,207,1013,843,4.76E-69,261,170,170
84616,Ntome_NODE_33490_length_447_cov_4,Nsylvestris_NODE_36828_length_255_cov_4,98.99,99,1,0,349,447,255,157,4.92E-44,178,98,98
84632,Ntome_NODE_33502_length_446_cov_5,Nsylvestris_NODE_25760_length_731_cov_4,94.515,237,12,1,1,236,495,731,3.51E-100,364,235,236
84646,Ntome_NODE_33510_length_445_cov_17,Nsylvestris_NODE_24302_length_812_cov_37,92.511,454,17,4,1,445,515,70,0,634,444,445
84665,Ntome_NODE_33529_length_444_cov_11,Nsylvestris_NODE_30014_length_526_cov_75,94.432,449,20,2,1,444,26,474,0,686,443,448
84667,Ntome_NODE_33533_length_444_cov_8,Nsylvestris_NODE_20292_length_1078_cov_31,94.595,444,24,0,1,444,163,606,0,688,443,443
84668,Ntome_NODE_33534_length_444_cov_7,Nsylvestris_NODE_26317_length_704_cov_34,90.948,232,21,0,1,232,243,474,1.28E-84,313,231,231
84670,Ntome_NODE_33539_length_444_cov_3,Nsylvestris_NODE_25006_length_771_cov_23,92.747,455,17,11,1,444,480,31,0,643,443,449
84693,Ntome_NODE_33567_length_442_cov_4,Nsylvestris_NODE_25027_length_770_cov_9,92.551,443,18,8,1,441,665,236,1.87E-177,621,440,429
84695,Ntome_NODE_33570_length_442_cov_2,Nsylvestris_NODE_36632_length_259_cov_4,92.899,169,8,2,276,442,18,184,1.70E-63,243,166,166
84710,Ntome_NODE_33577_length_441_cov_17,Nsylvestris_NODE_31695_length_408_cov_5,87.468,391,26,12,1,385,374,1,1.21E-119,429,384,373
84768,Ntome_NODE_33628_length_438_cov_6,Nsylvestris_NODE_31202_length_438_cov_8,79.602,201,14,3,226,399,235,435,2.96E-26,119,173,200
84801,Ntome_NODE_33651_length_437_cov_4,Nsylvestris_NODE_21726_length_975_cov_178,89.888,445,24,5,1,436,734,302,6.83E-157,553,435,432
84814,Ntome_NODE_33674_length_436_cov_3,Nsylvestris_NODE_20453_length_1068_cov_84,93.721,430,15,5,10,436,636,216,0,634,426,420
84815,Ntome_NODE_33676_length_436_cov_2,Nsylvestris_NODE_31672_length_410_cov_3,94.468,235,13,0,1,235,235,1,1.23E-99,363,234,234
84817,Ntome_NODE_33678_length_434_cov_228,Nsylvestris_NODE_27294_length_658_cov_54,87.784,352,34,5,1,350,457,113,7.22E-112,403,349,344
84833,Ntome_NODE_33702_length_434_cov_44,Nsylvestris_NODE_3988_length_3236_cov_33,85.821,134,19,0,31,164,7,140,1.74E-33,143,133,133
84838,Ntome_NODE_33709_length_434_cov_7,Nsylvestris_NODE_17763_length_1289_cov_15,86.444,450,27,11,1,434,1108,677,1.18E-129,462,433,431
84876,Ntome_NODE_33753_length_432_cov_3,Nsylvestris_NODE_20906_length_1035_cov_6,96.759,432,14,0,1,432,565,996,0,721,431,431
84890,Ntome_NODE_33764_length_431_cov_26,Nsylvestris_NODE_14115_length_1639_cov_113,92.188,128,10,0,171,298,1053,1180,3.66E-45,182,127,127
84921,Ntome_NODE_33811_length_429_cov_4,Nsylvestris_NODE_31159_length_441_cov_4,96.382,387,14,0,1,387,55,441,0,638,386,386
84923,Ntome_NODE_33813_length_429_cov_3,Nsylvestris_NODE_28140_length_623_cov_8,93.316,374,25,0,1,374,249,622,6.70E-157,553,373,373
84969,Ntome_NODE_33861_length_426_cov_6,Nsylvestris_NODE_20376_length_1073_cov_20,92.471,425,22,6,2,426,93,507,8.42E-171,599,424,414
84970,Ntome_NODE_33863_length_426_cov_6,Nsylvestris_NODE_26221_length_709_cov_10,88.969,417,41,4,8,423,46,458,4.06E-144,510,415,412
84981,Ntome_NODE_33875_length_425_cov_23,Nsylvestris_NODE_30137_length_514_cov_26,89.441,322,27,4,73,394,40,354,9.14E-111,399,321,314
84985,Ntome_NODE_33880_length_425_cov_7,Nsylvestris_NODE_35771_length_278_cov_4,91.2,125,11,0,1,125,154,278,7.80E-42,171,124,124
84988,Ntome_NODE_33887_length_425_cov_5,Nsylvestris_NODE_18145_length_1255_cov_7,91.206,398,32,3,10,404,385,782,1.86E-152,538,394,397
84989,Ntome_NODE_33889_length_425_cov_4,Nsylvestris_NODE_33156_length_347_cov_6,85.801,331,17,12,113,425,341,23,5.66E-88,324,312,318
84990,Ntome_NODE_33891_length_425_cov_4,Nsylvestris_NODE_32435_length_375_cov_6,87.719,399,21,18,3,397,1,375,5.38E-123,440,394,374
84992,Ntome_NODE_33894_length_425_cov_3,Nsylvestris_NODE_32802_length_360_cov_6,92.973,185,12,1,15,199,261,78,2.69E-71,268,184,183
84995,Ntome_NODE_33896_length_424_cov_43,Nsylvestris_NODE_32005_length_394_cov_2,87.831,378,35,10,57,424,6,382,8.99E-121,433,367,376
85000,Ntome_NODE_33901_length_424_cov_5,Nsylvestris_NODE_36476_length_263_cov_2,94.444,234,13,0,1,234,30,263,4.30E-99,361,233,233
85057,Ntome_NODE_33938_length_422_cov_5,Nsylvestris_NODE_35442_length_285_cov_5,96.629,267,9,0,1,267,268,2,4.13E-124,444,266,266
85062,Ntome_NODE_33944_length_422_cov_4,Nsylvestris_NODE_30598_length_479_cov_5,95.469,309,14,0,114,422,1,309,4.04E-139,494,308,308
85078,Ntome_NODE_33962_length_421_cov_4,Nsylvestris_NODE_31873_length_400_cov_3,90.254,236,20,3,184,418,1,234,2.03E-82,305,234,233
85079,Ntome_NODE_33966_length_421_cov_3,Nsylvestris_NODE_36596_length_260_cov_3,96.154,260,10,0,162,421,1,260,1.49E-118,425,259,259
85116,Ntome_NODE_34013_length_419_cov_2,Nsylvestris_NODE_25114_length_765_cov_70,93.478,230,15,0,1,230,280,51,1.54E-93,342,229,229
85122,Ntome_NODE_34019_length_418_cov_261,Nsylvestris_NODE_26335_length_703_cov_170,94.753,324,16,1,49,372,81,403,6.65E-142,503,323,322
85132,Ntome_NODE_34030_length_418_cov_6,Nsylvestris_NODE_24184_length_820_cov_81,89.806,412,18,2,2,401,173,572,5.14E-143,507,399,399
85216,Ntome_NODE_34131_length_409_cov_3,Nsylvestris_NODE_35875_length_276_cov_3,94.301,193,10,1,68,259,84,276,4.26E-79,294,191,192
85248,Ntome_NODE_34164_length_411_cov_4,Nsylvestris_NODE_32036_length_392_cov_6,90.411,365,23,5,1,356,31,392,6.63E-132,470,355,361
85249,Ntome_NODE_34167_length_411_cov_4,Nsylvestris_NODE_18732_length_1207_cov_72,89.448,417,36,1,3,411,27,443,6.49E-147,520,408,416
85259,Ntome_NODE_34180_length_410_cov_12,Nsylvestris_NODE_26041_length_717_cov_6,92.464,345,23,3,1,343,247,590,5.07E-138,490,342,343
85316,Ntome_NODE_34261_length_407_cov_3,Nsylvestris_NODE_30491_length_487_cov_5,97.472,356,6,1,52,407,1,353,1.72E-172,604,355,352
85320,Ntome_NODE_34265_length_407_cov_3,Nsylvestris_NODE_23916_length_837_cov_9,96.337,273,9,1,1,272,451,723,3.07E-125,448,271,272
85401,Ntome_NODE_34376_length_401_cov_9,Nsylvestris_NODE_31495_length_420_cov_4,90.909,231,12,4,4,233,235,13,2.49E-81,302,229,222
85428,Ntome_NODE_34393_length_400_cov_41,Nsylvestris_NODE_31945_length_396_cov_14,94.695,377,19,1,25,400,393,17,2.20E-166,584,375,376
85442,Ntome_NODE_34402_length_400_cov_5,Nsylvestris_NODE_30059_length_523_cov_4,96.988,166,5,0,1,166,166,1,1.16E-74,279,165,165
85448,Ntome_NODE_34411_length_400_cov_2,Nsylvestris_NODE_16914_length_1364_cov_50,90.647,417,12,4,1,399,205,612,1.05E-149,529,398,407
85459,Ntome_NODE_34421_length_399_cov_4,Nsylvestris_NODE_17919_length_1275_cov_69,93.155,336,23,0,1,336,593,258,3.82E-139,494,335,335
85474,Ntome_NODE_34434_length_398_cov_6,Nsylvestris_NODE_20880_length_1037_cov_8,94.595,37,1,1,175,211,188,223,2.13E-07,56.5,36,35
85481,Ntome_NODE_34442_length_398_cov_4,Nsylvestris_NODE_33131_length_348_cov_4,96.491,228,8,0,171,398,1,228,4.01E-104,377,227,227
85498,Ntome_NODE_34457_length_397_cov_4,Nsylvestris_NODE_35668_length_280_cov_4,82.784,273,21,6,125,397,280,34,7.13E-57,220,272,246
85518,Ntome_NODE_34491_length_396_cov_2,Nsylvestris_NODE_3902_length_3266_cov_141,84.487,419,29,16,2,396,1993,1587,3.08E-105,381,394,406
85521,Ntome_NODE_34495_length_395_cov_9,Nsylvestris_NODE_31784_length_404_cov_7,96.571,175,4,1,1,175,232,404,1.92E-77,289,174,172
85525,Ntome_NODE_34499_length_395_cov_7,Nsylvestris_NODE_37046_length_251_cov_3,84.016,244,27,5,61,292,246,3,5.48E-58,224,231,243
85526,Ntome_NODE_34502_length_395_cov_6,Nsylvestris_NODE_29037_length_582_cov_13,92.929,396,22,3,1,392,157,550,1.70E-162,571,391,393
85545,Ntome_NODE_34521_length_394_cov_11,Nsylvestris_NODE_22064_length_952_cov_8,92.416,356,23,3,43,394,906,551,1.74E-142,505,351,355
85547,Ntome_NODE_34528_length_394_cov_6,Nsylvestris_NODE_30065_length_521_cov_10,98.473,393,5,1,1,392,36,428,0,691,391,392
85570,Ntome_NODE_34559_length_393_cov_4,Nsylvestris_NODE_31920_length_398_cov_2,95.965,347,8,2,1,345,56,398,1.32E-158,558,344,342
85571,Ntome_NODE_34561_length_393_cov_3,Nsylvestris_NODE_33232_length_345_cov_4,97.273,110,3,0,284,393,54,163,7.15E-47,187,109,109
85573,Ntome_NODE_34566_length_392_cov_191,Nsylvestris_NODE_22930_length_895_cov_143,98.05,359,6,1,1,358,359,1,4.59E-178,623,357,358
85574,Ntome_NODE_34567_length_392_cov_154,Nsylvestris_NODE_34482_length_308_cov_63,84.32,338,22,11,52,388,1,308,2.44E-81,302,336,307
85581,Ntome_NODE_34573_length_392_cov_7,Nsylvestris_NODE_30908_length_457_cov_14,96.507,229,8,0,98,326,390,162,1.10E-104,379,228,228
85596,Ntome_NODE_34600_length_391_cov_4,Nsylvestris_NODE_34823_length_299_cov_6,95.638,298,13,0,90,387,299,2,1.05E-134,479,297,297
85645,Ntome_NODE_34656_length_388_cov_13,Nsylvestris_NODE_31822_length_402_cov_8,91.239,331,28,1,20,349,402,72,8.15E-126,449,329,330
85661,Ntome_NODE_34680_length_387_cov_7,Nsylvestris_NODE_30140_length_514_cov_8,94.1,339,20,0,49,387,514,176,7.90E-146,516,338,338
85664,Ntome_NODE_34689_length_387_cov_2,Nsylvestris_NODE_9677_length_2156_cov_24,97.416,387,10,0,1,387,755,1141,0,660,386,386
85691,Ntome_NODE_34721_length_386_cov_4,Nsylvestris_NODE_24162_length_822_cov_25,90.769,390,19,10,1,386,416,40,1.70E-142,505,385,376
85693,Ntome_NODE_34724_length_386_cov_4,Nsylvestris_NODE_35800_length_277_cov_7,91.176,272,21,3,101,369,4,275,8.39E-101,366,268,271
85704,Ntome_NODE_34737_length_385_cov_15,Nsylvestris_NODE_36488_length_262_cov_5,84.685,222,13,6,185,385,1,222,2.50E-51,202,200,221
85725,Ntome_NODE_34753_length_384_cov_23,Nsylvestris_NODE_32680_length_364_cov_13,92,350,21,6,11,357,19,364,2.21E-136,484,346,345
85733,Ntome_NODE_34760_length_384_cov_7,Nsylvestris_NODE_16979_length_1359_cov_15,97.598,333,8,0,51,383,1329,997,1.65E-162,571,332,332
85742,Ntome_NODE_34769_length_384_cov_3,Nsylvestris_NODE_13092_length_1752_cov_58,97.479,357,6,1,31,384,1213,1569,4.52E-173,606,353,356
85756,Ntome_NODE_34781_length_383_cov_8,Nsylvestris_NODE_27811_length_637_cov_138,93.6,375,23,1,1,374,623,249,1.28E-158,558,373,374
85766,Ntome_NODE_34796_length_383_cov_2,Nsylvestris_NODE_10506_length_2050_cov_28,94.643,392,12,1,1,383,937,546,7.54E-171,599,382,391
85782,Ntome_NODE_34809_length_382_cov_9,Nsylvestris_NODE_29000_length_584_cov_7,87.442,215,24,2,1,215,373,584,4.06E-64,244,214,211
85794,Ntome_NODE_34834_length_381_cov_5,Nsylvestris_NODE_26567_length_693_cov_18,88.221,416,10,9,1,381,3,414,3.69E-129,460,380,411
85834,Ntome_NODE_34881_length_379_cov_4,Nsylvestris_NODE_30152_length_513_cov_5,98.551,345,5,0,1,345,345,1,3.44E-174,610,344,344
85881,Ntome_NODE_34930_length_377_cov_9,Nsylvestris_NODE_31548_length_417_cov_2,90.852,317,27,2,1,317,315,1,4.79E-118,424,316,314
85898,Ntome_NODE_34951_length_376_cov_9,Nsylvestris_NODE_23203_length_878_cov_42,92.308,351,24,3,27,376,421,73,9.98E-140,496,349,348
85902,Ntome_NODE_34955_length_376_cov_5,Nsylvestris_NODE_36530_length_261_cov_7,95.618,251,3,4,40,283,11,260,1.04E-109,396,243,249
85906,Ntome_NODE_34962_length_376_cov_3,Nsylvestris_NODE_30586_length_480_cov_3,93.238,281,11,4,1,281,273,1,4.81E-113,407,280,272
85917,Ntome_NODE_34979_length_375_cov_10,Nsylvestris_NODE_36368_length_265_cov_4,88.312,154,13,4,3,152,5,157,1.14E-44,180,149,152
85918,Ntome_NODE_34980_length_375_cov_8,Nsylvestris_NODE_32341_length_379_cov_12,90.377,239,17,3,1,236,144,379,1.39E-83,309,235,235
85938,Ntome_NODE_35011_length_374_cov_4,Nsylvestris_NODE_1205_length_4701_cov_118,91.935,372,29,1,4,374,4297,3926,5.89E-147,520,370,371
85984,Ntome_NODE_35051_length_372_cov_7,Nsylvestris_NODE_20495_length_1065_cov_22,97.659,299,7,0,74,372,1065,767,2.72E-145,514,298,298
86003,Ntome_NODE_35083_length_371_cov_4,Nsylvestris_NODE_32855_length_358_cov_4,92.5,360,21,6,1,358,3,358,3.51E-144,510,357,355
86024,Ntome_NODE_35099_length_370_cov_11,Nsylvestris_NODE_31779_length_404_cov_21,90.775,271,22,3,18,286,15,284,1.34E-98,359,268,269
86037,Ntome_NODE_35122_length_369_cov_7,Nsylvestris_NODE_34952_length_296_cov_6,83.399,253,14,10,44,268,44,296,1.43E-53,209,224,252
86054,Ntome_NODE_35139_length_367_cov_11,Nsylvestris_NODE_36157_length_270_cov_2,93.836,146,9,0,1,146,146,1,6.55E-57,220,145,145
86085,Ntome_NODE_35190_length_366_cov_15,Nsylvestris_NODE_30674_length_473_cov_4,91.765,170,11,2,200,366,316,147,8.39E-61,233,166,169
86093,Ntome_NODE_35201_length_366_cov_5,Nsylvestris_NODE_31222_length_437_cov_9,97.701,261,6,0,1,261,261,1,7.65E-126,449,260,260
86094,Ntome_NODE_35203_length_366_cov_5,Nsylvestris_NODE_8320_length_2353_cov_31,88.503,374,23,6,13,366,2271,1898,2.14E-121,435,353,373
86127,Ntome_NODE_35248_length_364_cov_4,Nsylvestris_NODE_33525_length_336_cov_3,83.636,330,40,11,44,364,336,12,2.92E-80,298,320,324
86169,Ntome_NODE_35293_length_362_cov_116,Nsylvestris_NODE_34946_length_296_cov_19,89.764,127,6,2,1,126,80,200,1.85E-37,156,125,120
86194,Ntome_NODE_35323_length_361_cov_4,Nsylvestris_NODE_32002_length_394_cov_4,97.541,122,3,0,1,122,124,3,1.39E-53,209,121,121
86203,Ntome_NODE_35338_length_360_cov_16,Nsylvestris_NODE_32355_length_378_cov_12,83.473,357,25,13,25,355,9,357,2.23E-81,302,330,348
86204,Ntome_NODE_35339_length_360_cov_8,Nsylvestris_NODE_22183_length_943_cov_12,97.382,191,5,0,1,191,753,943,1.32E-88,326,190,190
86205,Ntome_NODE_35341_length_360_cov_7,Nsylvestris_NODE_13791_length_1674_cov_95,96.667,360,9,1,1,360,537,181,9.13E-170,595,359,356
86241,Ntome_NODE_35396_length_358_cov_5,Nsylvestris_NODE_29043_length_582_cov_6,97.5,240,6,0,16,255,240,1,3.53E-114,411,239,239
86254,Ntome_NODE_35420_length_357_cov_6,Nsylvestris_NODE_16965_length_1360_cov_8,91.785,353,29,0,4,356,965,613,1.22E-138,492,352,352
86265,Ntome_NODE_35456_length_356_cov_5,Nsylvestris_NODE_16960_length_1360_cov_24,97.183,284,8,0,2,285,1077,1360,2.64E-135,481,283,283
86267,Ntome_NODE_35461_length_356_cov_3,Nsylvestris_NODE_32216_length_385_cov_2,96.901,355,11,0,2,356,27,381,9.02E-170,595,354,354
86269,Ntome_NODE_35465_length_356_cov_3,Nsylvestris_NODE_21626_length_984_cov_26,84.59,305,27,8,54,356,451,165,2.22E-76,285,302,286
86279,Ntome_NODE_35479_length_355_cov_8,Nsylvestris_NODE_33785_length_328_cov_7,77.593,241,41,13,18,251,89,323,8.47E-31,134,233,234
86300,Ntome_NODE_35511_length_354_cov_3,Nsylvestris_NODE_8153_length_2380_cov_82,96.241,133,5,0,3,135,1323,1191,2.27E-56,219,132,132
86320,Ntome_NODE_35538_length_353_cov_4,Nsylvestris_NODE_31200_length_438_cov_12,94.571,350,16,1,1,350,69,415,1.53E-152,538,349,346
86331,Ntome_NODE_35553_length_353_cov_2,Nsylvestris_NODE_5714_length_2818_cov_31,95.751,353,13,1,1,353,2324,2674,1.95E-161,568,352,350
86350,Ntome_NODE_35573_length_352_cov_5,Nsylvestris_NODE_32264_length_383_cov_3,96.108,334,11,2,4,337,332,1,3.27E-154,544,333,331
86365,Ntome_NODE_35607_length_351_cov_5,Nsylvestris_NODE_34225_length_315_cov_8,95.254,295,14,0,1,295,295,1,2.02E-131,468,294,294
86413,Ntome_NODE_35686_length_348_cov_5,Nsylvestris_NODE_20773_length_1045_cov_11,94.224,277,16,0,72,348,1043,767,4.40E-118,424,276,276
86418,Ntome_NODE_35693_length_348_cov_3,Nsylvestris_NODE_27624_length_646_cov_5,94.842,349,14,2,1,348,371,26,1.16E-153,542,347,345
86438,Ntome_NODE_35720_length_347_cov_4,Nsylvestris_NODE_31581_length_415_cov_6,96.83,347,11,0,1,347,50,396,2.46E-165,580,346,346
86444,Ntome_NODE_35725_length_347_cov_4,Nsylvestris_NODE_17730_length_1292_cov_8,94.509,346,19,0,2,347,1040,695,1.94E-151,534,345,345
86447,Ntome_NODE_35727_length_347_cov_3,Nsylvestris_NODE_20800_length_1042_cov_75,86.93,329,18,7,39,345,468,143,9.76E-95,346,306,325
86454,Ntome_NODE_35733_length_347_cov_3,Nsylvestris_NODE_36945_length_253_cov_2,80.952,147,25,3,1,145,252,107,1.08E-24,113,144,145
86463,Ntome_NODE_35751_length_346_cov_9,Nsylvestris_NODE_22580_length_917_cov_12,92.197,346,26,1,1,346,293,637,1.53E-137,488,345,344
86476,Ntome_NODE_35777_length_346_cov_2,Nsylvestris_NODE_32508_length_372_cov_3,95.376,346,16,0,1,346,357,12,1.92E-156,551,345,345
86483,Ntome_NODE_35787_length_345_cov_8,Nsylvestris_NODE_26236_length_708_cov_27,97.345,339,9,0,7,345,138,476,3.16E-164,577,338,338
86491,Ntome_NODE_35805_length_345_cov_3,Nsylvestris_NODE_12915_length_1772_cov_230,95.115,348,14,1,1,345,1185,838,8.91E-155,545,344,347
86506,Ntome_NODE_35816_length_344_cov_7,Nsylvestris_NODE_28454_length_608_cov_6,95.361,194,8,1,1,194,74,266,4.56E-83,307,193,192
86514,Ntome_NODE_35822_length_344_cov_5,Nsylvestris_NODE_30815_length_463_cov_6,96.835,316,10,0,4,319,324,9,8.94E-150,529,315,315
86522,Ntome_NODE_35836_length_344_cov_2,Nsylvestris_NODE_33556_length_335_cov_5,93.119,218,10,3,121,333,1,218,2.73E-85,315,212,217
86542,Ntome_NODE_35858_length_343_cov_5,Nsylvestris_NODE_27376_length_657_cov_17,83.944,355,35,14,1,343,374,30,5.84E-87,320,342,344
86569,Ntome_NODE_35881_length_342_cov_20,Nsylvestris_NODE_19097_length_1175_cov_50,92.857,42,1,2,218,258,77,37,1.40E-08,60.2,40,40
86579,Ntome_NODE_35908_length_342_cov_3,Nsylvestris_NODE_28921_length_587_cov_8,93.805,113,7,0,49,161,475,587,6.21E-42,171,112,112
86611,Ntome_NODE_35956_length_340_cov_4,Nsylvestris_NODE_32180_length_386_cov_6,93.004,243,17,0,98,340,1,243,1.59E-97,355,242,242
86622,Ntome_NODE_35974_length_339_cov_5,Nsylvestris_NODE_16311_length_1418_cov_129,95.575,339,15,0,1,339,935,597,3.14E-154,544,338,338
86628,Ntome_NODE_35993_length_339_cov_2,Nsylvestris_NODE_35758_length_278_cov_5,95.21,167,6,1,175,339,278,112,9.86E-70,263,164,166
86645,Ntome_NODE_36006_length_338_cov_7,Nsylvestris_NODE_30116_length_516_cov_9,86.174,311,14,10,52,333,2,312,1.24E-83,309,281,310
86683,Ntome_NODE_36070_length_336_cov_10,Nsylvestris_NODE_26715_length_686_cov_167,91.74,339,22,3,1,334,581,244,6.93E-131,466,333,337
86689,Ntome_NODE_36083_length_336_cov_4,Nsylvestris_NODE_15052_length_1546_cov_48,94.925,335,17,0,1,335,1205,871,1.13E-148,525,334,334
86691,Ntome_NODE_36086_length_336_cov_4,Nsylvestris_NODE_30509_length_485_cov_18,86.726,339,40,4,2,336,7,344,1.55E-102,372,334,337
86694,Ntome_NODE_36094_length_336_cov_3,Nsylvestris_NODE_31768_length_405_cov_3,95.431,197,6,2,143,336,405,209,3.44E-84,311,193,196
86697,Ntome_NODE_36098_length_336_cov_3,Nsylvestris_NODE_11451_length_1936_cov_99,86.798,356,20,7,3,331,1602,1247,1.55E-102,372,328,355
86735,Ntome_NODE_36160_length_334_cov_5,Nsylvestris_NODE_24411_length_806_cov_41,90.882,340,16,3,1,334,680,350,1.16E-123,442,333,330
86761,Ntome_NODE_36198_length_333_cov_4,Nsylvestris_NODE_33025_length_352_cov_7,96.988,332,10,0,1,332,351,20,1.10E-158,558,331,331
86768,Ntome_NODE_36217_length_333_cov_2,Nsylvestris_NODE_36410_length_264_cov_3,99.621,264,1,0,64,327,264,1,6.82E-136,483,263,263
86813,Ntome_NODE_36267_length_331_cov_5,Nsylvestris_NODE_33163_length_347_cov_4,86.25,80,5,1,252,331,341,268,2.89E-15,82.4,79,73
86826,Ntome_NODE_36293_length_330_cov_25,Nsylvestris_NODE_29940_length_533_cov_7,85.816,141,13,5,192,330,41,176,1.30E-33,143,138,135
86832,Ntome_NODE_36300_length_330_cov_6,Nsylvestris_NODE_4066_length_3215_cov_76,90,60,4,2,226,283,625,566,1.34E-13,76.8,57,59
86838,Ntome_NODE_36313_length_330_cov_4,Nsylvestris_NODE_30407_length_494_cov_5,89.407,236,24,1,1,236,259,493,9.44E-80,296,235,234
86844,Ntome_NODE_36323_length_330_cov_2,Nsylvestris_NODE_22351_length_932_cov_44,96.732,306,9,1,26,330,561,256,1.11E-143,508,304,305
86850,Ntome_NODE_36337_length_329_cov_3,Nsylvestris_NODE_27814_length_637_cov_53,96.241,133,5,0,197,329,55,187,2.10E-56,219,132,132
86865,Ntome_NODE_36351_length_328_cov_77,Nsylvestris_NODE_30276_length_505_cov_8,91.473,129,5,4,205,328,461,334,1.65E-42,172,123,127
86876,Ntome_NODE_36379_length_328_cov_3,Nsylvestris_NODE_29840_length_542_cov_4,95,180,8,1,1,180,179,1,2.63E-75,281,179,178
86880,Ntome_NODE_36388_length_328_cov_1,Nsylvestris_NODE_32113_length_389_cov_5,92.284,324,24,1,1,324,356,34,1.13E-128,459,323,322
86922,Ntome_NODE_36442_length_326_cov_4,Nsylvestris_NODE_32139_length_388_cov_4,88.889,189,20,1,134,322,1,188,2.67E-60,231,188,187
86925,Ntome_NODE_36453_length_326_cov_1,Nsylvestris_NODE_32540_length_371_cov_2,95.392,217,6,3,1,216,214,1,1.18E-93,342,215,213
86974,Ntome_NODE_36521_length_324_cov_2,Nsylvestris_NODE_8824_length_2276_cov_16,97.368,228,6,0,86,313,2276,2049,1.48E-107,388,227,227
86997,Ntome_NODE_36541_length_323_cov_5,Nsylvestris_NODE_31546_length_417_cov_3,97.426,272,7,0,51,322,416,145,2.39E-130,464,271,271
87000,Ntome_NODE_36544_length_323_cov_5,Nsylvestris_NODE_30891_length_458_cov_7,90.476,273,22,1,39,311,458,190,4.17E-98,357,272,268
87004,Ntome_NODE_36551_length_323_cov_3,Nsylvestris_NODE_33058_length_351_cov_4,81.928,249,26,10,49,281,246,1,1.25E-48,193,232,245
87015,Ntome_NODE_36567_length_322_cov_5,Nsylvestris_NODE_31047_length_448_cov_7,95.062,324,13,3,1,322,3,325,3.90E-143,507,321,322
87017,Ntome_NODE_36570_length_322_cov_4,Nsylvestris_NODE_10611_length_2036_cov_26,95.886,316,13,0,7,322,856,541,8.39E-145,512,315,315
87018,Ntome_NODE_36572_length_321_cov_4,Nsylvestris_NODE_16523_length_1398_cov_15,91.489,329,16,3,2,321,432,757,1.11E-123,442,319,325
87032,Ntome_NODE_36600_length_321_cov_4,Nsylvestris_NODE_16236_length_1426_cov_91,97.196,321,9,0,1,321,809,1129,2.96E-154,544,320,320
87041,Ntome_NODE_36614_length_321_cov_2,Nsylvestris_NODE_28009_length_629_cov_3,90.909,275,16,4,50,321,395,127,3.20E-99,361,271,268
87063,Ntome_NODE_36634_length_320_cov_4,Nsylvestris_NODE_30444_length_491_cov_9,90.78,282,19,3,41,320,175,451,5.31E-102,370,279,276
87065,Ntome_NODE_36636_length_320_cov_4,Nsylvestris_NODE_33802_length_328_cov_3,93.262,282,19,0,1,282,47,328,6.72E-116,416,281,281
87095,Ntome_NODE_36676_length_319_cov_5,Nsylvestris_NODE_34013_length_321_cov_7,96.386,166,6,0,154,319,321,156,4.27E-73,274,165,165
87115,Ntome_NODE_36719_length_318_cov_6,Nsylvestris_NODE_31348_length_429_cov_8,97.59,83,1,1,1,83,348,429,4.50E-33,141,82,81
87139,Ntome_NODE_36764_length_317_cov_3,Nsylvestris_NODE_19348_length_1156_cov_8,85.938,128,2,1,1,112,128,1,1.62E-27,122,111,127
87148,Ntome_NODE_36778_length_316_cov_8,Nsylvestris_NODE_34781_length_300_cov_7,96.656,299,6,3,1,298,296,1,2.98E-139,494,297,295
87156,Ntome_NODE_36790_length_316_cov_4,Nsylvestris_NODE_30510_length_485_cov_12,82.734,139,23,1,51,189,348,485,1.62E-27,122,138,137
87162,Ntome_NODE_36796_length_316_cov_4,Nsylvestris_NODE_16397_length_1410_cov_22,92.434,304,17,2,1,301,849,1149,8.51E-120,429,300,300
87185,Ntome_NODE_36816_length_315_cov_15,Nsylvestris_NODE_34451_length_309_cov_7,96.117,309,11,1,1,308,1,309,4.93E-142,503,307,308
87233,Ntome_NODE_36910_length_313_cov_3,Nsylvestris_NODE_7935_length_2414_cov_105,93.311,299,19,1,16,313,407,109,3.89E-123,440,297,298
87238,Ntome_NODE_36917_length_313_cov_2,Nsylvestris_NODE_36468_length_263_cov_3,92.045,264,20,1,3,266,263,1,5.18E-102,370,263,262
87253,Ntome_NODE_36932_length_312_cov_5,Nsylvestris_NODE_36444_length_263_cov_5,95.42,262,9,3,1,260,3,263,2.35E-115,414,259,260
87259,Ntome_NODE_36951_length_312_cov_3,Nsylvestris_NODE_12769_length_1790_cov_13,96.795,312,10,0,1,312,1716,1405,1.35E-147,521,311,311
87260,Ntome_NODE_36953_length_312_cov_2,Nsylvestris_NODE_32282_length_382_cov_4,84.656,189,13,4,137,309,344,156,4.34E-43,174,172,188
87268,Ntome_NODE_36964_length_311_cov_12,Nsylvestris_NODE_36666_length_258_cov_25,94.922,256,7,3,1,255,8,258,8.49E-110,396,254,250
87286,Ntome_NODE_36986_length_311_cov_4,Nsylvestris_NODE_24752_length_786_cov_10,91.011,89,6,1,223,311,483,569,2.06E-26,119,88,86
87311,Ntome_NODE_37023_length_310_cov_6,Nsylvestris_NODE_25820_length_727_cov_103,89.198,324,21,2,1,310,587,264,1.09E-108,392,309,323
87319,Ntome_NODE_37038_length_310_cov_3,Nsylvestris_NODE_33859_length_326_cov_5,93.092,304,14,3,14,310,6,309,1.39E-122,438,296,303
87321,Ntome_NODE_37041_length_310_cov_3,Nsylvestris_NODE_28112_length_624_cov_10,94.056,286,15,1,27,310,598,313,6.45E-121,433,283,285
87342,Ntome_NODE_37071_length_309_cov_4,Nsylvestris_NODE_726_length_5395_cov_45,90.566,318,20,6,1,309,3649,3333,8.37E-115,412,308,316
87347,Ntome_NODE_37096_length_309_cov_2,Nsylvestris_NODE_27907_length_633_cov_3,89.796,245,24,1,65,309,622,379,8.73E-85,313,244,243
87349,Ntome_NODE_37098_length_309_cov_1,Nsylvestris_NODE_29004_length_584_cov_4,93.226,310,20,1,1,309,498,189,1.37E-127,455,308,309
87373,Ntome_NODE_37114_length_308_cov_6,Nsylvestris_NODE_23673_length_850_cov_58,93.399,303,17,1,6,308,624,325,8.22E-125,446,302,299
87377,Ntome_NODE_37126_length_308_cov_5,Nsylvestris_NODE_35712_length_279_cov_5,92.578,256,10,5,1,253,30,279,1.10E-98,359,252,249
87379,Ntome_NODE_37141_length_308_cov_3,Nsylvestris_NODE_20498_length_1065_cov_8,94.643,56,2,1,1,56,372,426,2.06E-16,86.1,55,54
87407,Ntome_NODE_37172_length_307_cov_4,Nsylvestris_NODE_36316_length_266_cov_4,93.82,178,11,0,129,306,61,238,1.90E-71,268,177,177
87413,Ntome_NODE_37182_length_307_cov_2,Nsylvestris_NODE_20874_length_1037_cov_31,83.224,304,31,3,1,304,523,806,3.19E-69,261,303,283
87439,Ntome_NODE_37215_length_306_cov_3,Nsylvestris_NODE_8988_length_2253_cov_11,94.578,166,9,0,1,166,259,94,4.11E-68,257,165,165
87452,Ntome_NODE_37233_length_305_cov_9,Nsylvestris_NODE_26691_length_687_cov_201,91.883,308,13,2,1,305,270,568,4.93E-117,420,304,298
87465,Ntome_NODE_37260_length_305_cov_2,Nsylvestris_NODE_26782_length_684_cov_10,97.917,48,1,0,10,57,637,684,7.35E-16,84.2,47,47
87495,Ntome_NODE_37293_length_304_cov_3,Nsylvestris_NODE_22118_length_948_cov_15,87.869,305,26,7,1,304,402,108,2.35E-95,348,303,294
87497,Ntome_NODE_37301_length_304_cov_2,Nsylvestris_NODE_34527_length_307_cov_3,93.534,232,12,2,74,304,1,230,1.09E-93,342,230,229
87525,Ntome_NODE_37346_length_303_cov_2,Nsylvestris_NODE_31723_length_407_cov_4,95.05,303,15,0,1,303,9,311,2.86E-134,477,302,302
87552,Ntome_NODE_37361_length_302_cov_6,Nsylvestris_NODE_16358_length_1414_cov_75,85.354,198,17,6,1,196,1056,1243,3.22E-49,195,195,187
87559,Ntome_NODE_37371_length_302_cov_5,Nsylvestris_NODE_28567_length_603_cov_6,97.701,261,6,0,42,302,603,343,6.22E-126,449,260,260
87564,Ntome_NODE_37383_length_302_cov_3,Nsylvestris_NODE_36735_length_257_cov_3,96.241,133,5,0,170,302,256,124,1.91E-56,219,132,132
87593,Ntome_NODE_37436_length_301_cov_3,Nsylvestris_NODE_4353_length_3139_cov_67,81.364,220,26,6,80,299,2071,1867,2.51E-40,165,219,204
87616,Ntome_NODE_37480_length_300_cov_3,Nsylvestris_NODE_9743_length_2147_cov_189,95.802,262,6,5,40,299,642,900,1.74E-116,418,259,258
87635,Ntome_NODE_37508_length_299_cov_4,Nsylvestris_NODE_30030_length_525_cov_26,93.617,282,6,1,28,297,93,374,2.90E-114,411,269,281
87708,Ntome_NODE_37605_length_297_cov_6,Nsylvestris_NODE_20249_length_1083_cov_7,84.513,226,34,1,1,226,242,18,1.45E-57,222,225,224
87736,Ntome_NODE_37647_length_296_cov_5,Nsylvestris_NODE_33508_length_336_cov_6,94.366,213,12,0,84,296,246,34,2.98E-89,327,212,212
87739,Ntome_NODE_37653_length_296_cov_4,Nsylvestris_NODE_31867_length_400_cov_5,89.562,297,14,2,1,296,88,368,2.93E-99,361,295,280
87768,Ntome_NODE_37693_length_295_cov_4,Nsylvestris_NODE_16616_length_1390_cov_92,97.966,295,6,0,1,295,743,449,7.63E-145,512,294,294
87769,Ntome_NODE_37694_length_295_cov_3,Nsylvestris_NODE_25565_length_741_cov_8,90.268,298,22,5,1,295,382,675,6.24E-106,383,294,293
87770,Ntome_NODE_37699_length_295_cov_3,Nsylvestris_NODE_25871_length_725_cov_12,96.61,295,10,0,1,295,209,503,3.57E-138,490,294,294
87772,Ntome_NODE_37702_length_295_cov_3,Nsylvestris_NODE_29547_length_561_cov_52,91.892,296,15,6,1,295,83,370,1.33E-112,405,294,287
87797,Ntome_NODE_37724_length_294_cov_9,Nsylvestris_NODE_36579_length_260_cov_6,93.75,256,16,0,38,293,257,2,1.73E-106,385,255,255
87813,Ntome_NODE_37755_length_294_cov_3,Nsylvestris_NODE_9380_length_2196_cov_222,88.496,113,10,3,1,113,1262,1371,6.91E-31,134,112,109
87827,Ntome_NODE_37795_length_293_cov_3,Nsylvestris_NODE_16477_length_1402_cov_9,95.563,293,10,2,4,293,223,515,5.98E-131,466,289,292
87844,Ntome_NODE_37834_length_292_cov_4,Nsylvestris_NODE_33428_length_338_cov_10,93.893,262,9,1,28,289,3,257,1.33E-107,388,261,254
87847,Ntome_NODE_37841_length_292_cov_4,Nsylvestris_NODE_32912_length_356_cov_4,92.466,292,15,1,1,292,18,302,2.83E-114,411,291,284
87875,Ntome_NODE_37864_length_291_cov_8,Nsylvestris_NODE_30595_length_479_cov_8,93.559,295,14,4,1,291,186,479,1.67E-121,435,290,293
87900,Ntome_NODE_37905_length_290_cov_7,Nsylvestris_NODE_24008_length_832_cov_7,93.284,268,18,0,1,268,351,84,7.87E-110,396,267,267
87909,Ntome_NODE_37917_length_290_cov_4,Nsylvestris_NODE_32080_length_390_cov_165,96.587,293,7,2,1,290,70,362,5.87E-136,483,289,292
87921,Ntome_NODE_37941_length_289_cov_43,Nsylvestris_NODE_32895_length_356_cov_51,92.347,196,13,2,36,230,25,219,2.96E-74,278,194,194
87927,Ntome_NODE_37945_length_289_cov_9,Nsylvestris_NODE_29957_length_532_cov_2,91.63,227,13,3,65,289,532,310,1.05E-83,309,224,222
87933,Ntome_NODE_37963_length_289_cov_4,Nsylvestris_NODE_21275_length_1009_cov_5,91.623,191,5,2,1,187,764,947,4.99E-67,254,186,183
87939,Ntome_NODE_37976_length_289_cov_2,Nsylvestris_NODE_34626_length_304_cov_7,88.889,135,13,2,1,133,135,1,2.41E-40,165,132,134
87980,Ntome_NODE_38002_length_288_cov_5,Nsylvestris_NODE_32349_length_379_cov_3,97.569,288,7,0,1,288,363,76,2.69E-139,494,287,287
87986,Ntome_NODE_38011_length_288_cov_4,Nsylvestris_NODE_27637_length_645_cov_5,96.596,235,8,0,7,241,1,235,3.63E-108,390,234,234
87987,Ntome_NODE_38012_length_288_cov_4,Nsylvestris_NODE_35730_length_279_cov_3,97.512,201,5,0,1,201,71,271,2.87E-94,344,200,200
87988,Ntome_NODE_38015_length_288_cov_4,Nsylvestris_NODE_31170_length_440_cov_37,95.918,196,5,2,91,283,440,245,2.25E-85,315,192,195
87996,Ntome_NODE_38033_length_288_cov_2,Nsylvestris_NODE_30991_length_452_cov_9,87.762,286,35,0,1,286,8,293,1.73E-91,335,285,285
88023,Ntome_NODE_38077_length_287_cov_1,Nsylvestris_NODE_20003_length_1102_cov_217,94.656,262,14,0,1,262,357,618,3.59E-113,407,261,261
88113,Ntome_NODE_38221_length_284_cov_4,Nsylvestris_NODE_27900_length_633_cov_7,91.544,272,20,1,1,269,1,272,1.30E-102,372,268,271
88118,Ntome_NODE_38237_length_284_cov_3,Nsylvestris_NODE_32051_length_392_cov_3,87.814,279,11,11,12,284,32,293,1.33E-82,305,272,261
88130,Ntome_NODE_38256_length_283_cov_4,Nsylvestris_NODE_8626_length_2306_cov_35,97.509,281,7,0,3,283,1238,958,2.06E-135,481,280,280
88131,Ntome_NODE_38257_length_284_cov_4,Nsylvestris_NODE_20235_length_1083_cov_197,92.982,57,4,0,144,200,620,676,6.80E-16,84.2,56,56
88132,Ntome_NODE_38265_length_283_cov_3,Nsylvestris_NODE_31997_length_394_cov_5,93.902,246,14,1,1,246,265,21,4.64E-102,370,245,244
88160,Ntome_NODE_38298_length_282_cov_5,Nsylvestris_NODE_32255_length_383_cov_6,93.19,279,16,2,1,279,87,362,3.52E-113,407,278,275
88161,Ntome_NODE_38304_length_282_cov_4,Nsylvestris_NODE_28348_length_612_cov_13,92.334,287,17,2,1,282,142,428,4.56E-112,403,281,286
88167,Ntome_NODE_38322_length_282_cov_3,Nsylvestris_NODE_25590_length_740_cov_4,100,31,0,0,222,252,49,19,4.09E-08,58.4,30,30
88170,Ntome_NODE_38327_length_282_cov_3,Nsylvestris_NODE_23068_length_887_cov_14,91.429,280,24,0,3,282,434,713,1.65E-106,385,279,279
88189,Ntome_NODE_38339_length_281_cov_16,Nsylvestris_NODE_30027_length_525_cov_82,94.224,277,16,0,1,277,186,462,3.49E-118,424,276,276
88197,Ntome_NODE_38347_length_281_cov_6,Nsylvestris_NODE_26678_length_688_cov_11,92,200,4,2,1,194,204,397,4.81E-72,270,193,193
88200,Ntome_NODE_38352_length_281_cov_5,Nsylvestris_NODE_13768_length_1677_cov_45,80.702,285,31,12,1,281,134,398,6.40E-51,200,280,264
88204,Ntome_NODE_38371_length_281_cov_2,Nsylvestris_NODE_1227_length_4677_cov_68,88.06,134,11,2,134,267,3432,3304,5.05E-37,154,133,128
88219,Ntome_NODE_38389_length_280_cov_5,Nsylvestris_NODE_25294_length_755_cov_16,92.908,282,15,5,1,280,477,755,1.26E-112,405,279,278
88220,Ntome_NODE_38392_length_280_cov_5,Nsylvestris_NODE_24788_length_784_cov_11,88.776,294,16,6,3,280,739,447,2.78E-94,344,277,292
88221,Ntome_NODE_38394_length_280_cov_4,Nsylvestris_NODE_21361_length_1004_cov_6,80.074,271,41,9,7,275,853,594,1.38E-47,189,268,259
88229,Ntome_NODE_38411_length_280_cov_3,Nsylvestris_NODE_36474_length_263_cov_3,89.726,146,14,1,136,280,262,117,1.78E-46,185,144,145
88265,Ntome_NODE_38457_length_279_cov_3,Nsylvestris_NODE_23532_length_858_cov_5,90.253,277,24,2,1,276,505,779,9.89E-99,359,275,274
88276,Ntome_NODE_38470_length_278_cov_7,Nsylvestris_NODE_25815_length_728_cov_4,86.364,88,6,6,188,273,171,88,3.97E-18,91.6,85,83
88287,Ntome_NODE_38491_length_278_cov_4,Nsylvestris_NODE_33122_length_348_cov_22,95.683,278,12,0,1,278,13,290,2.04E-125,448,277,277
88288,Ntome_NODE_38494_length_278_cov_4,Nsylvestris_NODE_32369_length_378_cov_3,82.969,229,38,1,48,276,378,151,1.36E-52,206,228,227
88292,Ntome_NODE_38503_length_278_cov_3,Nsylvestris_NODE_25310_length_754_cov_49,97.143,280,5,1,1,277,409,130,4.36E-132,470,276,279
88317,Ntome_NODE_38542_length_277_cov_4,Nsylvestris_NODE_10589_length_2039_cov_52,97.473,277,7,0,1,277,366,642,3.36E-133,473,276,276
88322,Ntome_NODE_38555_length_277_cov_2,Nsylvestris_NODE_30701_length_471_cov_7,98.917,277,3,0,1,277,298,22,7.17E-140,496,276,276
88357,Ntome_NODE_38623_length_275_cov_3,Nsylvestris_NODE_33347_length_341_cov_3,91.866,209,7,3,1,209,143,341,6.03E-76,283,208,198
88390,Ntome_NODE_38656_length_274_cov_6,Nsylvestris_NODE_33992_length_322_cov_4,93.81,210,13,0,2,211,214,5,5.92E-86,316,209,209
88398,Ntome_NODE_38678_length_274_cov_3,Nsylvestris_NODE_31310_length_431_cov_7,87.826,115,14,0,5,119,249,363,1.78E-31,135,114,114
88404,Ntome_NODE_38693_length_274_cov_1,Nsylvestris_NODE_15749_length_1475_cov_113,92.336,274,18,2,1,274,466,196,4.45E-107,387,273,270
88424,Ntome_NODE_38718_length_273_cov_4,Nsylvestris_NODE_35911_length_275_cov_3,97.209,215,6,0,1,215,215,1,2.08E-100,364,214,214
88459,Ntome_NODE_38760_length_272_cov_4,Nsylvestris_NODE_34871_length_298_cov_6,88.421,95,10,1,138,231,100,6,8.27E-25,113,93,94
88480,Ntome_NODE_38798_length_271_cov_5,Nsylvestris_NODE_15187_length_1532_cov_25,95.572,271,12,0,1,271,644,374,1.55E-121,435,270,270
88500,Ntome_NODE_38838_length_270_cov_14,Nsylvestris_NODE_36078_length_271_cov_23,92.969,256,15,2,15,267,13,268,4.41E-102,370,252,255
88501,Ntome_NODE_38839_length_270_cov_10,Nsylvestris_NODE_30818_length_461_cov_4,97.619,84,2,0,1,84,32,115,2.91E-34,145,83,83
88511,Ntome_NODE_38862_length_270_cov_4,Nsylvestris_NODE_35398_length_286_cov_5,89.655,232,18,5,35,260,285,54,3.53E-78,291,225,231
88517,Ntome_NODE_38892_length_270_cov_3,Nsylvestris_NODE_21018_length_1027_cov_14,95.911,269,11,0,2,270,376,108,4.29E-122,436,268,268
88520,Ntome_NODE_38894_length_270_cov_2,Nsylvestris_NODE_20421_length_1070_cov_52,98.864,88,1,0,76,163,367,280,3.74E-38,158,87,87
88529,Ntome_NODE_38898_length_269_cov_78,Nsylvestris_NODE_33576_length_334_cov_28,93.939,231,11,1,2,229,100,330,7.40E-95,346,227,230
88541,Ntome_NODE_38922_length_269_cov_3,Nsylvestris_NODE_34128_length_318_cov_4,95.597,159,6,1,112,269,1,159,4.61E-67,254,157,158
88542,Ntome_NODE_38923_length_269_cov_3,Nsylvestris_NODE_9632_length_2161_cov_8,97.297,148,4,0,122,269,1,148,1.66E-66,252,147,147
88543,Ntome_NODE_38925_length_269_cov_3,Nsylvestris_NODE_33333_length_341_cov_5,96.911,259,7,1,10,268,297,40,5.52E-121,433,258,257
88545,Ntome_NODE_38927_length_269_cov_3,Nsylvestris_NODE_2070_length_4011_cov_26,97.77,269,6,0,1,269,2874,2606,1.96E-130,464,268,268
88552,Ntome_NODE_38942_length_268_cov_8,Nsylvestris_NODE_31157_length_441_cov_5,96.988,166,5,0,1,166,276,441,7.58E-75,279,165,165
88570,Ntome_NODE_38969_length_268_cov_4,Nsylvestris_NODE_29880_length_538_cov_7,98.039,204,4,0,65,268,538,335,1.22E-97,355,203,203
88593,Ntome_NODE_39000_length_267_cov_5,Nsylvestris_NODE_20862_length_1038_cov_24,89.256,121,11,2,87,206,576,457,6.18E-36,150,119,119
88610,Ntome_NODE_39022_length_267_cov_2,Nsylvestris_NODE_13502_length_1706_cov_57,98.127,267,5,0,1,267,1050,784,5.40E-131,466,266,266
88633,Ntome_NODE_39058_length_266_cov_4,Nsylvestris_NODE_33297_length_343_cov_3,93.962,265,15,1,1,265,61,324,5.53E-111,399,264,263
88637,Ntome_NODE_39068_length_266_cov_3,Nsylvestris_NODE_29179_length_576_cov_6,86.94,268,22,4,1,260,263,525,1.25E-77,289,259,262
88639,Ntome_NODE_39070_length_266_cov_3,Nsylvestris_NODE_28814_length_592_cov_8,98.12,266,5,0,1,266,399,134,1.93E-130,464,265,265
88640,Ntome_NODE_39072_length_266_cov_2,Nsylvestris_NODE_17243_length_1337_cov_22,98.496,266,4,0,1,266,893,628,4.16E-132,470,265,265
88669,Ntome_NODE_39111_length_265_cov_4,Nsylvestris_NODE_34961_length_296_cov_4,95.055,182,8,1,9,189,114,295,1.61E-76,285,180,181
88719,Ntome_NODE_39195_length_264_cov_2,Nsylvestris_NODE_16900_length_1365_cov_69,92.893,197,14,0,1,197,1121,1317,4.46E-77,287,196,196
88743,Ntome_NODE_39228_length_263_cov_4,Nsylvestris_NODE_23883_length_839_cov_98,96.774,62,2,0,97,158,778,839,4.80E-22,104,61,61
88753,Ntome_NODE_39246_length_263_cov_3,Nsylvestris_NODE_34504_length_308_cov_2,98.361,122,2,0,1,122,122,1,2.12E-55,215,121,121
88756,Ntome_NODE_39251_length_263_cov_3,Nsylvestris_NODE_30704_length_471_cov_5,93.633,267,11,4,1,263,417,153,2.54E-109,394,262,264
88806,Ntome_NODE_39303_length_262_cov_3,Nsylvestris_NODE_22158_length_945_cov_17,82.117,274,34,7,3,261,624,897,4.55E-57,220,258,273
88824,Ntome_NODE_39333_length_261_cov_4,Nsylvestris_NODE_28511_length_606_cov_4,87.879,264,19,7,1,261,268,521,2.03E-80,298,260,253
88825,Ntome_NODE_39336_length_260_cov_4,Nsylvestris_NODE_31398_length_425_cov_16,95.094,265,6,4,3,260,10,274,2.49E-114,411,257,264
88827,Ntome_NODE_39344_length_261_cov_3,Nsylvestris_NODE_16357_length_1414_cov_113,95.263,190,9,0,72,261,1299,1110,1.57E-81,302,189,189
88830,Ntome_NODE_39354_length_260_cov_3,Nsylvestris_NODE_35073_length_293_cov_4,91.463,164,13,1,97,260,293,131,3.49E-58,224,163,162
88837,Ntome_NODE_39375_length_260_cov_6,Nsylvestris_NODE_35111_length_292_cov_6,90.909,143,11,2,118,259,62,203,3.53E-48,191,141,141
88890,Ntome_NODE_39457_length_259_cov_2,Nsylvestris_NODE_20242_length_1083_cov_62,96.109,257,10,0,1,257,588,332,4.12E-117,420,256,256
88905,Ntome_NODE_39479_length_258_cov_5,Nsylvestris_NODE_26945_length_676_cov_6,96.774,248,8,0,1,248,248,1,1.91E-115,414,247,247
88909,Ntome_NODE_39488_length_258_cov_4,Nsylvestris_NODE_13656_length_1690_cov_76,85.714,259,13,10,1,258,1044,1279,1.59E-66,252,257,235
88917,Ntome_NODE_39494_length_258_cov_3,Nsylvestris_NODE_30473_length_488_cov_8,94.8,250,13,0,3,252,228,477,3.22E-108,390,249,249
88943,Ntome_NODE_39529_length_257_cov_5,Nsylvestris_NODE_3978_length_3239_cov_19,93.385,257,17,0,1,257,346,90,1.93E-105,381,256,256
88949,Ntome_NODE_39537_length_257_cov_4,Nsylvestris_NODE_36635_length_259_cov_4,97.98,198,2,1,60,257,259,64,9.10E-94,342,197,195
88951,Ntome_NODE_39543_length_257_cov_4,Nsylvestris_NODE_32229_length_384_cov_6,92.692,260,16,1,1,257,370,111,1.16E-102,372,256,259
88959,Ntome_NODE_39566_length_257_cov_2,Nsylvestris_NODE_33938_length_324_cov_3,88.976,127,13,1,113,239,199,324,1.27E-37,156,126,125
88982,Ntome_NODE_39595_length_256_cov_4,Nsylvestris_NODE_35268_length_289_cov_3,95.862,145,5,1,113,256,59,203,5.69E-61,233,143,144
89016,Ntome_NODE_39649_length_255_cov_4,Nsylvestris_NODE_31227_length_437_cov_5,90.09,111,10,1,1,111,110,1,9.83E-34,143,110,109
89065,Ntome_NODE_39727_length_254_cov_2,Nsylvestris_NODE_31366_length_428_cov_4,90.65,246,17,4,1,243,186,428,1.17E-87,322,242,242
89068,Ntome_NODE_39731_length_254_cov_1,Nsylvestris_NODE_14405_length_1610_cov_15,95.669,254,11,0,1,254,1218,965,8.74E-114,409,253,253
89098,Ntome_NODE_39774_length_253_cov_3,Nsylvestris_NODE_20959_length_1031_cov_30,87.671,146,15,3,108,252,203,60,5.78E-41,167,144,143
89107,Ntome_NODE_39780_length_253_cov_2,Nsylvestris_NODE_36104_length_271_cov_4,96.444,225,8,0,27,251,1,225,1.14E-102,372,224,224
89130,Ntome_NODE_39812_length_252_cov_4,Nsylvestris_NODE_24948_length_774_cov_33,94.8,250,13,0,3,252,400,649,3.14E-108,390,249,249
89131,Ntome_NODE_39815_length_252_cov_4,Nsylvestris_NODE_13812_length_1672_cov_108,89.72,214,10,6,51,252,547,760,7.14E-70,263,201,213
89132,Ntome_NODE_39817_length_251_cov_4,Nsylvestris_NODE_8861_length_2270_cov_67,90.98,255,17,3,2,250,914,1168,1.15E-92,339,248,254
89172,Ntome_NODE_39858_length_251_cov_9,Nsylvestris_NODE_32708_length_363_cov_51,91.02,245,22,0,7,251,260,16,1.92E-90,331,244,244
89180,Ntome_NODE_39872_length_251_cov_4,Nsylvestris_NODE_35967_length_274_cov_2,96.216,185,7,0,67,251,4,188,4.19E-82,303,184,184
89184,Ntome_NODE_39883_length_251_cov_3,Nsylvestris_NODE_30767_length_467_cov_10,95.652,161,7,0,1,161,307,467,9.19E-69,259,160,160
89209,Ntome_NODE_39923_length_250_cov_4,Nsylvestris_NODE_36522_length_262_cov_2,92.105,190,12,2,56,245,261,75,1.97E-70,265,189,186
89216,Ntome_NODE_39949_length_250_cov_3,Nsylvestris_NODE_31889_length_399_cov_3,92.035,113,6,1,1,110,115,3,1.23E-37,156,109,112
